date,state,daily,donations_new,donations_returning,year
2006-01-01,Johor,87,36,51,2006
2006-01-02,Johor,15,4,11,2006
2006-01-03,Johor,8,2,6,2006
2006-01-04,Johor,33,25,8,2006
2006-01-05,Johor,20,16,4,2006
2006-01-06,Johor,4,0,4,2006
2006-01-07,Johor,1,1,0,2006
2006-01-08,Johor,86,10,76,2006
2006-01-09,Johor,3,3,0,2006
2006-01-10,Johor,2,0,2,2006
2006-01-11,Johor,14,6,8,2006
2006-01-12,Johor,38,33,5,2006
2006-01-13,Johor,24,20,4,2006
2006-01-14,Johor,2,1,1,2006
2006-01-15,Johor,148,18,130,2006
2006-01-16,Johor,75,62,13,2006
2006-01-17,Johor,25,19,6,2006
2006-01-18,Johor,26,21,5,2006
2006-01-19,Johor,50,44,6,2006
2006-01-20,Johor,62,51,11,2006
2006-01-21,Johor,40,32,8,2006
2006-01-22,Johor,2,2,0,2006
2006-01-23,Johor,8,2,6,2006
2006-01-24,Johor,3,0,3,2006
2006-01-25,Johor,12,7,5,2006
2006-01-26,Johor,12,7,5,2006
2006-01-27,Johor,22,9,13,2006
2006-01-28,Johor,0,0,0,2006
2006-01-29,Johor,0,0,0,2006
2006-01-30,Johor,2,2,0,2006
2006-01-31,Johor,0,0,0,2006
2006-02-01,Johor,0,0,0,2006
2006-02-02,Johor,23,8,15,2006
2006-02-03,Johor,8,1,7,2006
2006-02-04,Johor,0,0,0,2006
2006-02-05,Johor,98,53,45,2006
2006-02-06,Johor,14,9,5,2006
2006-02-07,Johor,48,17,31,2006
2006-02-08,Johor,85,45,40,2006
2006-02-09,Johor,16,8,8,2006
2006-02-10,Johor,23,16,7,2006
2006-02-11,Johor,10,9,1,2006
2006-02-12,Johor,126,27,99,2006
2006-02-13,Johor,16,11,5,2006
2006-02-14,Johor,35,28,7,2006
2006-02-15,Johor,32,23,9,2006
2006-02-16,Johor,14,8,6,2006
2006-02-17,Johor,13,7,6,2006
2006-02-18,Johor,54,53,1,2006
2006-02-19,Johor,4,3,1,2006
2006-02-20,Johor,11,5,6,2006
2006-02-21,Johor,70,53,17,2006
2006-02-22,Johor,20,11,9,2006
2006-02-23,Johor,4,1,3,2006
2006-02-24,Johor,63,52,11,2006
2006-02-25,Johor,0,0,0,2006
2006-02-26,Johor,79,34,45,2006
2006-02-27,Johor,25,16,9,2006
2006-02-28,Johor,23,16,7,2006
2006-03-01,Johor,16,12,4,2006
2006-03-02,Johor,2,0,2,2006
2006-03-03,Johor,31,25,6,2006
2006-03-04,Johor,0,0,0,2006
2006-03-05,Johor,36,9,27,2006
2006-03-06,Johor,9,0,9,2006
2006-03-07,Johor,48,42,6,2006
2006-03-08,Johor,21,13,8,2006
2006-03-09,Johor,20,3,17,2006
2006-03-10,Johor,29,23,6,2006
2006-03-11,Johor,1,0,1,2006
2006-03-12,Johor,117,48,69,2006
2006-03-13,Johor,8,2,6,2006
2006-03-14,Johor,11,3,8,2006
2006-03-15,Johor,10,3,7,2006
2006-03-16,Johor,186,143,43,2006
2006-03-17,Johor,50,42,8,2006
2006-03-18,Johor,1,0,1,2006
2006-03-19,Johor,0,0,0,2006
2006-03-20,Johor,8,2,6,2006
2006-03-21,Johor,13,8,5,2006
2006-03-22,Johor,2,1,1,2006
2006-03-23,Johor,2,0,2,2006
2006-03-24,Johor,19,13,6,2006
2006-03-25,Johor,19,6,13,2006
2006-03-26,Johor,25,8,17,2006
2006-03-27,Johor,3,0,3,2006
2006-03-28,Johor,6,2,4,2006
2006-03-29,Johor,33,28,5,2006
2006-03-30,Johor,0,0,0,2006
2006-03-31,Johor,6,2,4,2006
2006-04-01,Johor,0,0,0,2006
2006-04-02,Johor,37,20,17,2006
2006-04-03,Johor,4,2,2,2006
2006-04-04,Johor,20,17,3,2006
2006-04-05,Johor,11,8,3,2006
2006-04-06,Johor,103,66,37,2006
2006-04-07,Johor,23,13,10,2006
2006-04-08,Johor,0,0,0,2006
2006-04-09,Johor,1,0,1,2006
2006-04-10,Johor,11,1,10,2006
2006-04-11,Johor,1,0,1,2006
2006-04-12,Johor,4,0,4,2006
2006-04-13,Johor,54,47,7,2006
2006-04-14,Johor,39,27,12,2006
2006-04-15,Johor,61,41,20,2006
2006-04-16,Johor,119,43,76,2006
2006-04-17,Johor,24,16,8,2006
2006-04-18,Johor,11,4,7,2006
2006-04-19,Johor,10,5,5,2006
2006-04-20,Johor,7,2,5,2006
2006-04-21,Johor,9,5,4,2006
2006-04-22,Johor,1,0,1,2006
2006-04-23,Johor,137,32,105,2006
2006-04-24,Johor,43,35,8,2006
2006-04-25,Johor,1,0,1,2006
2006-04-26,Johor,87,25,62,2006
2006-04-27,Johor,24,15,9,2006
2006-04-28,Johor,53,38,15,2006
2006-04-29,Johor,2,1,1,2006
2006-04-30,Johor,54,11,43,2006
2006-05-01,Johor,1,1,0,2006
2006-05-02,Johor,45,30,15,2006
2006-05-03,Johor,13,5,8,2006
2006-05-04,Johor,64,45,19,2006
2006-05-05,Johor,36,14,22,2006
2006-05-06,Johor,1,0,1,2006
2006-05-07,Johor,84,11,73,2006
2006-05-08,Johor,65,34,31,2006
2006-05-09,Johor,61,30,31,2006
2006-05-10,Johor,18,9,9,2006
2006-05-11,Johor,37,21,16,2006
2006-05-12,Johor,0,0,0,2006
2006-05-13,Johor,1,0,1,2006
2006-05-14,Johor,20,7,13,2006
2006-05-15,Johor,21,11,10,2006
2006-05-16,Johor,40,29,11,2006
2006-05-17,Johor,18,7,11,2006
2006-05-18,Johor,12,7,5,2006
2006-05-19,Johor,25,7,18,2006
2006-05-20,Johor,0,0,0,2006
2006-05-21,Johor,89,15,74,2006
2006-05-22,Johor,35,16,19,2006
2006-05-23,Johor,67,35,32,2006
2006-05-24,Johor,51,36,15,2006
2006-05-25,Johor,64,40,24,2006
2006-05-26,Johor,66,55,11,2006
2006-05-27,Johor,3,1,2,2006
2006-05-28,Johor,149,26,123,2006
2006-05-29,Johor,61,26,35,2006
2006-05-30,Johor,67,30,37,2006
2006-05-31,Johor,5,0,5,2006
2006-06-01,Johor,4,0,4,2006
2006-06-02,Johor,1,0,1,2006
2006-06-03,Johor,0,0,0,2006
2006-06-04,Johor,1,0,1,2006
2006-06-05,Johor,5,2,3,2006
2006-06-06,Johor,34,19,15,2006
2006-06-07,Johor,49,22,27,2006
2006-06-08,Johor,24,12,12,2006
2006-06-09,Johor,16,5,11,2006
2006-06-10,Johor,0,0,0,2006
2006-06-11,Johor,90,31,59,2006
2006-06-12,Johor,6,3,3,2006
2006-06-13,Johor,13,4,9,2006
2006-06-14,Johor,28,24,4,2006
2006-06-15,Johor,32,23,9,2006
2006-06-16,Johor,22,9,13,2006
2006-06-17,Johor,61,33,28,2006
2006-06-18,Johor,1,1,0,2006
2006-06-19,Johor,38,21,17,2006
2006-06-20,Johor,57,38,19,2006
2006-06-21,Johor,13,6,7,2006
2006-06-22,Johor,26,15,11,2006
2006-06-23,Johor,16,4,12,2006
2006-06-24,Johor,1,1,0,2006
2006-06-25,Johor,0,0,0,2006
2006-06-26,Johor,28,18,10,2006
2006-06-27,Johor,27,20,7,2006
2006-06-28,Johor,11,2,9,2006
2006-06-29,Johor,16,2,14,2006
2006-06-30,Johor,3,1,2,2006
2006-07-01,Johor,1,0,1,2006
2006-07-02,Johor,0,0,0,2006
2006-07-03,Johor,36,24,12,2006
2006-07-04,Johor,63,53,10,2006
2006-07-05,Johor,51,18,33,2006
2006-07-06,Johor,8,4,4,2006
2006-07-07,Johor,28,13,15,2006
2006-07-08,Johor,27,23,4,2006
2006-07-09,Johor,16,2,14,2006
2006-07-10,Johor,58,38,20,2006
2006-07-11,Johor,52,25,27,2006
2006-07-12,Johor,28,17,11,2006
2006-07-13,Johor,4,1,3,2006
2006-07-14,Johor,34,17,17,2006
2006-07-15,Johor,19,12,7,2006
2006-07-16,Johor,111,22,89,2006
2006-07-17,Johor,61,24,37,2006
2006-07-18,Johor,27,6,21,2006
2006-07-19,Johor,16,6,10,2006
2006-07-20,Johor,11,2,9,2006
2006-07-21,Johor,5,1,4,2006
2006-07-22,Johor,1,0,1,2006
2006-07-23,Johor,126,35,91,2006
2006-07-24,Johor,20,9,11,2006
2006-07-25,Johor,7,1,6,2006
2006-07-26,Johor,86,50,36,2006
2006-07-27,Johor,30,12,18,2006
2006-07-28,Johor,17,8,9,2006
2006-07-29,Johor,0,0,0,2006
2006-07-30,Johor,0,0,0,2006
2006-07-31,Johor,9,4,5,2006
2006-08-01,Johor,1,0,1,2006
2006-08-02,Johor,5,1,4,2006
2006-08-03,Johor,8,2,6,2006
2006-08-04,Johor,23,2,21,2006
2006-08-05,Johor,38,35,3,2006
2006-08-06,Johor,2,1,1,2006
2006-08-07,Johor,15,6,9,2006
2006-08-08,Johor,22,6,16,2006
2006-08-09,Johor,16,7,9,2006
2006-08-10,Johor,21,14,7,2006
2006-08-11,Johor,46,29,17,2006
2006-08-12,Johor,1,0,1,2006
2006-08-13,Johor,42,15,27,2006
2006-08-14,Johor,56,27,29,2006
2006-08-15,Johor,17,7,10,2006
2006-08-16,Johor,2,1,1,2006
2006-08-17,Johor,1,0,1,2006
2006-08-18,Johor,1,0,1,2006
2006-08-19,Johor,0,0,0,2006
2006-08-20,Johor,0,0,0,2006
2006-08-21,Johor,5,1,4,2006
2006-08-22,Johor,16,4,12,2006
2006-08-23,Johor,4,1,3,2006
2006-08-24,Johor,6,4,2,2006
2006-08-25,Johor,4,0,4,2006
2006-08-26,Johor,1,1,0,2006
2006-08-27,Johor,67,13,54,2006
2006-08-28,Johor,25,15,10,2006
2006-08-29,Johor,0,0,0,2006
2006-08-30,Johor,12,2,10,2006
2006-08-31,Johor,106,25,81,2006
2006-09-01,Johor,4,0,4,2006
2006-09-02,Johor,2,0,2,2006
2006-09-03,Johor,156,68,88,2006
2006-09-04,Johor,12,3,9,2006
2006-09-05,Johor,18,5,13,2006
2006-09-06,Johor,7,3,4,2006
2006-09-07,Johor,4,1,3,2006
2006-09-08,Johor,2,0,2,2006
2006-09-09,Johor,46,6,40,2006
2006-09-10,Johor,48,18,30,2006
2006-09-11,Johor,21,6,15,2006
2006-09-12,Johor,40,12,28,2006
2006-09-13,Johor,5,1,4,2006
2006-09-14,Johor,4,0,4,2006
2006-09-15,Johor,5,0,5,2006
2006-09-16,Johor,19,15,4,2006
2006-09-17,Johor,36,9,27,2006
2006-09-18,Johor,5,0,5,2006
2006-09-19,Johor,4,0,4,2006
2006-09-20,Johor,6,1,5,2006
2006-09-21,Johor,7,1,6,2006
2006-09-22,Johor,8,2,6,2006
2006-09-23,Johor,41,15,26,2006
2006-09-24,Johor,1,0,1,2006
2006-09-25,Johor,2,0,2,2006
2006-09-26,Johor,22,13,9,2006
2006-09-27,Johor,8,3,5,2006
2006-09-28,Johor,1,1,0,2006
2006-09-29,Johor,3,2,1,2006
2006-09-30,Johor,1,1,0,2006
2006-10-01,Johor,0,0,0,2006
2006-10-02,Johor,2,0,2,2006
2006-10-03,Johor,13,2,11,2006
2006-10-04,Johor,6,2,4,2006
2006-10-05,Johor,4,1,3,2006
2006-10-06,Johor,14,3,11,2006
2006-10-07,Johor,1,0,1,2006
2006-10-08,Johor,66,18,48,2006
2006-10-09,Johor,6,1,5,2006
2006-10-10,Johor,9,4,5,2006
2006-10-11,Johor,2,0,2,2006
2006-10-12,Johor,5,1,4,2006
2006-10-13,Johor,2,0,2,2006
2006-10-14,Johor,2,0,2,2006
2006-10-15,Johor,108,13,95,2006
2006-10-16,Johor,3,2,1,2006
2006-10-17,Johor,1,1,0,2006
2006-10-18,Johor,16,2,14,2006
2006-10-19,Johor,11,6,5,2006
2006-10-20,Johor,1,0,1,2006
2006-10-21,Johor,1,1,0,2006
2006-10-22,Johor,0,0,0,2006
2006-10-23,Johor,1,0,1,2006
2006-10-24,Johor,1,0,1,2006
2006-10-25,Johor,0,0,0,2006
2006-10-26,Johor,2,1,1,2006
2006-10-27,Johor,4,0,4,2006
2006-10-28,Johor,0,0,0,2006
2006-10-29,Johor,2,1,1,2006
2006-10-30,Johor,8,1,7,2006
2006-10-31,Johor,13,4,9,2006
2006-11-01,Johor,4,1,3,2006
2006-11-02,Johor,2,0,2,2006
2006-11-03,Johor,2,0,2,2006
2006-11-04,Johor,2,1,1,2006
2006-11-05,Johor,44,15,29,2006
2006-11-06,Johor,5,2,3,2006
2006-11-07,Johor,7,3,4,2006
2006-11-08,Johor,12,1,11,2006
2006-11-09,Johor,8,3,5,2006
2006-11-10,Johor,14,4,10,2006
2006-11-11,Johor,1,0,1,2006
2006-11-12,Johor,78,18,60,2006
2006-11-13,Johor,13,3,10,2006
2006-11-14,Johor,9,4,5,2006
2006-11-15,Johor,4,0,4,2006
2006-11-16,Johor,5,0,5,2006
2006-11-17,Johor,1,0,1,2006
2006-11-18,Johor,12,5,7,2006
2006-11-19,Johor,0,0,0,2006
2006-11-20,Johor,8,0,8,2006
2006-11-21,Johor,1,0,1,2006
2006-11-22,Johor,5,0,5,2006
2006-11-23,Johor,9,1,8,2006
2006-11-24,Johor,3,0,3,2006
2006-11-25,Johor,1,0,1,2006
2006-11-26,Johor,142,26,116,2006
2006-11-27,Johor,5,0,5,2006
2006-11-28,Johor,8,3,5,2006
2006-11-29,Johor,4,1,3,2006
2006-11-30,Johor,68,35,33,2006
2006-12-01,Johor,6,1,5,2006
2006-12-02,Johor,42,16,26,2006
2006-12-03,Johor,1,0,1,2006
2006-12-04,Johor,4,0,4,2006
2006-12-05,Johor,10,4,6,2006
2006-12-06,Johor,12,6,6,2006
2006-12-07,Johor,8,2,6,2006
2006-12-08,Johor,5,0,5,2006
2006-12-09,Johor,3,3,0,2006
2006-12-10,Johor,80,11,69,2006
2006-12-11,Johor,4,0,4,2006
2006-12-12,Johor,5,1,4,2006
2006-12-13,Johor,4,0,4,2006
2006-12-14,Johor,8,1,7,2006
2006-12-15,Johor,6,1,5,2006
2006-12-16,Johor,56,22,34,2006
2006-12-17,Johor,1,0,1,2006
2006-12-18,Johor,4,0,4,2006
2006-12-19,Johor,2,1,1,2006
2006-12-20,Johor,6,0,6,2006
2006-12-21,Johor,38,24,14,2006
2006-12-22,Johor,7,3,4,2006
2006-12-23,Johor,0,0,0,2006
2006-12-24,Johor,3,0,3,2006
2006-12-25,Johor,0,0,0,2006
2006-12-26,Johor,6,0,6,2006
2006-12-27,Johor,52,10,42,2006
2006-12-28,Johor,7,0,7,2006
2006-12-29,Johor,8,2,6,2006
2006-12-30,Johor,1,0,1,2006
2006-12-31,Johor,1,0,1,2006
2007-01-01,Johor,0,0,0,2007
2007-01-02,Johor,7,1,6,2007
2007-01-03,Johor,5,0,5,2007
2007-01-04,Johor,4,1,3,2007
2007-01-05,Johor,8,2,6,2007
2007-01-06,Johor,0,0,0,2007
2007-01-07,Johor,0,0,0,2007
2007-01-08,Johor,9,4,5,2007
2007-01-09,Johor,3,1,2,2007
2007-01-10,Johor,7,1,6,2007
2007-01-11,Johor,1,0,1,2007
2007-01-12,Johor,3,1,2,2007
2007-01-13,Johor,2,0,2,2007
2007-01-14,Johor,39,5,34,2007
2007-01-15,Johor,9,2,7,2007
2007-01-16,Johor,2,1,1,2007
2007-01-17,Johor,6,1,5,2007
2007-01-18,Johor,6,0,6,2007
2007-01-19,Johor,5,0,5,2007
2007-01-20,Johor,0,0,0,2007
2007-01-21,Johor,85,49,36,2007
2007-01-22,Johor,1,0,1,2007
2007-01-23,Johor,69,56,13,2007
2007-01-24,Johor,3,2,1,2007
2007-01-25,Johor,2,0,2,2007
2007-01-26,Johor,5,3,2,2007
2007-01-27,Johor,1,1,0,2007
2007-01-28,Johor,0,0,0,2007
2007-01-29,Johor,10,0,10,2007
2007-01-30,Johor,29,16,13,2007
2007-01-31,Johor,5,1,4,2007
2007-02-01,Johor,2,0,2,2007
2007-02-02,Johor,8,1,7,2007
2007-02-03,Johor,1,0,1,2007
2007-02-04,Johor,70,16,54,2007
2007-02-05,Johor,2,0,2,2007
2007-02-06,Johor,5,1,4,2007
2007-02-07,Johor,5,2,3,2007
2007-02-08,Johor,4,1,3,2007
2007-02-09,Johor,4,0,4,2007
2007-02-10,Johor,74,34,40,2007
2007-02-11,Johor,96,59,37,2007
2007-02-12,Johor,3,0,3,2007
2007-02-13,Johor,8,4,4,2007
2007-02-14,Johor,22,5,17,2007
2007-02-15,Johor,58,44,14,2007
2007-02-16,Johor,13,6,7,2007
2007-02-17,Johor,1,0,1,2007
2007-02-18,Johor,0,0,0,2007
2007-02-19,Johor,0,0,0,2007
2007-02-20,Johor,0,0,0,2007
2007-02-21,Johor,12,3,9,2007
2007-02-22,Johor,8,0,8,2007
2007-02-23,Johor,5,2,3,2007
2007-02-24,Johor,71,63,8,2007
2007-02-25,Johor,30,3,27,2007
2007-02-26,Johor,6,2,4,2007
2007-02-27,Johor,0,0,0,2007
2007-02-28,Johor,8,5,3,2007
2007-03-01,Johor,13,6,7,2007
2007-03-02,Johor,4,0,4,2007
2007-03-03,Johor,1,1,0,2007
2007-03-04,Johor,41,23,18,2007
2007-03-05,Johor,5,1,4,2007
2007-03-06,Johor,6,4,2,2007
2007-03-07,Johor,54,21,33,2007
2007-03-08,Johor,8,0,8,2007
2007-03-09,Johor,8,4,4,2007
2007-03-10,Johor,20,4,16,2007
2007-03-11,Johor,5,2,3,2007
2007-03-12,Johor,9,1,8,2007
2007-03-13,Johor,6,2,4,2007
2007-03-14,Johor,6,1,5,2007
2007-03-15,Johor,10,2,8,2007
2007-03-16,Johor,22,4,18,2007
2007-03-17,Johor,0,0,0,2007
2007-03-18,Johor,1,0,1,2007
2007-03-19,Johor,2,2,0,2007
2007-03-20,Johor,4,0,4,2007
2007-03-21,Johor,5,0,5,2007
2007-03-22,Johor,8,1,7,2007
2007-03-23,Johor,6,1,5,2007
2007-03-24,Johor,5,1,4,2007
2007-03-25,Johor,158,38,120,2007
2007-03-26,Johor,15,2,13,2007
2007-03-27,Johor,6,0,6,2007
2007-03-28,Johor,3,2,1,2007
2007-03-29,Johor,5,1,4,2007
2007-03-30,Johor,3,1,2,2007
2007-03-31,Johor,2,1,1,2007
2007-04-01,Johor,25,16,9,2007
2007-04-02,Johor,5,3,2,2007
2007-04-03,Johor,1,0,1,2007
2007-04-04,Johor,8,2,6,2007
2007-04-05,Johor,7,2,5,2007
2007-04-06,Johor,5,0,5,2007
2007-04-07,Johor,3,0,3,2007
2007-04-08,Johor,37,11,26,2007
2007-04-09,Johor,1,1,0,2007
2007-04-10,Johor,7,2,5,2007
2007-04-11,Johor,1,0,1,2007
2007-04-12,Johor,3,0,3,2007
2007-04-13,Johor,3,1,2,2007
2007-04-14,Johor,89,39,50,2007
2007-04-15,Johor,0,0,0,2007
2007-04-16,Johor,11,3,8,2007
2007-04-17,Johor,7,0,7,2007
2007-04-18,Johor,5,2,3,2007
2007-04-19,Johor,17,4,13,2007
2007-04-20,Johor,5,2,3,2007
2007-04-21,Johor,0,0,0,2007
2007-04-22,Johor,103,20,83,2007
2007-04-23,Johor,4,1,3,2007
2007-04-24,Johor,5,4,1,2007
2007-04-25,Johor,13,0,13,2007
2007-04-26,Johor,1,0,1,2007
2007-04-27,Johor,7,1,6,2007
2007-04-28,Johor,4,1,3,2007
2007-04-29,Johor,91,30,61,2007
2007-04-30,Johor,9,1,8,2007
2007-05-01,Johor,0,0,0,2007
2007-05-02,Johor,1,1,0,2007
2007-05-03,Johor,8,1,7,2007
2007-05-04,Johor,36,13,23,2007
2007-05-05,Johor,2,1,1,2007
2007-05-06,Johor,3,1,2,2007
2007-05-07,Johor,2,0,2,2007
2007-05-08,Johor,9,3,6,2007
2007-05-09,Johor,5,0,5,2007
2007-05-10,Johor,37,13,24,2007
2007-05-11,Johor,4,0,4,2007
2007-05-12,Johor,8,0,8,2007
2007-05-13,Johor,114,15,99,2007
2007-05-14,Johor,6,2,4,2007
2007-05-15,Johor,5,0,5,2007
2007-05-16,Johor,4,0,4,2007
2007-05-17,Johor,6,1,5,2007
2007-05-18,Johor,4,0,4,2007
2007-05-19,Johor,80,78,2,2007
2007-05-20,Johor,90,14,76,2007
2007-05-21,Johor,2,0,2,2007
2007-05-22,Johor,1,0,1,2007
2007-05-23,Johor,7,0,7,2007
2007-05-24,Johor,69,16,53,2007
2007-05-25,Johor,4,2,2,2007
2007-05-26,Johor,0,0,0,2007
2007-05-27,Johor,16,6,10,2007
2007-05-28,Johor,3,0,3,2007
2007-05-29,Johor,1,0,1,2007
2007-05-30,Johor,3,0,3,2007
2007-05-31,Johor,2,1,1,2007
2007-06-01,Johor,0,0,0,2007
2007-06-02,Johor,2,0,2,2007
2007-06-03,Johor,120,35,85,2007
2007-06-04,Johor,1,0,1,2007
2007-06-05,Johor,8,2,6,2007
2007-06-06,Johor,6,2,4,2007
2007-06-07,Johor,9,0,9,2007
2007-06-08,Johor,4,0,4,2007
2007-06-09,Johor,0,0,0,2007
2007-06-10,Johor,84,6,78,2007
2007-06-11,Johor,7,0,7,2007
2007-06-12,Johor,4,0,4,2007
2007-06-13,Johor,2,1,1,2007
2007-06-14,Johor,5,1,4,2007
2007-06-15,Johor,2,0,2,2007
2007-06-16,Johor,6,3,3,2007
2007-06-17,Johor,92,27,65,2007
2007-06-18,Johor,8,3,5,2007
2007-06-19,Johor,2,0,2,2007
2007-06-20,Johor,2,0,2,2007
2007-06-21,Johor,3,0,3,2007
2007-06-22,Johor,7,3,4,2007
2007-06-23,Johor,18,3,15,2007
2007-06-24,Johor,24,19,5,2007
2007-06-25,Johor,20,8,12,2007
2007-06-26,Johor,16,11,5,2007
2007-06-27,Johor,3,1,2,2007
2007-06-28,Johor,4,3,1,2007
2007-06-29,Johor,21,5,16,2007
2007-06-30,Johor,1,0,1,2007
2007-07-01,Johor,2,1,1,2007
2007-07-02,Johor,12,3,9,2007
2007-07-03,Johor,34,22,12,2007
2007-07-04,Johor,3,1,2,2007
2007-07-05,Johor,4,0,4,2007
2007-07-06,Johor,3,0,3,2007
2007-07-07,Johor,3,1,2,2007
2007-07-08,Johor,12,5,7,2007
2007-07-09,Johor,6,3,3,2007
2007-07-10,Johor,4,0,4,2007
2007-07-11,Johor,13,10,3,2007
2007-07-12,Johor,17,9,8,2007
2007-07-13,Johor,10,7,3,2007
2007-07-14,Johor,0,0,0,2007
2007-07-15,Johor,0,0,0,2007
2007-07-16,Johor,13,12,1,2007
2007-07-17,Johor,20,15,5,2007
2007-07-18,Johor,15,11,4,2007
2007-07-19,Johor,14,9,5,2007
2007-07-20,Johor,6,2,4,2007
2007-07-21,Johor,0,0,0,2007
2007-07-22,Johor,112,20,92,2007
2007-07-23,Johor,6,1,5,2007
2007-07-24,Johor,4,0,4,2007
2007-07-25,Johor,3,2,1,2007
2007-07-26,Johor,4,0,4,2007
2007-07-27,Johor,6,0,6,2007
2007-07-28,Johor,64,28,36,2007
2007-07-29,Johor,0,0,0,2007
2007-07-30,Johor,4,0,4,2007
2007-07-31,Johor,5,2,3,2007
2007-08-01,Johor,7,2,5,2007
2007-08-02,Johor,8,5,3,2007
2007-08-03,Johor,7,4,3,2007
2007-08-04,Johor,2,1,1,2007
2007-08-05,Johor,103,24,79,2007
2007-08-06,Johor,23,19,4,2007
2007-08-07,Johor,21,15,6,2007
2007-08-08,Johor,54,40,14,2007
2007-08-09,Johor,28,24,4,2007
2007-08-10,Johor,8,3,5,2007
2007-08-11,Johor,1,1,0,2007
2007-08-12,Johor,94,17,77,2007
2007-08-13,Johor,25,23,2,2007
2007-08-14,Johor,11,8,3,2007
2007-08-15,Johor,11,6,5,2007
2007-08-16,Johor,59,13,46,2007
2007-08-17,Johor,26,17,9,2007
2007-08-18,Johor,2,2,0,2007
2007-08-19,Johor,1,0,1,2007
2007-08-20,Johor,24,19,5,2007
2007-08-21,Johor,22,16,6,2007
2007-08-22,Johor,56,53,3,2007
2007-08-23,Johor,15,6,9,2007
2007-08-24,Johor,18,12,6,2007
2007-08-25,Johor,0,0,0,2007
2007-08-26,Johor,34,8,26,2007
2007-08-27,Johor,15,11,4,2007
2007-08-28,Johor,12,12,0,2007
2007-08-29,Johor,13,6,7,2007
2007-08-30,Johor,16,10,6,2007
2007-08-31,Johor,141,32,109,2007
2007-09-01,Johor,1,0,1,2007
2007-09-02,Johor,116,23,93,2007
2007-09-03,Johor,17,11,6,2007
2007-09-04,Johor,6,3,3,2007
2007-09-05,Johor,10,7,3,2007
2007-09-06,Johor,25,11,14,2007
2007-09-07,Johor,4,2,2,2007
2007-09-08,Johor,1,0,1,2007
2007-09-09,Johor,53,19,34,2007
2007-09-10,Johor,28,18,10,2007
2007-09-11,Johor,17,10,7,2007
2007-09-12,Johor,19,13,6,2007
2007-09-13,Johor,0,0,0,2007
2007-09-14,Johor,3,1,2,2007
2007-09-15,Johor,0,0,0,2007
2007-09-16,Johor,0,0,0,2007
2007-09-17,Johor,17,13,4,2007
2007-09-18,Johor,18,15,3,2007
2007-09-19,Johor,11,9,2,2007
2007-09-20,Johor,16,12,4,2007
2007-09-21,Johor,9,7,2,2007
2007-09-22,Johor,0,0,0,2007
2007-09-23,Johor,42,10,32,2007
2007-09-24,Johor,6,4,2,2007
2007-09-25,Johor,14,10,4,2007
2007-09-26,Johor,14,10,4,2007
2007-09-27,Johor,4,3,1,2007
2007-09-28,Johor,10,6,4,2007
2007-09-29,Johor,24,21,3,2007
2007-09-30,Johor,115,45,70,2007
2007-10-01,Johor,18,9,9,2007
2007-10-02,Johor,12,7,5,2007
2007-10-03,Johor,20,12,8,2007
2007-10-04,Johor,31,15,16,2007
2007-10-05,Johor,15,14,1,2007
2007-10-06,Johor,1,0,1,2007
2007-10-07,Johor,16,3,13,2007
2007-10-08,Johor,19,13,6,2007
2007-10-09,Johor,12,6,6,2007
2007-10-10,Johor,65,47,18,2007
2007-10-11,Johor,30,21,9,2007
2007-10-12,Johor,9,5,4,2007
2007-10-13,Johor,0,0,0,2007
2007-10-14,Johor,1,0,1,2007
2007-10-15,Johor,0,0,0,2007
2007-10-16,Johor,35,28,7,2007
2007-10-17,Johor,46,32,14,2007
2007-10-18,Johor,50,36,14,2007
2007-10-19,Johor,27,13,14,2007
2007-10-20,Johor,0,0,0,2007
2007-10-21,Johor,89,13,76,2007
2007-10-22,Johor,43,30,13,2007
2007-10-23,Johor,24,13,11,2007
2007-10-24,Johor,26,20,6,2007
2007-10-25,Johor,26,17,9,2007
2007-10-26,Johor,15,10,5,2007
2007-10-27,Johor,0,0,0,2007
2007-10-28,Johor,99,24,75,2007
2007-10-29,Johor,22,13,9,2007
2007-10-30,Johor,19,14,5,2007
2007-10-31,Johor,13,8,5,2007
2007-11-01,Johor,15,9,6,2007
2007-11-02,Johor,20,10,10,2007
2007-11-03,Johor,12,4,8,2007
2007-11-04,Johor,99,15,84,2007
2007-11-05,Johor,24,18,6,2007
2007-11-06,Johor,29,18,11,2007
2007-11-07,Johor,18,12,6,2007
2007-11-08,Johor,0,0,0,2007
2007-11-09,Johor,26,8,18,2007
2007-11-10,Johor,1,1,0,2007
2007-11-11,Johor,0,0,0,2007
2007-11-12,Johor,17,12,5,2007
2007-11-13,Johor,14,9,5,2007
2007-11-14,Johor,21,16,5,2007
2007-11-15,Johor,22,18,4,2007
2007-11-16,Johor,26,18,8,2007
2007-11-17,Johor,55,29,26,2007
2007-11-18,Johor,1,0,1,2007
2007-11-19,Johor,47,32,15,2007
2007-11-20,Johor,25,12,13,2007
2007-11-21,Johor,19,11,8,2007
2007-11-22,Johor,16,12,4,2007
2007-11-23,Johor,23,15,8,2007
2007-11-24,Johor,1,1,0,2007
2007-11-25,Johor,128,31,97,2007
2007-11-26,Johor,22,9,13,2007
2007-11-27,Johor,12,8,4,2007
2007-11-28,Johor,7,2,5,2007
2007-11-29,Johor,3,0,3,2007
2007-11-30,Johor,8,2,6,2007
2007-12-01,Johor,0,0,0,2007
2007-12-02,Johor,69,26,43,2007
2007-12-03,Johor,12,5,7,2007
2007-12-04,Johor,7,2,5,2007
2007-12-05,Johor,3,0,3,2007
2007-12-06,Johor,2,1,1,2007
2007-12-07,Johor,1,0,1,2007
2007-12-08,Johor,1,0,1,2007
2007-12-09,Johor,2,0,2,2007
2007-12-10,Johor,6,0,6,2007
2007-12-11,Johor,5,0,5,2007
2007-12-12,Johor,4,0,4,2007
2007-12-13,Johor,1,0,1,2007
2007-12-14,Johor,3,1,2,2007
2007-12-15,Johor,0,0,0,2007
2007-12-16,Johor,31,13,18,2007
2007-12-17,Johor,5,0,5,2007
2007-12-18,Johor,3,0,3,2007
2007-12-19,Johor,6,1,5,2007
2007-12-20,Johor,0,0,0,2007
2007-12-21,Johor,6,1,5,2007
2007-12-22,Johor,85,39,46,2007
2007-12-23,Johor,2,2,0,2007
2007-12-24,Johor,13,3,10,2007
2007-12-25,Johor,1,0,1,2007
2007-12-26,Johor,8,0,8,2007
2007-12-27,Johor,5,3,2,2007
2007-12-28,Johor,2,0,2,2007
2007-12-29,Johor,0,0,0,2007
2007-12-30,Johor,47,21,26,2007
2007-12-31,Johor,9,2,7,2007
2008-01-01,Johor,1,0,1,2008
2008-01-02,Johor,7,1,6,2008
2008-01-03,Johor,7,0,7,2008
2008-01-04,Johor,5,3,2,2008
2008-01-05,Johor,49,9,40,2008
2008-01-06,Johor,0,0,0,2008
2008-01-07,Johor,5,2,3,2008
2008-01-08,Johor,7,1,6,2008
2008-01-09,Johor,7,4,3,2008
2008-01-10,Johor,0,0,0,2008
2008-01-11,Johor,2,1,1,2008
2008-01-12,Johor,0,0,0,2008
2008-01-13,Johor,51,11,40,2008
2008-01-14,Johor,4,0,4,2008
2008-01-15,Johor,7,0,7,2008
2008-01-16,Johor,14,2,12,2008
2008-01-17,Johor,22,13,9,2008
2008-01-18,Johor,12,5,7,2008
2008-01-19,Johor,27,12,15,2008
2008-01-20,Johor,1,0,1,2008
2008-01-21,Johor,12,3,9,2008
2008-01-22,Johor,5,1,4,2008
2008-01-23,Johor,1,0,1,2008
2008-01-24,Johor,11,6,5,2008
2008-01-25,Johor,17,10,7,2008
2008-01-26,Johor,45,33,12,2008
2008-01-27,Johor,21,13,8,2008
2008-01-28,Johor,6,2,4,2008
2008-01-29,Johor,5,1,4,2008
2008-01-30,Johor,3,1,2,2008
2008-01-31,Johor,4,1,3,2008
2008-02-01,Johor,4,0,4,2008
2008-02-02,Johor,39,16,23,2008
2008-02-03,Johor,1,0,1,2008
2008-02-04,Johor,67,11,56,2008
2008-02-05,Johor,5,1,4,2008
2008-02-06,Johor,151,133,18,2008
2008-02-07,Johor,2,0,2,2008
2008-02-08,Johor,3,1,2,2008
2008-02-09,Johor,0,0,0,2008
2008-02-10,Johor,24,21,3,2008
2008-02-11,Johor,9,2,7,2008
2008-02-12,Johor,11,1,10,2008
2008-02-13,Johor,5,0,5,2008
2008-02-14,Johor,12,2,10,2008
2008-02-15,Johor,15,7,8,2008
2008-02-16,Johor,0,0,0,2008
2008-02-17,Johor,110,15,95,2008
2008-02-18,Johor,4,2,2,2008
2008-02-19,Johor,113,102,11,2008
2008-02-20,Johor,11,1,10,2008
2008-02-21,Johor,8,0,8,2008
2008-02-22,Johor,4,0,4,2008
2008-02-23,Johor,22,17,5,2008
2008-02-24,Johor,315,195,120,2008
2008-02-25,Johor,8,0,8,2008
2008-02-26,Johor,90,83,7,2008
2008-02-27,Johor,8,2,6,2008
2008-02-28,Johor,3,0,3,2008
2008-02-29,Johor,3,0,3,2008
2008-03-01,Johor,0,0,0,2008
2008-03-02,Johor,17,8,9,2008
2008-03-03,Johor,4,3,1,2008
2008-03-04,Johor,6,2,4,2008
2008-03-05,Johor,6,2,4,2008
2008-03-06,Johor,6,1,5,2008
2008-03-07,Johor,3,0,3,2008
2008-03-08,Johor,0,0,0,2008
2008-03-09,Johor,0,0,0,2008
2008-03-10,Johor,4,0,4,2008
2008-03-11,Johor,2,0,2,2008
2008-03-12,Johor,7,1,6,2008
2008-03-13,Johor,8,0,8,2008
2008-03-14,Johor,13,7,6,2008
2008-03-15,Johor,66,51,15,2008
2008-03-16,Johor,33,19,14,2008
2008-03-17,Johor,8,3,5,2008
2008-03-18,Johor,6,0,6,2008
2008-03-19,Johor,7,2,5,2008
2008-03-20,Johor,5,1,4,2008
2008-03-21,Johor,60,20,40,2008
2008-03-22,Johor,14,5,9,2008
2008-03-23,Johor,1,0,1,2008
2008-03-24,Johor,25,15,10,2008
2008-03-25,Johor,63,39,24,2008
2008-03-26,Johor,147,98,49,2008
2008-03-27,Johor,36,25,11,2008
2008-03-28,Johor,17,7,10,2008
2008-03-29,Johor,3,1,2,2008
2008-03-30,Johor,27,1,26,2008
2008-03-31,Johor,64,54,10,2008
2008-04-01,Johor,8,3,5,2008
2008-04-02,Johor,20,13,7,2008
2008-04-03,Johor,4,1,3,2008
2008-04-04,Johor,4,1,3,2008
2008-04-05,Johor,21,21,0,2008
2008-04-06,Johor,1,1,0,2008
2008-04-07,Johor,8,0,8,2008
2008-04-08,Johor,3,2,1,2008
2008-04-09,Johor,6,2,4,2008
2008-04-10,Johor,11,1,10,2008
2008-04-11,Johor,8,5,3,2008
2008-04-12,Johor,2,1,1,2008
2008-04-13,Johor,61,15,46,2008
2008-04-14,Johor,4,1,3,2008
2008-04-15,Johor,9,2,7,2008
2008-04-16,Johor,21,14,7,2008
2008-04-17,Johor,38,27,11,2008
2008-04-18,Johor,54,30,24,2008
2008-04-19,Johor,3,0,3,2008
2008-04-20,Johor,173,38,135,2008
2008-04-21,Johor,24,15,9,2008
2008-04-22,Johor,25,14,11,2008
2008-04-23,Johor,16,8,8,2008
2008-04-24,Johor,17,4,13,2008
2008-04-25,Johor,8,4,4,2008
2008-04-26,Johor,6,2,4,2008
2008-04-27,Johor,101,22,79,2008
2008-04-28,Johor,9,4,5,2008
2008-04-29,Johor,15,7,8,2008
2008-04-30,Johor,71,43,28,2008
2008-05-01,Johor,3,2,1,2008
2008-05-02,Johor,10,1,9,2008
2008-05-03,Johor,0,0,0,2008
2008-05-04,Johor,155,27,128,2008
2008-05-05,Johor,5,1,4,2008
2008-05-06,Johor,0,0,0,2008
2008-05-07,Johor,95,85,10,2008
2008-05-08,Johor,11,2,9,2008
2008-05-09,Johor,13,6,7,2008
2008-05-10,Johor,97,46,51,2008
2008-05-11,Johor,26,19,7,2008
2008-05-12,Johor,9,3,6,2008
2008-05-13,Johor,10,5,5,2008
2008-05-14,Johor,36,31,5,2008
2008-05-15,Johor,8,2,6,2008
2008-05-16,Johor,4,1,3,2008
2008-05-17,Johor,46,37,9,2008
2008-05-18,Johor,185,175,10,2008
2008-05-19,Johor,142,101,41,2008
2008-05-20,Johor,8,0,8,2008
2008-05-21,Johor,10,5,5,2008
2008-05-22,Johor,9,5,4,2008
2008-05-23,Johor,6,4,2,2008
2008-05-24,Johor,1,0,1,2008
2008-05-25,Johor,99,18,81,2008
2008-05-26,Johor,6,2,4,2008
2008-05-27,Johor,6,2,4,2008
2008-05-28,Johor,7,0,7,2008
2008-05-29,Johor,11,1,10,2008
2008-05-30,Johor,4,0,4,2008
2008-05-31,Johor,1,0,1,2008
2008-06-01,Johor,109,29,80,2008
2008-06-02,Johor,8,0,8,2008
2008-06-03,Johor,12,4,8,2008
2008-06-04,Johor,9,2,7,2008
2008-06-05,Johor,42,36,6,2008
2008-06-06,Johor,5,0,5,2008
2008-06-07,Johor,0,0,0,2008
2008-06-08,Johor,123,13,110,2008
2008-06-09,Johor,10,2,8,2008
2008-06-10,Johor,37,31,6,2008
2008-06-11,Johor,2,0,2,2008
2008-06-12,Johor,18,12,6,2008
2008-06-13,Johor,14,6,8,2008
2008-06-14,Johor,0,0,0,2008
2008-06-15,Johor,111,31,80,2008
2008-06-16,Johor,10,3,7,2008
2008-06-17,Johor,8,1,7,2008
2008-06-18,Johor,18,9,9,2008
2008-06-19,Johor,47,21,26,2008
2008-06-20,Johor,3,1,2,2008
2008-06-21,Johor,1,0,1,2008
2008-06-22,Johor,30,18,12,2008
2008-06-23,Johor,11,5,6,2008
2008-06-24,Johor,18,15,3,2008
2008-06-25,Johor,10,7,3,2008
2008-06-26,Johor,5,4,1,2008
2008-06-27,Johor,7,4,3,2008
2008-06-28,Johor,19,19,0,2008
2008-06-29,Johor,61,29,32,2008
2008-06-30,Johor,6,1,5,2008
2008-07-01,Johor,21,11,10,2008
2008-07-02,Johor,11,9,2,2008
2008-07-03,Johor,15,7,8,2008
2008-07-04,Johor,11,3,8,2008
2008-07-05,Johor,2,1,1,2008
2008-07-06,Johor,72,35,37,2008
2008-07-07,Johor,21,11,10,2008
2008-07-08,Johor,9,4,5,2008
2008-07-09,Johor,2,1,1,2008
2008-07-10,Johor,3,1,2,2008
2008-07-11,Johor,1,0,1,2008
2008-07-12,Johor,1,0,1,2008
2008-07-13,Johor,22,18,4,2008
2008-07-14,Johor,3,0,3,2008
2008-07-15,Johor,7,1,6,2008
2008-07-16,Johor,2,0,2,2008
2008-07-17,Johor,14,2,12,2008
2008-07-18,Johor,5,0,5,2008
2008-07-19,Johor,13,5,8,2008
2008-07-20,Johor,175,75,100,2008
2008-07-21,Johor,9,3,6,2008
2008-07-22,Johor,4,0,4,2008
2008-07-23,Johor,4,1,3,2008
2008-07-24,Johor,18,12,6,2008
2008-07-25,Johor,8,3,5,2008
2008-07-26,Johor,23,16,7,2008
2008-07-27,Johor,116,35,81,2008
2008-07-28,Johor,9,2,7,2008
2008-07-29,Johor,5,4,1,2008
2008-07-30,Johor,6,3,3,2008
2008-07-31,Johor,2,0,2,2008
2008-08-01,Johor,7,3,4,2008
2008-08-02,Johor,2,0,2,2008
2008-08-03,Johor,57,38,19,2008
2008-08-04,Johor,15,3,12,2008
2008-08-05,Johor,8,5,3,2008
2008-08-06,Johor,13,7,6,2008
2008-08-07,Johor,49,33,16,2008
2008-08-08,Johor,9,5,4,2008
2008-08-09,Johor,2,0,2,2008
2008-08-10,Johor,112,27,85,2008
2008-08-11,Johor,8,2,6,2008
2008-08-12,Johor,12,5,7,2008
2008-08-13,Johor,7,5,2,2008
2008-08-14,Johor,19,7,12,2008
2008-08-15,Johor,2,0,2,2008
2008-08-16,Johor,1,1,0,2008
2008-08-17,Johor,99,23,76,2008
2008-08-18,Johor,5,1,4,2008
2008-08-19,Johor,4,1,3,2008
2008-08-20,Johor,4,2,2,2008
2008-08-21,Johor,59,9,50,2008
2008-08-22,Johor,8,2,6,2008
2008-08-23,Johor,55,48,7,2008
2008-08-24,Johor,77,18,59,2008
2008-08-25,Johor,11,1,10,2008
2008-08-26,Johor,4,1,3,2008
2008-08-27,Johor,5,3,2,2008
2008-08-28,Johor,9,4,5,2008
2008-08-29,Johor,5,2,3,2008
2008-08-30,Johor,1,0,1,2008
2008-08-31,Johor,92,16,76,2008
2008-09-01,Johor,1,1,0,2008
2008-09-02,Johor,4,3,1,2008
2008-09-03,Johor,4,2,2,2008
2008-09-04,Johor,4,1,3,2008
2008-09-05,Johor,2,0,2,2008
2008-09-06,Johor,0,0,0,2008
2008-09-07,Johor,95,22,73,2008
2008-09-08,Johor,3,0,3,2008
2008-09-09,Johor,3,1,2,2008
2008-09-10,Johor,0,0,0,2008
2008-09-11,Johor,4,1,3,2008
2008-09-12,Johor,5,0,5,2008
2008-09-13,Johor,1,1,0,2008
2008-09-14,Johor,43,22,21,2008
2008-09-15,Johor,12,4,8,2008
2008-09-16,Johor,5,1,4,2008
2008-09-17,Johor,7,3,4,2008
2008-09-18,Johor,8,3,5,2008
2008-09-19,Johor,3,2,1,2008
2008-09-20,Johor,2,0,2,2008
2008-09-21,Johor,94,25,69,2008
2008-09-22,Johor,5,1,4,2008
2008-09-23,Johor,6,4,2,2008
2008-09-24,Johor,5,2,3,2008
2008-09-25,Johor,2,1,1,2008
2008-09-26,Johor,3,2,1,2008
2008-09-27,Johor,2,0,2,2008
2008-09-28,Johor,95,15,80,2008
2008-09-29,Johor,28,7,21,2008
2008-09-30,Johor,4,2,2,2008
2008-10-01,Johor,0,0,0,2008
2008-10-02,Johor,7,1,6,2008
2008-10-03,Johor,4,1,3,2008
2008-10-04,Johor,0,0,0,2008
2008-10-05,Johor,0,0,0,2008
2008-10-06,Johor,9,1,8,2008
2008-10-07,Johor,9,3,6,2008
2008-10-08,Johor,14,5,9,2008
2008-10-09,Johor,8,1,7,2008
2008-10-10,Johor,5,1,4,2008
2008-10-11,Johor,0,0,0,2008
2008-10-12,Johor,134,27,107,2008
2008-10-13,Johor,16,9,7,2008
2008-10-14,Johor,3,0,3,2008
2008-10-15,Johor,18,9,9,2008
2008-10-16,Johor,6,4,2,2008
2008-10-17,Johor,5,1,4,2008
2008-10-18,Johor,2,0,2,2008
2008-10-19,Johor,84,17,67,2008
2008-10-20,Johor,3,0,3,2008
2008-10-21,Johor,2,0,2,2008
2008-10-22,Johor,6,2,4,2008
2008-10-23,Johor,12,0,12,2008
2008-10-24,Johor,16,6,10,2008
2008-10-25,Johor,0,0,0,2008
2008-10-26,Johor,64,17,47,2008
2008-10-27,Johor,2,0,2,2008
2008-10-28,Johor,17,9,8,2008
2008-10-29,Johor,12,5,7,2008
2008-10-30,Johor,5,1,4,2008
2008-10-31,Johor,9,5,4,2008
2008-11-01,Johor,0,0,0,2008
2008-11-02,Johor,394,356,38,2008
2008-11-03,Johor,8,4,4,2008
2008-11-04,Johor,10,6,4,2008
2008-11-05,Johor,15,10,5,2008
2008-11-06,Johor,54,33,21,2008
2008-11-07,Johor,8,0,8,2008
2008-11-08,Johor,206,198,8,2008
2008-11-09,Johor,101,86,15,2008
2008-11-10,Johor,11,5,6,2008
2008-11-11,Johor,56,49,7,2008
2008-11-12,Johor,25,9,16,2008
2008-11-13,Johor,56,37,19,2008
2008-11-14,Johor,4,1,3,2008
2008-11-15,Johor,83,69,14,2008
2008-11-16,Johor,79,50,29,2008
2008-11-17,Johor,14,5,9,2008
2008-11-18,Johor,92,85,7,2008
2008-11-19,Johor,90,65,25,2008
2008-11-20,Johor,68,45,23,2008
2008-11-21,Johor,7,1,6,2008
2008-11-22,Johor,106,96,10,2008
2008-11-23,Johor,181,111,70,2008
2008-11-24,Johor,6,0,6,2008
2008-11-25,Johor,9,3,6,2008
2008-11-26,Johor,75,60,15,2008
2008-11-27,Johor,7,0,7,2008
2008-11-28,Johor,6,1,5,2008
2008-11-29,Johor,16,13,3,2008
2008-11-30,Johor,141,89,52,2008
2008-12-01,Johor,4,1,3,2008
2008-12-02,Johor,11,1,10,2008
2008-12-03,Johor,5,2,3,2008
2008-12-04,Johor,7,1,6,2008
2008-12-05,Johor,1,0,1,2008
2008-12-06,Johor,2,0,2,2008
2008-12-07,Johor,81,32,49,2008
2008-12-08,Johor,2,1,1,2008
2008-12-09,Johor,11,2,9,2008
2008-12-10,Johor,5,1,4,2008
2008-12-11,Johor,4,1,3,2008
2008-12-12,Johor,6,1,5,2008
2008-12-13,Johor,1,0,1,2008
2008-12-14,Johor,104,23,81,2008
2008-12-15,Johor,2,0,2,2008
2008-12-16,Johor,8,2,6,2008
2008-12-17,Johor,14,3,11,2008
2008-12-18,Johor,6,1,5,2008
2008-12-19,Johor,3,1,2,2008
2008-12-20,Johor,35,16,19,2008
2008-12-21,Johor,102,33,69,2008
2008-12-22,Johor,5,3,2,2008
2008-12-23,Johor,6,0,6,2008
2008-12-24,Johor,73,22,51,2008
2008-12-25,Johor,0,0,0,2008
2008-12-26,Johor,6,1,5,2008
2008-12-27,Johor,1,1,0,2008
2008-12-28,Johor,0,0,0,2008
2008-12-29,Johor,2,0,2,2008
2008-12-30,Johor,6,3,3,2008
2008-12-31,Johor,7,1,6,2008
2009-01-01,Johor,20,8,12,2009
2009-01-02,Johor,18,11,7,2009
2009-01-03,Johor,4,3,1,2009
2009-01-04,Johor,114,46,68,2009
2009-01-05,Johor,36,17,19,2009
2009-01-06,Johor,21,14,7,2009
2009-01-07,Johor,50,33,17,2009
2009-01-08,Johor,26,13,13,2009
2009-01-09,Johor,18,6,12,2009
2009-01-10,Johor,55,49,6,2009
2009-01-11,Johor,0,0,0,2009
2009-01-12,Johor,181,160,21,2009
2009-01-13,Johor,28,11,17,2009
2009-01-14,Johor,15,9,6,2009
2009-01-15,Johor,9,5,4,2009
2009-01-16,Johor,26,17,9,2009
2009-01-17,Johor,96,78,18,2009
2009-01-18,Johor,86,50,36,2009
2009-01-19,Johor,25,14,11,2009
2009-01-20,Johor,22,10,12,2009
2009-01-21,Johor,89,13,76,2009
2009-01-22,Johor,20,13,7,2009
2009-01-23,Johor,24,13,11,2009
2009-01-24,Johor,42,21,21,2009
2009-01-25,Johor,0,0,0,2009
2009-01-26,Johor,1,1,0,2009
2009-01-27,Johor,0,0,0,2009
2009-01-28,Johor,24,10,14,2009
2009-01-29,Johor,28,13,15,2009
2009-01-30,Johor,23,6,17,2009
2009-01-31,Johor,95,69,26,2009
2009-02-01,Johor,109,69,40,2009
2009-02-02,Johor,20,10,10,2009
2009-02-03,Johor,61,46,15,2009
2009-02-04,Johor,19,11,8,2009
2009-02-05,Johor,22,18,4,2009
2009-02-06,Johor,14,7,7,2009
2009-02-07,Johor,31,28,3,2009
2009-02-08,Johor,409,272,137,2009
2009-02-09,Johor,0,0,0,2009
2009-02-10,Johor,7,0,7,2009
2009-02-11,Johor,141,98,43,2009
2009-02-12,Johor,71,57,14,2009
2009-02-13,Johor,3,0,3,2009
2009-02-14,Johor,28,26,2,2009
2009-02-15,Johor,73,68,5,2009
2009-02-16,Johor,47,40,7,2009
2009-02-17,Johor,12,1,11,2009
2009-02-18,Johor,53,47,6,2009
2009-02-19,Johor,68,59,9,2009
2009-02-20,Johor,12,4,8,2009
2009-02-21,Johor,183,153,30,2009
2009-02-22,Johor,336,256,80,2009
2009-02-23,Johor,14,4,10,2009
2009-02-24,Johor,101,84,17,2009
2009-02-25,Johor,71,44,27,2009
2009-02-26,Johor,27,15,12,2009
2009-02-27,Johor,37,23,14,2009
2009-02-28,Johor,146,88,58,2009
2009-03-01,Johor,42,36,6,2009
2009-03-02,Johor,14,6,8,2009
2009-03-03,Johor,58,41,17,2009
2009-03-04,Johor,121,97,24,2009
2009-03-05,Johor,53,46,7,2009
2009-03-06,Johor,17,9,8,2009
2009-03-07,Johor,20,12,8,2009
2009-03-08,Johor,97,55,42,2009
2009-03-09,Johor,0,0,0,2009
2009-03-10,Johor,10,4,6,2009
2009-03-11,Johor,11,3,8,2009
2009-03-12,Johor,42,24,18,2009
2009-03-13,Johor,10,5,5,2009
2009-03-14,Johor,35,32,3,2009
2009-03-15,Johor,318,187,131,2009
2009-03-16,Johor,18,6,12,2009
2009-03-17,Johor,41,15,26,2009
2009-03-18,Johor,69,37,32,2009
2009-03-19,Johor,107,75,32,2009
2009-03-20,Johor,45,34,11,2009
2009-03-21,Johor,44,38,6,2009
2009-03-22,Johor,234,104,130,2009
2009-03-23,Johor,24,10,14,2009
2009-03-24,Johor,73,41,32,2009
2009-03-25,Johor,12,6,6,2009
2009-03-26,Johor,72,45,27,2009
2009-03-27,Johor,19,7,12,2009
2009-03-28,Johor,68,54,14,2009
2009-03-29,Johor,191,125,66,2009
2009-03-30,Johor,30,16,14,2009
2009-03-31,Johor,22,12,10,2009
2009-04-01,Johor,105,67,38,2009
2009-04-02,Johor,23,9,14,2009
2009-04-03,Johor,13,7,6,2009
2009-04-04,Johor,43,24,19,2009
2009-04-05,Johor,186,162,24,2009
2009-04-06,Johor,53,41,12,2009
2009-04-07,Johor,16,9,7,2009
2009-04-08,Johor,0,0,0,2009
2009-04-09,Johor,11,2,9,2009
2009-04-10,Johor,45,27,18,2009
2009-04-11,Johor,154,144,10,2009
2009-04-12,Johor,384,266,118,2009
2009-04-13,Johor,18,10,8,2009
2009-04-14,Johor,42,23,19,2009
2009-04-15,Johor,137,123,14,2009
2009-04-16,Johor,241,217,24,2009
2009-04-17,Johor,13,4,9,2009
2009-04-18,Johor,95,81,14,2009
2009-04-19,Johor,591,384,207,2009
2009-04-20,Johor,29,11,18,2009
2009-04-21,Johor,19,8,11,2009
2009-04-22,Johor,17,5,12,2009
2009-04-23,Johor,58,49,9,2009
2009-04-24,Johor,23,7,16,2009
2009-04-25,Johor,68,50,18,2009
2009-04-26,Johor,283,131,152,2009
2009-04-27,Johor,30,15,15,2009
2009-04-28,Johor,53,42,11,2009
2009-04-29,Johor,112,71,41,2009
2009-04-30,Johor,30,29,1,2009
2009-05-01,Johor,54,51,3,2009
2009-05-02,Johor,29,26,3,2009
2009-05-03,Johor,73,23,50,2009
2009-05-04,Johor,42,22,20,2009
2009-05-05,Johor,18,10,8,2009
2009-05-06,Johor,12,8,4,2009
2009-05-07,Johor,54,40,14,2009
2009-05-08,Johor,10,5,5,2009
2009-05-09,Johor,22,16,6,2009
2009-05-10,Johor,165,101,64,2009
2009-05-11,Johor,29,8,21,2009
2009-05-12,Johor,43,33,10,2009
2009-05-13,Johor,18,7,11,2009
2009-05-14,Johor,25,11,14,2009
2009-05-15,Johor,5,2,3,2009
2009-05-16,Johor,35,11,24,2009
2009-05-17,Johor,221,185,36,2009
2009-05-18,Johor,22,9,13,2009
2009-05-19,Johor,58,42,16,2009
2009-05-20,Johor,23,11,12,2009
2009-05-21,Johor,38,27,11,2009
2009-05-22,Johor,42,13,29,2009
2009-05-23,Johor,53,48,5,2009
2009-05-24,Johor,193,71,122,2009
2009-05-25,Johor,120,102,18,2009
2009-05-26,Johor,28,18,10,2009
2009-05-27,Johor,67,61,6,2009
2009-05-28,Johor,55,46,9,2009
2009-05-29,Johor,28,15,13,2009
2009-05-30,Johor,22,16,6,2009
2009-05-31,Johor,26,22,4,2009
2009-06-01,Johor,15,7,8,2009
2009-06-02,Johor,34,17,17,2009
2009-06-03,Johor,27,21,6,2009
2009-06-04,Johor,23,15,8,2009
2009-06-05,Johor,36,17,19,2009
2009-06-06,Johor,26,16,10,2009
2009-06-07,Johor,124,75,49,2009
2009-06-08,Johor,17,4,13,2009
2009-06-09,Johor,16,9,7,2009
2009-06-10,Johor,111,85,26,2009
2009-06-11,Johor,43,26,17,2009
2009-06-12,Johor,14,4,10,2009
2009-06-13,Johor,5,3,2,2009
2009-06-14,Johor,358,191,167,2009
2009-06-15,Johor,20,10,10,2009
2009-06-16,Johor,28,17,11,2009
2009-06-17,Johor,62,38,24,2009
2009-06-18,Johor,119,84,35,2009
2009-06-19,Johor,19,12,7,2009
2009-06-20,Johor,7,5,2,2009
2009-06-21,Johor,319,216,103,2009
2009-06-22,Johor,42,25,17,2009
2009-06-23,Johor,34,22,12,2009
2009-06-24,Johor,56,32,24,2009
2009-06-25,Johor,114,92,22,2009
2009-06-26,Johor,16,9,7,2009
2009-06-27,Johor,24,21,3,2009
2009-06-28,Johor,0,0,0,2009
2009-06-29,Johor,48,45,3,2009
2009-06-30,Johor,32,13,19,2009
2009-07-01,Johor,27,15,12,2009
2009-07-02,Johor,63,32,31,2009
2009-07-03,Johor,15,9,6,2009
2009-07-04,Johor,121,99,22,2009
2009-07-05,Johor,262,177,85,2009
2009-07-06,Johor,36,18,18,2009
2009-07-07,Johor,76,27,49,2009
2009-07-08,Johor,20,10,10,2009
2009-07-09,Johor,109,82,27,2009
2009-07-10,Johor,16,7,9,2009
2009-07-11,Johor,35,33,2,2009
2009-07-12,Johor,292,158,134,2009
2009-07-13,Johor,62,34,28,2009
2009-07-14,Johor,111,94,17,2009
2009-07-15,Johor,40,32,8,2009
2009-07-16,Johor,73,30,43,2009
2009-07-17,Johor,19,7,12,2009
2009-07-18,Johor,21,14,7,2009
2009-07-19,Johor,309,195,114,2009
2009-07-20,Johor,28,12,16,2009
2009-07-21,Johor,90,65,25,2009
2009-07-22,Johor,68,39,29,2009
2009-07-23,Johor,13,5,8,2009
2009-07-24,Johor,16,6,10,2009
2009-07-25,Johor,229,160,69,2009
2009-07-26,Johor,156,90,66,2009
2009-07-27,Johor,21,8,13,2009
2009-07-28,Johor,17,3,14,2009
2009-07-29,Johor,18,10,8,2009
2009-07-30,Johor,84,68,16,2009
2009-07-31,Johor,20,9,11,2009
2009-08-01,Johor,245,176,69,2009
2009-08-02,Johor,270,164,106,2009
2009-08-03,Johor,25,11,14,2009
2009-08-04,Johor,51,25,26,2009
2009-08-05,Johor,103,76,27,2009
2009-08-06,Johor,64,47,17,2009
2009-08-07,Johor,23,11,12,2009
2009-08-08,Johor,73,38,35,2009
2009-08-09,Johor,278,170,108,2009
2009-08-10,Johor,38,20,18,2009
2009-08-11,Johor,21,6,15,2009
2009-08-12,Johor,74,55,19,2009
2009-08-13,Johor,104,84,20,2009
2009-08-14,Johor,20,9,11,2009
2009-08-15,Johor,170,132,38,2009
2009-08-16,Johor,135,71,64,2009
2009-08-17,Johor,123,87,36,2009
2009-08-18,Johor,33,6,27,2009
2009-08-19,Johor,132,92,40,2009
2009-08-20,Johor,39,9,30,2009
2009-08-21,Johor,49,22,27,2009
2009-08-22,Johor,4,4,0,2009
2009-08-23,Johor,276,143,133,2009
2009-08-24,Johor,23,12,11,2009
2009-08-25,Johor,78,50,28,2009
2009-08-26,Johor,88,48,40,2009
2009-08-27,Johor,14,6,8,2009
2009-08-28,Johor,17,4,13,2009
2009-08-29,Johor,30,24,6,2009
2009-08-30,Johor,29,26,3,2009
2009-08-31,Johor,132,40,92,2009
2009-09-01,Johor,36,24,12,2009
2009-09-02,Johor,9,2,7,2009
2009-09-03,Johor,62,42,20,2009
2009-09-04,Johor,18,2,16,2009
2009-09-05,Johor,52,40,12,2009
2009-09-06,Johor,161,111,50,2009
2009-09-07,Johor,23,8,15,2009
2009-09-08,Johor,20,6,14,2009
2009-09-09,Johor,101,55,46,2009
2009-09-10,Johor,22,9,13,2009
2009-09-11,Johor,51,23,28,2009
2009-09-12,Johor,136,105,31,2009
2009-09-13,Johor,317,217,100,2009
2009-09-14,Johor,94,67,27,2009
2009-09-15,Johor,30,17,13,2009
2009-09-16,Johor,40,25,15,2009
2009-09-17,Johor,84,40,44,2009
2009-09-18,Johor,43,21,22,2009
2009-09-19,Johor,100,82,18,2009
2009-09-20,Johor,25,20,5,2009
2009-09-21,Johor,0,0,0,2009
2009-09-22,Johor,1,0,1,2009
2009-09-23,Johor,35,14,21,2009
2009-09-24,Johor,43,12,31,2009
2009-09-25,Johor,21,7,14,2009
2009-09-26,Johor,40,36,4,2009
2009-09-27,Johor,185,78,107,2009
2009-09-28,Johor,29,10,19,2009
2009-09-29,Johor,86,65,21,2009
2009-09-30,Johor,23,7,16,2009
2009-10-01,Johor,20,6,14,2009
2009-10-02,Johor,39,15,24,2009
2009-10-03,Johor,79,65,14,2009
2009-10-04,Johor,265,111,154,2009
2009-10-05,Johor,64,33,31,2009
2009-10-06,Johor,73,31,42,2009
2009-10-07,Johor,87,54,33,2009
2009-10-08,Johor,109,82,27,2009
2009-10-09,Johor,23,5,18,2009
2009-10-10,Johor,210,149,61,2009
2009-10-11,Johor,106,72,34,2009
2009-10-12,Johor,36,14,22,2009
2009-10-13,Johor,72,45,27,2009
2009-10-14,Johor,75,36,39,2009
2009-10-15,Johor,122,83,39,2009
2009-10-16,Johor,28,7,21,2009
2009-10-17,Johor,114,92,22,2009
2009-10-18,Johor,355,154,201,2009
2009-10-19,Johor,32,16,16,2009
2009-10-20,Johor,34,13,21,2009
2009-10-21,Johor,33,7,26,2009
2009-10-22,Johor,42,21,21,2009
2009-10-23,Johor,35,9,26,2009
2009-10-24,Johor,44,27,17,2009
2009-10-25,Johor,158,108,50,2009
2009-10-26,Johor,25,9,16,2009
2009-10-27,Johor,25,4,21,2009
2009-10-28,Johor,189,104,85,2009
2009-10-29,Johor,155,122,33,2009
2009-10-30,Johor,17,10,7,2009
2009-10-31,Johor,64,49,15,2009
2009-11-01,Johor,278,116,162,2009
2009-11-02,Johor,25,7,18,2009
2009-11-03,Johor,66,51,15,2009
2009-11-04,Johor,18,6,12,2009
2009-11-05,Johor,67,40,27,2009
2009-11-06,Johor,13,7,6,2009
2009-11-07,Johor,25,20,5,2009
2009-11-08,Johor,207,72,135,2009
2009-11-09,Johor,56,30,26,2009
2009-11-10,Johor,20,9,11,2009
2009-11-11,Johor,178,95,83,2009
2009-11-12,Johor,153,136,17,2009
2009-11-13,Johor,18,8,10,2009
2009-11-14,Johor,28,24,4,2009
2009-11-15,Johor,96,70,26,2009
2009-11-16,Johor,45,18,27,2009
2009-11-17,Johor,60,40,20,2009
2009-11-18,Johor,77,41,36,2009
2009-11-19,Johor,166,143,23,2009
2009-11-20,Johor,17,5,12,2009
2009-11-21,Johor,64,39,25,2009
2009-11-22,Johor,69,32,37,2009
2009-11-23,Johor,56,26,30,2009
2009-11-24,Johor,13,5,8,2009
2009-11-25,Johor,20,9,11,2009
2009-11-26,Johor,51,29,22,2009
2009-11-27,Johor,0,0,0,2009
2009-11-28,Johor,69,52,17,2009
2009-11-29,Johor,161,78,83,2009
2009-11-30,Johor,31,10,21,2009
2009-12-01,Johor,27,8,19,2009
2009-12-02,Johor,78,61,17,2009
2009-12-03,Johor,82,69,13,2009
2009-12-04,Johor,24,11,13,2009
2009-12-05,Johor,91,84,7,2009
2009-12-06,Johor,109,48,61,2009
2009-12-07,Johor,24,7,17,2009
2009-12-08,Johor,35,23,12,2009
2009-12-09,Johor,46,29,17,2009
2009-12-10,Johor,94,34,60,2009
2009-12-11,Johor,8,2,6,2009
2009-12-12,Johor,210,137,73,2009
2009-12-13,Johor,306,147,159,2009
2009-12-14,Johor,2,1,1,2009
2009-12-15,Johor,3,0,3,2009
2009-12-16,Johor,3,2,1,2009
2009-12-17,Johor,11,0,11,2009
2009-12-18,Johor,0,0,0,2009
2009-12-19,Johor,42,28,14,2009
2009-12-20,Johor,320,163,157,2009
2009-12-21,Johor,12,1,11,2009
2009-12-22,Johor,130,83,47,2009
2009-12-23,Johor,18,6,12,2009
2009-12-24,Johor,39,24,15,2009
2009-12-25,Johor,18,5,13,2009
2009-12-26,Johor,58,41,17,2009
2009-12-27,Johor,227,92,135,2009
2009-12-28,Johor,47,19,28,2009
2009-12-29,Johor,17,8,9,2009
2009-12-30,Johor,69,36,33,2009
2009-12-31,Johor,21,11,10,2009
2010-01-01,Johor,26,6,20,2010
2010-01-02,Johor,86,72,14,2010
2010-01-03,Johor,354,203,151,2010
2010-01-04,Johor,30,15,15,2010
2010-01-05,Johor,47,21,26,2010
2010-01-06,Johor,73,40,33,2010
2010-01-07,Johor,59,38,21,2010
2010-01-08,Johor,35,13,22,2010
2010-01-09,Johor,236,181,55,2010
2010-01-10,Johor,440,201,239,2010
2010-01-11,Johor,14,5,9,2010
2010-01-12,Johor,127,86,41,2010
2010-01-13,Johor,273,188,85,2010
2010-01-14,Johor,25,12,13,2010
2010-01-15,Johor,18,7,11,2010
2010-01-16,Johor,115,73,42,2010
2010-01-17,Johor,130,46,84,2010
2010-01-18,Johor,76,38,38,2010
2010-01-19,Johor,62,30,32,2010
2010-01-20,Johor,62,41,21,2010
2010-01-21,Johor,263,226,37,2010
2010-01-22,Johor,53,9,44,2010
2010-01-23,Johor,0,0,0,2010
2010-01-24,Johor,240,186,54,2010
2010-01-25,Johor,33,14,19,2010
2010-01-26,Johor,44,31,13,2010
2010-01-27,Johor,35,16,19,2010
2010-01-28,Johor,138,94,44,2010
2010-01-29,Johor,21,7,14,2010
2010-01-30,Johor,195,146,49,2010
2010-01-31,Johor,60,34,26,2010
2010-02-01,Johor,23,5,18,2010
2010-02-02,Johor,80,59,21,2010
2010-02-03,Johor,41,29,12,2010
2010-02-04,Johor,79,59,20,2010
2010-02-05,Johor,19,8,11,2010
2010-02-06,Johor,169,99,70,2010
2010-02-07,Johor,184,63,121,2010
2010-02-08,Johor,35,16,19,2010
2010-02-09,Johor,49,19,30,2010
2010-02-10,Johor,86,44,42,2010
2010-02-11,Johor,258,122,136,2010
2010-02-12,Johor,24,7,17,2010
2010-02-13,Johor,0,0,0,2010
2010-02-14,Johor,38,30,8,2010
2010-02-15,Johor,68,52,16,2010
2010-02-16,Johor,1,1,0,2010
2010-02-17,Johor,135,63,72,2010
2010-02-18,Johor,141,72,69,2010
2010-02-19,Johor,34,14,20,2010
2010-02-20,Johor,118,69,49,2010
2010-02-21,Johor,115,63,52,2010
2010-02-22,Johor,55,33,22,2010
2010-02-23,Johor,129,77,52,2010
2010-02-24,Johor,102,52,50,2010
2010-02-25,Johor,22,6,16,2010
2010-02-26,Johor,0,0,0,2010
2010-02-27,Johor,111,101,10,2010
2010-02-28,Johor,209,67,142,2010
2010-03-01,Johor,38,11,27,2010
2010-03-02,Johor,47,17,30,2010
2010-03-03,Johor,73,44,29,2010
2010-03-04,Johor,151,110,41,2010
2010-03-05,Johor,30,13,17,2010
2010-03-06,Johor,157,72,85,2010
2010-03-07,Johor,162,91,71,2010
2010-03-08,Johor,33,9,24,2010
2010-03-09,Johor,24,6,18,2010
2010-03-10,Johor,79,24,55,2010
2010-03-11,Johor,66,48,18,2010
2010-03-12,Johor,22,4,18,2010
2010-03-13,Johor,142,113,29,2010
2010-03-14,Johor,335,141,194,2010
2010-03-15,Johor,31,13,18,2010
2010-03-16,Johor,27,6,21,2010
2010-03-17,Johor,73,50,23,2010
2010-03-18,Johor,36,15,21,2010
2010-03-19,Johor,12,6,6,2010
2010-03-20,Johor,66,41,25,2010
2010-03-21,Johor,281,103,178,2010
2010-03-22,Johor,19,6,13,2010
2010-03-23,Johor,133,100,33,2010
2010-03-24,Johor,21,3,18,2010
2010-03-25,Johor,31,15,16,2010
2010-03-26,Johor,18,8,10,2010
2010-03-27,Johor,123,84,39,2010
2010-03-28,Johor,0,0,0,2010
2010-03-29,Johor,26,4,22,2010
2010-03-30,Johor,65,46,19,2010
2010-03-31,Johor,38,19,19,2010
2010-04-01,Johor,146,57,89,2010
2010-04-02,Johor,29,3,26,2010
2010-04-03,Johor,32,17,15,2010
2010-04-04,Johor,61,50,11,2010
2010-04-05,Johor,105,56,49,2010
2010-04-06,Johor,52,32,20,2010
2010-04-07,Johor,73,56,17,2010
2010-04-08,Johor,110,59,51,2010
2010-04-09,Johor,23,7,16,2010
2010-04-10,Johor,116,80,36,2010
2010-04-11,Johor,353,146,207,2010
2010-04-12,Johor,79,44,35,2010
2010-04-13,Johor,81,39,42,2010
2010-04-14,Johor,45,19,26,2010
2010-04-15,Johor,222,164,58,2010
2010-04-16,Johor,13,2,11,2010
2010-04-17,Johor,173,94,79,2010
2010-04-18,Johor,254,163,91,2010
2010-04-19,Johor,19,8,11,2010
2010-04-20,Johor,116,47,69,2010
2010-04-21,Johor,30,12,18,2010
2010-04-22,Johor,33,5,28,2010
2010-04-23,Johor,17,2,15,2010
2010-04-24,Johor,144,100,44,2010
2010-04-25,Johor,265,161,104,2010
2010-04-26,Johor,24,7,17,2010
2010-04-27,Johor,165,113,52,2010
2010-04-28,Johor,13,4,9,2010
2010-04-29,Johor,186,130,56,2010
2010-04-30,Johor,39,11,28,2010
2010-05-01,Johor,94,61,33,2010
2010-05-02,Johor,203,130,73,2010
2010-05-03,Johor,76,21,55,2010
2010-05-04,Johor,48,22,26,2010
2010-05-05,Johor,26,10,16,2010
2010-05-06,Johor,121,84,37,2010
2010-05-07,Johor,15,9,6,2010
2010-05-08,Johor,174,111,63,2010
2010-05-09,Johor,389,143,246,2010
2010-05-10,Johor,30,10,20,2010
2010-05-11,Johor,46,23,23,2010
2010-05-12,Johor,99,72,27,2010
2010-05-13,Johor,93,59,34,2010
2010-05-14,Johor,22,6,16,2010
2010-05-15,Johor,105,62,43,2010
2010-05-16,Johor,286,137,149,2010
2010-05-17,Johor,29,7,22,2010
2010-05-18,Johor,202,149,53,2010
2010-05-19,Johor,105,65,40,2010
2010-05-20,Johor,100,69,31,2010
2010-05-21,Johor,30,7,23,2010
2010-05-22,Johor,84,34,50,2010
2010-05-23,Johor,109,38,71,2010
2010-05-24,Johor,21,5,16,2010
2010-05-25,Johor,49,30,19,2010
2010-05-26,Johor,66,27,39,2010
2010-05-27,Johor,48,18,30,2010
2010-05-28,Johor,0,0,0,2010
2010-05-29,Johor,148,121,27,2010
2010-05-30,Johor,285,113,172,2010
2010-05-31,Johor,25,8,17,2010
2010-06-01,Johor,18,9,9,2010
2010-06-02,Johor,54,21,33,2010
2010-06-03,Johor,99,58,41,2010
2010-06-04,Johor,31,14,17,2010
2010-06-05,Johor,52,38,14,2010
2010-06-06,Johor,175,49,126,2010
2010-06-07,Johor,28,10,18,2010
2010-06-08,Johor,32,17,15,2010
2010-06-09,Johor,117,45,72,2010
2010-06-10,Johor,104,62,42,2010
2010-06-11,Johor,25,10,15,2010
2010-06-12,Johor,0,0,0,2010
2010-06-13,Johor,209,67,142,2010
2010-06-14,Johor,39,27,12,2010
2010-06-15,Johor,69,41,28,2010
2010-06-16,Johor,57,22,35,2010
2010-06-17,Johor,197,78,119,2010
2010-06-18,Johor,22,5,17,2010
2010-06-19,Johor,34,19,15,2010
2010-06-20,Johor,261,119,142,2010
2010-06-21,Johor,23,6,17,2010
2010-06-22,Johor,66,40,26,2010
2010-06-23,Johor,96,47,49,2010
2010-06-24,Johor,54,25,29,2010
2010-06-25,Johor,54,22,32,2010
2010-06-26,Johor,97,75,22,2010
2010-06-27,Johor,108,65,43,2010
2010-06-28,Johor,43,19,24,2010
2010-06-29,Johor,51,21,30,2010
2010-06-30,Johor,85,53,32,2010
2010-07-01,Johor,20,5,15,2010
2010-07-02,Johor,13,5,8,2010
2010-07-03,Johor,58,43,15,2010
2010-07-04,Johor,228,95,133,2010
2010-07-05,Johor,32,7,25,2010
2010-07-06,Johor,215,133,82,2010
2010-07-07,Johor,71,25,46,2010
2010-07-08,Johor,92,60,32,2010
2010-07-09,Johor,27,7,20,2010
2010-07-10,Johor,67,58,9,2010
2010-07-11,Johor,360,163,197,2010
2010-07-12,Johor,143,72,71,2010
2010-07-13,Johor,37,18,19,2010
2010-07-14,Johor,34,11,23,2010
2010-07-15,Johor,170,73,97,2010
2010-07-16,Johor,92,42,50,2010
2010-07-17,Johor,131,86,45,2010
2010-07-18,Johor,290,143,147,2010
2010-07-19,Johor,18,5,13,2010
2010-07-20,Johor,83,67,16,2010
2010-07-21,Johor,50,21,29,2010
2010-07-22,Johor,47,17,30,2010
2010-07-23,Johor,12,3,9,2010
2010-07-24,Johor,204,120,84,2010
2010-07-25,Johor,204,84,120,2010
2010-07-26,Johor,24,4,20,2010
2010-07-27,Johor,56,28,28,2010
2010-07-28,Johor,54,38,16,2010
2010-07-29,Johor,151,81,70,2010
2010-07-30,Johor,9,2,7,2010
2010-07-31,Johor,81,55,26,2010
2010-08-01,Johor,195,85,110,2010
2010-08-02,Johor,94,35,59,2010
2010-08-03,Johor,17,5,12,2010
2010-08-04,Johor,184,71,113,2010
2010-08-05,Johor,155,96,59,2010
2010-08-06,Johor,62,20,42,2010
2010-08-07,Johor,136,81,55,2010
2010-08-08,Johor,261,94,167,2010
2010-08-09,Johor,110,61,49,2010
2010-08-10,Johor,98,57,41,2010
2010-08-11,Johor,0,0,0,2010
2010-08-12,Johor,10,3,7,2010
2010-08-13,Johor,7,2,5,2010
2010-08-14,Johor,2,2,0,2010
2010-08-15,Johor,308,139,169,2010
2010-08-16,Johor,15,1,14,2010
2010-08-17,Johor,32,13,19,2010
2010-08-18,Johor,29,11,18,2010
2010-08-19,Johor,51,14,37,2010
2010-08-20,Johor,45,14,31,2010
2010-08-21,Johor,85,25,60,2010
2010-08-22,Johor,295,152,143,2010
2010-08-23,Johor,31,12,19,2010
2010-08-24,Johor,30,17,13,2010
2010-08-25,Johor,68,30,38,2010
2010-08-26,Johor,115,70,45,2010
2010-08-27,Johor,9,2,7,2010
2010-08-28,Johor,37,15,22,2010
2010-08-29,Johor,72,42,30,2010
2010-08-30,Johor,9,2,7,2010
2010-08-31,Johor,165,34,131,2010
2010-09-01,Johor,42,29,13,2010
2010-09-02,Johor,35,28,7,2010
2010-09-03,Johor,12,1,11,2010
2010-09-04,Johor,43,23,20,2010
2010-09-05,Johor,165,49,116,2010
2010-09-06,Johor,8,2,6,2010
2010-09-07,Johor,32,12,20,2010
2010-09-08,Johor,54,16,38,2010
2010-09-09,Johor,21,2,19,2010
2010-09-10,Johor,0,0,0,2010
2010-09-11,Johor,1,1,0,2010
2010-09-12,Johor,76,30,46,2010
2010-09-13,Johor,25,8,17,2010
2010-09-14,Johor,23,4,19,2010
2010-09-15,Johor,34,5,29,2010
2010-09-16,Johor,23,13,10,2010
2010-09-17,Johor,40,13,27,2010
2010-09-18,Johor,246,133,113,2010
2010-09-19,Johor,253,95,158,2010
2010-09-20,Johor,62,32,30,2010
2010-09-21,Johor,20,4,16,2010
2010-09-22,Johor,29,7,22,2010
2010-09-23,Johor,162,79,83,2010
2010-09-24,Johor,18,4,14,2010
2010-09-25,Johor,62,32,30,2010
2010-09-26,Johor,223,88,135,2010
2010-09-27,Johor,30,6,24,2010
2010-09-28,Johor,18,2,16,2010
2010-09-29,Johor,57,30,27,2010
2010-09-30,Johor,78,50,28,2010
2010-10-01,Johor,146,80,66,2010
2010-10-02,Johor,61,42,19,2010
2010-10-03,Johor,105,61,44,2010
2010-10-04,Johor,54,26,28,2010
2010-10-05,Johor,81,41,40,2010
2010-10-06,Johor,31,12,19,2010
2010-10-07,Johor,100,52,48,2010
2010-10-08,Johor,29,15,14,2010
2010-10-09,Johor,224,67,157,2010
2010-10-10,Johor,223,106,117,2010
2010-10-11,Johor,162,79,83,2010
2010-10-12,Johor,100,78,22,2010
2010-10-13,Johor,133,75,58,2010
2010-10-14,Johor,139,86,53,2010
2010-10-15,Johor,78,56,22,2010
2010-10-16,Johor,216,123,93,2010
2010-10-17,Johor,139,54,85,2010
2010-10-18,Johor,91,69,22,2010
2010-10-19,Johor,82,47,35,2010
2010-10-20,Johor,40,19,21,2010
2010-10-21,Johor,203,129,74,2010
2010-10-22,Johor,24,11,13,2010
2010-10-23,Johor,201,100,101,2010
2010-10-24,Johor,222,75,147,2010
2010-10-25,Johor,16,2,14,2010
2010-10-26,Johor,21,5,16,2010
2010-10-27,Johor,76,40,36,2010
2010-10-28,Johor,35,9,26,2010
2010-10-29,Johor,21,3,18,2010
2010-10-30,Johor,61,28,33,2010
2010-10-31,Johor,232,83,149,2010
2010-11-01,Johor,160,72,88,2010
2010-11-02,Johor,59,28,31,2010
2010-11-03,Johor,112,65,47,2010
2010-11-04,Johor,81,37,44,2010
2010-11-05,Johor,57,33,24,2010
2010-11-06,Johor,65,33,32,2010
2010-11-07,Johor,128,74,54,2010
2010-11-08,Johor,116,52,64,2010
2010-11-09,Johor,114,96,18,2010
2010-11-10,Johor,140,119,21,2010
2010-11-11,Johor,159,127,32,2010
2010-11-12,Johor,16,3,13,2010
2010-11-13,Johor,68,46,22,2010
2010-11-14,Johor,123,54,69,2010
2010-11-15,Johor,108,59,49,2010
2010-11-16,Johor,12,3,9,2010
2010-11-17,Johor,0,0,0,2010
2010-11-18,Johor,60,37,23,2010
2010-11-19,Johor,13,3,10,2010
2010-11-20,Johor,23,16,7,2010
2010-11-21,Johor,128,41,87,2010
2010-11-22,Johor,62,24,38,2010
2010-11-23,Johor,22,4,18,2010
2010-11-24,Johor,19,5,14,2010
2010-11-25,Johor,207,103,104,2010
2010-11-26,Johor,24,7,17,2010
2010-11-27,Johor,93,22,71,2010
2010-11-28,Johor,91,33,58,2010
2010-11-29,Johor,25,2,23,2010
2010-11-30,Johor,60,36,24,2010
2010-12-01,Johor,25,10,15,2010
2010-12-02,Johor,60,37,23,2010
2010-12-03,Johor,28,10,18,2010
2010-12-04,Johor,99,75,24,2010
2010-12-05,Johor,168,91,77,2010
2010-12-06,Johor,97,35,62,2010
2010-12-07,Johor,1,1,0,2010
2010-12-08,Johor,103,31,72,2010
2010-12-09,Johor,28,6,22,2010
2010-12-10,Johor,15,1,14,2010
2010-12-11,Johor,95,63,32,2010
2010-12-12,Johor,432,163,269,2010
2010-12-13,Johor,17,6,11,2010
2010-12-14,Johor,50,11,39,2010
2010-12-15,Johor,21,3,18,2010
2010-12-16,Johor,87,27,60,2010
2010-12-17,Johor,26,4,22,2010
2010-12-18,Johor,122,75,47,2010
2010-12-19,Johor,247,108,139,2010
2010-12-20,Johor,116,57,59,2010
2010-12-21,Johor,94,47,47,2010
2010-12-22,Johor,100,59,41,2010
2010-12-23,Johor,22,7,15,2010
2010-12-24,Johor,33,12,21,2010
2010-12-25,Johor,16,5,11,2010
2010-12-26,Johor,196,108,88,2010
2010-12-27,Johor,114,71,43,2010
2010-12-28,Johor,19,5,14,2010
2010-12-29,Johor,71,24,47,2010
2010-12-30,Johor,60,28,32,2010
2010-12-31,Johor,90,59,31,2010
2011-01-01,Johor,25,14,11,2011
2011-01-02,Johor,134,61,73,2011
2011-01-03,Johor,60,21,39,2011
2011-01-04,Johor,69,27,42,2011
2011-01-05,Johor,191,66,125,2011
2011-01-06,Johor,64,39,25,2011
2011-01-07,Johor,77,37,40,2011
2011-01-08,Johor,90,37,53,2011
2011-01-09,Johor,216,66,150,2011
2011-01-10,Johor,187,101,86,2011
2011-01-11,Johor,64,33,31,2011
2011-01-12,Johor,34,4,30,2011
2011-01-13,Johor,29,4,25,2011
2011-01-14,Johor,12,4,8,2011
2011-01-15,Johor,28,9,19,2011
2011-01-16,Johor,146,36,110,2011
2011-01-17,Johor,68,23,45,2011
2011-01-18,Johor,61,20,41,2011
2011-01-19,Johor,48,29,19,2011
2011-01-20,Johor,209,117,92,2011
2011-01-21,Johor,77,56,21,2011
2011-01-22,Johor,103,41,62,2011
2011-01-23,Johor,207,85,122,2011
2011-01-24,Johor,24,3,21,2011
2011-01-25,Johor,16,1,15,2011
2011-01-26,Johor,60,28,32,2011
2011-01-27,Johor,20,6,14,2011
2011-01-28,Johor,18,4,14,2011
2011-01-29,Johor,67,23,44,2011
2011-01-30,Johor,132,52,80,2011
2011-01-31,Johor,23,5,18,2011
2011-02-01,Johor,95,17,78,2011
2011-02-02,Johor,17,3,14,2011
2011-02-03,Johor,0,0,0,2011
2011-02-04,Johor,36,28,8,2011
2011-02-05,Johor,0,0,0,2011
2011-02-06,Johor,82,18,64,2011
2011-02-07,Johor,33,11,22,2011
2011-02-08,Johor,41,22,19,2011
2011-02-09,Johor,46,26,20,2011
2011-02-10,Johor,72,30,42,2011
2011-02-11,Johor,4,1,3,2011
2011-02-12,Johor,205,150,55,2011
2011-02-13,Johor,167,56,111,2011
2011-02-14,Johor,25,7,18,2011
2011-02-15,Johor,0,0,0,2011
2011-02-16,Johor,73,49,24,2011
2011-02-17,Johor,215,80,135,2011
2011-02-18,Johor,24,4,20,2011
2011-02-19,Johor,150,79,71,2011
2011-02-20,Johor,276,82,194,2011
2011-02-21,Johor,27,6,21,2011
2011-02-22,Johor,18,7,11,2011
2011-02-23,Johor,24,8,16,2011
2011-02-24,Johor,83,50,33,2011
2011-02-25,Johor,12,4,8,2011
2011-02-26,Johor,0,0,0,2011
2011-02-27,Johor,90,61,29,2011
2011-02-28,Johor,29,7,22,2011
2011-03-01,Johor,53,24,29,2011
2011-03-02,Johor,148,86,62,2011
2011-03-03,Johor,98,45,53,2011
2011-03-04,Johor,49,24,25,2011
2011-03-05,Johor,128,62,66,2011
2011-03-06,Johor,162,39,123,2011
2011-03-07,Johor,37,19,18,2011
2011-03-08,Johor,130,68,62,2011
2011-03-09,Johor,61,37,24,2011
2011-03-10,Johor,69,27,42,2011
2011-03-11,Johor,30,12,18,2011
2011-03-12,Johor,266,137,129,2011
2011-03-13,Johor,295,116,179,2011
2011-03-14,Johor,26,2,24,2011
2011-03-15,Johor,19,6,13,2011
2011-03-16,Johor,90,48,42,2011
2011-03-17,Johor,65,34,31,2011
2011-03-18,Johor,17,3,14,2011
2011-03-19,Johor,183,131,52,2011
2011-03-20,Johor,253,84,169,2011
2011-03-21,Johor,24,3,21,2011
2011-03-22,Johor,35,20,15,2011
2011-03-23,Johor,106,33,73,2011
2011-03-24,Johor,59,19,40,2011
2011-03-25,Johor,17,2,15,2011
2011-03-26,Johor,67,40,27,2011
2011-03-27,Johor,168,88,80,2011
2011-03-28,Johor,21,3,18,2011
2011-03-29,Johor,54,33,21,2011
2011-03-30,Johor,91,27,64,2011
2011-03-31,Johor,92,36,56,2011
2011-04-01,Johor,86,48,38,2011
2011-04-02,Johor,84,42,42,2011
2011-04-03,Johor,230,112,118,2011
2011-04-04,Johor,33,8,25,2011
2011-04-05,Johor,65,26,39,2011
2011-04-06,Johor,51,32,19,2011
2011-04-07,Johor,101,54,47,2011
2011-04-08,Johor,154,103,51,2011
2011-04-09,Johor,114,71,43,2011
2011-04-10,Johor,196,72,124,2011
2011-04-11,Johor,40,8,32,2011
2011-04-12,Johor,132,78,54,2011
2011-04-13,Johor,118,31,87,2011
2011-04-14,Johor,16,6,10,2011
2011-04-15,Johor,21,3,18,2011
2011-04-16,Johor,93,48,45,2011
2011-04-17,Johor,112,53,59,2011
2011-04-18,Johor,27,5,22,2011
2011-04-19,Johor,48,18,30,2011
2011-04-20,Johor,38,16,22,2011
2011-04-21,Johor,124,62,62,2011
2011-04-22,Johor,36,7,29,2011
2011-04-23,Johor,248,124,124,2011
2011-04-24,Johor,364,133,231,2011
2011-04-25,Johor,21,5,16,2011
2011-04-26,Johor,25,4,21,2011
2011-04-27,Johor,14,5,9,2011
2011-04-28,Johor,21,9,12,2011
2011-04-29,Johor,14,4,10,2011
2011-04-30,Johor,0,0,0,2011
2011-05-01,Johor,245,106,139,2011
2011-05-02,Johor,0,0,0,2011
2011-05-03,Johor,25,5,20,2011
2011-05-04,Johor,23,7,16,2011
2011-05-05,Johor,39,9,30,2011
2011-05-06,Johor,15,5,10,2011
2011-05-07,Johor,45,25,20,2011
2011-05-08,Johor,261,90,171,2011
2011-05-09,Johor,31,4,27,2011
2011-05-10,Johor,10,5,5,2011
2011-05-11,Johor,25,4,21,2011
2011-05-12,Johor,59,29,30,2011
2011-05-13,Johor,32,8,24,2011
2011-05-14,Johor,54,13,41,2011
2011-05-15,Johor,183,77,106,2011
2011-05-16,Johor,38,7,31,2011
2011-05-17,Johor,16,14,2,2011
2011-05-18,Johor,76,14,62,2011
2011-05-19,Johor,117,68,49,2011
2011-05-20,Johor,30,5,25,2011
2011-05-21,Johor,98,28,70,2011
2011-05-22,Johor,136,46,90,2011
2011-05-23,Johor,20,6,14,2011
2011-05-24,Johor,128,59,69,2011
2011-05-25,Johor,28,11,17,2011
2011-05-26,Johor,21,3,18,2011
2011-05-27,Johor,58,36,22,2011
2011-05-28,Johor,2,0,2,2011
2011-05-29,Johor,156,33,123,2011
2011-05-30,Johor,49,20,29,2011
2011-05-31,Johor,22,3,19,2011
2011-06-01,Johor,64,30,34,2011
2011-06-02,Johor,48,15,33,2011
2011-06-03,Johor,19,5,14,2011
2011-06-04,Johor,65,36,29,2011
2011-06-05,Johor,220,89,131,2011
2011-06-06,Johor,22,6,16,2011
2011-06-07,Johor,42,11,31,2011
2011-06-08,Johor,65,22,43,2011
2011-06-09,Johor,58,26,32,2011
2011-06-10,Johor,75,44,31,2011
2011-06-11,Johor,44,29,15,2011
2011-06-12,Johor,322,126,196,2011
2011-06-13,Johor,23,6,17,2011
2011-06-14,Johor,153,85,68,2011
2011-06-15,Johor,175,99,76,2011
2011-06-16,Johor,35,11,24,2011
2011-06-17,Johor,2,1,1,2011
2011-06-18,Johor,78,14,64,2011
2011-06-19,Johor,146,86,60,2011
2011-06-20,Johor,91,65,26,2011
2011-06-21,Johor,105,48,57,2011
2011-06-22,Johor,949,255,694,2011
2011-06-23,Johor,52,14,38,2011
2011-06-24,Johor,22,4,18,2011
2011-06-25,Johor,333,163,170,2011
2011-06-26,Johor,35,23,12,2011
2011-06-27,Johor,38,11,27,2011
2011-06-28,Johor,55,18,37,2011
2011-06-29,Johor,19,4,15,2011
2011-06-30,Johor,57,23,34,2011
2011-07-01,Johor,58,25,33,2011
2011-07-02,Johor,82,62,20,2011
2011-07-03,Johor,191,44,147,2011
2011-07-04,Johor,31,6,25,2011
2011-07-05,Johor,53,25,28,2011
2011-07-06,Johor,65,31,34,2011
2011-07-07,Johor,90,54,36,2011
2011-07-08,Johor,23,6,17,2011
2011-07-09,Johor,80,23,57,2011
2011-07-10,Johor,357,128,229,2011
2011-07-11,Johor,93,44,49,2011
2011-07-12,Johor,108,51,57,2011
2011-07-13,Johor,168,95,73,2011
2011-07-14,Johor,56,19,37,2011
2011-07-15,Johor,23,4,19,2011
2011-07-16,Johor,46,17,29,2011
2011-07-17,Johor,312,99,213,2011
2011-07-18,Johor,18,4,14,2011
2011-07-19,Johor,119,46,73,2011
2011-07-20,Johor,105,23,82,2011
2011-07-21,Johor,74,36,38,2011
2011-07-22,Johor,11,1,10,2011
2011-07-23,Johor,139,53,86,2011
2011-07-24,Johor,196,74,122,2011
2011-07-25,Johor,72,23,49,2011
2011-07-26,Johor,59,43,16,2011
2011-07-27,Johor,205,111,94,2011
2011-07-28,Johor,74,41,33,2011
2011-07-29,Johor,23,7,16,2011
2011-07-30,Johor,114,78,36,2011
2011-07-31,Johor,323,116,207,2011
2011-08-01,Johor,0,0,0,2011
2011-08-02,Johor,11,0,11,2011
2011-08-03,Johor,72,40,32,2011
2011-08-04,Johor,43,31,12,2011
2011-08-05,Johor,7,1,6,2011
2011-08-06,Johor,33,16,17,2011
2011-08-07,Johor,243,105,138,2011
2011-08-08,Johor,24,6,18,2011
2011-08-09,Johor,80,40,40,2011
2011-08-10,Johor,29,11,18,2011
2011-08-11,Johor,9,3,6,2011
2011-08-12,Johor,31,11,20,2011
2011-08-13,Johor,72,16,56,2011
2011-08-14,Johor,223,88,135,2011
2011-08-15,Johor,21,7,14,2011
2011-08-16,Johor,74,41,33,2011
2011-08-17,Johor,160,65,95,2011
2011-08-18,Johor,88,36,52,2011
2011-08-19,Johor,14,8,6,2011
2011-08-20,Johor,95,56,39,2011
2011-08-21,Johor,322,138,184,2011
2011-08-22,Johor,44,16,28,2011
2011-08-23,Johor,27,17,10,2011
2011-08-24,Johor,66,25,41,2011
2011-08-25,Johor,106,50,56,2011
2011-08-26,Johor,61,27,34,2011
2011-08-27,Johor,80,58,22,2011
2011-08-28,Johor,284,107,177,2011
2011-08-29,Johor,19,2,17,2011
2011-08-30,Johor,0,0,0,2011
2011-08-31,Johor,2,0,2,2011
2011-09-01,Johor,0,0,0,2011
2011-09-02,Johor,50,30,20,2011
2011-09-03,Johor,64,26,38,2011
2011-09-04,Johor,231,87,144,2011
2011-09-05,Johor,76,33,43,2011
2011-09-06,Johor,23,2,21,2011
2011-09-07,Johor,142,123,19,2011
2011-09-08,Johor,76,40,36,2011
2011-09-09,Johor,80,32,48,2011
2011-09-10,Johor,74,44,30,2011
2011-09-11,Johor,123,53,70,2011
2011-09-12,Johor,76,11,65,2011
2011-09-13,Johor,83,27,56,2011
2011-09-14,Johor,144,91,53,2011
2011-09-15,Johor,107,54,53,2011
2011-09-16,Johor,46,24,22,2011
2011-09-17,Johor,44,31,13,2011
2011-09-18,Johor,279,121,158,2011
2011-09-19,Johor,86,42,44,2011
2011-09-20,Johor,50,30,20,2011
2011-09-21,Johor,123,50,73,2011
2011-09-22,Johor,78,49,29,2011
2011-09-23,Johor,38,2,36,2011
2011-09-24,Johor,138,65,73,2011
2011-09-25,Johor,500,158,342,2011
2011-09-26,Johor,20,4,16,2011
2011-09-27,Johor,37,16,21,2011
2011-09-28,Johor,55,24,31,2011
2011-09-29,Johor,61,34,27,2011
2011-09-30,Johor,27,6,21,2011
2011-10-01,Johor,79,55,24,2011
2011-10-02,Johor,162,66,96,2011
2011-10-03,Johor,45,8,37,2011
2011-10-04,Johor,35,18,17,2011
2011-10-05,Johor,105,74,31,2011
2011-10-06,Johor,81,28,53,2011
2011-10-07,Johor,23,5,18,2011
2011-10-08,Johor,126,51,75,2011
2011-10-09,Johor,258,101,157,2011
2011-10-10,Johor,28,7,21,2011
2011-10-11,Johor,40,13,27,2011
2011-10-12,Johor,29,9,20,2011
2011-10-13,Johor,78,39,39,2011
2011-10-14,Johor,18,3,15,2011
2011-10-15,Johor,85,56,29,2011
2011-10-16,Johor,303,86,217,2011
2011-10-17,Johor,21,1,20,2011
2011-10-18,Johor,91,48,43,2011
2011-10-19,Johor,239,93,146,2011
2011-10-20,Johor,20,9,11,2011
2011-10-21,Johor,11,1,10,2011
2011-10-22,Johor,211,105,106,2011
2011-10-23,Johor,205,45,160,2011
2011-10-24,Johor,20,5,15,2011
2011-10-25,Johor,87,32,55,2011
2011-10-26,Johor,84,54,30,2011
2011-10-27,Johor,134,49,85,2011
2011-10-28,Johor,58,31,27,2011
2011-10-29,Johor,120,73,47,2011
2011-10-30,Johor,203,85,118,2011
2011-10-31,Johor,26,8,18,2011
2011-11-01,Johor,102,63,39,2011
2011-11-02,Johor,66,23,43,2011
2011-11-03,Johor,95,31,64,2011
2011-11-04,Johor,88,42,46,2011
2011-11-05,Johor,40,21,19,2011
2011-11-06,Johor,87,31,56,2011
2011-11-07,Johor,81,55,26,2011
2011-11-08,Johor,50,26,24,2011
2011-11-09,Johor,84,46,38,2011
2011-11-10,Johor,94,26,68,2011
2011-11-11,Johor,50,14,36,2011
2011-11-12,Johor,242,130,112,2011
2011-11-13,Johor,182,64,118,2011
2011-11-14,Johor,33,4,29,2011
2011-11-15,Johor,149,47,102,2011
2011-11-16,Johor,130,42,88,2011
2011-11-17,Johor,173,67,106,2011
2011-11-18,Johor,100,47,53,2011
2011-11-19,Johor,145,70,75,2011
2011-11-20,Johor,181,95,86,2011
2011-11-21,Johor,74,13,61,2011
2011-11-22,Johor,0,0,0,2011
2011-11-23,Johor,40,6,34,2011
2011-11-24,Johor,79,32,47,2011
2011-11-25,Johor,25,3,22,2011
2011-11-26,Johor,164,126,38,2011
2011-11-27,Johor,227,106,121,2011
2011-11-28,Johor,82,26,56,2011
2011-11-29,Johor,42,20,22,2011
2011-11-30,Johor,27,7,20,2011
2011-12-01,Johor,18,5,13,2011
2011-12-02,Johor,16,2,14,2011
2011-12-03,Johor,90,56,34,2011
2011-12-04,Johor,412,143,269,2011
2011-12-05,Johor,19,6,13,2011
2011-12-06,Johor,60,10,50,2011
2011-12-07,Johor,96,48,48,2011
2011-12-08,Johor,64,21,43,2011
2011-12-09,Johor,20,3,17,2011
2011-12-10,Johor,179,89,90,2011
2011-12-11,Johor,356,131,225,2011
2011-12-12,Johor,26,8,18,2011
2011-12-13,Johor,68,46,22,2011
2011-12-14,Johor,175,98,77,2011
2011-12-15,Johor,115,46,69,2011
2011-12-16,Johor,17,6,11,2011
2011-12-17,Johor,58,28,30,2011
2011-12-18,Johor,230,92,138,2011
2011-12-19,Johor,19,5,14,2011
2011-12-20,Johor,197,77,120,2011
2011-12-21,Johor,12,3,9,2011
2011-12-22,Johor,19,3,16,2011
2011-12-23,Johor,13,2,11,2011
2011-12-24,Johor,108,70,38,2011
2011-12-25,Johor,137,69,68,2011
2011-12-26,Johor,68,44,24,2011
2011-12-27,Johor,35,6,29,2011
2011-12-28,Johor,23,7,16,2011
2011-12-29,Johor,99,36,63,2011
2011-12-30,Johor,49,17,32,2011
2011-12-31,Johor,22,15,7,2011
2012-01-01,Johor,231,67,164,2012
2012-01-02,Johor,106,50,56,2012
2012-01-03,Johor,38,8,30,2012
2012-01-04,Johor,60,12,48,2012
2012-01-05,Johor,74,44,30,2012
2012-01-06,Johor,82,37,45,2012
2012-01-07,Johor,165,69,96,2012
2012-01-08,Johor,292,122,170,2012
2012-01-09,Johor,46,16,30,2012
2012-01-10,Johor,43,15,28,2012
2012-01-11,Johor,194,75,119,2012
2012-01-12,Johor,28,7,21,2012
2012-01-13,Johor,44,16,28,2012
2012-01-14,Johor,198,111,87,2012
2012-01-15,Johor,265,79,186,2012
2012-01-16,Johor,82,37,45,2012
2012-01-17,Johor,110,56,54,2012
2012-01-18,Johor,152,117,35,2012
2012-01-19,Johor,66,25,41,2012
2012-01-20,Johor,21,2,19,2012
2012-01-21,Johor,73,45,28,2012
2012-01-22,Johor,117,63,54,2012
2012-01-23,Johor,58,34,24,2012
2012-01-24,Johor,60,38,22,2012
2012-01-25,Johor,57,22,35,2012
2012-01-26,Johor,41,13,28,2012
2012-01-27,Johor,41,10,31,2012
2012-01-28,Johor,309,230,79,2012
2012-01-29,Johor,112,58,54,2012
2012-01-30,Johor,28,3,25,2012
2012-01-31,Johor,52,13,39,2012
2012-02-01,Johor,98,50,48,2012
2012-02-02,Johor,176,83,93,2012
2012-02-03,Johor,27,4,23,2012
2012-02-04,Johor,1,1,0,2012
2012-02-05,Johor,144,60,84,2012
2012-02-06,Johor,95,43,52,2012
2012-02-07,Johor,263,147,116,2012
2012-02-08,Johor,25,3,22,2012
2012-02-09,Johor,77,35,42,2012
2012-02-10,Johor,18,2,16,2012
2012-02-11,Johor,72,26,46,2012
2012-02-12,Johor,182,43,139,2012
2012-02-13,Johor,81,5,76,2012
2012-02-14,Johor,103,43,60,2012
2012-02-15,Johor,71,51,20,2012
2012-02-16,Johor,87,41,46,2012
2012-02-17,Johor,9,1,8,2012
2012-02-18,Johor,197,96,101,2012
2012-02-19,Johor,226,54,172,2012
2012-02-20,Johor,30,6,24,2012
2012-02-21,Johor,21,6,15,2012
2012-02-22,Johor,122,73,49,2012
2012-02-23,Johor,26,6,20,2012
2012-02-24,Johor,19,1,18,2012
2012-02-25,Johor,138,67,71,2012
2012-02-26,Johor,205,104,101,2012
2012-02-27,Johor,26,4,22,2012
2012-02-28,Johor,119,45,74,2012
2012-02-29,Johor,86,33,53,2012
2012-03-01,Johor,181,45,136,2012
2012-03-02,Johor,37,10,27,2012
2012-03-03,Johor,72,46,26,2012
2012-03-04,Johor,328,117,211,2012
2012-03-05,Johor,12,1,11,2012
2012-03-06,Johor,144,74,70,2012
2012-03-07,Johor,29,14,15,2012
2012-03-08,Johor,32,7,25,2012
2012-03-09,Johor,79,35,44,2012
2012-03-10,Johor,72,38,34,2012
2012-03-11,Johor,364,148,216,2012
2012-03-12,Johor,35,3,32,2012
2012-03-13,Johor,15,2,13,2012
2012-03-14,Johor,39,5,34,2012
2012-03-15,Johor,17,5,12,2012
2012-03-16,Johor,10,2,8,2012
2012-03-17,Johor,2,0,2,2012
2012-03-18,Johor,521,165,356,2012
2012-03-19,Johor,39,10,29,2012
2012-03-20,Johor,130,64,66,2012
2012-03-21,Johor,71,27,44,2012
2012-03-22,Johor,66,17,49,2012
2012-03-23,Johor,15,3,12,2012
2012-03-24,Johor,89,54,35,2012
2012-03-25,Johor,354,124,230,2012
2012-03-26,Johor,109,76,33,2012
2012-03-27,Johor,103,26,77,2012
2012-03-28,Johor,129,41,88,2012
2012-03-29,Johor,28,5,23,2012
2012-03-30,Johor,25,5,20,2012
2012-03-31,Johor,103,55,48,2012
2012-04-01,Johor,208,76,132,2012
2012-04-02,Johor,21,4,17,2012
2012-04-03,Johor,19,1,18,2012
2012-04-04,Johor,109,47,62,2012
2012-04-05,Johor,92,69,23,2012
2012-04-06,Johor,42,5,37,2012
2012-04-07,Johor,69,19,50,2012
2012-04-08,Johor,291,67,224,2012
2012-04-09,Johor,29,6,23,2012
2012-04-10,Johor,93,20,73,2012
2012-04-11,Johor,0,0,0,2012
2012-04-12,Johor,34,5,29,2012
2012-04-13,Johor,31,3,28,2012
2012-04-14,Johor,195,98,97,2012
2012-04-15,Johor,279,54,225,2012
2012-04-16,Johor,33,10,23,2012
2012-04-17,Johor,119,44,75,2012
2012-04-18,Johor,107,40,67,2012
2012-04-19,Johor,133,49,84,2012
2012-04-20,Johor,111,28,83,2012
2012-04-21,Johor,0,0,0,2012
2012-04-22,Johor,538,161,377,2012
2012-04-23,Johor,40,18,22,2012
2012-04-24,Johor,81,23,58,2012
2012-04-25,Johor,102,68,34,2012
2012-04-26,Johor,72,36,36,2012
2012-04-27,Johor,12,0,12,2012
2012-04-28,Johor,218,94,124,2012
2012-04-29,Johor,235,108,127,2012
2012-04-30,Johor,106,42,64,2012
2012-05-01,Johor,102,39,63,2012
2012-05-02,Johor,54,32,22,2012
2012-05-03,Johor,112,39,73,2012
2012-05-04,Johor,29,2,27,2012
2012-05-05,Johor,140,50,90,2012
2012-05-06,Johor,97,48,49,2012
2012-05-07,Johor,29,8,21,2012
2012-05-08,Johor,32,6,26,2012
2012-05-09,Johor,79,36,43,2012
2012-05-10,Johor,27,3,24,2012
2012-05-11,Johor,99,32,67,2012
2012-05-12,Johor,106,44,62,2012
2012-05-13,Johor,231,62,169,2012
2012-05-14,Johor,28,7,21,2012
2012-05-15,Johor,38,8,30,2012
2012-05-16,Johor,95,35,60,2012
2012-05-17,Johor,18,4,14,2012
2012-05-18,Johor,40,21,19,2012
2012-05-19,Johor,0,0,0,2012
2012-05-20,Johor,256,101,155,2012
2012-05-21,Johor,28,4,24,2012
2012-05-22,Johor,20,2,18,2012
2012-05-23,Johor,54,7,47,2012
2012-05-24,Johor,115,47,68,2012
2012-05-25,Johor,42,22,20,2012
2012-05-26,Johor,0,0,0,2012
2012-05-27,Johor,311,81,230,2012
2012-05-28,Johor,21,5,16,2012
2012-05-29,Johor,51,16,35,2012
2012-05-30,Johor,35,4,31,2012
2012-05-31,Johor,122,64,58,2012
2012-06-01,Johor,22,4,18,2012
2012-06-02,Johor,50,22,28,2012
2012-06-03,Johor,108,32,76,2012
2012-06-04,Johor,21,3,18,2012
2012-06-05,Johor,91,44,47,2012
2012-06-06,Johor,86,32,54,2012
2012-06-07,Johor,29,12,17,2012
2012-06-08,Johor,17,3,14,2012
2012-06-09,Johor,135,59,76,2012
2012-06-10,Johor,329,91,238,2012
2012-06-11,Johor,16,2,14,2012
2012-06-12,Johor,140,47,93,2012
2012-06-13,Johor,141,73,68,2012
2012-06-14,Johor,64,17,47,2012
2012-06-15,Johor,50,18,32,2012
2012-06-16,Johor,152,115,37,2012
2012-06-17,Johor,207,63,144,2012
2012-06-18,Johor,74,44,30,2012
2012-06-19,Johor,87,25,62,2012
2012-06-20,Johor,93,29,64,2012
2012-06-21,Johor,49,22,27,2012
2012-06-22,Johor,27,5,22,2012
2012-06-23,Johor,165,63,102,2012
2012-06-24,Johor,259,76,183,2012
2012-06-25,Johor,20,4,16,2012
2012-06-26,Johor,27,8,19,2012
2012-06-27,Johor,27,6,21,2012
2012-06-28,Johor,60,19,41,2012
2012-06-29,Johor,23,7,16,2012
2012-06-30,Johor,47,21,26,2012
2012-07-01,Johor,313,112,201,2012
2012-07-02,Johor,32,7,25,2012
2012-07-03,Johor,72,36,36,2012
2012-07-04,Johor,153,94,59,2012
2012-07-05,Johor,102,43,59,2012
2012-07-06,Johor,35,15,20,2012
2012-07-07,Johor,33,12,21,2012
2012-07-08,Johor,123,62,61,2012
2012-07-09,Johor,51,26,25,2012
2012-07-10,Johor,194,101,93,2012
2012-07-11,Johor,72,21,51,2012
2012-07-12,Johor,171,54,117,2012
2012-07-13,Johor,25,3,22,2012
2012-07-14,Johor,165,73,92,2012
2012-07-15,Johor,400,135,265,2012
2012-07-16,Johor,36,8,28,2012
2012-07-17,Johor,126,29,97,2012
2012-07-18,Johor,168,46,122,2012
2012-07-19,Johor,106,60,46,2012
2012-07-20,Johor,40,4,36,2012
2012-07-21,Johor,23,8,15,2012
2012-07-22,Johor,232,69,163,2012
2012-07-23,Johor,8,1,7,2012
2012-07-24,Johor,18,5,13,2012
2012-07-25,Johor,28,19,9,2012
2012-07-26,Johor,71,35,36,2012
2012-07-27,Johor,1,0,1,2012
2012-07-28,Johor,19,8,11,2012
2012-07-29,Johor,136,54,82,2012
2012-07-30,Johor,16,1,15,2012
2012-07-31,Johor,82,43,39,2012
2012-08-01,Johor,122,85,37,2012
2012-08-02,Johor,11,2,9,2012
2012-08-03,Johor,42,10,32,2012
2012-08-04,Johor,154,51,103,2012
2012-08-05,Johor,300,102,198,2012
2012-08-06,Johor,13,3,10,2012
2012-08-07,Johor,101,49,52,2012
2012-08-08,Johor,90,45,45,2012
2012-08-09,Johor,135,74,61,2012
2012-08-10,Johor,16,5,11,2012
2012-08-11,Johor,132,66,66,2012
2012-08-12,Johor,426,114,312,2012
2012-08-13,Johor,15,5,10,2012
2012-08-14,Johor,42,16,26,2012
2012-08-15,Johor,48,14,34,2012
2012-08-16,Johor,61,29,32,2012
2012-08-17,Johor,86,32,54,2012
2012-08-18,Johor,0,0,0,2012
2012-08-19,Johor,0,0,0,2012
2012-08-20,Johor,0,0,0,2012
2012-08-21,Johor,0,0,0,2012
2012-08-22,Johor,64,29,35,2012
2012-08-23,Johor,49,12,37,2012
2012-08-24,Johor,85,40,45,2012
2012-08-25,Johor,105,58,47,2012
2012-08-26,Johor,284,70,214,2012
2012-08-27,Johor,64,19,45,2012
2012-08-28,Johor,13,3,10,2012
2012-08-29,Johor,91,58,33,2012
2012-08-30,Johor,78,43,35,2012
2012-08-31,Johor,162,18,144,2012
2012-09-01,Johor,105,49,56,2012
2012-09-02,Johor,145,50,95,2012
2012-09-03,Johor,30,2,28,2012
2012-09-04,Johor,44,19,25,2012
2012-09-05,Johor,51,8,43,2012
2012-09-06,Johor,32,10,22,2012
2012-09-07,Johor,15,2,13,2012
2012-09-08,Johor,76,45,31,2012
2012-09-09,Johor,361,143,218,2012
2012-09-10,Johor,27,3,24,2012
2012-09-11,Johor,437,341,96,2012
2012-09-12,Johor,23,5,18,2012
2012-09-13,Johor,87,44,43,2012
2012-09-14,Johor,33,5,28,2012
2012-09-15,Johor,49,27,22,2012
2012-09-16,Johor,214,60,154,2012
2012-09-17,Johor,0,0,0,2012
2012-09-18,Johor,24,5,19,2012
2012-09-19,Johor,84,38,46,2012
2012-09-20,Johor,49,23,26,2012
2012-09-21,Johor,23,6,17,2012
2012-09-22,Johor,131,25,106,2012
2012-09-23,Johor,139,39,100,2012
2012-09-24,Johor,65,34,31,2012
2012-09-25,Johor,39,13,26,2012
2012-09-26,Johor,121,79,42,2012
2012-09-27,Johor,70,24,46,2012
2012-09-28,Johor,102,48,54,2012
2012-09-29,Johor,92,43,49,2012
2012-09-30,Johor,106,35,71,2012
2012-10-01,Johor,31,4,27,2012
2012-10-02,Johor,7,1,6,2012
2012-10-03,Johor,66,17,49,2012
2012-10-04,Johor,59,16,43,2012
2012-10-05,Johor,10,2,8,2012
2012-10-06,Johor,106,45,61,2012
2012-10-07,Johor,276,69,207,2012
2012-10-08,Johor,33,9,24,2012
2012-10-09,Johor,81,27,54,2012
2012-10-10,Johor,67,34,33,2012
2012-10-11,Johor,120,61,59,2012
2012-10-12,Johor,65,45,20,2012
2012-10-13,Johor,127,58,69,2012
2012-10-14,Johor,247,69,178,2012
2012-10-15,Johor,15,4,11,2012
2012-10-16,Johor,99,39,60,2012
2012-10-17,Johor,75,35,40,2012
2012-10-18,Johor,126,55,71,2012
2012-10-19,Johor,37,16,21,2012
2012-10-20,Johor,116,45,71,2012
2012-10-21,Johor,335,62,273,2012
2012-10-22,Johor,44,9,35,2012
2012-10-23,Johor,108,38,70,2012
2012-10-24,Johor,119,18,101,2012
2012-10-25,Johor,27,5,22,2012
2012-10-26,Johor,0,0,0,2012
2012-10-27,Johor,0,0,0,2012
2012-10-28,Johor,148,59,89,2012
2012-10-29,Johor,20,2,18,2012
2012-10-30,Johor,21,1,20,2012
2012-10-31,Johor,106,24,82,2012
2012-11-01,Johor,35,7,28,2012
2012-11-02,Johor,11,5,6,2012
2012-11-03,Johor,125,52,73,2012
2012-11-04,Johor,382,145,237,2012
2012-11-05,Johor,19,4,15,2012
2012-11-06,Johor,98,24,74,2012
2012-11-07,Johor,91,33,58,2012
2012-11-08,Johor,57,24,33,2012
2012-11-09,Johor,27,2,25,2012
2012-11-10,Johor,74,58,16,2012
2012-11-11,Johor,189,57,132,2012
2012-11-12,Johor,23,8,15,2012
2012-11-13,Johor,0,0,0,2012
2012-11-14,Johor,25,4,21,2012
2012-11-15,Johor,49,21,28,2012
2012-11-16,Johor,17,5,12,2012
2012-11-17,Johor,98,38,60,2012
2012-11-18,Johor,342,132,210,2012
2012-11-19,Johor,83,36,47,2012
2012-11-20,Johor,77,24,53,2012
2012-11-21,Johor,102,24,78,2012
2012-11-22,Johor,17,9,8,2012
2012-11-23,Johor,29,3,26,2012
2012-11-24,Johor,198,79,119,2012
2012-11-25,Johor,179,61,118,2012
2012-11-26,Johor,17,5,12,2012
2012-11-27,Johor,94,22,72,2012
2012-11-28,Johor,117,58,59,2012
2012-11-29,Johor,117,35,82,2012
2012-11-30,Johor,104,40,64,2012
2012-12-01,Johor,32,10,22,2012
2012-12-02,Johor,137,43,94,2012
2012-12-03,Johor,29,6,23,2012
2012-12-04,Johor,81,20,61,2012
2012-12-05,Johor,55,19,36,2012
2012-12-06,Johor,26,3,23,2012
2012-12-07,Johor,28,4,24,2012
2012-12-08,Johor,46,22,24,2012
2012-12-09,Johor,223,62,161,2012
2012-12-10,Johor,28,10,18,2012
2012-12-11,Johor,72,26,46,2012
2012-12-12,Johor,103,26,77,2012
2012-12-13,Johor,62,22,40,2012
2012-12-14,Johor,14,1,13,2012
2012-12-15,Johor,0,0,0,2012
2012-12-16,Johor,307,126,181,2012
2012-12-17,Johor,24,2,22,2012
2012-12-18,Johor,34,6,28,2012
2012-12-19,Johor,33,11,22,2012
2012-12-20,Johor,0,0,0,2012
2012-12-21,Johor,70,36,34,2012
2012-12-22,Johor,95,37,58,2012
2012-12-23,Johor,128,46,82,2012
2012-12-24,Johor,23,3,20,2012
2012-12-25,Johor,0,0,0,2012
2012-12-26,Johor,76,22,54,2012
2012-12-27,Johor,45,23,22,2012
2012-12-28,Johor,11,1,10,2012
2012-12-29,Johor,139,67,72,2012
2012-12-30,Johor,451,73,378,2012
2012-12-31,Johor,22,3,19,2012
2013-01-01,Johor,31,4,27,2013
2013-01-02,Johor,58,27,31,2013
2013-01-03,Johor,83,14,69,2013
2013-01-04,Johor,22,4,18,2013
2013-01-05,Johor,33,24,9,2013
2013-01-06,Johor,381,101,280,2013
2013-01-07,Johor,20,2,18,2013
2013-01-08,Johor,80,26,54,2013
2013-01-09,Johor,52,19,33,2013
2013-01-10,Johor,49,21,28,2013
2013-01-11,Johor,14,7,7,2013
2013-01-12,Johor,115,36,79,2013
2013-01-13,Johor,220,80,140,2013
2013-01-14,Johor,119,43,76,2013
2013-01-15,Johor,98,25,73,2013
2013-01-16,Johor,154,97,57,2013
2013-01-17,Johor,52,26,26,2013
2013-01-18,Johor,44,14,30,2013
2013-01-19,Johor,87,50,37,2013
2013-01-20,Johor,300,87,213,2013
2013-01-21,Johor,43,5,38,2013
2013-01-22,Johor,65,31,34,2013
2013-01-23,Johor,137,72,65,2013
2013-01-24,Johor,79,40,39,2013
2013-01-25,Johor,19,0,19,2013
2013-01-26,Johor,54,33,21,2013
2013-01-27,Johor,433,157,276,2013
2013-01-28,Johor,0,0,0,2013
2013-01-29,Johor,122,35,87,2013
2013-01-30,Johor,147,79,68,2013
2013-01-31,Johor,104,61,43,2013
2013-02-01,Johor,12,5,7,2013
2013-02-02,Johor,113,53,60,2013
2013-02-03,Johor,137,56,81,2013
2013-02-04,Johor,75,40,35,2013
2013-02-05,Johor,78,21,57,2013
2013-02-06,Johor,35,6,29,2013
2013-02-07,Johor,162,51,111,2013
2013-02-08,Johor,98,57,41,2013
2013-02-09,Johor,52,27,25,2013
2013-02-10,Johor,68,43,25,2013
2013-02-11,Johor,44,22,22,2013
2013-02-12,Johor,37,19,18,2013
2013-02-13,Johor,58,8,50,2013
2013-02-14,Johor,63,19,44,2013
2013-02-15,Johor,11,2,9,2013
2013-02-16,Johor,97,46,51,2013
2013-02-17,Johor,159,84,75,2013
2013-02-18,Johor,106,22,84,2013
2013-02-19,Johor,147,74,73,2013
2013-02-20,Johor,71,23,48,2013
2013-02-21,Johor,56,19,37,2013
2013-02-22,Johor,83,28,55,2013
2013-02-23,Johor,124,50,74,2013
2013-02-24,Johor,196,56,140,2013
2013-02-25,Johor,79,23,56,2013
2013-02-26,Johor,110,17,93,2013
2013-02-27,Johor,95,35,60,2013
2013-02-28,Johor,39,15,24,2013
2013-03-01,Johor,31,3,28,2013
2013-03-02,Johor,90,43,47,2013
2013-03-03,Johor,187,62,125,2013
2013-03-04,Johor,107,37,70,2013
2013-03-05,Johor,108,34,74,2013
2013-03-06,Johor,88,29,59,2013
2013-03-07,Johor,96,45,51,2013
2013-03-08,Johor,25,3,22,2013
2013-03-09,Johor,173,128,45,2013
2013-03-10,Johor,398,90,308,2013
2013-03-11,Johor,82,52,30,2013
2013-03-12,Johor,78,56,22,2013
2013-03-13,Johor,109,21,88,2013
2013-03-14,Johor,61,25,36,2013
2013-03-15,Johor,20,2,18,2013
2013-03-16,Johor,134,63,71,2013
2013-03-17,Johor,316,132,184,2013
2013-03-18,Johor,25,3,22,2013
2013-03-19,Johor,71,14,57,2013
2013-03-20,Johor,46,9,37,2013
2013-03-21,Johor,54,19,35,2013
2013-03-22,Johor,34,3,31,2013
2013-03-23,Johor,201,110,91,2013
2013-03-24,Johor,436,133,303,2013
2013-03-25,Johor,27,4,23,2013
2013-03-26,Johor,23,2,21,2013
2013-03-27,Johor,52,10,42,2013
2013-03-28,Johor,85,42,43,2013
2013-03-29,Johor,40,6,34,2013
2013-03-30,Johor,124,62,62,2013
2013-03-31,Johor,223,100,123,2013
2013-04-01,Johor,48,16,32,2013
2013-04-02,Johor,76,45,31,2013
2013-04-03,Johor,30,2,28,2013
2013-04-04,Johor,51,17,34,2013
2013-04-05,Johor,31,6,25,2013
2013-04-06,Johor,144,94,50,2013
2013-04-07,Johor,320,111,209,2013
2013-04-08,Johor,25,3,22,2013
2013-04-09,Johor,49,21,28,2013
2013-04-10,Johor,96,63,33,2013
2013-04-11,Johor,42,22,20,2013
2013-04-12,Johor,25,2,23,2013
2013-04-13,Johor,140,35,105,2013
2013-04-14,Johor,416,107,309,2013
2013-04-15,Johor,22,5,17,2013
2013-04-16,Johor,110,64,46,2013
2013-04-17,Johor,63,39,24,2013
2013-04-18,Johor,59,16,43,2013
2013-04-19,Johor,114,52,62,2013
2013-04-20,Johor,111,55,56,2013
2013-04-21,Johor,177,53,124,2013
2013-04-22,Johor,28,3,25,2013
2013-04-23,Johor,25,5,20,2013
2013-04-24,Johor,94,31,63,2013
2013-04-25,Johor,44,19,25,2013
2013-04-26,Johor,47,20,27,2013
2013-04-27,Johor,104,34,70,2013
2013-04-28,Johor,257,61,196,2013
2013-04-29,Johor,50,29,21,2013
2013-04-30,Johor,72,23,49,2013
2013-05-01,Johor,79,15,64,2013
2013-05-02,Johor,47,18,29,2013
2013-05-03,Johor,33,5,28,2013
2013-05-04,Johor,42,13,29,2013
2013-05-05,Johor,0,0,0,2013
2013-05-06,Johor,19,2,17,2013
2013-05-07,Johor,80,36,44,2013
2013-05-08,Johor,85,17,68,2013
2013-05-09,Johor,54,24,30,2013
2013-05-10,Johor,105,39,66,2013
2013-05-11,Johor,141,50,91,2013
2013-05-12,Johor,429,131,298,2013
2013-05-13,Johor,32,14,18,2013
2013-05-14,Johor,93,27,66,2013
2013-05-15,Johor,130,61,69,2013
2013-05-16,Johor,58,16,42,2013
2013-05-17,Johor,23,2,21,2013
2013-05-18,Johor,99,41,58,2013
2013-05-19,Johor,279,74,205,2013
2013-05-20,Johor,22,4,18,2013
2013-05-21,Johor,63,6,57,2013
2013-05-22,Johor,91,35,56,2013
2013-05-23,Johor,30,9,21,2013
2013-05-24,Johor,0,0,0,2013
2013-05-25,Johor,126,86,40,2013
2013-05-26,Johor,312,74,238,2013
2013-05-27,Johor,38,6,32,2013
2013-05-28,Johor,22,4,18,2013
2013-05-29,Johor,107,29,78,2013
2013-05-30,Johor,68,29,39,2013
2013-05-31,Johor,9,1,8,2013
2013-06-01,Johor,83,16,67,2013
2013-06-02,Johor,231,92,139,2013
2013-06-03,Johor,25,5,20,2013
2013-06-04,Johor,26,4,22,2013
2013-06-05,Johor,138,41,97,2013
2013-06-06,Johor,27,9,18,2013
2013-06-07,Johor,25,4,21,2013
2013-06-08,Johor,35,18,17,2013
2013-06-09,Johor,70,28,42,2013
2013-06-10,Johor,23,1,22,2013
2013-06-11,Johor,25,3,22,2013
2013-06-12,Johor,80,14,66,2013
2013-06-13,Johor,72,47,25,2013
2013-06-14,Johor,36,8,28,2013
2013-06-15,Johor,93,57,36,2013
2013-06-16,Johor,243,66,177,2013
2013-06-17,Johor,70,13,57,2013
2013-06-18,Johor,88,52,36,2013
2013-06-19,Johor,139,55,84,2013
2013-06-20,Johor,164,80,84,2013
2013-06-21,Johor,19,4,15,2013
2013-06-22,Johor,53,42,11,2013
2013-06-23,Johor,136,49,87,2013
2013-06-24,Johor,21,3,18,2013
2013-06-25,Johor,156,50,106,2013
2013-06-26,Johor,90,42,48,2013
2013-06-27,Johor,142,43,99,2013
2013-06-28,Johor,26,8,18,2013
2013-06-29,Johor,9,4,5,2013
2013-06-30,Johor,467,145,322,2013
2013-07-01,Johor,40,13,27,2013
2013-07-02,Johor,66,21,45,2013
2013-07-03,Johor,84,39,45,2013
2013-07-04,Johor,122,26,96,2013
2013-07-05,Johor,64,26,38,2013
2013-07-06,Johor,156,82,74,2013
2013-07-07,Johor,383,85,298,2013
2013-07-08,Johor,47,4,43,2013
2013-07-09,Johor,34,9,25,2013
2013-07-10,Johor,0,0,0,2013
2013-07-11,Johor,71,49,22,2013
2013-07-12,Johor,15,2,13,2013
2013-07-13,Johor,32,18,14,2013
2013-07-14,Johor,358,100,258,2013
2013-07-15,Johor,9,2,7,2013
2013-07-16,Johor,67,39,28,2013
2013-07-17,Johor,11,0,11,2013
2013-07-18,Johor,105,47,58,2013
2013-07-19,Johor,9,0,9,2013
2013-07-20,Johor,50,25,25,2013
2013-07-21,Johor,349,126,223,2013
2013-07-22,Johor,12,3,9,2013
2013-07-23,Johor,12,1,11,2013
2013-07-24,Johor,198,83,115,2013
2013-07-25,Johor,63,22,41,2013
2013-07-26,Johor,4,1,3,2013
2013-07-27,Johor,138,22,116,2013
2013-07-28,Johor,292,81,211,2013
2013-07-29,Johor,14,2,12,2013
2013-07-30,Johor,59,28,31,2013
2013-07-31,Johor,94,33,61,2013
2013-08-01,Johor,28,18,10,2013
2013-08-02,Johor,14,2,12,2013
2013-08-03,Johor,79,36,43,2013
2013-08-04,Johor,299,88,211,2013
2013-08-05,Johor,43,10,33,2013
2013-08-06,Johor,71,16,55,2013
2013-08-07,Johor,17,3,14,2013
2013-08-08,Johor,0,0,0,2013
2013-08-09,Johor,0,0,0,2013
2013-08-10,Johor,0,0,0,2013
2013-08-11,Johor,21,11,10,2013
2013-08-12,Johor,18,1,17,2013
2013-08-13,Johor,56,25,31,2013
2013-08-14,Johor,73,21,52,2013
2013-08-15,Johor,91,38,53,2013
2013-08-16,Johor,85,37,48,2013
2013-08-17,Johor,49,21,28,2013
2013-08-18,Johor,389,143,246,2013
2013-08-19,Johor,35,5,30,2013
2013-08-20,Johor,48,14,34,2013
2013-08-21,Johor,210,76,134,2013
2013-08-22,Johor,49,14,35,2013
2013-08-23,Johor,64,37,27,2013
2013-08-24,Johor,233,100,133,2013
2013-08-25,Johor,119,58,61,2013
2013-08-26,Johor,98,41,57,2013
2013-08-27,Johor,47,9,38,2013
2013-08-28,Johor,132,30,102,2013
2013-08-29,Johor,98,39,59,2013
2013-08-30,Johor,69,34,35,2013
2013-08-31,Johor,220,48,172,2013
2013-09-01,Johor,233,88,145,2013
2013-09-02,Johor,48,15,33,2013
2013-09-03,Johor,108,47,61,2013
2013-09-04,Johor,130,61,69,2013
2013-09-05,Johor,81,27,54,2013
2013-09-06,Johor,21,6,15,2013
2013-09-07,Johor,153,75,78,2013
2013-09-08,Johor,251,61,190,2013
2013-09-09,Johor,6,3,3,2013
2013-09-10,Johor,56,18,38,2013
2013-09-11,Johor,76,11,65,2013
2013-09-12,Johor,51,15,36,2013
2013-09-13,Johor,74,45,29,2013
2013-09-14,Johor,22,10,12,2013
2013-09-15,Johor,231,69,162,2013
2013-09-16,Johor,95,18,77,2013
2013-09-17,Johor,15,1,14,2013
2013-09-18,Johor,81,48,33,2013
2013-09-19,Johor,114,60,54,2013
2013-09-20,Johor,11,2,9,2013
2013-09-21,Johor,130,65,65,2013
2013-09-22,Johor,169,47,122,2013
2013-09-23,Johor,39,10,29,2013
2013-09-24,Johor,138,77,61,2013
2013-09-25,Johor,88,19,69,2013
2013-09-26,Johor,18,3,15,2013
2013-09-27,Johor,146,78,68,2013
2013-09-28,Johor,110,47,63,2013
2013-09-29,Johor,390,76,314,2013
2013-09-30,Johor,30,1,29,2013
2013-10-01,Johor,58,12,46,2013
2013-10-02,Johor,102,52,50,2013
2013-10-03,Johor,101,24,77,2013
2013-10-04,Johor,120,60,60,2013
2013-10-05,Johor,133,64,69,2013
2013-10-06,Johor,258,56,202,2013
2013-10-07,Johor,22,1,21,2013
2013-10-08,Johor,88,25,63,2013
2013-10-09,Johor,219,108,111,2013
2013-10-10,Johor,33,14,19,2013
2013-10-11,Johor,17,3,14,2013
2013-10-12,Johor,149,71,78,2013
2013-10-13,Johor,268,80,188,2013
2013-10-14,Johor,24,3,21,2013
2013-10-15,Johor,0,0,0,2013
2013-10-16,Johor,97,50,47,2013
2013-10-17,Johor,168,98,70,2013
2013-10-18,Johor,17,3,14,2013
2013-10-19,Johor,169,60,109,2013
2013-10-20,Johor,283,77,206,2013
2013-10-21,Johor,18,3,15,2013
2013-10-22,Johor,91,18,73,2013
2013-10-23,Johor,79,21,58,2013
2013-10-24,Johor,69,39,30,2013
2013-10-25,Johor,21,4,17,2013
2013-10-26,Johor,169,63,106,2013
2013-10-27,Johor,288,116,172,2013
2013-10-28,Johor,27,4,23,2013
2013-10-29,Johor,98,53,45,2013
2013-10-30,Johor,64,18,46,2013
2013-10-31,Johor,36,6,30,2013
2013-11-01,Johor,18,2,16,2013
2013-11-02,Johor,0,0,0,2013
2013-11-03,Johor,241,80,161,2013
2013-11-04,Johor,36,6,30,2013
2013-11-05,Johor,0,0,0,2013
2013-11-06,Johor,65,24,41,2013
2013-11-07,Johor,115,37,78,2013
2013-11-08,Johor,16,5,11,2013
2013-11-09,Johor,118,47,71,2013
2013-11-10,Johor,338,70,268,2013
2013-11-11,Johor,29,4,25,2013
2013-11-12,Johor,94,54,40,2013
2013-11-13,Johor,24,6,18,2013
2013-11-14,Johor,147,59,88,2013
2013-11-15,Johor,16,2,14,2013
2013-11-16,Johor,53,42,11,2013
2013-11-17,Johor,86,43,43,2013
2013-11-18,Johor,32,5,27,2013
2013-11-19,Johor,105,22,83,2013
2013-11-20,Johor,118,20,98,2013
2013-11-21,Johor,56,13,43,2013
2013-11-22,Johor,0,0,0,2013
2013-11-23,Johor,0,0,0,2013
2013-11-24,Johor,196,41,155,2013
2013-11-25,Johor,32,9,23,2013
2013-11-26,Johor,45,16,29,2013
2013-11-27,Johor,120,42,78,2013
2013-11-28,Johor,77,42,35,2013
2013-11-29,Johor,27,4,23,2013
2013-11-30,Johor,16,8,8,2013
2013-12-01,Johor,93,34,59,2013
2013-12-02,Johor,12,0,12,2013
2013-12-03,Johor,71,15,56,2013
2013-12-04,Johor,146,44,102,2013
2013-12-05,Johor,65,20,45,2013
2013-12-06,Johor,70,23,47,2013
2013-12-07,Johor,101,38,63,2013
2013-12-08,Johor,165,81,84,2013
2013-12-09,Johor,0,0,0,2013
2013-12-10,Johor,109,33,76,2013
2013-12-11,Johor,83,34,49,2013
2013-12-12,Johor,78,18,60,2013
2013-12-13,Johor,22,3,19,2013
2013-12-14,Johor,54,20,34,2013
2013-12-15,Johor,226,56,170,2013
2013-12-16,Johor,24,3,21,2013
2013-12-17,Johor,71,19,52,2013
2013-12-18,Johor,54,22,32,2013
2013-12-19,Johor,52,7,45,2013
2013-12-20,Johor,104,45,59,2013
2013-12-21,Johor,30,9,21,2013
2013-12-22,Johor,260,55,205,2013
2013-12-23,Johor,57,26,31,2013
2013-12-24,Johor,47,14,33,2013
2013-12-25,Johor,0,0,0,2013
2013-12-26,Johor,42,15,27,2013
2013-12-27,Johor,55,15,40,2013
2013-12-28,Johor,120,41,79,2013
2013-12-29,Johor,185,80,105,2013
2013-12-30,Johor,23,3,20,2013
2013-12-31,Johor,55,13,42,2013
2014-01-01,Johor,43,11,32,2014
2014-01-02,Johor,81,23,58,2014
2014-01-03,Johor,1,0,1,2014
2014-01-04,Johor,128,75,53,2014
2014-01-05,Johor,337,54,283,2014
2014-01-06,Johor,58,18,40,2014
2014-01-07,Johor,18,3,15,2014
2014-01-08,Johor,20,1,19,2014
2014-01-09,Johor,149,37,112,2014
2014-01-10,Johor,74,29,45,2014
2014-01-11,Johor,86,39,47,2014
2014-01-12,Johor,283,60,223,2014
2014-01-13,Johor,230,100,130,2014
2014-01-14,Johor,0,0,0,2014
2014-01-15,Johor,73,31,42,2014
2014-01-16,Johor,93,22,71,2014
2014-01-17,Johor,290,147,143,2014
2014-01-18,Johor,0,0,0,2014
2014-01-19,Johor,351,65,286,2014
2014-01-20,Johor,65,11,54,2014
2014-01-21,Johor,99,30,69,2014
2014-01-22,Johor,237,80,157,2014
2014-01-23,Johor,26,4,22,2014
2014-01-24,Johor,0,0,0,2014
2014-01-25,Johor,16,7,9,2014
2014-01-26,Johor,116,24,92,2014
2014-01-27,Johor,99,66,33,2014
2014-01-28,Johor,22,6,16,2014
2014-01-29,Johor,250,83,167,2014
2014-01-30,Johor,16,2,14,2014
2014-01-31,Johor,0,0,0,2014
2014-02-01,Johor,69,26,43,2014
2014-02-02,Johor,49,24,25,2014
2014-02-03,Johor,57,17,40,2014
2014-02-04,Johor,82,53,29,2014
2014-02-05,Johor,72,45,27,2014
2014-02-06,Johor,73,29,44,2014
2014-02-07,Johor,0,0,0,2014
2014-02-08,Johor,23,6,17,2014
2014-02-09,Johor,78,31,47,2014
2014-02-10,Johor,106,33,73,2014
2014-02-11,Johor,97,35,62,2014
2014-02-12,Johor,79,23,56,2014
2014-02-13,Johor,82,19,63,2014
2014-02-14,Johor,118,50,68,2014
2014-02-15,Johor,153,80,73,2014
2014-02-16,Johor,272,74,198,2014
2014-02-17,Johor,54,16,38,2014
2014-02-18,Johor,98,46,52,2014
2014-02-19,Johor,83,10,73,2014
2014-02-20,Johor,67,28,39,2014
2014-02-21,Johor,136,45,91,2014
2014-02-22,Johor,117,45,72,2014
2014-02-23,Johor,227,55,172,2014
2014-02-24,Johor,33,6,27,2014
2014-02-25,Johor,61,7,54,2014
2014-02-26,Johor,89,18,71,2014
2014-02-27,Johor,175,63,112,2014
2014-02-28,Johor,0,0,0,2014
2014-03-01,Johor,138,121,17,2014
2014-03-02,Johor,246,60,186,2014
2014-03-03,Johor,88,21,67,2014
2014-03-04,Johor,91,48,43,2014
2014-03-05,Johor,96,47,49,2014
2014-03-06,Johor,110,57,53,2014
2014-03-07,Johor,0,0,0,2014
2014-03-08,Johor,179,69,110,2014
2014-03-09,Johor,262,57,205,2014
2014-03-10,Johor,48,23,25,2014
2014-03-11,Johor,106,54,52,2014
2014-03-12,Johor,78,50,28,2014
2014-03-13,Johor,66,15,51,2014
2014-03-14,Johor,0,0,0,2014
2014-03-15,Johor,60,27,33,2014
2014-03-16,Johor,206,45,161,2014
2014-03-17,Johor,52,37,15,2014
2014-03-18,Johor,77,25,52,2014
2014-03-19,Johor,97,34,63,2014
2014-03-20,Johor,19,4,15,2014
2014-03-21,Johor,0,0,0,2014
2014-03-22,Johor,67,38,29,2014
2014-03-23,Johor,265,66,199,2014
2014-03-24,Johor,40,15,25,2014
2014-03-25,Johor,68,27,41,2014
2014-03-26,Johor,94,37,57,2014
2014-03-27,Johor,125,19,106,2014
2014-03-28,Johor,0,0,0,2014
2014-03-29,Johor,149,65,84,2014
2014-03-30,Johor,290,85,205,2014
2014-03-31,Johor,26,1,25,2014
2014-04-01,Johor,70,25,45,2014
2014-04-02,Johor,108,29,79,2014
2014-04-03,Johor,56,10,46,2014
2014-04-04,Johor,0,0,0,2014
2014-04-05,Johor,164,78,86,2014
2014-04-06,Johor,293,80,213,2014
2014-04-07,Johor,24,3,21,2014
2014-04-08,Johor,19,6,13,2014
2014-04-09,Johor,56,11,45,2014
2014-04-10,Johor,72,18,54,2014
2014-04-11,Johor,39,18,21,2014
2014-04-12,Johor,170,104,66,2014
2014-04-13,Johor,268,73,195,2014
2014-04-14,Johor,64,22,42,2014
2014-04-15,Johor,20,7,13,2014
2014-04-16,Johor,77,36,41,2014
2014-04-17,Johor,85,19,66,2014
2014-04-18,Johor,54,29,25,2014
2014-04-19,Johor,110,44,66,2014
2014-04-20,Johor,250,77,173,2014
2014-04-21,Johor,35,17,18,2014
2014-04-22,Johor,99,33,66,2014
2014-04-23,Johor,69,12,57,2014
2014-04-24,Johor,178,73,105,2014
2014-04-25,Johor,42,13,29,2014
2014-04-26,Johor,69,34,35,2014
2014-04-27,Johor,314,85,229,2014
2014-04-28,Johor,20,2,18,2014
2014-04-29,Johor,20,3,17,2014
2014-04-30,Johor,95,19,76,2014
2014-05-01,Johor,189,77,112,2014
2014-05-02,Johor,57,30,27,2014
2014-05-03,Johor,60,32,28,2014
2014-05-04,Johor,232,56,176,2014
2014-05-05,Johor,27,4,23,2014
2014-05-06,Johor,114,32,82,2014
2014-05-07,Johor,163,45,118,2014
2014-05-08,Johor,60,15,45,2014
2014-05-09,Johor,0,0,0,2014
2014-05-10,Johor,85,27,58,2014
2014-05-11,Johor,290,51,239,2014
2014-05-12,Johor,52,17,35,2014
2014-05-13,Johor,131,60,71,2014
2014-05-14,Johor,89,26,63,2014
2014-05-15,Johor,86,36,50,2014
2014-05-16,Johor,0,0,0,2014
2014-05-17,Johor,182,69,113,2014
2014-05-18,Johor,320,117,203,2014
2014-05-19,Johor,67,25,42,2014
2014-05-20,Johor,67,14,53,2014
2014-05-21,Johor,168,78,90,2014
2014-05-22,Johor,20,4,16,2014
2014-05-23,Johor,114,56,58,2014
2014-05-24,Johor,32,10,22,2014
2014-05-25,Johor,230,54,176,2014
2014-05-26,Johor,70,22,48,2014
2014-05-27,Johor,19,2,17,2014
2014-05-28,Johor,61,19,42,2014
2014-05-29,Johor,66,19,47,2014
2014-05-30,Johor,29,14,15,2014
2014-05-31,Johor,163,73,90,2014
2014-06-01,Johor,225,78,147,2014
2014-06-02,Johor,25,2,23,2014
2014-06-03,Johor,62,17,45,2014
2014-06-04,Johor,41,6,35,2014
2014-06-05,Johor,53,12,41,2014
2014-06-06,Johor,44,14,30,2014
2014-06-07,Johor,155,44,111,2014
2014-06-08,Johor,362,84,278,2014
2014-06-09,Johor,17,1,16,2014
2014-06-10,Johor,42,27,15,2014
2014-06-11,Johor,74,22,52,2014
2014-06-12,Johor,24,5,19,2014
2014-06-13,Johor,0,0,0,2014
2014-06-14,Johor,160,92,68,2014
2014-06-15,Johor,191,35,156,2014
2014-06-16,Johor,73,28,45,2014
2014-06-17,Johor,130,30,100,2014
2014-06-18,Johor,142,46,96,2014
2014-06-19,Johor,53,9,44,2014
2014-06-20,Johor,61,53,8,2014
2014-06-21,Johor,88,45,43,2014
2014-06-22,Johor,177,62,115,2014
2014-06-23,Johor,89,44,45,2014
2014-06-24,Johor,111,65,46,2014
2014-06-25,Johor,167,86,81,2014
2014-06-26,Johor,0,0,0,2014
2014-06-27,Johor,0,0,0,2014
2014-06-28,Johor,8,6,2,2014
2014-06-29,Johor,198,57,141,2014
2014-06-30,Johor,23,6,17,2014
2014-07-01,Johor,31,20,11,2014
2014-07-02,Johor,1,0,1,2014
2014-07-03,Johor,69,30,39,2014
2014-07-04,Johor,17,11,6,2014
2014-07-05,Johor,147,67,80,2014
2014-07-06,Johor,52,21,31,2014
2014-07-07,Johor,31,13,18,2014
2014-07-08,Johor,41,32,9,2014
2014-07-09,Johor,147,85,62,2014
2014-07-10,Johor,25,9,16,2014
2014-07-11,Johor,18,9,9,2014
2014-07-12,Johor,118,38,80,2014
2014-07-13,Johor,340,101,239,2014
2014-07-14,Johor,10,1,9,2014
2014-07-15,Johor,11,0,11,2014
2014-07-16,Johor,232,95,137,2014
2014-07-17,Johor,69,30,39,2014
2014-07-18,Johor,29,12,17,2014
2014-07-19,Johor,47,26,21,2014
2014-07-20,Johor,323,98,225,2014
2014-07-21,Johor,77,26,51,2014
2014-07-22,Johor,103,29,74,2014
2014-07-23,Johor,137,48,89,2014
2014-07-24,Johor,102,48,54,2014
2014-07-25,Johor,44,29,15,2014
2014-07-26,Johor,165,47,118,2014
2014-07-27,Johor,10,2,8,2014
2014-07-28,Johor,0,0,0,2014
2014-07-29,Johor,0,0,0,2014
2014-07-30,Johor,31,8,23,2014
2014-07-31,Johor,9,0,9,2014
2014-08-01,Johor,67,26,41,2014
2014-08-02,Johor,81,35,46,2014
2014-08-03,Johor,300,80,220,2014
2014-08-04,Johor,47,15,32,2014
2014-08-05,Johor,67,19,48,2014
2014-08-06,Johor,130,72,58,2014
2014-08-07,Johor,57,36,21,2014
2014-08-08,Johor,70,8,62,2014
2014-08-09,Johor,77,38,39,2014
2014-08-10,Johor,133,37,96,2014
2014-08-11,Johor,33,4,29,2014
2014-08-12,Johor,74,10,64,2014
2014-08-13,Johor,130,40,90,2014
2014-08-14,Johor,42,16,26,2014
2014-08-15,Johor,92,56,36,2014
2014-08-16,Johor,197,113,84,2014
2014-08-17,Johor,191,58,133,2014
2014-08-18,Johor,109,37,72,2014
2014-08-19,Johor,117,45,72,2014
2014-08-20,Johor,58,44,14,2014
2014-08-21,Johor,96,24,72,2014
2014-08-22,Johor,0,0,0,2014
2014-08-23,Johor,96,63,33,2014
2014-08-24,Johor,360,68,292,2014
2014-08-25,Johor,98,36,62,2014
2014-08-26,Johor,98,51,47,2014
2014-08-27,Johor,143,65,78,2014
2014-08-28,Johor,77,21,56,2014
2014-08-29,Johor,0,0,0,2014
2014-08-30,Johor,102,48,54,2014
2014-08-31,Johor,343,111,232,2014
2014-09-01,Johor,46,9,37,2014
2014-09-02,Johor,83,22,61,2014
2014-09-03,Johor,96,27,69,2014
2014-09-04,Johor,94,27,67,2014
2014-09-05,Johor,4,3,1,2014
2014-09-06,Johor,102,50,52,2014
2014-09-07,Johor,79,28,51,2014
2014-09-08,Johor,56,24,32,2014
2014-09-09,Johor,36,4,32,2014
2014-09-10,Johor,159,64,95,2014
2014-09-11,Johor,99,26,73,2014
2014-09-12,Johor,0,0,0,2014
2014-09-13,Johor,74,45,29,2014
2014-09-14,Johor,152,56,96,2014
2014-09-15,Johor,28,8,20,2014
2014-09-16,Johor,135,26,109,2014
2014-09-17,Johor,38,10,28,2014
2014-09-18,Johor,148,58,90,2014
2014-09-19,Johor,58,27,31,2014
2014-09-20,Johor,75,47,28,2014
2014-09-21,Johor,309,78,231,2014
2014-09-22,Johor,73,57,16,2014
2014-09-23,Johor,185,88,97,2014
2014-09-24,Johor,213,82,131,2014
2014-09-25,Johor,57,26,31,2014
2014-09-26,Johor,34,16,18,2014
2014-09-27,Johor,247,119,128,2014
2014-09-28,Johor,162,39,123,2014
2014-09-29,Johor,122,30,92,2014
2014-09-30,Johor,78,32,46,2014
2014-10-01,Johor,112,67,45,2014
2014-10-02,Johor,57,20,37,2014
2014-10-03,Johor,34,17,17,2014
2014-10-04,Johor,53,26,27,2014
2014-10-05,Johor,83,19,64,2014
2014-10-06,Johor,51,9,42,2014
2014-10-07,Johor,45,15,30,2014
2014-10-08,Johor,107,57,50,2014
2014-10-09,Johor,75,49,26,2014
2014-10-10,Johor,91,54,37,2014
2014-10-11,Johor,201,81,120,2014
2014-10-12,Johor,329,65,264,2014
2014-10-13,Johor,57,16,41,2014
2014-10-14,Johor,63,24,39,2014
2014-10-15,Johor,48,13,35,2014
2014-10-16,Johor,175,83,92,2014
2014-10-17,Johor,0,0,0,2014
2014-10-18,Johor,80,40,40,2014
2014-10-19,Johor,311,127,184,2014
2014-10-20,Johor,19,2,17,2014
2014-10-21,Johor,87,52,35,2014
2014-10-22,Johor,0,0,0,2014
2014-10-23,Johor,122,33,89,2014
2014-10-24,Johor,66,39,27,2014
2014-10-25,Johor,54,52,2,2014
2014-10-26,Johor,183,66,117,2014
2014-10-27,Johor,81,41,40,2014
2014-10-28,Johor,42,5,37,2014
2014-10-29,Johor,168,87,81,2014
2014-10-30,Johor,141,88,53,2014
2014-10-31,Johor,151,67,84,2014
2014-11-01,Johor,20,13,7,2014
2014-11-02,Johor,129,59,70,2014
2014-11-03,Johor,22,4,18,2014
2014-11-04,Johor,69,36,33,2014
2014-11-05,Johor,89,29,60,2014
2014-11-06,Johor,37,14,23,2014
2014-11-07,Johor,10,3,7,2014
2014-11-08,Johor,215,82,133,2014
2014-11-09,Johor,284,69,215,2014
2014-11-10,Johor,25,2,23,2014
2014-11-11,Johor,89,30,59,2014
2014-11-12,Johor,145,75,70,2014
2014-11-13,Johor,17,2,15,2014
2014-11-14,Johor,0,0,0,2014
2014-11-15,Johor,243,124,119,2014
2014-11-16,Johor,234,75,159,2014
2014-11-17,Johor,26,3,23,2014
2014-11-18,Johor,76,31,45,2014
2014-11-19,Johor,124,22,102,2014
2014-11-20,Johor,81,46,35,2014
2014-11-21,Johor,46,31,15,2014
2014-11-22,Johor,186,95,91,2014
2014-11-23,Johor,225,67,158,2014
2014-11-24,Johor,71,20,51,2014
2014-11-25,Johor,47,10,37,2014
2014-11-26,Johor,54,30,24,2014
2014-11-27,Johor,94,31,63,2014
2014-11-28,Johor,41,21,20,2014
2014-11-29,Johor,0,0,0,2014
2014-11-30,Johor,378,97,281,2014
2014-12-01,Johor,132,36,96,2014
2014-12-02,Johor,26,1,25,2014
2014-12-03,Johor,76,21,55,2014
2014-12-04,Johor,81,21,60,2014
2014-12-05,Johor,0,0,0,2014
2014-12-06,Johor,83,35,48,2014
2014-12-07,Johor,233,83,150,2014
2014-12-08,Johor,22,3,19,2014
2014-12-09,Johor,86,41,45,2014
2014-12-10,Johor,131,76,55,2014
2014-12-11,Johor,66,22,44,2014
2014-12-12,Johor,0,0,0,2014
2014-12-13,Johor,80,29,51,2014
2014-12-14,Johor,354,85,269,2014
2014-12-15,Johor,23,3,20,2014
2014-12-16,Johor,191,92,99,2014
2014-12-17,Johor,134,76,58,2014
2014-12-18,Johor,68,23,45,2014
2014-12-19,Johor,82,28,54,2014
2014-12-20,Johor,19,10,9,2014
2014-12-21,Johor,240,42,198,2014
2014-12-22,Johor,21,1,20,2014
2014-12-23,Johor,42,27,15,2014
2014-12-24,Johor,59,28,31,2014
2014-12-25,Johor,0,0,0,2014
2014-12-26,Johor,0,0,0,2014
2014-12-27,Johor,115,59,56,2014
2014-12-28,Johor,174,71,103,2014
2014-12-29,Johor,20,4,16,2014
2014-12-30,Johor,81,31,50,2014
2014-12-31,Johor,123,44,79,2014
2015-01-01,Johor,84,33,51,2015
2015-01-02,Johor,0,0,0,2015
2015-01-03,Johor,155,72,83,2015
2015-01-04,Johor,271,82,189,2015
2015-01-05,Johor,56,34,22,2015
2015-01-06,Johor,32,6,26,2015
2015-01-07,Johor,153,92,61,2015
2015-01-08,Johor,59,9,50,2015
2015-01-09,Johor,138,38,100,2015
2015-01-10,Johor,118,53,65,2015
2015-01-11,Johor,182,66,116,2015
2015-01-12,Johor,80,30,50,2015
2015-01-13,Johor,72,54,18,2015
2015-01-14,Johor,207,82,125,2015
2015-01-15,Johor,110,61,49,2015
2015-01-16,Johor,0,0,0,2015
2015-01-17,Johor,86,51,35,2015
2015-01-18,Johor,268,91,177,2015
2015-01-19,Johor,151,74,77,2015
2015-01-20,Johor,132,40,92,2015
2015-01-21,Johor,102,32,70,2015
2015-01-22,Johor,108,31,77,2015
2015-01-23,Johor,43,24,19,2015
2015-01-24,Johor,49,14,35,2015
2015-01-25,Johor,276,59,217,2015
2015-01-26,Johor,22,4,18,2015
2015-01-27,Johor,79,24,55,2015
2015-01-28,Johor,87,19,68,2015
2015-01-29,Johor,90,33,57,2015
2015-01-30,Johor,133,45,88,2015
2015-01-31,Johor,167,117,50,2015
2015-02-01,Johor,137,36,101,2015
2015-02-02,Johor,32,5,27,2015
2015-02-03,Johor,360,186,174,2015
2015-02-04,Johor,13,1,12,2015
2015-02-05,Johor,66,11,55,2015
2015-02-06,Johor,0,0,0,2015
2015-02-07,Johor,88,47,41,2015
2015-02-08,Johor,201,36,165,2015
2015-02-09,Johor,53,22,31,2015
2015-02-10,Johor,62,12,50,2015
2015-02-11,Johor,40,16,24,2015
2015-02-12,Johor,145,101,44,2015
2015-02-13,Johor,7,1,6,2015
2015-02-14,Johor,67,27,40,2015
2015-02-15,Johor,337,63,274,2015
2015-02-16,Johor,102,42,60,2015
2015-02-17,Johor,134,28,106,2015
2015-02-18,Johor,102,54,48,2015
2015-02-19,Johor,0,0,0,2015
2015-02-20,Johor,0,0,0,2015
2015-02-21,Johor,87,37,50,2015
2015-02-22,Johor,57,28,29,2015
2015-02-23,Johor,164,65,99,2015
2015-02-24,Johor,61,11,50,2015
2015-02-25,Johor,84,18,66,2015
2015-02-26,Johor,26,5,21,2015
2015-02-27,Johor,5,0,5,2015
2015-02-28,Johor,166,74,92,2015
2015-03-01,Johor,140,40,100,2015
2015-03-02,Johor,73,28,45,2015
2015-03-03,Johor,144,42,102,2015
2015-03-04,Johor,30,3,27,2015
2015-03-05,Johor,53,11,42,2015
2015-03-06,Johor,2,0,2,2015
2015-03-07,Johor,197,87,110,2015
2015-03-08,Johor,317,79,238,2015
2015-03-09,Johor,102,50,52,2015
2015-03-10,Johor,140,55,85,2015
2015-03-11,Johor,168,120,48,2015
2015-03-12,Johor,27,8,19,2015
2015-03-13,Johor,0,0,0,2015
2015-03-14,Johor,117,31,86,2015
2015-03-15,Johor,180,44,136,2015
2015-03-16,Johor,108,47,61,2015
2015-03-17,Johor,58,22,36,2015
2015-03-18,Johor,97,35,62,2015
2015-03-19,Johor,45,15,30,2015
2015-03-20,Johor,38,13,25,2015
2015-03-21,Johor,58,19,39,2015
2015-03-22,Johor,279,68,211,2015
2015-03-23,Johor,0,0,0,2015
2015-03-24,Johor,43,10,33,2015
2015-03-25,Johor,151,38,113,2015
2015-03-26,Johor,89,35,54,2015
2015-03-27,Johor,69,25,44,2015
2015-03-28,Johor,191,83,108,2015
2015-03-29,Johor,315,63,252,2015
2015-03-30,Johor,80,20,60,2015
2015-03-31,Johor,87,31,56,2015
2015-04-01,Johor,103,29,74,2015
2015-04-02,Johor,108,30,78,2015
2015-04-03,Johor,0,0,0,2015
2015-04-04,Johor,111,43,68,2015
2015-04-05,Johor,102,24,78,2015
2015-04-06,Johor,20,3,17,2015
2015-04-07,Johor,72,18,54,2015
2015-04-08,Johor,94,17,77,2015
2015-04-09,Johor,148,37,111,2015
2015-04-10,Johor,4,1,3,2015
2015-04-11,Johor,130,64,66,2015
2015-04-12,Johor,294,62,232,2015
2015-04-13,Johor,121,67,54,2015
2015-04-14,Johor,27,3,24,2015
2015-04-15,Johor,105,22,83,2015
2015-04-16,Johor,73,22,51,2015
2015-04-17,Johor,1,1,0,2015
2015-04-18,Johor,82,48,34,2015
2015-04-19,Johor,384,89,295,2015
2015-04-20,Johor,25,4,21,2015
2015-04-21,Johor,60,25,35,2015
2015-04-22,Johor,59,20,39,2015
2015-04-23,Johor,101,54,47,2015
2015-04-24,Johor,93,35,58,2015
2015-04-25,Johor,90,45,45,2015
2015-04-26,Johor,289,55,234,2015
2015-04-27,Johor,25,10,15,2015
2015-04-28,Johor,45,11,34,2015
2015-04-29,Johor,156,98,58,2015
2015-04-30,Johor,19,1,18,2015
2015-05-01,Johor,198,95,103,2015
2015-05-02,Johor,40,11,29,2015
2015-05-03,Johor,253,64,189,2015
2015-05-04,Johor,0,0,0,2015
2015-05-05,Johor,29,6,23,2015
2015-05-06,Johor,119,48,71,2015
2015-05-07,Johor,63,24,39,2015
2015-05-08,Johor,43,27,16,2015
2015-05-09,Johor,62,30,32,2015
2015-05-10,Johor,312,56,256,2015
2015-05-11,Johor,51,6,45,2015
2015-05-12,Johor,78,50,28,2015
2015-05-13,Johor,89,59,30,2015
2015-05-14,Johor,52,13,39,2015
2015-05-15,Johor,25,17,8,2015
2015-05-16,Johor,152,74,78,2015
2015-05-17,Johor,139,45,94,2015
2015-05-18,Johor,94,37,57,2015
2015-05-19,Johor,35,22,13,2015
2015-05-20,Johor,47,27,20,2015
2015-05-21,Johor,117,74,43,2015
2015-05-22,Johor,52,28,24,2015
2015-05-23,Johor,197,81,116,2015
2015-05-24,Johor,324,62,262,2015
2015-05-25,Johor,26,4,22,2015
2015-05-26,Johor,83,23,60,2015
2015-05-27,Johor,126,54,72,2015
2015-05-28,Johor,39,19,20,2015
2015-05-29,Johor,53,22,31,2015
2015-05-30,Johor,124,37,87,2015
2015-05-31,Johor,296,77,219,2015
2015-06-01,Johor,68,35,33,2015
2015-06-02,Johor,69,18,51,2015
2015-06-03,Johor,47,23,24,2015
2015-06-04,Johor,52,23,29,2015
2015-06-05,Johor,82,34,48,2015
2015-06-06,Johor,221,136,85,2015
2015-06-07,Johor,218,45,173,2015
2015-06-08,Johor,83,50,33,2015
2015-06-09,Johor,96,23,73,2015
2015-06-10,Johor,86,14,72,2015
2015-06-11,Johor,164,72,92,2015
2015-06-12,Johor,46,4,42,2015
2015-06-13,Johor,0,0,0,2015
2015-06-14,Johor,236,68,168,2015
2015-06-15,Johor,84,37,47,2015
2015-06-16,Johor,100,18,82,2015
2015-06-17,Johor,76,18,58,2015
2015-06-18,Johor,0,0,0,2015
2015-06-19,Johor,17,6,11,2015
2015-06-20,Johor,32,12,20,2015
2015-06-21,Johor,272,72,200,2015
2015-06-22,Johor,13,3,10,2015
2015-06-23,Johor,63,37,26,2015
2015-06-24,Johor,37,14,23,2015
2015-06-25,Johor,79,23,56,2015
2015-06-26,Johor,39,15,24,2015
2015-06-27,Johor,133,51,82,2015
2015-06-28,Johor,225,51,174,2015
2015-06-29,Johor,18,3,15,2015
2015-06-30,Johor,81,56,25,2015
2015-07-01,Johor,50,36,14,2015
2015-07-02,Johor,137,39,98,2015
2015-07-03,Johor,20,9,11,2015
2015-07-04,Johor,52,17,35,2015
2015-07-05,Johor,247,97,150,2015
2015-07-06,Johor,17,1,16,2015
2015-07-07,Johor,90,64,26,2015
2015-07-08,Johor,73,33,40,2015
2015-07-09,Johor,54,17,37,2015
2015-07-10,Johor,52,19,33,2015
2015-07-11,Johor,136,63,73,2015
2015-07-12,Johor,362,94,268,2015
2015-07-13,Johor,22,4,18,2015
2015-07-14,Johor,45,25,20,2015
2015-07-15,Johor,93,30,63,2015
2015-07-16,Johor,13,1,12,2015
2015-07-17,Johor,0,0,0,2015
2015-07-18,Johor,0,0,0,2015
2015-07-19,Johor,66,48,18,2015
2015-07-20,Johor,126,41,85,2015
2015-07-21,Johor,78,23,55,2015
2015-07-22,Johor,122,46,76,2015
2015-07-23,Johor,181,77,104,2015
2015-07-24,Johor,143,57,86,2015
2015-07-25,Johor,172,77,95,2015
2015-07-26,Johor,220,44,176,2015
2015-07-27,Johor,36,1,35,2015
2015-07-28,Johor,130,63,67,2015
2015-07-29,Johor,232,82,150,2015
2015-07-30,Johor,58,12,46,2015
2015-07-31,Johor,15,6,9,2015
2015-08-01,Johor,113,51,62,2015
2015-08-02,Johor,126,32,94,2015
2015-08-03,Johor,61,32,29,2015
2015-08-04,Johor,69,24,45,2015
2015-08-05,Johor,110,49,61,2015
2015-08-06,Johor,18,2,16,2015
2015-08-07,Johor,0,0,0,2015
2015-08-08,Johor,112,52,60,2015
2015-08-09,Johor,284,54,230,2015
2015-08-10,Johor,136,79,57,2015
2015-08-11,Johor,69,31,38,2015
2015-08-12,Johor,251,117,134,2015
2015-08-13,Johor,19,0,19,2015
2015-08-14,Johor,19,7,12,2015
2015-08-15,Johor,100,53,47,2015
2015-08-16,Johor,314,77,237,2015
2015-08-17,Johor,56,12,44,2015
2015-08-18,Johor,78,19,59,2015
2015-08-19,Johor,271,149,122,2015
2015-08-20,Johor,74,14,60,2015
2015-08-21,Johor,33,14,19,2015
2015-08-22,Johor,186,94,92,2015
2015-08-23,Johor,159,40,119,2015
2015-08-24,Johor,62,14,48,2015
2015-08-25,Johor,58,23,35,2015
2015-08-26,Johor,66,34,32,2015
2015-08-27,Johor,64,32,32,2015
2015-08-28,Johor,0,0,0,2015
2015-08-29,Johor,123,48,75,2015
2015-08-30,Johor,254,93,161,2015
2015-08-31,Johor,240,67,173,2015
2015-09-01,Johor,84,47,37,2015
2015-09-02,Johor,59,20,39,2015
2015-09-03,Johor,60,9,51,2015
2015-09-04,Johor,0,0,0,2015
2015-09-05,Johor,91,45,46,2015
2015-09-06,Johor,276,82,194,2015
2015-09-07,Johor,227,128,99,2015
2015-09-08,Johor,92,44,48,2015
2015-09-09,Johor,71,47,24,2015
2015-09-10,Johor,65,27,38,2015
2015-09-11,Johor,31,9,22,2015
2015-09-12,Johor,80,36,44,2015
2015-09-13,Johor,334,88,246,2015
2015-09-14,Johor,146,87,59,2015
2015-09-15,Johor,21,2,19,2015
2015-09-16,Johor,192,76,116,2015
2015-09-17,Johor,54,23,31,2015
2015-09-18,Johor,53,16,37,2015
2015-09-19,Johor,79,37,42,2015
2015-09-20,Johor,176,40,136,2015
2015-09-21,Johor,24,3,21,2015
2015-09-22,Johor,41,6,35,2015
2015-09-23,Johor,99,19,80,2015
2015-09-24,Johor,0,0,0,2015
2015-09-25,Johor,0,0,0,2015
2015-09-26,Johor,95,41,54,2015
2015-09-27,Johor,212,42,170,2015
2015-09-28,Johor,92,37,55,2015
2015-09-29,Johor,33,4,29,2015
2015-09-30,Johor,138,42,96,2015
2015-10-01,Johor,69,13,56,2015
2015-10-02,Johor,0,0,0,2015
2015-10-03,Johor,76,29,47,2015
2015-10-04,Johor,295,58,237,2015
2015-10-05,Johor,23,1,22,2015
2015-10-06,Johor,9,2,7,2015
2015-10-07,Johor,97,48,49,2015
2015-10-08,Johor,75,32,43,2015
2015-10-09,Johor,0,0,0,2015
2015-10-10,Johor,174,93,81,2015
2015-10-11,Johor,326,68,258,2015
2015-10-12,Johor,128,51,77,2015
2015-10-13,Johor,68,14,54,2015
2015-10-14,Johor,1,1,0,2015
2015-10-15,Johor,59,17,42,2015
2015-10-16,Johor,2,0,2,2015
2015-10-17,Johor,104,34,70,2015
2015-10-18,Johor,327,57,270,2015
2015-10-19,Johor,97,41,56,2015
2015-10-20,Johor,57,20,37,2015
2015-10-21,Johor,21,1,20,2015
2015-10-22,Johor,53,25,28,2015
2015-10-23,Johor,0,0,0,2015
2015-10-24,Johor,33,12,21,2015
2015-10-25,Johor,251,56,195,2015
2015-10-26,Johor,144,57,87,2015
2015-10-27,Johor,23,5,18,2015
2015-10-28,Johor,115,29,86,2015
2015-10-29,Johor,44,17,27,2015
2015-10-30,Johor,79,41,38,2015
2015-10-31,Johor,349,145,204,2015
2015-11-01,Johor,161,39,122,2015
2015-11-02,Johor,52,13,39,2015
2015-11-03,Johor,45,21,24,2015
2015-11-04,Johor,80,20,60,2015
2015-11-05,Johor,122,29,93,2015
2015-11-06,Johor,0,0,0,2015
2015-11-07,Johor,86,27,59,2015
2015-11-08,Johor,297,66,231,2015
2015-11-09,Johor,27,7,20,2015
2015-11-10,Johor,94,45,49,2015
2015-11-11,Johor,39,14,25,2015
2015-11-12,Johor,75,5,70,2015
2015-11-13,Johor,0,0,0,2015
2015-11-14,Johor,75,29,46,2015
2015-11-15,Johor,115,34,81,2015
2015-11-16,Johor,29,7,22,2015
2015-11-17,Johor,153,57,96,2015
2015-11-18,Johor,0,0,0,2015
2015-11-19,Johor,123,63,60,2015
2015-11-20,Johor,0,0,0,2015
2015-11-21,Johor,156,91,65,2015
2015-11-22,Johor,192,41,151,2015
2015-11-23,Johor,29,4,25,2015
2015-11-24,Johor,64,13,51,2015
2015-11-25,Johor,243,110,133,2015
2015-11-26,Johor,21,1,20,2015
2015-11-27,Johor,67,30,37,2015
2015-11-28,Johor,123,57,66,2015
2015-11-29,Johor,85,20,65,2015
2015-11-30,Johor,13,1,12,2015
2015-12-01,Johor,90,18,72,2015
2015-12-02,Johor,214,107,107,2015
2015-12-03,Johor,34,5,29,2015
2015-12-04,Johor,57,25,32,2015
2015-12-05,Johor,165,70,95,2015
2015-12-06,Johor,301,71,230,2015
2015-12-07,Johor,33,8,25,2015
2015-12-08,Johor,155,72,83,2015
2015-12-09,Johor,80,25,55,2015
2015-12-10,Johor,65,28,37,2015
2015-12-11,Johor,0,0,0,2015
2015-12-12,Johor,161,70,91,2015
2015-12-13,Johor,304,92,212,2015
2015-12-14,Johor,23,4,19,2015
2015-12-15,Johor,73,19,54,2015
2015-12-16,Johor,83,33,50,2015
2015-12-17,Johor,189,85,104,2015
2015-12-18,Johor,0,0,0,2015
2015-12-19,Johor,207,108,99,2015
2015-12-20,Johor,274,57,217,2015
2015-12-21,Johor,28,2,26,2015
2015-12-22,Johor,35,10,25,2015
2015-12-23,Johor,50,6,44,2015
2015-12-24,Johor,0,0,0,2015
2015-12-25,Johor,49,18,31,2015
2015-12-26,Johor,151,42,109,2015
2015-12-27,Johor,201,42,159,2015
2015-12-28,Johor,29,5,24,2015
2015-12-29,Johor,42,8,34,2015
2015-12-30,Johor,100,43,57,2015
2015-12-31,Johor,62,16,46,2015
2016-01-01,Johor,7,4,3,2016
2016-01-02,Johor,86,40,46,2016
2016-01-03,Johor,147,39,108,2016
2016-01-04,Johor,39,4,35,2016
2016-01-05,Johor,83,45,38,2016
2016-01-06,Johor,51,7,44,2016
2016-01-07,Johor,86,56,30,2016
2016-01-08,Johor,0,0,0,2016
2016-01-09,Johor,109,44,65,2016
2016-01-10,Johor,359,93,266,2016
2016-01-11,Johor,25,4,21,2016
2016-01-12,Johor,84,30,54,2016
2016-01-13,Johor,134,71,63,2016
2016-01-14,Johor,59,12,47,2016
2016-01-15,Johor,0,0,0,2016
2016-01-16,Johor,128,54,74,2016
2016-01-17,Johor,142,28,114,2016
2016-01-18,Johor,27,3,24,2016
2016-01-19,Johor,145,28,117,2016
2016-01-20,Johor,101,25,76,2016
2016-01-21,Johor,159,108,51,2016
2016-01-22,Johor,0,0,0,2016
2016-01-23,Johor,31,18,13,2016
2016-01-24,Johor,446,127,319,2016
2016-01-25,Johor,4,0,4,2016
2016-01-26,Johor,150,83,67,2016
2016-01-27,Johor,70,11,59,2016
2016-01-28,Johor,27,3,24,2016
2016-01-29,Johor,0,0,0,2016
2016-01-30,Johor,77,31,46,2016
2016-01-31,Johor,250,25,225,2016
2016-02-01,Johor,72,32,40,2016
2016-02-02,Johor,95,53,42,2016
2016-02-03,Johor,120,41,79,2016
2016-02-04,Johor,127,38,89,2016
2016-02-05,Johor,0,0,0,2016
2016-02-06,Johor,114,35,79,2016
2016-02-07,Johor,18,4,14,2016
2016-02-08,Johor,0,0,0,2016
2016-02-09,Johor,0,0,0,2016
2016-02-10,Johor,52,7,45,2016
2016-02-11,Johor,28,4,24,2016
2016-02-12,Johor,0,0,0,2016
2016-02-13,Johor,39,10,29,2016
2016-02-14,Johor,41,7,34,2016
2016-02-15,Johor,20,2,18,2016
2016-02-16,Johor,26,3,23,2016
2016-02-17,Johor,27,4,23,2016
2016-02-18,Johor,32,1,31,2016
2016-02-19,Johor,0,0,0,2016
2016-02-20,Johor,79,19,60,2016
2016-02-21,Johor,100,12,88,2016
2016-02-22,Johor,45,12,33,2016
2016-02-23,Johor,34,5,29,2016
2016-02-24,Johor,34,12,22,2016
2016-02-25,Johor,17,4,13,2016
2016-02-26,Johor,40,25,15,2016
2016-02-27,Johor,44,34,10,2016
2016-02-28,Johor,181,26,155,2016
2016-02-29,Johor,32,7,25,2016
2016-03-01,Johor,53,6,47,2016
2016-03-02,Johor,162,91,71,2016
2016-03-03,Johor,46,16,30,2016
2016-03-04,Johor,0,0,0,2016
2016-03-05,Johor,106,38,68,2016
2016-03-06,Johor,382,115,267,2016
2016-03-07,Johor,101,26,75,2016
2016-03-08,Johor,114,53,61,2016
2016-03-09,Johor,91,31,60,2016
2016-03-10,Johor,40,17,23,2016
2016-03-11,Johor,0,0,0,2016
2016-03-12,Johor,155,49,106,2016
2016-03-13,Johor,310,64,246,2016
2016-03-14,Johor,97,49,48,2016
2016-03-15,Johor,56,28,28,2016
2016-03-16,Johor,74,16,58,2016
2016-03-17,Johor,45,7,38,2016
2016-03-18,Johor,81,36,45,2016
2016-03-19,Johor,164,48,116,2016
2016-03-20,Johor,391,94,297,2016
2016-03-21,Johor,33,0,33,2016
2016-03-22,Johor,71,28,43,2016
2016-03-23,Johor,177,46,131,2016
2016-03-24,Johor,80,19,61,2016
2016-03-25,Johor,0,0,0,2016
2016-03-26,Johor,168,78,90,2016
2016-03-27,Johor,130,35,95,2016
2016-03-28,Johor,174,81,93,2016
2016-03-29,Johor,139,65,74,2016
2016-03-30,Johor,222,124,98,2016
2016-03-31,Johor,52,19,33,2016
2016-04-01,Johor,0,0,0,2016
2016-04-02,Johor,47,19,28,2016
2016-04-03,Johor,292,94,198,2016
2016-04-04,Johor,109,44,65,2016
2016-04-05,Johor,43,6,37,2016
2016-04-06,Johor,217,136,81,2016
2016-04-07,Johor,39,6,33,2016
2016-04-08,Johor,0,0,0,2016
2016-04-09,Johor,116,40,76,2016
2016-04-10,Johor,358,117,241,2016
2016-04-11,Johor,18,6,12,2016
2016-04-12,Johor,148,95,53,2016
2016-04-13,Johor,82,33,49,2016
2016-04-14,Johor,57,13,44,2016
2016-04-15,Johor,12,5,7,2016
2016-04-16,Johor,227,111,116,2016
2016-04-17,Johor,287,44,243,2016
2016-04-18,Johor,31,12,19,2016
2016-04-19,Johor,49,19,30,2016
2016-04-20,Johor,72,27,45,2016
2016-04-21,Johor,66,34,32,2016
2016-04-22,Johor,0,0,0,2016
2016-04-23,Johor,106,39,67,2016
2016-04-24,Johor,312,101,211,2016
2016-04-25,Johor,18,3,15,2016
2016-04-26,Johor,113,40,73,2016
2016-04-27,Johor,29,7,22,2016
2016-04-28,Johor,135,91,44,2016
2016-04-29,Johor,0,0,0,2016
2016-04-30,Johor,108,38,70,2016
2016-05-01,Johor,299,85,214,2016
2016-05-02,Johor,164,71,93,2016
2016-05-03,Johor,29,5,24,2016
2016-05-04,Johor,42,9,33,2016
2016-05-05,Johor,91,34,57,2016
2016-05-06,Johor,101,36,65,2016
2016-05-07,Johor,162,64,98,2016
2016-05-08,Johor,326,72,254,2016
2016-05-09,Johor,26,4,22,2016
2016-05-10,Johor,25,3,22,2016
2016-05-11,Johor,102,47,55,2016
2016-05-12,Johor,164,33,131,2016
2016-05-13,Johor,0,0,0,2016
2016-05-14,Johor,146,59,87,2016
2016-05-15,Johor,242,82,160,2016
2016-05-16,Johor,24,2,22,2016
2016-05-17,Johor,86,48,38,2016
2016-05-18,Johor,155,63,92,2016
2016-05-19,Johor,68,21,47,2016
2016-05-20,Johor,1,0,1,2016
2016-05-21,Johor,138,67,71,2016
2016-05-22,Johor,257,59,198,2016
2016-05-23,Johor,91,38,53,2016
2016-05-24,Johor,53,25,28,2016
2016-05-25,Johor,59,33,26,2016
2016-05-26,Johor,16,1,15,2016
2016-05-27,Johor,19,7,12,2016
2016-05-28,Johor,102,41,61,2016
2016-05-29,Johor,220,59,161,2016
2016-05-30,Johor,32,2,30,2016
2016-05-31,Johor,45,18,27,2016
2016-06-01,Johor,68,20,48,2016
2016-06-02,Johor,145,54,91,2016
2016-06-03,Johor,0,0,0,2016
2016-06-04,Johor,309,92,217,2016
2016-06-05,Johor,67,16,51,2016
2016-06-06,Johor,0,0,0,2016
2016-06-07,Johor,27,5,22,2016
2016-06-08,Johor,53,18,35,2016
2016-06-09,Johor,103,38,65,2016
2016-06-10,Johor,0,0,0,2016
2016-06-11,Johor,98,36,62,2016
2016-06-12,Johor,164,32,132,2016
2016-06-13,Johor,59,19,40,2016
2016-06-14,Johor,62,39,23,2016
2016-06-15,Johor,26,7,19,2016
2016-06-16,Johor,167,64,103,2016
2016-06-17,Johor,0,0,0,2016
2016-06-18,Johor,60,24,36,2016
2016-06-19,Johor,81,7,74,2016
2016-06-20,Johor,16,1,15,2016
2016-06-21,Johor,87,43,44,2016
2016-06-22,Johor,44,21,23,2016
2016-06-23,Johor,104,42,62,2016
2016-06-24,Johor,33,12,21,2016
2016-06-25,Johor,46,19,27,2016
2016-06-26,Johor,260,69,191,2016
2016-06-27,Johor,13,3,10,2016
2016-06-28,Johor,11,4,7,2016
2016-06-29,Johor,28,11,17,2016
2016-06-30,Johor,139,50,89,2016
2016-07-01,Johor,78,28,50,2016
2016-07-02,Johor,160,84,76,2016
2016-07-03,Johor,402,103,299,2016
2016-07-04,Johor,104,72,32,2016
2016-07-05,Johor,16,1,15,2016
2016-07-06,Johor,0,0,0,2016
2016-07-07,Johor,0,0,0,2016
2016-07-08,Johor,62,17,45,2016
2016-07-09,Johor,45,30,15,2016
2016-07-10,Johor,286,95,191,2016
2016-07-11,Johor,16,3,13,2016
2016-07-12,Johor,91,22,69,2016
2016-07-13,Johor,133,34,99,2016
2016-07-14,Johor,92,40,52,2016
2016-07-15,Johor,0,0,0,2016
2016-07-16,Johor,179,73,106,2016
2016-07-17,Johor,334,77,257,2016
2016-07-18,Johor,34,8,26,2016
2016-07-19,Johor,82,25,57,2016
2016-07-20,Johor,96,25,71,2016
2016-07-21,Johor,115,45,70,2016
2016-07-22,Johor,0,0,0,2016
2016-07-23,Johor,199,58,141,2016
2016-07-24,Johor,224,55,169,2016
2016-07-25,Johor,70,22,48,2016
2016-07-26,Johor,86,41,45,2016
2016-07-27,Johor,169,58,111,2016
2016-07-28,Johor,93,45,48,2016
2016-07-29,Johor,22,11,11,2016
2016-07-30,Johor,199,89,110,2016
2016-07-31,Johor,314,85,229,2016
2016-08-01,Johor,12,3,9,2016
2016-08-02,Johor,80,34,46,2016
2016-08-03,Johor,144,77,67,2016
2016-08-04,Johor,16,8,8,2016
2016-08-05,Johor,148,60,88,2016
2016-08-06,Johor,222,71,151,2016
2016-08-07,Johor,203,59,144,2016
2016-08-08,Johor,28,4,24,2016
2016-08-09,Johor,100,56,44,2016
2016-08-10,Johor,78,32,46,2016
2016-08-11,Johor,39,18,21,2016
2016-08-12,Johor,0,0,0,2016
2016-08-13,Johor,209,87,122,2016
2016-08-14,Johor,272,73,199,2016
2016-08-15,Johor,81,60,21,2016
2016-08-16,Johor,91,66,25,2016
2016-08-17,Johor,57,28,29,2016
2016-08-18,Johor,85,19,66,2016
2016-08-19,Johor,30,11,19,2016
2016-08-20,Johor,63,28,35,2016
2016-08-21,Johor,265,86,179,2016
2016-08-22,Johor,33,3,30,2016
2016-08-23,Johor,131,73,58,2016
2016-08-24,Johor,136,48,88,2016
2016-08-25,Johor,105,35,70,2016
2016-08-26,Johor,0,0,0,2016
2016-08-27,Johor,103,39,64,2016
2016-08-28,Johor,303,92,211,2016
2016-08-29,Johor,26,5,21,2016
2016-08-30,Johor,70,22,48,2016
2016-08-31,Johor,75,17,58,2016
2016-09-01,Johor,71,36,35,2016
2016-09-02,Johor,25,14,11,2016
2016-09-03,Johor,97,36,61,2016
2016-09-04,Johor,242,54,188,2016
2016-09-05,Johor,45,29,16,2016
2016-09-06,Johor,52,38,14,2016
2016-09-07,Johor,65,25,40,2016
2016-09-08,Johor,80,48,32,2016
2016-09-09,Johor,0,0,0,2016
2016-09-10,Johor,110,49,61,2016
2016-09-11,Johor,127,30,97,2016
2016-09-12,Johor,0,0,0,2016
2016-09-13,Johor,17,2,15,2016
2016-09-14,Johor,36,10,26,2016
2016-09-15,Johor,88,29,59,2016
2016-09-16,Johor,83,30,53,2016
2016-09-17,Johor,80,33,47,2016
2016-09-18,Johor,116,27,89,2016
2016-09-19,Johor,100,42,58,2016
2016-09-20,Johor,167,54,113,2016
2016-09-21,Johor,156,56,100,2016
2016-09-22,Johor,56,26,30,2016
2016-09-23,Johor,66,38,28,2016
2016-09-24,Johor,175,96,79,2016
2016-09-25,Johor,164,36,128,2016
2016-09-26,Johor,139,62,77,2016
2016-09-27,Johor,85,47,38,2016
2016-09-28,Johor,41,14,27,2016
2016-09-29,Johor,74,39,35,2016
2016-09-30,Johor,0,0,0,2016
2016-10-01,Johor,114,47,67,2016
2016-10-02,Johor,238,40,198,2016
2016-10-03,Johor,25,2,23,2016
2016-10-04,Johor,63,31,32,2016
2016-10-05,Johor,62,41,21,2016
2016-10-06,Johor,53,30,23,2016
2016-10-07,Johor,74,37,37,2016
2016-10-08,Johor,159,86,73,2016
2016-10-09,Johor,227,40,187,2016
2016-10-10,Johor,159,53,106,2016
2016-10-11,Johor,54,8,46,2016
2016-10-12,Johor,78,24,54,2016
2016-10-13,Johor,101,48,53,2016
2016-10-14,Johor,86,37,49,2016
2016-10-15,Johor,77,26,51,2016
2016-10-16,Johor,289,87,202,2016
2016-10-17,Johor,60,15,45,2016
2016-10-18,Johor,17,1,16,2016
2016-10-19,Johor,43,17,26,2016
2016-10-20,Johor,60,19,41,2016
2016-10-21,Johor,4,0,4,2016
2016-10-22,Johor,77,37,40,2016
2016-10-23,Johor,196,44,152,2016
2016-10-24,Johor,26,5,21,2016
2016-10-25,Johor,7,1,6,2016
2016-10-26,Johor,175,77,98,2016
2016-10-27,Johor,25,1,24,2016
2016-10-28,Johor,53,21,32,2016
2016-10-29,Johor,0,0,0,2016
2016-10-30,Johor,227,76,151,2016
2016-10-31,Johor,8,1,7,2016
2016-11-01,Johor,11,1,10,2016
2016-11-02,Johor,4,0,4,2016
2016-11-03,Johor,8,0,8,2016
2016-11-04,Johor,0,0,0,2016
2016-11-05,Johor,0,0,0,2016
2016-11-06,Johor,80,17,63,2016
2016-11-07,Johor,12,1,11,2016
2016-11-08,Johor,74,35,39,2016
2016-11-09,Johor,117,29,88,2016
2016-11-10,Johor,6,0,6,2016
2016-11-11,Johor,0,0,0,2016
2016-11-12,Johor,17,5,12,2016
2016-11-13,Johor,12,3,9,2016
2016-11-14,Johor,10,2,8,2016
2016-11-15,Johor,8,0,8,2016
2016-11-16,Johor,5,1,4,2016
2016-11-17,Johor,7,0,7,2016
2016-11-18,Johor,0,0,0,2016
2016-11-19,Johor,0,0,0,2016
2016-11-20,Johor,149,31,118,2016
2016-11-21,Johor,15,1,14,2016
2016-11-22,Johor,10,1,9,2016
2016-11-23,Johor,13,3,10,2016
2016-11-24,Johor,47,13,34,2016
2016-11-25,Johor,0,0,0,2016
2016-11-26,Johor,0,0,0,2016
2016-11-27,Johor,8,0,8,2016
2016-11-28,Johor,20,3,17,2016
2016-11-29,Johor,6,0,6,2016
2016-11-30,Johor,37,14,23,2016
2016-12-01,Johor,2,0,2,2016
2016-12-02,Johor,0,0,0,2016
2016-12-03,Johor,17,2,15,2016
2016-12-04,Johor,140,5,135,2016
2016-12-05,Johor,2,0,2,2016
2016-12-06,Johor,7,1,6,2016
2016-12-07,Johor,4,0,4,2016
2016-12-08,Johor,26,7,19,2016
2016-12-09,Johor,38,20,18,2016
2016-12-10,Johor,60,10,50,2016
2016-12-11,Johor,124,24,100,2016
2016-12-12,Johor,0,0,0,2016
2016-12-13,Johor,4,1,3,2016
2016-12-14,Johor,4,0,4,2016
2016-12-15,Johor,8,0,8,2016
2016-12-16,Johor,9,5,4,2016
2016-12-17,Johor,48,11,37,2016
2016-12-18,Johor,79,16,63,2016
2016-12-19,Johor,10,1,9,2016
2016-12-20,Johor,4,2,2,2016
2016-12-21,Johor,3,0,3,2016
2016-12-22,Johor,5,0,5,2016
2016-12-23,Johor,0,0,0,2016
2016-12-24,Johor,0,0,0,2016
2016-12-25,Johor,77,15,62,2016
2016-12-26,Johor,9,0,9,2016
2016-12-27,Johor,8,0,8,2016
2016-12-28,Johor,5,0,5,2016
2016-12-29,Johor,5,0,5,2016
2016-12-30,Johor,0,0,0,2016
2016-12-31,Johor,124,14,110,2016
2017-01-01,Johor,64,21,43,2017
2017-01-02,Johor,91,63,28,2017
2017-01-03,Johor,17,2,15,2017
2017-01-04,Johor,80,10,70,2017
2017-01-05,Johor,59,23,36,2017
2017-01-06,Johor,0,0,0,2017
2017-01-07,Johor,141,53,88,2017
2017-01-08,Johor,282,63,219,2017
2017-01-09,Johor,72,22,50,2017
2017-01-10,Johor,174,59,115,2017
2017-01-11,Johor,148,109,39,2017
2017-01-12,Johor,133,69,64,2017
2017-01-13,Johor,0,0,0,2017
2017-01-14,Johor,102,64,38,2017
2017-01-15,Johor,214,32,182,2017
2017-01-16,Johor,48,25,23,2017
2017-01-17,Johor,40,11,29,2017
2017-01-18,Johor,61,22,39,2017
2017-01-19,Johor,20,3,17,2017
2017-01-20,Johor,0,0,0,2017
2017-01-21,Johor,23,11,12,2017
2017-01-22,Johor,259,45,214,2017
2017-01-23,Johor,67,56,11,2017
2017-01-24,Johor,43,14,29,2017
2017-01-25,Johor,88,7,81,2017
2017-01-26,Johor,91,24,67,2017
2017-01-27,Johor,0,0,0,2017
2017-01-28,Johor,0,0,0,2017
2017-01-29,Johor,118,40,78,2017
2017-01-30,Johor,28,7,21,2017
2017-01-31,Johor,126,61,65,2017
2017-02-01,Johor,69,14,55,2017
2017-02-02,Johor,27,7,20,2017
2017-02-03,Johor,88,43,45,2017
2017-02-04,Johor,92,37,55,2017
2017-02-05,Johor,183,40,143,2017
2017-02-06,Johor,34,14,20,2017
2017-02-07,Johor,53,17,36,2017
2017-02-08,Johor,193,91,102,2017
2017-02-09,Johor,276,116,160,2017
2017-02-10,Johor,0,0,0,2017
2017-02-11,Johor,18,10,8,2017
2017-02-12,Johor,287,69,218,2017
2017-02-13,Johor,85,67,18,2017
2017-02-14,Johor,95,61,34,2017
2017-02-15,Johor,115,55,60,2017
2017-02-16,Johor,57,22,35,2017
2017-02-17,Johor,39,24,15,2017
2017-02-18,Johor,177,53,124,2017
2017-02-19,Johor,66,17,49,2017
2017-02-20,Johor,51,19,32,2017
2017-02-21,Johor,33,15,18,2017
2017-02-22,Johor,210,84,126,2017
2017-02-23,Johor,109,28,81,2017
2017-02-24,Johor,0,0,0,2017
2017-02-25,Johor,115,45,70,2017
2017-02-26,Johor,148,42,106,2017
2017-02-27,Johor,15,3,12,2017
2017-02-28,Johor,219,104,115,2017
2017-03-01,Johor,112,59,53,2017
2017-03-02,Johor,74,24,50,2017
2017-03-03,Johor,0,0,0,2017
2017-03-04,Johor,88,32,56,2017
2017-03-05,Johor,150,58,92,2017
2017-03-06,Johor,60,32,28,2017
2017-03-07,Johor,90,30,60,2017
2017-03-08,Johor,77,39,38,2017
2017-03-09,Johor,50,34,16,2017
2017-03-10,Johor,0,0,0,2017
2017-03-11,Johor,103,39,64,2017
2017-03-12,Johor,233,70,163,2017
2017-03-13,Johor,85,44,41,2017
2017-03-14,Johor,129,64,65,2017
2017-03-15,Johor,73,47,26,2017
2017-03-16,Johor,167,46,121,2017
2017-03-17,Johor,0,0,0,2017
2017-03-18,Johor,94,31,63,2017
2017-03-19,Johor,314,73,241,2017
2017-03-20,Johor,66,53,13,2017
2017-03-21,Johor,45,10,35,2017
2017-03-22,Johor,71,13,58,2017
2017-03-23,Johor,164,46,118,2017
2017-03-24,Johor,0,0,0,2017
2017-03-25,Johor,81,31,50,2017
2017-03-26,Johor,205,43,162,2017
2017-03-27,Johor,103,54,49,2017
2017-03-28,Johor,103,48,55,2017
2017-03-29,Johor,108,43,65,2017
2017-03-30,Johor,102,45,57,2017
2017-03-31,Johor,64,32,32,2017
2017-04-01,Johor,93,41,52,2017
2017-04-02,Johor,150,37,113,2017
2017-04-03,Johor,9,1,8,2017
2017-04-04,Johor,55,18,37,2017
2017-04-05,Johor,26,8,18,2017
2017-04-06,Johor,67,42,25,2017
2017-04-07,Johor,0,0,0,2017
2017-04-08,Johor,119,55,64,2017
2017-04-09,Johor,187,45,142,2017
2017-04-10,Johor,54,14,40,2017
2017-04-11,Johor,42,17,25,2017
2017-04-12,Johor,103,37,66,2017
2017-04-13,Johor,70,19,51,2017
2017-04-14,Johor,15,2,13,2017
2017-04-15,Johor,122,27,95,2017
2017-04-16,Johor,192,54,138,2017
2017-04-17,Johor,35,8,27,2017
2017-04-18,Johor,107,37,70,2017
2017-04-19,Johor,167,73,94,2017
2017-04-20,Johor,187,104,83,2017
2017-04-21,Johor,0,0,0,2017
2017-04-22,Johor,215,68,147,2017
2017-04-23,Johor,306,91,215,2017
2017-04-24,Johor,95,36,59,2017
2017-04-25,Johor,67,20,47,2017
2017-04-26,Johor,100,19,81,2017
2017-04-27,Johor,111,36,75,2017
2017-04-28,Johor,0,0,0,2017
2017-04-29,Johor,172,85,87,2017
2017-04-30,Johor,311,60,251,2017
2017-05-01,Johor,136,34,102,2017
2017-05-02,Johor,64,18,46,2017
2017-05-03,Johor,155,59,96,2017
2017-05-04,Johor,50,21,29,2017
2017-05-05,Johor,0,0,0,2017
2017-05-06,Johor,93,41,52,2017
2017-05-07,Johor,164,35,129,2017
2017-05-08,Johor,129,46,83,2017
2017-05-09,Johor,145,53,92,2017
2017-05-10,Johor,128,64,64,2017
2017-05-11,Johor,53,24,29,2017
2017-05-12,Johor,0,0,0,2017
2017-05-13,Johor,178,83,95,2017
2017-05-14,Johor,338,65,273,2017
2017-05-15,Johor,124,44,80,2017
2017-05-16,Johor,82,24,58,2017
2017-05-17,Johor,50,2,48,2017
2017-05-18,Johor,147,60,87,2017
2017-05-19,Johor,0,0,0,2017
2017-05-20,Johor,172,62,110,2017
2017-05-21,Johor,188,51,137,2017
2017-05-22,Johor,83,18,65,2017
2017-05-23,Johor,220,83,137,2017
2017-05-24,Johor,35,11,24,2017
2017-05-25,Johor,44,13,31,2017
2017-05-26,Johor,116,38,78,2017
2017-05-27,Johor,0,0,0,2017
2017-05-28,Johor,135,33,102,2017
2017-05-29,Johor,39,11,28,2017
2017-05-30,Johor,26,12,14,2017
2017-05-31,Johor,22,12,10,2017
2017-06-01,Johor,78,19,59,2017
2017-06-02,Johor,0,0,0,2017
2017-06-03,Johor,39,4,35,2017
2017-06-04,Johor,112,31,81,2017
2017-06-05,Johor,33,15,18,2017
2017-06-06,Johor,42,14,28,2017
2017-06-07,Johor,36,12,24,2017
2017-06-08,Johor,129,43,86,2017
2017-06-09,Johor,0,0,0,2017
2017-06-10,Johor,21,5,16,2017
2017-06-11,Johor,285,55,230,2017
2017-06-12,Johor,33,21,12,2017
2017-06-13,Johor,105,33,72,2017
2017-06-14,Johor,57,43,14,2017
2017-06-15,Johor,164,75,89,2017
2017-06-16,Johor,0,0,0,2017
2017-06-17,Johor,187,69,118,2017
2017-06-18,Johor,210,55,155,2017
2017-06-19,Johor,82,71,11,2017
2017-06-20,Johor,68,36,32,2017
2017-06-21,Johor,52,28,24,2017
2017-06-22,Johor,142,44,98,2017
2017-06-23,Johor,55,14,41,2017
2017-06-24,Johor,74,30,44,2017
2017-06-25,Johor,0,0,0,2017
2017-06-26,Johor,0,0,0,2017
2017-06-27,Johor,5,0,5,2017
2017-06-28,Johor,47,11,36,2017
2017-06-29,Johor,86,25,61,2017
2017-06-30,Johor,0,0,0,2017
2017-07-01,Johor,157,43,114,2017
2017-07-02,Johor,160,58,102,2017
2017-07-03,Johor,69,12,57,2017
2017-07-04,Johor,63,19,44,2017
2017-07-05,Johor,52,20,32,2017
2017-07-06,Johor,45,19,26,2017
2017-07-07,Johor,0,0,0,2017
2017-07-08,Johor,108,34,74,2017
2017-07-09,Johor,292,46,246,2017
2017-07-10,Johor,86,22,64,2017
2017-07-11,Johor,78,34,44,2017
2017-07-12,Johor,124,65,59,2017
2017-07-13,Johor,84,48,36,2017
2017-07-14,Johor,53,26,27,2017
2017-07-15,Johor,268,108,160,2017
2017-07-16,Johor,214,53,161,2017
2017-07-17,Johor,69,46,23,2017
2017-07-18,Johor,71,21,50,2017
2017-07-19,Johor,82,31,51,2017
2017-07-20,Johor,26,3,23,2017
2017-07-21,Johor,0,0,0,2017
2017-07-22,Johor,171,58,113,2017
2017-07-23,Johor,557,136,421,2017
2017-07-24,Johor,63,13,50,2017
2017-07-25,Johor,64,20,44,2017
2017-07-26,Johor,145,61,84,2017
2017-07-27,Johor,69,8,61,2017
2017-07-28,Johor,0,0,0,2017
2017-07-29,Johor,59,7,52,2017
2017-07-30,Johor,294,75,219,2017
2017-07-31,Johor,115,77,38,2017
2017-08-01,Johor,75,21,54,2017
2017-08-02,Johor,122,24,98,2017
2017-08-03,Johor,47,24,23,2017
2017-08-04,Johor,198,68,130,2017
2017-08-05,Johor,402,157,245,2017
2017-08-06,Johor,412,94,318,2017
2017-08-07,Johor,47,18,29,2017
2017-08-08,Johor,127,85,42,2017
2017-08-09,Johor,45,23,22,2017
2017-08-10,Johor,63,21,42,2017
2017-08-11,Johor,0,0,0,2017
2017-08-12,Johor,77,18,59,2017
2017-08-13,Johor,132,30,102,2017
2017-08-14,Johor,138,62,76,2017
2017-08-15,Johor,99,33,66,2017
2017-08-16,Johor,22,2,20,2017
2017-08-17,Johor,42,19,23,2017
2017-08-18,Johor,0,0,0,2017
2017-08-19,Johor,113,33,80,2017
2017-08-20,Johor,253,60,193,2017
2017-08-21,Johor,155,52,103,2017
2017-08-22,Johor,34,18,16,2017
2017-08-23,Johor,138,91,47,2017
2017-08-24,Johor,41,13,28,2017
2017-08-25,Johor,0,0,0,2017
2017-08-26,Johor,95,26,69,2017
2017-08-27,Johor,205,45,160,2017
2017-08-28,Johor,18,1,17,2017
2017-08-29,Johor,42,20,22,2017
2017-08-30,Johor,49,13,36,2017
2017-08-31,Johor,99,18,81,2017
2017-09-01,Johor,0,0,0,2017
2017-09-02,Johor,107,47,60,2017
2017-09-03,Johor,219,51,168,2017
2017-09-04,Johor,62,31,31,2017
2017-09-05,Johor,81,34,47,2017
2017-09-06,Johor,111,46,65,2017
2017-09-07,Johor,63,54,9,2017
2017-09-08,Johor,0,0,0,2017
2017-09-09,Johor,140,43,97,2017
2017-09-10,Johor,262,67,195,2017
2017-09-11,Johor,38,15,23,2017
2017-09-12,Johor,82,38,44,2017
2017-09-13,Johor,82,19,63,2017
2017-09-14,Johor,63,9,54,2017
2017-09-15,Johor,0,0,0,2017
2017-09-16,Johor,166,53,113,2017
2017-09-17,Johor,286,80,206,2017
2017-09-18,Johor,99,41,58,2017
2017-09-19,Johor,64,31,33,2017
2017-09-20,Johor,139,33,106,2017
2017-09-21,Johor,49,24,25,2017
2017-09-22,Johor,0,0,0,2017
2017-09-23,Johor,132,63,69,2017
2017-09-24,Johor,149,41,108,2017
2017-09-25,Johor,138,55,83,2017
2017-09-26,Johor,68,5,63,2017
2017-09-27,Johor,157,53,104,2017
2017-09-28,Johor,26,11,15,2017
2017-09-29,Johor,0,0,0,2017
2017-09-30,Johor,41,22,19,2017
2017-10-01,Johor,57,7,50,2017
2017-10-02,Johor,17,4,13,2017
2017-10-03,Johor,9,1,8,2017
2017-10-04,Johor,95,58,37,2017
2017-10-05,Johor,10,2,8,2017
2017-10-06,Johor,0,0,0,2017
2017-10-07,Johor,107,41,66,2017
2017-10-08,Johor,145,30,115,2017
2017-10-09,Johor,53,24,29,2017
2017-10-10,Johor,139,64,75,2017
2017-10-11,Johor,180,96,84,2017
2017-10-12,Johor,67,26,41,2017
2017-10-13,Johor,0,0,0,2017
2017-10-14,Johor,181,60,121,2017
2017-10-15,Johor,390,76,314,2017
2017-10-16,Johor,39,12,27,2017
2017-10-17,Johor,40,8,32,2017
2017-10-18,Johor,0,0,0,2017
2017-10-19,Johor,50,20,30,2017
2017-10-20,Johor,71,31,40,2017
2017-10-21,Johor,136,41,95,2017
2017-10-22,Johor,198,46,152,2017
2017-10-23,Johor,87,36,51,2017
2017-10-24,Johor,143,69,74,2017
2017-10-25,Johor,19,0,19,2017
2017-10-26,Johor,39,14,25,2017
2017-10-27,Johor,33,12,21,2017
2017-10-28,Johor,80,38,42,2017
2017-10-29,Johor,255,51,204,2017
2017-10-30,Johor,39,1,38,2017
2017-10-31,Johor,88,51,37,2017
2017-11-01,Johor,86,56,30,2017
2017-11-02,Johor,59,16,43,2017
2017-11-03,Johor,0,0,0,2017
2017-11-04,Johor,140,25,115,2017
2017-11-05,Johor,107,26,81,2017
2017-11-06,Johor,41,8,33,2017
2017-11-07,Johor,14,0,14,2017
2017-11-08,Johor,52,22,30,2017
2017-11-09,Johor,65,48,17,2017
2017-11-10,Johor,0,0,0,2017
2017-11-11,Johor,69,36,33,2017
2017-11-12,Johor,197,26,171,2017
2017-11-13,Johor,19,0,19,2017
2017-11-14,Johor,20,6,14,2017
2017-11-15,Johor,12,3,9,2017
2017-11-16,Johor,14,2,12,2017
2017-11-17,Johor,0,0,0,2017
2017-11-18,Johor,36,5,31,2017
2017-11-19,Johor,34,8,26,2017
2017-11-20,Johor,17,2,15,2017
2017-11-21,Johor,90,51,39,2017
2017-11-22,Johor,142,52,90,2017
2017-11-23,Johor,113,49,64,2017
2017-11-24,Johor,0,0,0,2017
2017-11-25,Johor,192,75,117,2017
2017-11-26,Johor,196,31,165,2017
2017-11-27,Johor,76,34,42,2017
2017-11-28,Johor,124,24,100,2017
2017-11-29,Johor,79,41,38,2017
2017-11-30,Johor,62,23,39,2017
2017-12-01,Johor,0,0,0,2017
2017-12-02,Johor,80,32,48,2017
2017-12-03,Johor,245,63,182,2017
2017-12-04,Johor,43,15,28,2017
2017-12-05,Johor,74,15,59,2017
2017-12-06,Johor,53,18,35,2017
2017-12-07,Johor,137,81,56,2017
2017-12-08,Johor,0,0,0,2017
2017-12-09,Johor,177,81,96,2017
2017-12-10,Johor,282,69,213,2017
2017-12-11,Johor,80,51,29,2017
2017-12-12,Johor,87,37,50,2017
2017-12-13,Johor,197,128,69,2017
2017-12-14,Johor,66,14,52,2017
2017-12-15,Johor,0,0,0,2017
2017-12-16,Johor,183,41,142,2017
2017-12-17,Johor,266,72,194,2017
2017-12-18,Johor,22,7,15,2017
2017-12-19,Johor,69,8,61,2017
2017-12-20,Johor,34,8,26,2017
2017-12-21,Johor,63,14,49,2017
2017-12-22,Johor,0,0,0,2017
2017-12-23,Johor,67,20,47,2017
2017-12-24,Johor,312,82,230,2017
2017-12-25,Johor,0,0,0,2017
2017-12-26,Johor,82,27,55,2017
2017-12-27,Johor,75,24,51,2017
2017-12-28,Johor,86,30,56,2017
2017-12-29,Johor,0,0,0,2017
2017-12-30,Johor,74,29,45,2017
2017-12-31,Johor,231,40,191,2017
2018-01-01,Johor,78,21,57,2018
2018-01-02,Johor,77,26,51,2018
2018-01-03,Johor,71,32,39,2018
2018-01-04,Johor,68,32,36,2018
2018-01-05,Johor,0,0,0,2018
2018-01-06,Johor,101,39,62,2018
2018-01-07,Johor,187,51,136,2018
2018-01-08,Johor,71,46,25,2018
2018-01-09,Johor,87,49,38,2018
2018-01-10,Johor,198,59,139,2018
2018-01-11,Johor,171,99,72,2018
2018-01-12,Johor,0,0,0,2018
2018-01-13,Johor,128,56,72,2018
2018-01-14,Johor,214,47,167,2018
2018-01-15,Johor,44,12,32,2018
2018-01-16,Johor,163,72,91,2018
2018-01-17,Johor,57,7,50,2018
2018-01-18,Johor,76,24,52,2018
2018-01-19,Johor,0,0,0,2018
2018-01-20,Johor,87,33,54,2018
2018-01-21,Johor,151,42,109,2018
2018-01-22,Johor,49,12,37,2018
2018-01-23,Johor,167,71,96,2018
2018-01-24,Johor,117,32,85,2018
2018-01-25,Johor,126,42,84,2018
2018-01-26,Johor,0,0,0,2018
2018-01-27,Johor,126,30,96,2018
2018-01-28,Johor,358,63,295,2018
2018-01-29,Johor,57,17,40,2018
2018-01-30,Johor,58,21,37,2018
2018-01-31,Johor,315,128,187,2018
2018-02-01,Johor,38,15,23,2018
2018-02-02,Johor,0,0,0,2018
2018-02-03,Johor,191,54,137,2018
2018-02-04,Johor,150,32,118,2018
2018-02-05,Johor,107,26,81,2018
2018-02-06,Johor,130,66,64,2018
2018-02-07,Johor,158,73,85,2018
2018-02-08,Johor,131,39,92,2018
2018-02-09,Johor,0,0,0,2018
2018-02-10,Johor,21,5,16,2018
2018-02-11,Johor,147,41,106,2018
2018-02-12,Johor,150,72,78,2018
2018-02-13,Johor,70,16,54,2018
2018-02-14,Johor,117,64,53,2018
2018-02-15,Johor,79,29,50,2018
2018-02-16,Johor,0,0,0,2018
2018-02-17,Johor,18,5,13,2018
2018-02-18,Johor,148,53,95,2018
2018-02-19,Johor,89,20,69,2018
2018-02-20,Johor,73,35,38,2018
2018-02-21,Johor,142,56,86,2018
2018-02-22,Johor,40,17,23,2018
2018-02-23,Johor,39,8,31,2018
2018-02-24,Johor,161,62,99,2018
2018-02-25,Johor,169,52,117,2018
2018-02-26,Johor,85,28,57,2018
2018-02-27,Johor,56,26,30,2018
2018-02-28,Johor,63,39,24,2018
2018-03-01,Johor,109,36,73,2018
2018-03-02,Johor,42,21,21,2018
2018-03-03,Johor,271,89,182,2018
2018-03-04,Johor,180,44,136,2018
2018-03-05,Johor,12,2,10,2018
2018-03-06,Johor,95,25,70,2018
2018-03-07,Johor,12,4,8,2018
2018-03-08,Johor,78,41,37,2018
2018-03-09,Johor,0,0,0,2018
2018-03-10,Johor,288,75,213,2018
2018-03-11,Johor,326,88,238,2018
2018-03-12,Johor,68,27,41,2018
2018-03-13,Johor,97,28,69,2018
2018-03-14,Johor,86,28,58,2018
2018-03-15,Johor,134,38,96,2018
2018-03-16,Johor,0,0,0,2018
2018-03-17,Johor,38,18,20,2018
2018-03-18,Johor,298,49,249,2018
2018-03-19,Johor,44,17,27,2018
2018-03-20,Johor,73,19,54,2018
2018-03-21,Johor,81,23,58,2018
2018-03-22,Johor,58,19,39,2018
2018-03-23,Johor,0,0,0,2018
2018-03-24,Johor,0,0,0,2018
2018-03-25,Johor,293,65,228,2018
2018-03-26,Johor,11,0,11,2018
2018-03-27,Johor,169,69,100,2018
2018-03-28,Johor,202,69,133,2018
2018-03-29,Johor,63,17,46,2018
2018-03-30,Johor,0,0,0,2018
2018-03-31,Johor,85,20,65,2018
2018-04-01,Johor,228,49,179,2018
2018-04-02,Johor,98,24,74,2018
2018-04-03,Johor,64,17,47,2018
2018-04-04,Johor,95,15,80,2018
2018-04-05,Johor,18,5,13,2018
2018-04-06,Johor,0,0,0,2018
2018-04-07,Johor,102,40,62,2018
2018-04-08,Johor,186,29,157,2018
2018-04-09,Johor,105,52,53,2018
2018-04-10,Johor,56,24,32,2018
2018-04-11,Johor,163,118,45,2018
2018-04-12,Johor,80,27,53,2018
2018-04-13,Johor,0,0,0,2018
2018-04-14,Johor,73,28,45,2018
2018-04-15,Johor,536,117,419,2018
2018-04-16,Johor,28,4,24,2018
2018-04-17,Johor,63,20,43,2018
2018-04-18,Johor,64,41,23,2018
2018-04-19,Johor,70,9,61,2018
2018-04-20,Johor,0,0,0,2018
2018-04-21,Johor,153,74,79,2018
2018-04-22,Johor,181,46,135,2018
2018-04-23,Johor,56,6,50,2018
2018-04-24,Johor,125,32,93,2018
2018-04-25,Johor,56,9,47,2018
2018-04-26,Johor,132,68,64,2018
2018-04-27,Johor,44,22,22,2018
2018-04-28,Johor,29,8,21,2018
2018-04-29,Johor,247,68,179,2018
2018-04-30,Johor,57,16,41,2018
2018-05-01,Johor,270,72,198,2018
2018-05-02,Johor,89,25,64,2018
2018-05-03,Johor,174,48,126,2018
2018-05-04,Johor,0,0,0,2018
2018-05-05,Johor,219,102,117,2018
2018-05-06,Johor,381,74,307,2018
2018-05-07,Johor,107,36,71,2018
2018-05-08,Johor,94,31,63,2018
2018-05-09,Johor,0,0,0,2018
2018-05-10,Johor,3,0,3,2018
2018-05-11,Johor,0,0,0,2018
2018-05-12,Johor,189,90,99,2018
2018-05-13,Johor,257,48,209,2018
2018-05-14,Johor,80,19,61,2018
2018-05-15,Johor,66,32,34,2018
2018-05-16,Johor,41,9,32,2018
2018-05-17,Johor,0,0,0,2018
2018-05-18,Johor,0,0,0,2018
2018-05-19,Johor,23,8,15,2018
2018-05-20,Johor,185,39,146,2018
2018-05-21,Johor,20,4,16,2018
2018-05-22,Johor,41,9,32,2018
2018-05-23,Johor,65,12,53,2018
2018-05-24,Johor,200,48,152,2018
2018-05-25,Johor,32,12,20,2018
2018-05-26,Johor,134,44,90,2018
2018-05-27,Johor,177,33,144,2018
2018-05-28,Johor,14,1,13,2018
2018-05-29,Johor,139,66,73,2018
2018-05-30,Johor,10,2,8,2018
2018-05-31,Johor,103,39,64,2018
2018-06-01,Johor,0,0,0,2018
2018-06-02,Johor,35,9,26,2018
2018-06-03,Johor,309,75,234,2018
2018-06-04,Johor,168,141,27,2018
2018-06-05,Johor,76,52,24,2018
2018-06-06,Johor,67,41,26,2018
2018-06-07,Johor,63,20,43,2018
2018-06-08,Johor,33,8,25,2018
2018-06-09,Johor,92,25,67,2018
2018-06-10,Johor,246,51,195,2018
2018-06-11,Johor,61,28,33,2018
2018-06-12,Johor,47,18,29,2018
2018-06-13,Johor,73,25,48,2018
2018-06-14,Johor,50,20,30,2018
2018-06-15,Johor,0,0,0,2018
2018-06-16,Johor,0,0,0,2018
2018-06-17,Johor,95,37,58,2018
2018-06-18,Johor,41,10,31,2018
2018-06-19,Johor,90,19,71,2018
2018-06-20,Johor,57,6,51,2018
2018-06-21,Johor,99,40,59,2018
2018-06-22,Johor,0,0,0,2018
2018-06-23,Johor,59,12,47,2018
2018-06-24,Johor,275,69,206,2018
2018-06-25,Johor,56,26,30,2018
2018-06-26,Johor,146,48,98,2018
2018-06-27,Johor,59,21,38,2018
2018-06-28,Johor,47,6,41,2018
2018-06-29,Johor,0,0,0,2018
2018-06-30,Johor,0,0,0,2018
2018-07-01,Johor,436,153,283,2018
2018-07-02,Johor,16,1,15,2018
2018-07-03,Johor,53,14,39,2018
2018-07-04,Johor,116,73,43,2018
2018-07-05,Johor,94,42,52,2018
2018-07-06,Johor,14,3,11,2018
2018-07-07,Johor,117,29,88,2018
2018-07-08,Johor,326,118,208,2018
2018-07-09,Johor,197,80,117,2018
2018-07-10,Johor,43,7,36,2018
2018-07-11,Johor,79,24,55,2018
2018-07-12,Johor,53,3,50,2018
2018-07-13,Johor,0,0,0,2018
2018-07-14,Johor,85,40,45,2018
2018-07-15,Johor,238,42,196,2018
2018-07-16,Johor,53,23,30,2018
2018-07-17,Johor,88,36,52,2018
2018-07-18,Johor,113,41,72,2018
2018-07-19,Johor,99,38,61,2018
2018-07-20,Johor,0,0,0,2018
2018-07-21,Johor,169,67,102,2018
2018-07-22,Johor,261,57,204,2018
2018-07-23,Johor,69,24,45,2018
2018-07-24,Johor,96,26,70,2018
2018-07-25,Johor,117,71,46,2018
2018-07-26,Johor,72,41,31,2018
2018-07-27,Johor,0,0,0,2018
2018-07-28,Johor,79,26,53,2018
2018-07-29,Johor,357,98,259,2018
2018-07-30,Johor,53,15,38,2018
2018-07-31,Johor,273,141,132,2018
2018-08-01,Johor,51,11,40,2018
2018-08-02,Johor,18,6,12,2018
2018-08-03,Johor,2,0,2,2018
2018-08-04,Johor,157,69,88,2018
2018-08-05,Johor,364,97,267,2018
2018-08-06,Johor,54,24,30,2018
2018-08-07,Johor,145,41,104,2018
2018-08-08,Johor,140,47,93,2018
2018-08-09,Johor,21,1,20,2018
2018-08-10,Johor,0,0,0,2018
2018-08-11,Johor,79,41,38,2018
2018-08-12,Johor,267,48,219,2018
2018-08-13,Johor,74,22,52,2018
2018-08-14,Johor,128,65,63,2018
2018-08-15,Johor,62,37,25,2018
2018-08-16,Johor,41,15,26,2018
2018-08-17,Johor,265,102,163,2018
2018-08-18,Johor,357,120,237,2018
2018-08-19,Johor,186,61,125,2018
2018-08-20,Johor,16,4,12,2018
2018-08-21,Johor,48,17,31,2018
2018-08-22,Johor,0,0,0,2018
2018-08-23,Johor,49,7,42,2018
2018-08-24,Johor,0,0,0,2018
2018-08-25,Johor,196,65,131,2018
2018-08-26,Johor,296,66,230,2018
2018-08-27,Johor,76,36,40,2018
2018-08-28,Johor,40,19,21,2018
2018-08-29,Johor,138,41,97,2018
2018-08-30,Johor,83,14,69,2018
2018-08-31,Johor,123,31,92,2018
2018-09-01,Johor,0,0,0,2018
2018-09-02,Johor,192,54,138,2018
2018-09-03,Johor,39,16,23,2018
2018-09-04,Johor,99,62,37,2018
2018-09-05,Johor,83,33,50,2018
2018-09-06,Johor,57,13,44,2018
2018-09-07,Johor,26,8,18,2018
2018-09-08,Johor,80,33,47,2018
2018-09-09,Johor,116,23,93,2018
2018-09-10,Johor,85,20,65,2018
2018-09-11,Johor,0,0,0,2018
2018-09-12,Johor,75,30,45,2018
2018-09-13,Johor,61,9,52,2018
2018-09-14,Johor,0,0,0,2018
2018-09-15,Johor,203,58,145,2018
2018-09-16,Johor,183,48,135,2018
2018-09-17,Johor,102,23,79,2018
2018-09-18,Johor,70,40,30,2018
2018-09-19,Johor,88,29,59,2018
2018-09-20,Johor,66,34,32,2018
2018-09-21,Johor,0,0,0,2018
2018-09-22,Johor,79,35,44,2018
2018-09-23,Johor,229,58,171,2018
2018-09-24,Johor,123,48,75,2018
2018-09-25,Johor,56,34,22,2018
2018-09-26,Johor,246,144,102,2018
2018-09-27,Johor,22,6,16,2018
2018-09-28,Johor,19,14,5,2018
2018-09-29,Johor,72,24,48,2018
2018-09-30,Johor,279,53,226,2018
2018-10-01,Johor,78,36,42,2018
2018-10-02,Johor,60,23,37,2018
2018-10-03,Johor,174,94,80,2018
2018-10-04,Johor,37,12,25,2018
2018-10-05,Johor,0,0,0,2018
2018-10-06,Johor,158,44,114,2018
2018-10-07,Johor,324,65,259,2018
2018-10-08,Johor,91,15,76,2018
2018-10-09,Johor,80,49,31,2018
2018-10-10,Johor,154,60,94,2018
2018-10-11,Johor,49,12,37,2018
2018-10-12,Johor,0,0,0,2018
2018-10-13,Johor,153,78,75,2018
2018-10-14,Johor,449,84,365,2018
2018-10-15,Johor,0,0,0,2018
2018-10-16,Johor,90,21,69,2018
2018-10-17,Johor,143,44,99,2018
2018-10-18,Johor,102,78,24,2018
2018-10-19,Johor,0,0,0,2018
2018-10-20,Johor,134,43,91,2018
2018-10-21,Johor,255,58,197,2018
2018-10-22,Johor,94,31,63,2018
2018-10-23,Johor,90,40,50,2018
2018-10-24,Johor,84,49,35,2018
2018-10-25,Johor,53,18,35,2018
2018-10-26,Johor,0,0,0,2018
2018-10-27,Johor,87,33,54,2018
2018-10-28,Johor,282,54,228,2018
2018-10-29,Johor,60,27,33,2018
2018-10-30,Johor,78,31,47,2018
2018-10-31,Johor,22,3,19,2018
2018-11-01,Johor,56,21,35,2018
2018-11-02,Johor,0,0,0,2018
2018-11-03,Johor,139,56,83,2018
2018-11-04,Johor,188,39,149,2018
2018-11-05,Johor,54,10,44,2018
2018-11-06,Johor,0,0,0,2018
2018-11-07,Johor,178,60,118,2018
2018-11-08,Johor,64,28,36,2018
2018-11-09,Johor,18,4,14,2018
2018-11-10,Johor,197,67,130,2018
2018-11-11,Johor,296,80,216,2018
2018-11-12,Johor,42,16,26,2018
2018-11-13,Johor,164,54,110,2018
2018-11-14,Johor,179,69,110,2018
2018-11-15,Johor,66,22,44,2018
2018-11-16,Johor,0,0,0,2018
2018-11-17,Johor,283,124,159,2018
2018-11-18,Johor,331,95,236,2018
2018-11-19,Johor,49,15,34,2018
2018-11-20,Johor,0,0,0,2018
2018-11-21,Johor,125,30,95,2018
2018-11-22,Johor,10,0,10,2018
2018-11-23,Johor,0,0,0,2018
2018-11-24,Johor,33,15,18,2018
2018-11-25,Johor,92,20,72,2018
2018-11-26,Johor,22,2,20,2018
2018-11-27,Johor,18,2,16,2018
2018-11-28,Johor,72,19,53,2018
2018-11-29,Johor,38,7,31,2018
2018-11-30,Johor,0,0,0,2018
2018-12-01,Johor,83,40,43,2018
2018-12-02,Johor,262,50,212,2018
2018-12-03,Johor,42,13,29,2018
2018-12-04,Johor,64,19,45,2018
2018-12-05,Johor,98,44,54,2018
2018-12-06,Johor,121,28,93,2018
2018-12-07,Johor,10,4,6,2018
2018-12-08,Johor,170,40,130,2018
2018-12-09,Johor,334,56,278,2018
2018-12-10,Johor,41,2,39,2018
2018-12-11,Johor,72,28,44,2018
2018-12-12,Johor,30,9,21,2018
2018-12-13,Johor,84,49,35,2018
2018-12-14,Johor,27,5,22,2018
2018-12-15,Johor,120,42,78,2018
2018-12-16,Johor,236,48,188,2018
2018-12-17,Johor,44,18,26,2018
2018-12-18,Johor,78,25,53,2018
2018-12-19,Johor,72,16,56,2018
2018-12-20,Johor,86,40,46,2018
2018-12-21,Johor,0,0,0,2018
2018-12-22,Johor,97,37,60,2018
2018-12-23,Johor,185,40,145,2018
2018-12-24,Johor,45,18,27,2018
2018-12-25,Johor,0,0,0,2018
2018-12-26,Johor,76,45,31,2018
2018-12-27,Johor,37,16,21,2018
2018-12-28,Johor,0,0,0,2018
2018-12-29,Johor,149,37,112,2018
2018-12-30,Johor,173,41,132,2018
2018-12-31,Johor,8,1,7,2018
2019-01-01,Johor,68,2,66,2019
2019-01-02,Johor,68,14,54,2019
2019-01-03,Johor,181,102,79,2019
2019-01-04,Johor,0,0,0,2019
2019-01-05,Johor,122,31,91,2019
2019-01-06,Johor,224,49,175,2019
2019-01-07,Johor,71,22,49,2019
2019-01-08,Johor,45,13,32,2019
2019-01-09,Johor,114,68,46,2019
2019-01-10,Johor,90,40,50,2019
2019-01-11,Johor,37,13,24,2019
2019-01-12,Johor,0,0,0,2019
2019-01-13,Johor,354,69,285,2019
2019-01-14,Johor,137,83,54,2019
2019-01-15,Johor,79,14,65,2019
2019-01-16,Johor,123,48,75,2019
2019-01-17,Johor,183,90,93,2019
2019-01-18,Johor,0,0,0,2019
2019-01-19,Johor,194,85,109,2019
2019-01-20,Johor,407,107,300,2019
2019-01-21,Johor,138,57,81,2019
2019-01-22,Johor,125,50,75,2019
2019-01-23,Johor,106,59,47,2019
2019-01-24,Johor,265,141,124,2019
2019-01-25,Johor,0,0,0,2019
2019-01-26,Johor,248,93,155,2019
2019-01-27,Johor,236,54,182,2019
2019-01-28,Johor,103,49,54,2019
2019-01-29,Johor,107,30,77,2019
2019-01-30,Johor,178,60,118,2019
2019-01-31,Johor,68,4,64,2019
2019-02-01,Johor,0,0,0,2019
2019-02-02,Johor,117,54,63,2019
2019-02-03,Johor,221,58,163,2019
2019-02-04,Johor,52,12,40,2019
2019-02-05,Johor,0,0,0,2019
2019-02-06,Johor,54,24,30,2019
2019-02-07,Johor,114,41,73,2019
2019-02-08,Johor,0,0,0,2019
2019-02-09,Johor,163,58,105,2019
2019-02-10,Johor,199,50,149,2019
2019-02-11,Johor,108,41,67,2019
2019-02-12,Johor,115,57,58,2019
2019-02-13,Johor,115,60,55,2019
2019-02-14,Johor,78,16,62,2019
2019-02-15,Johor,104,69,35,2019
2019-02-16,Johor,100,36,64,2019
2019-02-17,Johor,202,65,137,2019
2019-02-18,Johor,80,44,36,2019
2019-02-19,Johor,112,58,54,2019
2019-02-20,Johor,70,19,51,2019
2019-02-21,Johor,56,15,41,2019
2019-02-22,Johor,0,0,0,2019
2019-02-23,Johor,178,72,106,2019
2019-02-24,Johor,564,121,443,2019
2019-02-25,Johor,63,35,28,2019
2019-02-26,Johor,107,34,73,2019
2019-02-27,Johor,143,50,93,2019
2019-02-28,Johor,56,32,24,2019
2019-03-01,Johor,71,28,43,2019
2019-03-02,Johor,77,22,55,2019
2019-03-03,Johor,267,51,216,2019
2019-03-04,Johor,168,47,121,2019
2019-03-05,Johor,95,35,60,2019
2019-03-06,Johor,59,19,40,2019
2019-03-07,Johor,53,16,37,2019
2019-03-08,Johor,0,0,0,2019
2019-03-09,Johor,353,89,264,2019
2019-03-10,Johor,198,43,155,2019
2019-03-11,Johor,77,38,39,2019
2019-03-12,Johor,154,85,69,2019
2019-03-13,Johor,200,102,98,2019
2019-03-14,Johor,87,38,49,2019
2019-03-15,Johor,0,0,0,2019
2019-03-16,Johor,128,53,75,2019
2019-03-17,Johor,388,112,276,2019
2019-03-18,Johor,50,23,27,2019
2019-03-19,Johor,33,6,27,2019
2019-03-20,Johor,101,26,75,2019
2019-03-21,Johor,80,56,24,2019
2019-03-22,Johor,0,0,0,2019
2019-03-23,Johor,221,73,148,2019
2019-03-24,Johor,197,61,136,2019
2019-03-25,Johor,79,22,57,2019
2019-03-26,Johor,131,54,77,2019
2019-03-27,Johor,74,28,46,2019
2019-03-28,Johor,62,18,44,2019
2019-03-29,Johor,0,0,0,2019
2019-03-30,Johor,229,87,142,2019
2019-03-31,Johor,286,93,193,2019
2019-04-01,Johor,47,15,32,2019
2019-04-02,Johor,25,7,18,2019
2019-04-03,Johor,46,11,35,2019
2019-04-04,Johor,68,17,51,2019
2019-04-05,Johor,0,0,0,2019
2019-04-06,Johor,109,48,61,2019
2019-04-07,Johor,232,56,176,2019
2019-04-08,Johor,29,6,23,2019
2019-04-09,Johor,172,141,31,2019
2019-04-10,Johor,148,58,90,2019
2019-04-11,Johor,89,33,56,2019
2019-04-12,Johor,0,0,0,2019
2019-04-13,Johor,84,30,54,2019
2019-04-14,Johor,336,115,221,2019
2019-04-15,Johor,60,22,38,2019
2019-04-16,Johor,111,57,54,2019
2019-04-17,Johor,234,68,166,2019
2019-04-18,Johor,156,48,108,2019
2019-04-19,Johor,0,0,0,2019
2019-04-20,Johor,106,27,79,2019
2019-04-21,Johor,306,102,204,2019
2019-04-22,Johor,31,8,23,2019
2019-04-23,Johor,84,41,43,2019
2019-04-24,Johor,136,21,115,2019
2019-04-25,Johor,114,39,75,2019
2019-04-26,Johor,0,0,0,2019
2019-04-27,Johor,57,13,44,2019
2019-04-28,Johor,231,67,164,2019
2019-04-29,Johor,127,36,91,2019
2019-04-30,Johor,89,22,67,2019
2019-05-01,Johor,273,73,200,2019
2019-05-02,Johor,89,19,70,2019
2019-05-03,Johor,0,0,0,2019
2019-05-04,Johor,171,57,114,2019
2019-05-05,Johor,309,69,240,2019
2019-05-06,Johor,0,0,0,2019
2019-05-07,Johor,10,1,9,2019
2019-05-08,Johor,29,7,22,2019
2019-05-09,Johor,24,9,15,2019
2019-05-10,Johor,0,0,0,2019
2019-05-11,Johor,140,36,104,2019
2019-05-12,Johor,208,42,166,2019
2019-05-13,Johor,33,17,16,2019
2019-05-14,Johor,9,1,8,2019
2019-05-15,Johor,41,15,26,2019
2019-05-16,Johor,85,14,71,2019
2019-05-17,Johor,0,0,0,2019
2019-05-18,Johor,116,56,60,2019
2019-05-19,Johor,408,118,290,2019
2019-05-20,Johor,59,10,49,2019
2019-05-21,Johor,31,16,15,2019
2019-05-22,Johor,86,56,30,2019
2019-05-23,Johor,203,139,64,2019
2019-05-24,Johor,0,0,0,2019
2019-05-25,Johor,32,13,19,2019
2019-05-26,Johor,408,98,310,2019
2019-05-27,Johor,23,9,14,2019
2019-05-28,Johor,170,71,99,2019
2019-05-29,Johor,48,11,37,2019
2019-05-30,Johor,73,17,56,2019
2019-05-31,Johor,0,0,0,2019
2019-06-01,Johor,32,12,20,2019
2019-06-02,Johor,169,43,126,2019
2019-06-03,Johor,33,7,26,2019
2019-06-04,Johor,48,21,27,2019
2019-06-05,Johor,0,0,0,2019
2019-06-06,Johor,0,0,0,2019
2019-06-07,Johor,8,1,7,2019
2019-06-08,Johor,54,33,21,2019
2019-06-09,Johor,87,5,82,2019
2019-06-10,Johor,59,11,48,2019
2019-06-11,Johor,89,17,72,2019
2019-06-12,Johor,72,19,53,2019
2019-06-13,Johor,42,10,32,2019
2019-06-14,Johor,0,0,0,2019
2019-06-15,Johor,84,23,61,2019
2019-06-16,Johor,521,177,344,2019
2019-06-17,Johor,90,38,52,2019
2019-06-18,Johor,69,8,61,2019
2019-06-19,Johor,56,4,52,2019
2019-06-20,Johor,71,18,53,2019
2019-06-21,Johor,0,0,0,2019
2019-06-22,Johor,76,32,44,2019
2019-06-23,Johor,227,33,194,2019
2019-06-24,Johor,105,20,85,2019
2019-06-25,Johor,74,7,67,2019
2019-06-26,Johor,24,4,20,2019
2019-06-27,Johor,53,15,38,2019
2019-06-28,Johor,54,16,38,2019
2019-06-29,Johor,156,40,116,2019
2019-06-30,Johor,338,51,287,2019
2019-07-01,Johor,86,22,64,2019
2019-07-02,Johor,91,27,64,2019
2019-07-03,Johor,149,82,67,2019
2019-07-04,Johor,56,24,32,2019
2019-07-05,Johor,39,10,29,2019
2019-07-06,Johor,104,36,68,2019
2019-07-07,Johor,421,120,301,2019
2019-07-08,Johor,83,35,48,2019
2019-07-09,Johor,137,52,85,2019
2019-07-10,Johor,156,47,109,2019
2019-07-11,Johor,78,16,62,2019
2019-07-12,Johor,0,0,0,2019
2019-07-13,Johor,109,51,58,2019
2019-07-14,Johor,201,31,170,2019
2019-07-15,Johor,155,38,117,2019
2019-07-16,Johor,133,45,88,2019
2019-07-17,Johor,126,25,101,2019
2019-07-18,Johor,72,30,42,2019
2019-07-19,Johor,0,0,0,2019
2019-07-20,Johor,87,17,70,2019
2019-07-21,Johor,362,98,264,2019
2019-07-22,Johor,152,70,82,2019
2019-07-23,Johor,59,17,42,2019
2019-07-24,Johor,150,44,106,2019
2019-07-25,Johor,133,92,41,2019
2019-07-26,Johor,45,13,32,2019
2019-07-27,Johor,114,37,77,2019
2019-07-28,Johor,212,61,151,2019
2019-07-29,Johor,104,26,78,2019
2019-07-30,Johor,226,76,150,2019
2019-07-31,Johor,73,24,49,2019
2019-08-01,Johor,137,34,103,2019
2019-08-02,Johor,0,0,0,2019
2019-08-03,Johor,130,31,99,2019
2019-08-04,Johor,328,84,244,2019
2019-08-05,Johor,43,16,27,2019
2019-08-06,Johor,175,58,117,2019
2019-08-07,Johor,122,67,55,2019
2019-08-08,Johor,67,11,56,2019
2019-08-09,Johor,37,17,20,2019
2019-08-10,Johor,0,0,0,2019
2019-08-11,Johor,0,0,0,2019
2019-08-12,Johor,79,21,58,2019
2019-08-13,Johor,68,22,46,2019
2019-08-14,Johor,69,31,38,2019
2019-08-15,Johor,58,33,25,2019
2019-08-16,Johor,0,0,0,2019
2019-08-17,Johor,106,47,59,2019
2019-08-18,Johor,278,65,213,2019
2019-08-19,Johor,79,42,37,2019
2019-08-20,Johor,66,32,34,2019
2019-08-21,Johor,163,34,129,2019
2019-08-22,Johor,160,88,72,2019
2019-08-23,Johor,136,36,100,2019
2019-08-24,Johor,434,154,280,2019
2019-08-25,Johor,408,112,296,2019
2019-08-26,Johor,72,27,45,2019
2019-08-27,Johor,124,68,56,2019
2019-08-28,Johor,71,38,33,2019
2019-08-29,Johor,36,6,30,2019
2019-08-30,Johor,0,0,0,2019
2019-08-31,Johor,255,53,202,2019
2019-09-01,Johor,391,111,280,2019
2019-09-02,Johor,63,20,43,2019
2019-09-03,Johor,185,71,114,2019
2019-09-04,Johor,59,21,38,2019
2019-09-05,Johor,53,18,35,2019
2019-09-06,Johor,0,0,0,2019
2019-09-07,Johor,69,15,54,2019
2019-09-08,Johor,287,80,207,2019
2019-09-09,Johor,0,0,0,2019
2019-09-10,Johor,232,155,77,2019
2019-09-11,Johor,206,97,109,2019
2019-09-12,Johor,78,40,38,2019
2019-09-13,Johor,0,0,0,2019
2019-09-14,Johor,75,29,46,2019
2019-09-15,Johor,405,103,302,2019
2019-09-16,Johor,79,24,55,2019
2019-09-17,Johor,119,42,77,2019
2019-09-18,Johor,173,60,113,2019
2019-09-19,Johor,65,24,41,2019
2019-09-20,Johor,0,0,0,2019
2019-09-21,Johor,75,18,57,2019
2019-09-22,Johor,242,58,184,2019
2019-09-23,Johor,140,47,93,2019
2019-09-24,Johor,107,30,77,2019
2019-09-25,Johor,85,24,61,2019
2019-09-26,Johor,133,46,87,2019
2019-09-27,Johor,0,0,0,2019
2019-09-28,Johor,217,75,142,2019
2019-09-29,Johor,235,38,197,2019
2019-09-30,Johor,114,41,73,2019
2019-10-01,Johor,67,31,36,2019
2019-10-02,Johor,135,36,99,2019
2019-10-03,Johor,67,5,62,2019
2019-10-04,Johor,0,0,0,2019
2019-10-05,Johor,143,58,85,2019
2019-10-06,Johor,288,66,222,2019
2019-10-07,Johor,123,72,51,2019
2019-10-08,Johor,88,43,45,2019
2019-10-09,Johor,75,17,58,2019
2019-10-10,Johor,123,36,87,2019
2019-10-11,Johor,0,0,0,2019
2019-10-12,Johor,73,21,52,2019
2019-10-13,Johor,246,70,176,2019
2019-10-14,Johor,72,25,47,2019
2019-10-15,Johor,145,54,91,2019
2019-10-16,Johor,161,52,109,2019
2019-10-17,Johor,53,22,31,2019
2019-10-18,Johor,0,0,0,2019
2019-10-19,Johor,84,22,62,2019
2019-10-20,Johor,217,30,187,2019
2019-10-21,Johor,72,29,43,2019
2019-10-22,Johor,82,30,52,2019
2019-10-23,Johor,130,24,106,2019
2019-10-24,Johor,142,53,89,2019
2019-10-25,Johor,0,0,0,2019
2019-10-26,Johor,107,27,80,2019
2019-10-27,Johor,220,43,177,2019
2019-10-28,Johor,102,23,79,2019
2019-10-29,Johor,100,29,71,2019
2019-10-30,Johor,74,20,54,2019
2019-10-31,Johor,63,14,49,2019
2019-11-01,Johor,32,9,23,2019
2019-11-02,Johor,71,18,53,2019
2019-11-03,Johor,240,82,158,2019
2019-11-04,Johor,178,114,64,2019
2019-11-05,Johor,67,4,63,2019
2019-11-06,Johor,112,46,66,2019
2019-11-07,Johor,51,13,38,2019
2019-11-08,Johor,0,0,0,2019
2019-11-09,Johor,137,58,79,2019
2019-11-10,Johor,276,90,186,2019
2019-11-11,Johor,87,34,53,2019
2019-11-12,Johor,69,22,47,2019
2019-11-13,Johor,77,19,58,2019
2019-11-14,Johor,45,25,20,2019
2019-11-15,Johor,68,40,28,2019
2019-11-16,Johor,93,43,50,2019
2019-11-17,Johor,199,49,150,2019
2019-11-18,Johor,74,42,32,2019
2019-11-19,Johor,117,23,94,2019
2019-11-20,Johor,127,17,110,2019
2019-11-21,Johor,124,29,95,2019
2019-11-22,Johor,0,0,0,2019
2019-11-23,Johor,182,49,133,2019
2019-11-24,Johor,201,61,140,2019
2019-11-25,Johor,51,16,35,2019
2019-11-26,Johor,73,18,55,2019
2019-11-27,Johor,63,17,46,2019
2019-11-28,Johor,129,28,101,2019
2019-11-29,Johor,45,22,23,2019
2019-11-30,Johor,146,36,110,2019
2019-12-01,Johor,297,54,243,2019
2019-12-02,Johor,67,12,55,2019
2019-12-03,Johor,73,34,39,2019
2019-12-04,Johor,57,16,41,2019
2019-12-05,Johor,6,2,4,2019
2019-12-06,Johor,0,0,0,2019
2019-12-07,Johor,92,29,63,2019
2019-12-08,Johor,241,126,115,2019
2019-12-09,Johor,67,34,33,2019
2019-12-10,Johor,75,34,41,2019
2019-12-11,Johor,108,22,86,2019
2019-12-12,Johor,91,26,65,2019
2019-12-13,Johor,0,0,0,2019
2019-12-14,Johor,137,59,78,2019
2019-12-15,Johor,368,58,310,2019
2019-12-16,Johor,103,33,70,2019
2019-12-17,Johor,96,29,67,2019
2019-12-18,Johor,102,63,39,2019
2019-12-19,Johor,83,27,56,2019
2019-12-20,Johor,0,0,0,2019
2019-12-21,Johor,97,19,78,2019
2019-12-22,Johor,238,49,189,2019
2019-12-23,Johor,63,12,51,2019
2019-12-24,Johor,48,11,37,2019
2019-12-25,Johor,85,21,64,2019
2019-12-26,Johor,69,21,48,2019
2019-12-27,Johor,0,0,0,2019
2019-12-28,Johor,77,25,52,2019
2019-12-29,Johor,288,130,158,2019
2019-12-30,Johor,66,6,60,2019
2019-12-31,Johor,124,28,96,2019
2020-01-01,Johor,91,19,72,2020
2020-01-02,Johor,97,26,71,2020
2020-01-03,Johor,0,0,0,2020
2020-01-04,Johor,137,37,100,2020
2020-01-05,Johor,194,33,161,2020
2020-01-06,Johor,67,37,30,2020
2020-01-07,Johor,112,35,77,2020
2020-01-08,Johor,236,71,165,2020
2020-01-09,Johor,110,38,72,2020
2020-01-10,Johor,0,0,0,2020
2020-01-11,Johor,106,29,77,2020
2020-01-12,Johor,356,81,275,2020
2020-01-13,Johor,131,38,93,2020
2020-01-14,Johor,62,6,56,2020
2020-01-15,Johor,246,124,122,2020
2020-01-16,Johor,71,27,44,2020
2020-01-17,Johor,0,0,0,2020
2020-01-18,Johor,172,53,119,2020
2020-01-19,Johor,195,80,115,2020
2020-01-20,Johor,150,82,68,2020
2020-01-21,Johor,169,96,73,2020
2020-01-22,Johor,117,47,70,2020
2020-01-23,Johor,105,43,62,2020
2020-01-24,Johor,0,0,0,2020
2020-01-25,Johor,84,37,47,2020
2020-01-26,Johor,95,33,62,2020
2020-01-27,Johor,68,20,48,2020
2020-01-28,Johor,109,18,91,2020
2020-01-29,Johor,92,34,58,2020
2020-01-30,Johor,113,19,94,2020
2020-01-31,Johor,0,0,0,2020
2020-02-01,Johor,83,40,43,2020
2020-02-02,Johor,190,33,157,2020
2020-02-03,Johor,90,28,62,2020
2020-02-04,Johor,122,56,66,2020
2020-02-05,Johor,139,72,67,2020
2020-02-06,Johor,133,66,67,2020
2020-02-07,Johor,0,0,0,2020
2020-02-08,Johor,242,104,138,2020
2020-02-09,Johor,305,47,258,2020
2020-02-10,Johor,150,78,72,2020
2020-02-11,Johor,46,23,23,2020
2020-02-12,Johor,76,38,38,2020
2020-02-13,Johor,112,36,76,2020
2020-02-14,Johor,0,0,0,2020
2020-02-15,Johor,131,60,71,2020
2020-02-16,Johor,266,46,220,2020
2020-02-17,Johor,28,5,23,2020
2020-02-18,Johor,146,44,102,2020
2020-02-19,Johor,74,22,52,2020
2020-02-20,Johor,45,14,31,2020
2020-02-21,Johor,39,20,19,2020
2020-02-22,Johor,135,30,105,2020
2020-02-23,Johor,233,59,174,2020
2020-02-24,Johor,64,23,41,2020
2020-02-25,Johor,120,32,88,2020
2020-02-26,Johor,198,107,91,2020
2020-02-27,Johor,57,22,35,2020
2020-02-28,Johor,0,0,0,2020
2020-02-29,Johor,274,81,193,2020
2020-03-01,Johor,302,100,202,2020
2020-03-02,Johor,63,4,59,2020
2020-03-03,Johor,56,28,28,2020
2020-03-04,Johor,108,66,42,2020
2020-03-05,Johor,121,61,60,2020
2020-03-06,Johor,0,0,0,2020
2020-03-07,Johor,207,77,130,2020
2020-03-08,Johor,373,75,298,2020
2020-03-09,Johor,55,10,45,2020
2020-03-10,Johor,104,61,43,2020
2020-03-11,Johor,131,59,72,2020
2020-03-12,Johor,94,40,54,2020
2020-03-13,Johor,0,0,0,2020
2020-03-14,Johor,73,23,50,2020
2020-03-15,Johor,332,63,269,2020
2020-03-16,Johor,66,34,32,2020
2020-03-17,Johor,79,30,49,2020
2020-03-18,Johor,56,12,44,2020
2020-03-19,Johor,90,19,71,2020
2020-03-20,Johor,16,7,9,2020
2020-03-21,Johor,146,39,107,2020
2020-03-22,Johor,75,22,53,2020
2020-03-23,Johor,111,32,79,2020
2020-03-24,Johor,149,42,107,2020
2020-03-25,Johor,148,46,102,2020
2020-03-26,Johor,97,25,72,2020
2020-03-27,Johor,6,0,6,2020
2020-03-28,Johor,105,43,62,2020
2020-03-29,Johor,88,27,61,2020
2020-03-30,Johor,55,17,38,2020
2020-03-31,Johor,60,11,49,2020
2020-04-01,Johor,49,4,45,2020
2020-04-02,Johor,49,13,36,2020
2020-04-03,Johor,2,0,2,2020
2020-04-04,Johor,53,14,39,2020
2020-04-05,Johor,65,13,52,2020
2020-04-06,Johor,57,15,42,2020
2020-04-07,Johor,43,7,36,2020
2020-04-08,Johor,60,13,47,2020
2020-04-09,Johor,45,8,37,2020
2020-04-10,Johor,8,4,4,2020
2020-04-11,Johor,42,11,31,2020
2020-04-12,Johor,92,21,71,2020
2020-04-13,Johor,65,21,44,2020
2020-04-14,Johor,85,23,62,2020
2020-04-15,Johor,167,51,116,2020
2020-04-16,Johor,83,26,57,2020
2020-04-17,Johor,25,6,19,2020
2020-04-18,Johor,67,18,49,2020
2020-04-19,Johor,134,41,93,2020
2020-04-20,Johor,181,59,122,2020
2020-04-21,Johor,241,70,171,2020
2020-04-22,Johor,275,104,171,2020
2020-04-23,Johor,98,25,73,2020
2020-04-24,Johor,0,0,0,2020
2020-04-25,Johor,17,2,15,2020
2020-04-26,Johor,54,11,43,2020
2020-04-27,Johor,117,29,88,2020
2020-04-28,Johor,159,40,119,2020
2020-04-29,Johor,132,42,90,2020
2020-04-30,Johor,145,50,95,2020
2020-05-01,Johor,22,7,15,2020
2020-05-02,Johor,109,29,80,2020
2020-05-03,Johor,227,46,181,2020
2020-05-04,Johor,64,15,49,2020
2020-05-05,Johor,57,18,39,2020
2020-05-06,Johor,76,33,43,2020
2020-05-07,Johor,235,69,166,2020
2020-05-08,Johor,0,0,0,2020
2020-05-09,Johor,149,60,89,2020
2020-05-10,Johor,195,102,93,2020
2020-05-11,Johor,61,20,41,2020
2020-05-12,Johor,25,5,20,2020
2020-05-13,Johor,37,9,28,2020
2020-05-14,Johor,51,8,43,2020
2020-05-15,Johor,0,0,0,2020
2020-05-16,Johor,217,82,135,2020
2020-05-17,Johor,374,96,278,2020
2020-05-18,Johor,103,36,67,2020
2020-05-19,Johor,108,45,63,2020
2020-05-20,Johor,152,80,72,2020
2020-05-21,Johor,172,66,106,2020
2020-05-22,Johor,0,0,0,2020
2020-05-23,Johor,43,16,27,2020
2020-05-24,Johor,0,0,0,2020
2020-05-25,Johor,0,0,0,2020
2020-05-26,Johor,93,23,70,2020
2020-05-27,Johor,67,8,59,2020
2020-05-28,Johor,120,24,96,2020
2020-05-29,Johor,71,8,63,2020
2020-05-30,Johor,225,52,173,2020
2020-05-31,Johor,189,44,145,2020
2020-06-01,Johor,120,36,84,2020
2020-06-02,Johor,111,32,79,2020
2020-06-03,Johor,124,32,92,2020
2020-06-04,Johor,116,36,80,2020
2020-06-05,Johor,0,0,0,2020
2020-06-06,Johor,206,48,158,2020
2020-06-07,Johor,267,61,206,2020
2020-06-08,Johor,72,22,50,2020
2020-06-09,Johor,92,24,68,2020
2020-06-10,Johor,120,43,77,2020
2020-06-11,Johor,84,25,59,2020
2020-06-12,Johor,0,0,0,2020
2020-06-13,Johor,205,107,98,2020
2020-06-14,Johor,573,78,495,2020
2020-06-15,Johor,77,13,64,2020
2020-06-16,Johor,82,24,58,2020
2020-06-17,Johor,152,23,129,2020
2020-06-18,Johor,75,15,60,2020
2020-06-19,Johor,0,0,0,2020
2020-06-20,Johor,181,59,122,2020
2020-06-21,Johor,285,65,220,2020
2020-06-22,Johor,98,30,68,2020
2020-06-23,Johor,79,29,50,2020
2020-06-24,Johor,98,31,67,2020
2020-06-25,Johor,93,28,65,2020
2020-06-26,Johor,0,0,0,2020
2020-06-27,Johor,175,46,129,2020
2020-06-28,Johor,322,91,231,2020
2020-06-29,Johor,96,22,74,2020
2020-06-30,Johor,99,32,67,2020
2020-07-01,Johor,199,72,127,2020
2020-07-02,Johor,63,15,48,2020
2020-07-03,Johor,0,0,0,2020
2020-07-04,Johor,81,15,66,2020
2020-07-05,Johor,245,50,195,2020
2020-07-06,Johor,59,13,46,2020
2020-07-07,Johor,73,18,55,2020
2020-07-08,Johor,64,16,48,2020
2020-07-09,Johor,87,41,46,2020
2020-07-10,Johor,0,0,0,2020
2020-07-11,Johor,119,45,74,2020
2020-07-12,Johor,325,74,251,2020
2020-07-13,Johor,156,59,97,2020
2020-07-14,Johor,109,41,68,2020
2020-07-15,Johor,90,32,58,2020
2020-07-16,Johor,109,46,63,2020
2020-07-17,Johor,0,0,0,2020
2020-07-18,Johor,176,54,122,2020
2020-07-19,Johor,241,57,184,2020
2020-07-20,Johor,182,78,104,2020
2020-07-21,Johor,115,32,83,2020
2020-07-22,Johor,127,36,91,2020
2020-07-23,Johor,130,44,86,2020
2020-07-24,Johor,0,0,0,2020
2020-07-25,Johor,90,19,71,2020
2020-07-26,Johor,180,35,145,2020
2020-07-27,Johor,61,14,47,2020
2020-07-28,Johor,52,19,33,2020
2020-07-29,Johor,75,37,38,2020
2020-07-30,Johor,57,17,40,2020
2020-07-31,Johor,0,0,0,2020
2020-08-01,Johor,0,0,0,2020
2020-08-02,Johor,219,52,167,2020
2020-08-03,Johor,35,5,30,2020
2020-08-04,Johor,67,23,44,2020
2020-08-05,Johor,135,51,84,2020
2020-08-06,Johor,84,27,57,2020
2020-08-07,Johor,0,0,0,2020
2020-08-08,Johor,252,86,166,2020
2020-08-09,Johor,336,82,254,2020
2020-08-10,Johor,175,33,142,2020
2020-08-11,Johor,66,19,47,2020
2020-08-12,Johor,151,50,101,2020
2020-08-13,Johor,75,12,63,2020
2020-08-14,Johor,0,0,0,2020
2020-08-15,Johor,175,58,117,2020
2020-08-16,Johor,317,81,236,2020
2020-08-17,Johor,52,8,44,2020
2020-08-18,Johor,129,60,69,2020
2020-08-19,Johor,246,102,144,2020
2020-08-20,Johor,0,0,0,2020
2020-08-21,Johor,0,0,0,2020
2020-08-22,Johor,85,21,64,2020
2020-08-23,Johor,266,70,196,2020
2020-08-24,Johor,216,74,142,2020
2020-08-25,Johor,120,60,60,2020
2020-08-26,Johor,153,51,102,2020
2020-08-27,Johor,82,11,71,2020
2020-08-28,Johor,0,0,0,2020
2020-08-29,Johor,73,25,48,2020
2020-08-30,Johor,158,45,113,2020
2020-08-31,Johor,181,40,141,2020
2020-09-01,Johor,117,36,81,2020
2020-09-02,Johor,85,46,39,2020
2020-09-03,Johor,66,9,57,2020
2020-09-04,Johor,0,0,0,2020
2020-09-05,Johor,137,82,55,2020
2020-09-06,Johor,387,75,312,2020
2020-09-07,Johor,67,14,53,2020
2020-09-08,Johor,48,13,35,2020
2020-09-09,Johor,119,32,87,2020
2020-09-10,Johor,105,39,66,2020
2020-09-11,Johor,0,0,0,2020
2020-09-12,Johor,81,18,63,2020
2020-09-13,Johor,475,89,386,2020
2020-09-14,Johor,77,29,48,2020
2020-09-15,Johor,87,23,64,2020
2020-09-16,Johor,235,34,201,2020
2020-09-17,Johor,78,13,65,2020
2020-09-18,Johor,0,0,0,2020
2020-09-19,Johor,61,20,41,2020
2020-09-20,Johor,332,62,270,2020
2020-09-21,Johor,76,22,54,2020
2020-09-22,Johor,93,44,49,2020
2020-09-23,Johor,146,30,116,2020
2020-09-24,Johor,54,18,36,2020
2020-09-25,Johor,0,0,0,2020
2020-09-26,Johor,118,27,91,2020
2020-09-27,Johor,205,56,149,2020
2020-09-28,Johor,114,27,87,2020
2020-09-29,Johor,131,22,109,2020
2020-09-30,Johor,108,19,89,2020
2020-10-01,Johor,82,8,74,2020
2020-10-02,Johor,0,0,0,2020
2020-10-03,Johor,98,25,73,2020
2020-10-04,Johor,293,65,228,2020
2020-10-05,Johor,109,29,80,2020
2020-10-06,Johor,67,4,63,2020
2020-10-07,Johor,85,45,40,2020
2020-10-08,Johor,58,11,47,2020
2020-10-09,Johor,0,0,0,2020
2020-10-10,Johor,75,24,51,2020
2020-10-11,Johor,414,85,329,2020
2020-10-12,Johor,73,19,54,2020
2020-10-13,Johor,49,5,44,2020
2020-10-14,Johor,112,24,88,2020
2020-10-15,Johor,85,32,53,2020
2020-10-16,Johor,0,0,0,2020
2020-10-17,Johor,154,45,109,2020
2020-10-18,Johor,231,47,184,2020
2020-10-19,Johor,117,30,87,2020
2020-10-20,Johor,79,29,50,2020
2020-10-21,Johor,116,27,89,2020
2020-10-22,Johor,76,20,56,2020
2020-10-23,Johor,0,0,0,2020
2020-10-24,Johor,163,56,107,2020
2020-10-25,Johor,340,57,283,2020
2020-10-26,Johor,109,32,77,2020
2020-10-27,Johor,107,30,77,2020
2020-10-28,Johor,131,24,107,2020
2020-10-29,Johor,107,38,69,2020
2020-10-30,Johor,0,0,0,2020
2020-10-31,Johor,106,27,79,2020
2020-11-01,Johor,159,38,121,2020
2020-11-02,Johor,46,14,32,2020
2020-11-03,Johor,101,43,58,2020
2020-11-04,Johor,74,16,58,2020
2020-11-05,Johor,144,62,82,2020
2020-11-06,Johor,0,0,0,2020
2020-11-07,Johor,74,15,59,2020
2020-11-08,Johor,91,15,76,2020
2020-11-09,Johor,107,38,69,2020
2020-11-10,Johor,171,94,77,2020
2020-11-11,Johor,35,4,31,2020
2020-11-12,Johor,66,13,53,2020
2020-11-13,Johor,0,0,0,2020
2020-11-14,Johor,268,131,137,2020
2020-11-15,Johor,241,48,193,2020
2020-11-16,Johor,107,20,87,2020
2020-11-17,Johor,93,19,74,2020
2020-11-18,Johor,124,26,98,2020
2020-11-19,Johor,78,25,53,2020
2020-11-20,Johor,0,0,0,2020
2020-11-21,Johor,78,12,66,2020
2020-11-22,Johor,247,58,189,2020
2020-11-23,Johor,72,15,57,2020
2020-11-24,Johor,101,31,70,2020
2020-11-25,Johor,106,29,77,2020
2020-11-26,Johor,80,15,65,2020
2020-11-27,Johor,0,0,0,2020
2020-11-28,Johor,183,46,137,2020
2020-11-29,Johor,234,53,181,2020
2020-11-30,Johor,136,27,109,2020
2020-12-01,Johor,74,20,54,2020
2020-12-02,Johor,145,74,71,2020
2020-12-03,Johor,51,7,44,2020
2020-12-04,Johor,0,0,0,2020
2020-12-05,Johor,99,41,58,2020
2020-12-06,Johor,262,58,204,2020
2020-12-07,Johor,39,4,35,2020
2020-12-08,Johor,31,6,25,2020
2020-12-09,Johor,113,36,77,2020
2020-12-10,Johor,33,3,30,2020
2020-12-11,Johor,0,0,0,2020
2020-12-12,Johor,163,75,88,2020
2020-12-13,Johor,130,13,117,2020
2020-12-14,Johor,37,7,30,2020
2020-12-15,Johor,75,16,59,2020
2020-12-16,Johor,140,79,61,2020
2020-12-17,Johor,76,17,59,2020
2020-12-18,Johor,0,0,0,2020
2020-12-19,Johor,142,48,94,2020
2020-12-20,Johor,351,72,279,2020
2020-12-21,Johor,71,15,56,2020
2020-12-22,Johor,120,37,83,2020
2020-12-23,Johor,110,18,92,2020
2020-12-24,Johor,144,33,111,2020
2020-12-25,Johor,0,0,0,2020
2020-12-26,Johor,186,50,136,2020
2020-12-27,Johor,261,61,200,2020
2020-12-28,Johor,88,16,72,2020
2020-12-29,Johor,50,8,42,2020
2020-12-30,Johor,54,9,45,2020
2020-12-31,Johor,90,9,81,2020
2021-01-01,Johor,0,0,0,2021
2021-01-02,Johor,63,12,51,2021
2021-01-03,Johor,227,46,181,2021
2021-01-04,Johor,49,11,38,2021
2021-01-05,Johor,76,13,63,2021
2021-01-06,Johor,123,71,52,2021
2021-01-07,Johor,90,22,68,2021
2021-01-08,Johor,0,0,0,2021
2021-01-09,Johor,80,48,32,2021
2021-01-10,Johor,120,23,97,2021
2021-01-11,Johor,57,8,49,2021
2021-01-12,Johor,67,15,52,2021
2021-01-13,Johor,53,11,42,2021
2021-01-14,Johor,71,15,56,2021
2021-01-15,Johor,157,56,101,2021
2021-01-16,Johor,64,20,44,2021
2021-01-17,Johor,216,53,163,2021
2021-01-18,Johor,93,13,80,2021
2021-01-19,Johor,78,15,63,2021
2021-01-20,Johor,79,24,55,2021
2021-01-21,Johor,133,49,84,2021
2021-01-22,Johor,0,0,0,2021
2021-01-23,Johor,113,35,78,2021
2021-01-24,Johor,347,82,265,2021
2021-01-25,Johor,134,30,104,2021
2021-01-26,Johor,102,22,80,2021
2021-01-27,Johor,95,27,68,2021
2021-01-28,Johor,209,71,138,2021
2021-01-29,Johor,0,0,0,2021
2021-01-30,Johor,163,49,114,2021
2021-01-31,Johor,229,50,179,2021
2021-02-01,Johor,95,23,72,2021
2021-02-02,Johor,95,28,67,2021
2021-02-03,Johor,108,37,71,2021
2021-02-04,Johor,33,2,31,2021
2021-02-05,Johor,0,0,0,2021
2021-02-06,Johor,166,53,113,2021
2021-02-07,Johor,221,36,185,2021
2021-02-08,Johor,62,13,49,2021
2021-02-09,Johor,75,16,59,2021
2021-02-10,Johor,83,27,56,2021
2021-02-11,Johor,85,20,65,2021
2021-02-12,Johor,0,0,0,2021
2021-02-13,Johor,186,44,142,2021
2021-02-14,Johor,168,47,121,2021
2021-02-15,Johor,97,22,75,2021
2021-02-16,Johor,101,29,72,2021
2021-02-17,Johor,97,19,78,2021
2021-02-18,Johor,108,20,88,2021
2021-02-19,Johor,0,0,0,2021
2021-02-20,Johor,127,51,76,2021
2021-02-21,Johor,477,96,381,2021
2021-02-22,Johor,127,13,114,2021
2021-02-23,Johor,113,28,85,2021
2021-02-24,Johor,85,31,54,2021
2021-02-25,Johor,81,30,51,2021
2021-02-26,Johor,65,21,44,2021
2021-02-27,Johor,205,76,129,2021
2021-02-28,Johor,294,61,233,2021
2021-03-01,Johor,79,18,61,2021
2021-03-02,Johor,72,17,55,2021
2021-03-03,Johor,78,22,56,2021
2021-03-04,Johor,89,17,72,2021
2021-03-05,Johor,0,0,0,2021
2021-03-06,Johor,173,56,117,2021
2021-03-07,Johor,266,48,218,2021
2021-03-08,Johor,79,10,69,2021
2021-03-09,Johor,63,13,50,2021
2021-03-10,Johor,59,13,46,2021
2021-03-11,Johor,79,21,58,2021
2021-03-12,Johor,0,0,0,2021
2021-03-13,Johor,123,32,91,2021
2021-03-14,Johor,300,54,246,2021
2021-03-15,Johor,124,32,92,2021
2021-03-16,Johor,93,15,78,2021
2021-03-17,Johor,155,36,119,2021
2021-03-18,Johor,94,19,75,2021
2021-03-19,Johor,0,0,0,2021
2021-03-20,Johor,126,24,102,2021
2021-03-21,Johor,321,69,252,2021
2021-03-22,Johor,155,94,61,2021
2021-03-23,Johor,129,39,90,2021
2021-03-24,Johor,97,31,66,2021
2021-03-25,Johor,105,38,67,2021
2021-03-26,Johor,24,2,22,2021
2021-03-27,Johor,130,45,85,2021
2021-03-28,Johor,288,69,219,2021
2021-03-29,Johor,94,24,70,2021
2021-03-30,Johor,121,29,92,2021
2021-03-31,Johor,129,28,101,2021
2021-04-01,Johor,76,8,68,2021
2021-04-02,Johor,0,0,0,2021
2021-04-03,Johor,174,31,143,2021
2021-04-04,Johor,248,51,197,2021
2021-04-05,Johor,79,12,67,2021
2021-04-06,Johor,141,59,82,2021
2021-04-07,Johor,122,58,64,2021
2021-04-08,Johor,116,33,83,2021
2021-04-09,Johor,0,0,0,2021
2021-04-10,Johor,138,38,100,2021
2021-04-11,Johor,353,57,296,2021
2021-04-12,Johor,143,35,108,2021
2021-04-13,Johor,0,0,0,2021
2021-04-14,Johor,33,2,31,2021
2021-04-15,Johor,59,11,48,2021
2021-04-16,Johor,0,0,0,2021
2021-04-17,Johor,63,17,46,2021
2021-04-18,Johor,199,57,142,2021
2021-04-19,Johor,11,2,9,2021
2021-04-20,Johor,50,6,44,2021
2021-04-21,Johor,48,5,43,2021
2021-04-22,Johor,90,16,74,2021
2021-04-23,Johor,0,0,0,2021
2021-04-24,Johor,50,31,19,2021
2021-04-25,Johor,227,47,180,2021
2021-04-26,Johor,60,10,50,2021
2021-04-27,Johor,68,20,48,2021
2021-04-28,Johor,59,12,47,2021
2021-04-29,Johor,111,26,85,2021
2021-04-30,Johor,91,55,36,2021
2021-05-01,Johor,126,36,90,2021
2021-05-02,Johor,352,75,277,2021
2021-05-03,Johor,53,9,44,2021
2021-05-04,Johor,79,20,59,2021
2021-05-05,Johor,36,3,33,2021
2021-05-06,Johor,88,18,70,2021
2021-05-07,Johor,20,5,15,2021
2021-05-08,Johor,51,16,35,2021
2021-05-09,Johor,252,42,210,2021
2021-05-10,Johor,55,8,47,2021
2021-05-11,Johor,136,28,108,2021
2021-05-12,Johor,46,9,37,2021
2021-05-13,Johor,0,0,0,2021
2021-05-14,Johor,0,0,0,2021
2021-05-15,Johor,106,31,75,2021
2021-05-16,Johor,239,39,200,2021
2021-05-17,Johor,100,9,91,2021
2021-05-18,Johor,163,35,128,2021
2021-05-19,Johor,173,32,141,2021
2021-05-20,Johor,100,32,68,2021
2021-05-21,Johor,0,0,0,2021
2021-05-22,Johor,145,29,116,2021
2021-05-23,Johor,337,43,294,2021
2021-05-24,Johor,138,28,110,2021
2021-05-25,Johor,102,35,67,2021
2021-05-26,Johor,111,32,79,2021
2021-05-27,Johor,94,22,72,2021
2021-05-28,Johor,0,0,0,2021
2021-05-29,Johor,61,13,48,2021
2021-05-30,Johor,356,53,303,2021
2021-05-31,Johor,157,22,135,2021
2021-06-01,Johor,34,6,28,2021
2021-06-02,Johor,52,8,44,2021
2021-06-03,Johor,49,6,43,2021
2021-06-04,Johor,0,0,0,2021
2021-06-05,Johor,45,4,41,2021
2021-06-06,Johor,300,46,254,2021
2021-06-07,Johor,112,39,73,2021
2021-06-08,Johor,88,15,73,2021
2021-06-09,Johor,66,7,59,2021
2021-06-10,Johor,69,11,58,2021
2021-06-11,Johor,0,0,0,2021
2021-06-12,Johor,87,14,73,2021
2021-06-13,Johor,271,59,212,2021
2021-06-14,Johor,151,36,115,2021
2021-06-15,Johor,141,42,99,2021
2021-06-16,Johor,142,32,110,2021
2021-06-17,Johor,151,39,112,2021
2021-06-18,Johor,0,0,0,2021
2021-06-19,Johor,181,44,137,2021
2021-06-20,Johor,405,84,321,2021
2021-06-21,Johor,133,33,100,2021
2021-06-22,Johor,114,26,88,2021
2021-06-23,Johor,135,32,103,2021
2021-06-24,Johor,99,37,62,2021
2021-06-25,Johor,0,0,0,2021
2021-06-26,Johor,199,38,161,2021
2021-06-27,Johor,240,64,176,2021
2021-06-28,Johor,105,26,79,2021
2021-06-29,Johor,95,35,60,2021
2021-06-30,Johor,66,6,60,2021
2021-07-01,Johor,91,20,71,2021
2021-07-02,Johor,0,0,0,2021
2021-07-03,Johor,193,33,160,2021
2021-07-04,Johor,200,42,158,2021
2021-07-05,Johor,70,10,60,2021
2021-07-06,Johor,63,10,53,2021
2021-07-07,Johor,128,29,99,2021
2021-07-08,Johor,102,12,90,2021
2021-07-09,Johor,0,0,0,2021
2021-07-10,Johor,177,52,125,2021
2021-07-11,Johor,273,71,202,2021
2021-07-12,Johor,113,28,85,2021
2021-07-13,Johor,86,24,62,2021
2021-07-14,Johor,82,21,61,2021
2021-07-15,Johor,101,22,79,2021
2021-07-16,Johor,0,0,0,2021
2021-07-17,Johor,146,34,112,2021
2021-07-18,Johor,209,32,177,2021
2021-07-19,Johor,29,2,27,2021
2021-07-20,Johor,0,0,0,2021
2021-07-21,Johor,88,23,65,2021
2021-07-22,Johor,115,26,89,2021
2021-07-23,Johor,0,0,0,2021
2021-07-24,Johor,123,42,81,2021
2021-07-25,Johor,198,50,148,2021
2021-07-26,Johor,49,10,39,2021
2021-07-27,Johor,58,16,42,2021
2021-07-28,Johor,63,14,49,2021
2021-07-29,Johor,70,24,46,2021
2021-07-30,Johor,33,4,29,2021
2021-07-31,Johor,115,35,80,2021
2021-08-01,Johor,189,47,142,2021
2021-08-02,Johor,82,20,62,2021
2021-08-03,Johor,70,21,49,2021
2021-08-04,Johor,96,18,78,2021
2021-08-05,Johor,59,11,48,2021
2021-08-06,Johor,0,0,0,2021
2021-08-07,Johor,166,46,120,2021
2021-08-08,Johor,195,49,146,2021
2021-08-09,Johor,69,21,48,2021
2021-08-10,Johor,187,60,127,2021
2021-08-11,Johor,95,16,79,2021
2021-08-12,Johor,94,20,74,2021
2021-08-13,Johor,0,0,0,2021
2021-08-14,Johor,108,19,89,2021
2021-08-15,Johor,179,45,134,2021
2021-08-16,Johor,51,14,37,2021
2021-08-17,Johor,61,22,39,2021
2021-08-18,Johor,55,15,40,2021
2021-08-19,Johor,84,24,60,2021
2021-08-20,Johor,28,4,24,2021
2021-08-21,Johor,94,27,67,2021
2021-08-22,Johor,140,27,113,2021
2021-08-23,Johor,92,26,66,2021
2021-08-24,Johor,62,20,42,2021
2021-08-25,Johor,101,22,79,2021
2021-08-26,Johor,86,25,61,2021
2021-08-27,Johor,0,0,0,2021
2021-08-28,Johor,107,34,73,2021
2021-08-29,Johor,230,49,181,2021
2021-08-30,Johor,159,29,130,2021
2021-08-31,Johor,187,54,133,2021
2021-09-01,Johor,82,16,66,2021
2021-09-02,Johor,53,17,36,2021
2021-09-03,Johor,0,0,0,2021
2021-09-04,Johor,138,34,104,2021
2021-09-05,Johor,249,42,207,2021
2021-09-06,Johor,59,17,42,2021
2021-09-07,Johor,45,7,38,2021
2021-09-08,Johor,88,16,72,2021
2021-09-09,Johor,86,26,60,2021
2021-09-10,Johor,0,0,0,2021
2021-09-11,Johor,205,54,151,2021
2021-09-12,Johor,334,71,263,2021
2021-09-13,Johor,93,22,71,2021
2021-09-14,Johor,84,26,58,2021
2021-09-15,Johor,81,12,69,2021
2021-09-16,Johor,317,69,248,2021
2021-09-17,Johor,22,4,18,2021
2021-09-18,Johor,90,30,60,2021
2021-09-19,Johor,305,51,254,2021
2021-09-20,Johor,118,17,101,2021
2021-09-21,Johor,75,15,60,2021
2021-09-22,Johor,93,18,75,2021
2021-09-23,Johor,114,30,84,2021
2021-09-24,Johor,0,0,0,2021
2021-09-25,Johor,189,36,153,2021
2021-09-26,Johor,235,48,187,2021
2021-09-27,Johor,93,21,72,2021
2021-09-28,Johor,58,5,53,2021
2021-09-29,Johor,83,13,70,2021
2021-09-30,Johor,78,20,58,2021
2021-10-01,Johor,0,0,0,2021
2021-10-02,Johor,153,44,109,2021
2021-10-03,Johor,249,31,218,2021
2021-10-04,Johor,105,23,82,2021
2021-10-05,Johor,110,28,82,2021
2021-10-06,Johor,86,14,72,2021
2021-10-07,Johor,119,35,84,2021
2021-10-08,Johor,0,0,0,2021
2021-10-09,Johor,247,81,166,2021
2021-10-10,Johor,361,53,308,2021
2021-10-11,Johor,42,5,37,2021
2021-10-12,Johor,98,31,67,2021
2021-10-13,Johor,145,65,80,2021
2021-10-14,Johor,91,29,62,2021
2021-10-15,Johor,0,0,0,2021
2021-10-16,Johor,134,26,108,2021
2021-10-17,Johor,246,50,196,2021
2021-10-18,Johor,99,14,85,2021
2021-10-19,Johor,93,18,75,2021
2021-10-20,Johor,65,16,49,2021
2021-10-21,Johor,88,21,67,2021
2021-10-22,Johor,0,0,0,2021
2021-10-23,Johor,79,28,51,2021
2021-10-24,Johor,299,52,247,2021
2021-10-25,Johor,100,15,85,2021
2021-10-26,Johor,79,17,62,2021
2021-10-27,Johor,107,25,82,2021
2021-10-28,Johor,55,9,46,2021
2021-10-29,Johor,0,0,0,2021
2021-10-30,Johor,190,53,137,2021
2021-10-31,Johor,196,28,168,2021
2021-11-01,Johor,97,26,71,2021
2021-11-02,Johor,80,20,60,2021
2021-11-03,Johor,130,57,73,2021
2021-11-04,Johor,108,29,79,2021
2021-11-05,Johor,0,0,0,2021
2021-11-06,Johor,167,46,121,2021
2021-11-07,Johor,202,34,168,2021
2021-11-08,Johor,56,15,41,2021
2021-11-09,Johor,86,38,48,2021
2021-11-10,Johor,204,65,139,2021
2021-11-11,Johor,59,13,46,2021
2021-11-12,Johor,0,0,0,2021
2021-11-13,Johor,130,32,98,2021
2021-11-14,Johor,301,61,240,2021
2021-11-15,Johor,80,23,57,2021
2021-11-16,Johor,94,26,68,2021
2021-11-17,Johor,81,20,61,2021
2021-11-18,Johor,132,40,92,2021
2021-11-19,Johor,0,0,0,2021
2021-11-20,Johor,180,38,142,2021
2021-11-21,Johor,277,62,215,2021
2021-11-22,Johor,122,30,92,2021
2021-11-23,Johor,143,49,94,2021
2021-11-24,Johor,105,24,81,2021
2021-11-25,Johor,63,9,54,2021
2021-11-26,Johor,0,0,0,2021
2021-11-27,Johor,199,44,155,2021
2021-11-28,Johor,237,37,200,2021
2021-11-29,Johor,77,14,63,2021
2021-11-30,Johor,57,13,44,2021
2021-12-01,Johor,104,50,54,2021
2021-12-02,Johor,162,47,115,2021
2021-12-03,Johor,0,0,0,2021
2021-12-04,Johor,169,49,120,2021
2021-12-05,Johor,351,61,290,2021
2021-12-06,Johor,89,18,71,2021
2021-12-07,Johor,73,21,52,2021
2021-12-08,Johor,100,20,80,2021
2021-12-09,Johor,51,15,36,2021
2021-12-10,Johor,0,0,0,2021
2021-12-11,Johor,117,32,85,2021
2021-12-12,Johor,324,68,256,2021
2021-12-13,Johor,100,21,79,2021
2021-12-14,Johor,90,32,58,2021
2021-12-15,Johor,81,13,68,2021
2021-12-16,Johor,87,32,55,2021
2021-12-17,Johor,0,0,0,2021
2021-12-18,Johor,195,34,161,2021
2021-12-19,Johor,248,48,200,2021
2021-12-20,Johor,84,19,65,2021
2021-12-21,Johor,79,21,58,2021
2021-12-22,Johor,119,29,90,2021
2021-12-23,Johor,73,13,60,2021
2021-12-24,Johor,77,22,55,2021
2021-12-25,Johor,99,16,83,2021
2021-12-26,Johor,209,32,177,2021
2021-12-27,Johor,76,13,63,2021
2021-12-28,Johor,87,18,69,2021
2021-12-29,Johor,79,14,65,2021
2021-12-30,Johor,113,18,95,2021
2021-12-31,Johor,0,0,0,2021
2022-01-01,Johor,191,48,143,2022
2022-01-02,Johor,222,51,171,2022
2022-01-03,Johor,110,19,91,2022
2022-01-04,Johor,75,20,55,2022
2022-01-05,Johor,108,43,65,2022
2022-01-06,Johor,99,20,79,2022
2022-01-07,Johor,0,0,0,2022
2022-01-08,Johor,170,37,133,2022
2022-01-09,Johor,386,88,298,2022
2022-01-10,Johor,116,28,88,2022
2022-01-11,Johor,127,29,98,2022
2022-01-12,Johor,97,34,63,2022
2022-01-13,Johor,105,34,71,2022
2022-01-14,Johor,0,0,0,2022
2022-01-15,Johor,160,46,114,2022
2022-01-16,Johor,263,35,228,2022
2022-01-17,Johor,51,7,44,2022
2022-01-18,Johor,92,29,63,2022
2022-01-19,Johor,109,21,88,2022
2022-01-20,Johor,73,16,57,2022
2022-01-21,Johor,0,0,0,2022
2022-01-22,Johor,141,45,96,2022
2022-01-23,Johor,265,46,219,2022
2022-01-24,Johor,104,19,85,2022
2022-01-25,Johor,80,20,60,2022
2022-01-26,Johor,85,19,66,2022
2022-01-27,Johor,92,15,77,2022
2022-01-28,Johor,0,0,0,2022
2022-01-29,Johor,71,18,53,2022
2022-01-30,Johor,153,31,122,2022
2022-01-31,Johor,72,12,60,2022
2022-02-01,Johor,56,14,42,2022
2022-02-02,Johor,41,5,36,2022
2022-02-03,Johor,96,24,72,2022
2022-02-04,Johor,0,0,0,2022
2022-02-05,Johor,172,38,134,2022
2022-02-06,Johor,172,44,128,2022
2022-02-07,Johor,77,11,66,2022
2022-02-08,Johor,94,25,69,2022
2022-02-09,Johor,76,19,57,2022
2022-02-10,Johor,76,23,53,2022
2022-02-11,Johor,36,7,29,2022
2022-02-12,Johor,186,37,149,2022
2022-02-13,Johor,277,56,221,2022
2022-02-14,Johor,89,25,64,2022
2022-02-15,Johor,77,15,62,2022
2022-02-16,Johor,67,15,52,2022
2022-02-17,Johor,97,21,76,2022
2022-02-18,Johor,18,5,13,2022
2022-02-19,Johor,155,45,110,2022
2022-02-20,Johor,293,58,235,2022
2022-02-21,Johor,94,27,67,2022
2022-02-22,Johor,124,40,84,2022
2022-02-23,Johor,75,10,65,2022
2022-02-24,Johor,60,13,47,2022
2022-02-25,Johor,0,0,0,2022
2022-02-26,Johor,60,16,44,2022
2022-02-27,Johor,237,62,175,2022
2022-02-28,Johor,37,4,33,2022
2022-03-01,Johor,70,14,56,2022
2022-03-02,Johor,155,80,75,2022
2022-03-03,Johor,33,3,30,2022
2022-03-04,Johor,15,4,11,2022
2022-03-05,Johor,118,37,81,2022
2022-03-06,Johor,255,49,206,2022
2022-03-07,Johor,114,42,72,2022
2022-03-08,Johor,89,32,57,2022
2022-03-09,Johor,97,32,65,2022
2022-03-10,Johor,89,12,77,2022
2022-03-11,Johor,16,4,12,2022
2022-03-12,Johor,33,12,21,2022
2022-03-13,Johor,260,50,210,2022
2022-03-14,Johor,61,2,59,2022
2022-03-15,Johor,61,15,46,2022
2022-03-16,Johor,115,19,96,2022
2022-03-17,Johor,97,24,73,2022
2022-03-18,Johor,17,3,14,2022
2022-03-19,Johor,172,36,136,2022
2022-03-20,Johor,384,82,302,2022
2022-03-21,Johor,102,32,70,2022
2022-03-22,Johor,59,18,41,2022
2022-03-23,Johor,301,52,249,2022
2022-03-24,Johor,85,13,72,2022
2022-03-25,Johor,0,0,0,2022
2022-03-26,Johor,150,43,107,2022
2022-03-27,Johor,285,47,238,2022
2022-03-28,Johor,129,44,85,2022
2022-03-29,Johor,195,118,77,2022
2022-03-30,Johor,59,4,55,2022
2022-03-31,Johor,102,35,67,2022
2022-04-01,Johor,28,5,23,2022
2022-04-02,Johor,193,50,143,2022
2022-04-03,Johor,164,23,141,2022
2022-04-04,Johor,51,9,42,2022
2022-04-05,Johor,48,12,36,2022
2022-04-06,Johor,31,5,26,2022
2022-04-07,Johor,36,5,31,2022
2022-04-08,Johor,13,5,8,2022
2022-04-09,Johor,175,42,133,2022
2022-04-10,Johor,170,36,134,2022
2022-04-11,Johor,73,19,54,2022
2022-04-12,Johor,59,19,40,2022
2022-04-13,Johor,133,46,87,2022
2022-04-14,Johor,95,20,75,2022
2022-04-15,Johor,58,26,32,2022
2022-04-16,Johor,172,53,119,2022
2022-04-17,Johor,345,67,278,2022
2022-04-18,Johor,43,9,34,2022
2022-04-19,Johor,54,12,42,2022
2022-04-20,Johor,61,16,45,2022
2022-04-21,Johor,69,21,48,2022
2022-04-22,Johor,0,0,0,2022
2022-04-23,Johor,105,46,59,2022
2022-04-24,Johor,240,63,177,2022
2022-04-25,Johor,117,32,85,2022
2022-04-26,Johor,86,17,69,2022
2022-04-27,Johor,82,31,51,2022
2022-04-28,Johor,90,14,76,2022
2022-04-29,Johor,10,5,5,2022
2022-04-30,Johor,93,33,60,2022
2022-05-01,Johor,144,32,112,2022
2022-05-02,Johor,0,0,0,2022
2022-05-03,Johor,0,0,0,2022
2022-05-04,Johor,47,12,35,2022
2022-05-05,Johor,142,26,116,2022
2022-05-06,Johor,32,5,27,2022
2022-05-07,Johor,154,41,113,2022
2022-05-08,Johor,357,66,291,2022
2022-05-09,Johor,110,40,70,2022
2022-05-10,Johor,116,16,100,2022
2022-05-11,Johor,121,28,93,2022
2022-05-12,Johor,105,33,72,2022
2022-05-13,Johor,26,10,16,2022
2022-05-14,Johor,183,54,129,2022
2022-05-15,Johor,368,89,279,2022
2022-05-16,Johor,127,27,100,2022
2022-05-17,Johor,132,38,94,2022
2022-05-18,Johor,76,7,69,2022
2022-05-19,Johor,154,58,96,2022
2022-05-20,Johor,35,9,26,2022
2022-05-21,Johor,133,24,109,2022
2022-05-22,Johor,358,74,284,2022
2022-05-23,Johor,112,16,96,2022
2022-05-24,Johor,205,79,126,2022
2022-05-25,Johor,68,13,55,2022
2022-05-26,Johor,159,54,105,2022
2022-05-27,Johor,0,0,0,2022
2022-05-28,Johor,145,55,90,2022
2022-05-29,Johor,228,37,191,2022
2022-05-30,Johor,113,47,66,2022
2022-05-31,Johor,78,15,63,2022
2022-06-01,Johor,86,24,62,2022
2022-06-02,Johor,147,52,95,2022
2022-06-03,Johor,105,31,74,2022
2022-06-04,Johor,188,55,133,2022
2022-06-05,Johor,287,63,224,2022
2022-06-06,Johor,186,75,111,2022
2022-06-07,Johor,85,19,66,2022
2022-06-08,Johor,98,22,76,2022
2022-06-09,Johor,126,40,86,2022
2022-06-10,Johor,25,6,19,2022
2022-06-11,Johor,174,34,140,2022
2022-06-12,Johor,291,56,235,2022
2022-06-13,Johor,74,12,62,2022
2022-06-14,Johor,131,13,118,2022
2022-06-15,Johor,238,105,133,2022
2022-06-16,Johor,96,27,69,2022
2022-06-17,Johor,71,32,39,2022
2022-06-18,Johor,237,69,168,2022
2022-06-19,Johor,299,50,249,2022
2022-06-20,Johor,44,7,37,2022
2022-06-21,Johor,115,37,78,2022
2022-06-22,Johor,174,31,143,2022
2022-06-23,Johor,139,60,79,2022
2022-06-24,Johor,19,3,16,2022
2022-06-25,Johor,79,14,65,2022
2022-06-26,Johor,328,44,284,2022
2022-06-27,Johor,55,7,48,2022
2022-06-28,Johor,111,25,86,2022
2022-06-29,Johor,94,27,67,2022
2022-06-30,Johor,75,19,56,2022
2022-07-01,Johor,29,4,25,2022
2022-07-02,Johor,142,37,105,2022
2022-07-03,Johor,284,48,236,2022
2022-07-04,Johor,101,15,86,2022
2022-07-05,Johor,118,26,92,2022
2022-07-06,Johor,71,16,55,2022
2022-07-07,Johor,92,15,77,2022
2022-07-08,Johor,24,10,14,2022
2022-07-09,Johor,96,23,73,2022
2022-07-10,Johor,0,0,0,2022
2022-07-11,Johor,92,27,65,2022
2022-07-12,Johor,157,44,113,2022
2022-07-13,Johor,37,7,30,2022
2022-07-14,Johor,88,19,69,2022
2022-07-15,Johor,15,3,12,2022
2022-07-16,Johor,125,36,89,2022
2022-07-17,Johor,333,72,261,2022
2022-07-18,Johor,96,37,59,2022
2022-07-19,Johor,130,30,100,2022
2022-07-20,Johor,128,22,106,2022
2022-07-21,Johor,57,8,49,2022
2022-07-22,Johor,59,29,30,2022
2022-07-23,Johor,90,20,70,2022
2022-07-24,Johor,217,34,183,2022
2022-07-25,Johor,37,3,34,2022
2022-07-26,Johor,61,14,47,2022
2022-07-27,Johor,36,2,34,2022
2022-07-28,Johor,101,20,81,2022
2022-07-29,Johor,75,19,56,2022
2022-07-30,Johor,212,61,151,2022
2022-07-31,Johor,284,41,243,2022
2022-08-01,Johor,124,31,93,2022
2022-08-02,Johor,45,8,37,2022
2022-08-03,Johor,130,37,93,2022
2022-08-04,Johor,51,11,40,2022
2022-08-05,Johor,28,8,20,2022
2022-08-06,Johor,159,37,122,2022
2022-08-07,Johor,267,52,215,2022
2022-08-08,Johor,129,78,51,2022
2022-08-09,Johor,88,19,69,2022
2022-08-10,Johor,64,5,59,2022
2022-08-11,Johor,72,16,56,2022
2022-08-12,Johor,24,5,19,2022
2022-08-13,Johor,128,31,97,2022
2022-08-14,Johor,317,75,242,2022
2022-08-15,Johor,112,51,61,2022
2022-08-16,Johor,93,23,70,2022
2022-08-17,Johor,127,39,88,2022
2022-08-18,Johor,130,24,106,2022
2022-08-19,Johor,34,9,25,2022
2022-08-20,Johor,204,46,158,2022
2022-08-21,Johor,393,63,330,2022
2022-08-22,Johor,64,9,55,2022
2022-08-23,Johor,85,19,66,2022
2022-08-24,Johor,79,24,55,2022
2022-08-25,Johor,59,7,52,2022
2022-08-26,Johor,39,10,29,2022
2022-08-27,Johor,107,35,72,2022
2022-08-28,Johor,269,43,226,2022
2022-08-29,Johor,58,15,43,2022
2022-08-30,Johor,82,28,54,2022
2022-08-31,Johor,209,42,167,2022
2022-09-01,Johor,64,19,45,2022
2022-09-02,Johor,73,14,59,2022
2022-09-03,Johor,170,46,124,2022
2022-09-04,Johor,240,40,200,2022
2022-09-05,Johor,99,32,67,2022
2022-09-06,Johor,83,7,76,2022
2022-09-07,Johor,86,55,31,2022
2022-09-08,Johor,181,46,135,2022
2022-09-09,Johor,16,5,11,2022
2022-09-10,Johor,76,29,47,2022
2022-09-11,Johor,265,48,217,2022
2022-09-12,Johor,90,14,76,2022
2022-09-13,Johor,75,13,62,2022
2022-09-14,Johor,75,10,65,2022
2022-09-15,Johor,114,34,80,2022
2022-09-16,Johor,180,29,151,2022
2022-09-17,Johor,196,35,161,2022
2022-09-18,Johor,167,31,136,2022
2022-09-19,Johor,122,19,103,2022
2022-09-20,Johor,105,24,81,2022
2022-09-21,Johor,106,16,90,2022
2022-09-22,Johor,116,28,88,2022
2022-09-23,Johor,68,19,49,2022
2022-09-24,Johor,20,1,19,2022
2022-09-25,Johor,222,27,195,2022
2022-09-26,Johor,60,12,48,2022
2022-09-27,Johor,137,27,110,2022
2022-09-28,Johor,83,43,40,2022
2022-09-29,Johor,98,31,67,2022
2022-09-30,Johor,34,6,28,2022
2022-10-01,Johor,141,33,108,2022
2022-10-02,Johor,369,60,309,2022
2022-10-03,Johor,88,23,65,2022
2022-10-04,Johor,86,18,68,2022
2022-10-05,Johor,119,49,70,2022
2022-10-06,Johor,97,15,82,2022
2022-10-07,Johor,23,8,15,2022
2022-10-08,Johor,172,32,140,2022
2022-10-09,Johor,166,42,124,2022
2022-10-10,Johor,157,81,76,2022
2022-10-11,Johor,135,29,106,2022
2022-10-12,Johor,104,22,82,2022
2022-10-13,Johor,126,15,111,2022
2022-10-14,Johor,52,19,33,2022
2022-10-15,Johor,156,54,102,2022
2022-10-16,Johor,382,68,314,2022
2022-10-17,Johor,142,54,88,2022
2022-10-18,Johor,77,12,65,2022
2022-10-19,Johor,137,22,115,2022
2022-10-20,Johor,97,25,72,2022
2022-10-21,Johor,0,0,0,2022
2022-10-22,Johor,95,23,72,2022
2022-10-23,Johor,284,40,244,2022
2022-10-24,Johor,50,12,38,2022
2022-10-25,Johor,84,16,68,2022
2022-10-26,Johor,139,32,107,2022
2022-10-27,Johor,69,13,56,2022
2022-10-28,Johor,68,25,43,2022
2022-10-29,Johor,155,43,112,2022
2022-10-30,Johor,294,49,245,2022
2022-10-31,Johor,78,25,53,2022
2022-11-01,Johor,54,12,42,2022
2022-11-02,Johor,98,25,73,2022
2022-11-03,Johor,93,47,46,2022
2022-11-04,Johor,23,7,16,2022
2022-11-05,Johor,162,36,126,2022
2022-11-06,Johor,247,75,172,2022
2022-11-07,Johor,100,29,71,2022
2022-11-08,Johor,98,22,76,2022
2022-11-09,Johor,145,81,64,2022
2022-11-10,Johor,101,21,80,2022
2022-11-11,Johor,54,4,50,2022
2022-11-12,Johor,172,45,127,2022
2022-11-13,Johor,256,39,217,2022
2022-11-14,Johor,158,53,105,2022
2022-11-15,Johor,48,6,42,2022
2022-11-16,Johor,211,53,158,2022
2022-11-17,Johor,105,26,79,2022
2022-11-18,Johor,51,10,41,2022
2022-11-19,Johor,0,0,0,2022
2022-11-20,Johor,196,36,160,2022
2022-11-21,Johor,55,9,46,2022
2022-11-22,Johor,124,45,79,2022
2022-11-23,Johor,105,22,83,2022
2022-11-24,Johor,105,29,76,2022
2022-11-25,Johor,0,0,0,2022
2022-11-26,Johor,56,11,45,2022
2022-11-27,Johor,198,39,159,2022
2022-11-28,Johor,69,16,53,2022
2022-11-29,Johor,97,36,61,2022
2022-11-30,Johor,128,30,98,2022
2022-12-01,Johor,65,15,50,2022
2022-12-02,Johor,23,5,18,2022
2022-12-03,Johor,203,47,156,2022
2022-12-04,Johor,331,54,277,2022
2022-12-05,Johor,92,31,61,2022
2022-12-06,Johor,108,32,76,2022
2022-12-07,Johor,131,44,87,2022
2022-12-08,Johor,99,44,55,2022
2022-12-09,Johor,21,1,20,2022
2022-12-10,Johor,158,37,121,2022
2022-12-11,Johor,202,43,159,2022
2022-12-12,Johor,92,22,70,2022
2022-12-13,Johor,75,12,63,2022
2022-12-14,Johor,68,13,55,2022
2022-12-15,Johor,83,15,68,2022
2022-12-16,Johor,81,31,50,2022
2022-12-17,Johor,108,26,82,2022
2022-12-18,Johor,255,55,200,2022
2022-12-19,Johor,79,13,66,2022
2022-12-20,Johor,115,30,85,2022
2022-12-21,Johor,167,27,140,2022
2022-12-22,Johor,119,37,82,2022
2022-12-23,Johor,0,0,0,2022
2022-12-24,Johor,135,17,118,2022
2022-12-25,Johor,76,23,53,2022
2022-12-26,Johor,156,22,134,2022
2022-12-27,Johor,108,18,90,2022
2022-12-28,Johor,116,53,63,2022
2022-12-29,Johor,84,13,71,2022
2022-12-30,Johor,36,10,26,2022
2022-12-31,Johor,141,44,97,2022
2023-01-01,Johor,346,67,279,2023
2023-01-02,Johor,174,39,135,2023
2023-01-03,Johor,88,21,67,2023
2023-01-04,Johor,122,62,60,2023
2023-01-05,Johor,60,8,52,2023
2023-01-06,Johor,23,3,20,2023
2023-01-07,Johor,118,33,85,2023
2023-01-08,Johor,246,43,203,2023
2023-01-09,Johor,114,24,90,2023
2023-01-10,Johor,78,15,63,2023
2023-01-11,Johor,109,42,67,2023
2023-01-12,Johor,59,13,46,2023
2023-01-13,Johor,27,3,24,2023
2023-01-14,Johor,127,36,91,2023
2023-01-15,Johor,276,41,235,2023
2023-01-16,Johor,121,22,99,2023
2023-01-17,Johor,140,34,106,2023
2023-01-18,Johor,103,16,87,2023
2023-01-19,Johor,129,41,88,2023
2023-01-20,Johor,87,22,65,2023
2023-01-21,Johor,90,12,78,2023
2023-01-22,Johor,87,20,67,2023
2023-01-23,Johor,95,17,78,2023
2023-01-24,Johor,115,23,92,2023
2023-01-25,Johor,96,19,77,2023
2023-01-26,Johor,99,16,83,2023
2023-01-27,Johor,0,0,0,2023
2023-01-28,Johor,100,22,78,2023
2023-01-29,Johor,196,41,155,2023
2023-01-30,Johor,76,16,60,2023
2023-01-31,Johor,165,80,85,2023
2023-02-01,Johor,100,28,72,2023
2023-02-02,Johor,63,10,53,2023
2023-02-03,Johor,37,8,29,2023
2023-02-04,Johor,159,40,119,2023
2023-02-05,Johor,299,43,256,2023
2023-02-06,Johor,117,21,96,2023
2023-02-07,Johor,99,48,51,2023
2023-02-08,Johor,64,11,53,2023
2023-02-09,Johor,83,20,63,2023
2023-02-10,Johor,19,5,14,2023
2023-02-11,Johor,137,32,105,2023
2023-02-12,Johor,310,74,236,2023
2023-02-13,Johor,108,25,83,2023
2023-02-14,Johor,119,29,90,2023
2023-02-15,Johor,100,40,60,2023
2023-02-16,Johor,50,7,43,2023
2023-02-17,Johor,30,3,27,2023
2023-02-18,Johor,228,34,194,2023
2023-02-19,Johor,286,112,174,2023
2023-02-20,Johor,124,34,90,2023
2023-02-21,Johor,130,34,96,2023
2023-02-22,Johor,137,33,104,2023
2023-02-23,Johor,131,62,69,2023
2023-02-24,Johor,0,0,0,2023
2023-02-25,Johor,119,26,93,2023
2023-02-26,Johor,350,60,290,2023
2023-02-27,Johor,135,73,62,2023
2023-02-28,Johor,102,16,86,2023
2023-03-01,Johor,108,48,60,2023
2023-03-02,Johor,34,3,31,2023
2023-03-03,Johor,26,5,21,2023
2023-03-04,Johor,152,51,101,2023
2023-03-05,Johor,383,58,325,2023
2023-03-06,Johor,111,41,70,2023
2023-03-07,Johor,97,24,73,2023
2023-03-08,Johor,90,16,74,2023
2023-03-09,Johor,131,64,67,2023
2023-03-10,Johor,28,6,22,2023
2023-03-11,Johor,223,54,169,2023
2023-03-12,Johor,261,69,192,2023
2023-03-13,Johor,132,76,56,2023
2023-03-14,Johor,147,51,96,2023
2023-03-15,Johor,128,34,94,2023
2023-03-16,Johor,109,52,57,2023
2023-03-17,Johor,71,17,54,2023
2023-03-18,Johor,186,38,148,2023
2023-03-19,Johor,327,49,278,2023
2023-03-20,Johor,138,48,90,2023
2023-03-21,Johor,104,8,96,2023
2023-03-22,Johor,134,26,108,2023
2023-03-23,Johor,83,23,60,2023
2023-03-24,Johor,0,0,0,2023
2023-03-25,Johor,26,10,16,2023
2023-03-26,Johor,117,27,90,2023
2023-03-27,Johor,34,5,29,2023
2023-03-28,Johor,44,2,42,2023
2023-03-29,Johor,49,8,41,2023
2023-03-30,Johor,105,37,68,2023
2023-03-31,Johor,13,1,12,2023
2023-04-01,Johor,179,36,143,2023
2023-04-02,Johor,169,29,140,2023
2023-04-03,Johor,63,14,49,2023
2023-04-04,Johor,66,7,59,2023
2023-04-05,Johor,50,8,42,2023
2023-04-06,Johor,78,8,70,2023
2023-04-07,Johor,48,13,35,2023
2023-04-08,Johor,122,42,80,2023
2023-04-09,Johor,249,40,209,2023
2023-04-10,Johor,64,17,47,2023
2023-04-11,Johor,74,12,62,2023
2023-04-12,Johor,69,10,59,2023
2023-04-13,Johor,61,8,53,2023
2023-04-14,Johor,43,21,22,2023
2023-04-15,Johor,94,22,72,2023
2023-04-16,Johor,260,37,223,2023
2023-04-17,Johor,112,33,79,2023
2023-04-18,Johor,64,15,49,2023
2023-04-19,Johor,82,15,67,2023
2023-04-20,Johor,87,22,65,2023
2023-04-21,Johor,21,4,17,2023
2023-04-22,Johor,0,0,0,2023
2023-04-23,Johor,0,0,0,2023
2023-04-24,Johor,54,10,44,2023
2023-04-25,Johor,106,26,80,2023
2023-04-26,Johor,122,29,93,2023
2023-04-27,Johor,115,15,100,2023
2023-04-28,Johor,0,0,0,2023
2023-04-29,Johor,122,37,85,2023
2023-04-30,Johor,297,50,247,2023
2023-05-01,Johor,179,29,150,2023
2023-05-02,Johor,73,18,55,2023
2023-05-03,Johor,69,18,51,2023
2023-05-04,Johor,165,45,120,2023
2023-05-05,Johor,40,8,32,2023
2023-05-06,Johor,188,46,142,2023
2023-05-07,Johor,388,63,325,2023
2023-05-08,Johor,106,17,89,2023
2023-05-09,Johor,124,43,81,2023
2023-05-10,Johor,107,35,72,2023
2023-05-11,Johor,152,40,112,2023
2023-05-12,Johor,39,11,28,2023
2023-05-13,Johor,174,54,120,2023
2023-05-14,Johor,331,58,273,2023
2023-05-15,Johor,64,11,53,2023
2023-05-16,Johor,134,39,95,2023
2023-05-17,Johor,179,55,124,2023
2023-05-18,Johor,54,10,44,2023
2023-05-19,Johor,34,9,25,2023
2023-05-20,Johor,244,38,206,2023
2023-05-21,Johor,343,51,292,2023
2023-05-22,Johor,130,23,107,2023
2023-05-23,Johor,115,29,86,2023
2023-05-24,Johor,111,28,83,2023
2023-05-25,Johor,94,35,59,2023
2023-05-26,Johor,48,10,38,2023
2023-05-27,Johor,145,37,108,2023
2023-05-28,Johor,268,41,227,2023
2023-05-29,Johor,83,25,58,2023
2023-05-30,Johor,133,47,86,2023
2023-05-31,Johor,85,33,52,2023
2023-06-01,Johor,74,10,64,2023
2023-06-02,Johor,38,5,33,2023
2023-06-03,Johor,105,27,78,2023
2023-06-04,Johor,340,60,280,2023
2023-06-05,Johor,258,46,212,2023
2023-06-06,Johor,115,25,90,2023
2023-06-07,Johor,92,37,55,2023
2023-06-08,Johor,103,32,71,2023
2023-06-09,Johor,20,5,15,2023
2023-06-10,Johor,174,46,128,2023
2023-06-11,Johor,358,66,292,2023
2023-06-12,Johor,107,34,73,2023
2023-06-13,Johor,91,32,59,2023
2023-06-14,Johor,216,33,183,2023
2023-06-15,Johor,117,31,86,2023
2023-06-16,Johor,34,9,25,2023
2023-06-17,Johor,200,43,157,2023
2023-06-18,Johor,331,67,264,2023
2023-06-19,Johor,96,18,78,2023
2023-06-20,Johor,94,13,81,2023
2023-06-21,Johor,97,25,72,2023
2023-06-22,Johor,100,23,77,2023
2023-06-23,Johor,0,0,0,2023
2023-06-24,Johor,155,34,121,2023
2023-06-25,Johor,191,35,156,2023
2023-06-26,Johor,132,33,99,2023
2023-06-27,Johor,50,3,47,2023
2023-06-28,Johor,36,1,35,2023
2023-06-29,Johor,0,0,0,2023
2023-06-30,Johor,33,7,26,2023
2023-07-01,Johor,176,45,131,2023
2023-07-02,Johor,322,51,271,2023
2023-07-03,Johor,77,18,59,2023
2023-07-04,Johor,97,31,66,2023
2023-07-05,Johor,126,29,97,2023
2023-07-06,Johor,95,18,77,2023
2023-07-07,Johor,56,17,39,2023
2023-07-08,Johor,151,39,112,2023
2023-07-09,Johor,274,47,227,2023
2023-07-10,Johor,120,26,94,2023
2023-07-11,Johor,129,36,93,2023
2023-07-12,Johor,53,6,47,2023
2023-07-13,Johor,92,23,69,2023
2023-07-14,Johor,47,14,33,2023
2023-07-15,Johor,90,17,73,2023
2023-07-16,Johor,253,45,208,2023
2023-07-17,Johor,98,29,69,2023
2023-07-18,Johor,99,24,75,2023
2023-07-19,Johor,107,14,93,2023
2023-07-20,Johor,86,20,66,2023
2023-07-21,Johor,20,4,16,2023
2023-07-22,Johor,144,42,102,2023
2023-07-23,Johor,217,48,169,2023
2023-07-24,Johor,139,25,114,2023
2023-07-25,Johor,81,21,60,2023
2023-07-26,Johor,85,12,73,2023
2023-07-27,Johor,102,17,85,2023
2023-07-28,Johor,0,0,0,2023
2023-07-29,Johor,129,28,101,2023
2023-07-30,Johor,184,28,156,2023
2023-07-31,Johor,94,27,67,2023
2023-08-01,Johor,56,7,49,2023
2023-08-02,Johor,91,17,74,2023
2023-08-03,Johor,23,1,22,2023
2023-08-04,Johor,32,8,24,2023
2023-08-05,Johor,182,38,144,2023
2023-08-06,Johor,281,39,242,2023
2023-08-07,Johor,97,23,74,2023
2023-08-08,Johor,76,23,53,2023
2023-08-09,Johor,125,21,104,2023
2023-08-10,Johor,59,8,51,2023
2023-08-11,Johor,64,9,55,2023
2023-08-12,Johor,192,47,145,2023
2023-08-13,Johor,308,36,272,2023
2023-08-14,Johor,88,23,65,2023
2023-08-15,Johor,114,28,86,2023
2023-08-16,Johor,99,19,80,2023
2023-08-17,Johor,108,20,88,2023
2023-08-18,Johor,24,4,20,2023
2023-08-19,Johor,193,29,164,2023
2023-08-20,Johor,275,37,238,2023
2023-08-21,Johor,68,11,57,2023
2023-08-22,Johor,159,25,134,2023
2023-08-23,Johor,155,50,105,2023
2023-08-24,Johor,60,7,53,2023
2023-08-25,Johor,0,0,0,2023
2023-08-26,Johor,117,40,77,2023
2023-08-27,Johor,243,35,208,2023
2023-08-28,Johor,90,33,57,2023
2023-08-29,Johor,76,31,45,2023
2023-08-30,Johor,85,27,58,2023
2023-08-31,Johor,105,16,89,2023
2023-09-01,Johor,29,6,23,2023
2023-09-02,Johor,105,27,78,2023
2023-09-03,Johor,272,50,222,2023
2023-09-04,Johor,55,11,44,2023
2023-09-05,Johor,86,26,60,2023
2023-09-06,Johor,72,19,53,2023
2023-09-07,Johor,114,24,90,2023
2023-09-08,Johor,62,16,46,2023
2023-09-09,Johor,162,40,122,2023
2023-09-10,Johor,269,41,228,2023
2023-09-11,Johor,67,12,55,2023
2023-09-12,Johor,85,13,72,2023
2023-09-13,Johor,138,33,105,2023
2023-09-14,Johor,89,9,80,2023
2023-09-15,Johor,41,14,27,2023
2023-09-16,Johor,211,32,179,2023
2023-09-17,Johor,285,58,227,2023
2023-09-18,Johor,146,16,130,2023
2023-09-19,Johor,103,15,88,2023
2023-09-20,Johor,114,41,73,2023
2023-09-21,Johor,104,26,78,2023
2023-09-22,Johor,0,0,0,2023
2023-09-23,Johor,93,12,81,2023
2023-09-24,Johor,240,42,198,2023
2023-09-25,Johor,77,13,64,2023
2023-09-26,Johor,60,9,51,2023
2023-09-27,Johor,75,17,58,2023
2023-09-28,Johor,72,27,45,2023
2023-09-29,Johor,34,8,26,2023
2023-09-30,Johor,144,44,100,2023
2023-10-01,Johor,269,39,230,2023
2023-10-02,Johor,61,9,52,2023
2023-10-03,Johor,57,7,50,2023
2023-10-04,Johor,112,23,89,2023
2023-10-05,Johor,122,27,95,2023
2023-10-06,Johor,26,5,21,2023
2023-10-07,Johor,136,35,101,2023
2023-10-08,Johor,223,45,178,2023
2023-10-09,Johor,62,14,48,2023
2023-10-10,Johor,99,24,75,2023
2023-10-11,Johor,85,23,62,2023
2023-10-12,Johor,202,104,98,2023
2023-10-13,Johor,25,5,20,2023
2023-10-14,Johor,127,28,99,2023
2023-10-15,Johor,290,45,245,2023
2023-10-16,Johor,116,48,68,2023
2023-10-17,Johor,81,16,65,2023
2023-10-18,Johor,122,17,105,2023
2023-10-19,Johor,66,16,50,2023
2023-10-20,Johor,28,4,24,2023
2023-10-21,Johor,135,35,100,2023
2023-10-22,Johor,235,37,198,2023
2023-10-23,Johor,98,31,67,2023
2023-10-24,Johor,94,26,68,2023
2023-10-25,Johor,80,26,54,2023
2023-10-26,Johor,110,21,89,2023
2023-10-27,Johor,0,0,0,2023
2023-10-28,Johor,103,22,81,2023
2023-10-29,Johor,268,39,229,2023
2023-10-30,Johor,68,17,51,2023
2023-10-31,Johor,121,53,68,2023
2023-11-01,Johor,85,40,45,2023
2023-11-02,Johor,49,6,43,2023
2023-11-03,Johor,32,5,27,2023
2023-11-04,Johor,151,25,126,2023
2023-11-05,Johor,278,41,237,2023
2023-11-06,Johor,57,9,48,2023
2023-11-07,Johor,105,31,74,2023
2023-11-08,Johor,134,34,100,2023
2023-11-09,Johor,105,12,93,2023
2023-11-10,Johor,31,13,18,2023
2023-11-11,Johor,166,47,119,2023
2023-11-12,Johor,194,39,155,2023
2023-11-13,Johor,127,13,114,2023
2023-11-14,Johor,86,12,74,2023
2023-11-15,Johor,158,62,96,2023
2023-11-16,Johor,92,43,49,2023
2023-11-17,Johor,25,1,24,2023
2023-11-18,Johor,149,19,130,2023
2023-11-19,Johor,309,47,262,2023
2023-11-20,Johor,95,30,65,2023
2023-11-21,Johor,134,51,83,2023
2023-11-22,Johor,124,35,89,2023
2023-11-23,Johor,72,18,54,2023
2023-11-24,Johor,0,0,0,2023
2023-11-25,Johor,101,20,81,2023
2023-11-26,Johor,192,43,149,2023
2023-11-27,Johor,75,18,57,2023
2023-11-28,Johor,98,53,45,2023
2023-11-29,Johor,133,42,91,2023
2023-11-30,Johor,96,23,73,2023
2023-12-01,Johor,106,40,66,2023
2023-12-02,Johor,139,31,108,2023
2023-12-03,Johor,251,36,215,2023
2023-12-04,Johor,120,32,88,2023
2023-12-05,Johor,85,12,73,2023
2023-12-06,Johor,147,63,84,2023
2023-12-07,Johor,112,19,93,2023
2023-12-08,Johor,45,9,36,2023
2023-12-09,Johor,153,49,104,2023
2023-12-10,Johor,258,40,218,2023
2023-12-11,Johor,89,20,69,2023
2023-12-12,Johor,111,25,86,2023
2023-12-13,Johor,161,54,107,2023
2023-12-14,Johor,96,31,65,2023
2023-12-15,Johor,24,7,17,2023
2023-12-16,Johor,131,38,93,2023
2023-12-17,Johor,159,29,130,2023
2023-12-18,Johor,120,28,92,2023
2023-12-19,Johor,102,21,81,2023
2023-12-20,Johor,185,75,110,2023
2023-12-21,Johor,118,16,102,2023
2023-12-22,Johor,0,0,0,2023
2023-12-23,Johor,129,40,89,2023
2023-12-24,Johor,167,22,145,2023
2023-12-25,Johor,136,25,111,2023
2023-12-26,Johor,74,7,67,2023
2023-12-27,Johor,120,30,90,2023
2023-12-28,Johor,80,15,65,2023
2023-12-29,Johor,34,5,29,2023
2023-12-30,Johor,213,42,171,2023
2023-12-31,Johor,255,41,214,2023
2024-01-01,Johor,159,23,136,2024
2024-01-02,Johor,116,40,76,2024
2024-01-03,Johor,91,30,61,2024
2024-01-04,Johor,121,68,53,2024
2024-01-05,Johor,60,10,50,2024
2024-01-06,Johor,149,31,118,2024
2024-01-07,Johor,281,58,223,2024
2024-01-08,Johor,95,25,70,2024
2024-01-09,Johor,71,5,66,2024
2024-01-10,Johor,151,33,118,2024
2024-01-11,Johor,128,34,94,2024
2024-01-12,Johor,79,29,50,2024
2024-01-13,Johor,189,36,153,2024
2024-01-14,Johor,357,44,313,2024
2024-01-15,Johor,100,22,78,2024
2024-01-16,Johor,87,15,72,2024
2024-01-17,Johor,150,66,84,2024
2024-01-18,Johor,112,40,72,2024
2024-01-19,Johor,24,4,20,2024
2024-01-20,Johor,138,24,114,2024
2024-01-21,Johor,362,53,309,2024
2024-01-22,Johor,100,25,75,2024
2024-01-23,Johor,143,38,105,2024
2024-01-24,Johor,82,10,72,2024
2024-01-25,Johor,158,52,106,2024
2024-01-26,Johor,0,0,0,2024
2024-01-27,Johor,122,28,94,2024
2024-01-28,Johor,250,52,198,2024
2024-01-29,Johor,80,10,70,2024
2024-01-30,Johor,52,6,46,2024
2024-01-31,Johor,113,70,43,2024
2024-02-01,Johor,119,25,94,2024
2024-02-02,Johor,28,5,23,2024
2006-01-01,Kedah,208,1,207,2006
2006-01-02,Kedah,102,0,102,2006
2006-01-03,Kedah,42,0,42,2006
2006-01-04,Kedah,30,0,30,2006
2006-01-05,Kedah,181,0,181,2006
2006-01-06,Kedah,107,1,106,2006
2006-01-07,Kedah,0,0,0,2006
2006-01-08,Kedah,158,4,154,2006
2006-01-09,Kedah,16,0,16,2006
2006-01-10,Kedah,0,0,0,2006
2006-01-11,Kedah,0,0,0,2006
2006-01-12,Kedah,22,0,22,2006
2006-01-13,Kedah,188,3,185,2006
2006-01-14,Kedah,0,0,0,2006
2006-01-15,Kedah,31,0,31,2006
2006-01-16,Kedah,92,0,92,2006
2006-01-17,Kedah,49,12,37,2006
2006-01-18,Kedah,108,9,99,2006
2006-01-19,Kedah,50,0,50,2006
2006-01-20,Kedah,122,0,122,2006
2006-01-21,Kedah,38,0,38,2006
2006-01-22,Kedah,0,0,0,2006
2006-01-23,Kedah,90,0,90,2006
2006-01-24,Kedah,211,2,209,2006
2006-01-25,Kedah,110,0,110,2006
2006-01-26,Kedah,336,0,336,2006
2006-01-27,Kedah,0,0,0,2006
2006-01-28,Kedah,95,1,94,2006
2006-01-29,Kedah,0,0,0,2006
2006-01-30,Kedah,0,0,0,2006
2006-01-31,Kedah,0,0,0,2006
2006-02-01,Kedah,80,0,80,2006
2006-02-02,Kedah,148,2,146,2006
2006-02-03,Kedah,18,0,18,2006
2006-02-04,Kedah,32,0,32,2006
2006-02-05,Kedah,209,11,198,2006
2006-02-06,Kedah,105,0,105,2006
2006-02-07,Kedah,70,0,70,2006
2006-02-08,Kedah,38,0,38,2006
2006-02-09,Kedah,40,0,40,2006
2006-02-10,Kedah,228,0,228,2006
2006-02-11,Kedah,0,0,0,2006
2006-02-12,Kedah,60,0,60,2006
2006-02-13,Kedah,86,0,86,2006
2006-02-14,Kedah,178,0,178,2006
2006-02-15,Kedah,24,0,24,2006
2006-02-16,Kedah,130,4,126,2006
2006-02-17,Kedah,38,0,38,2006
2006-02-18,Kedah,172,2,170,2006
2006-02-19,Kedah,167,0,167,2006
2006-02-20,Kedah,24,0,24,2006
2006-02-21,Kedah,416,27,389,2006
2006-02-22,Kedah,82,0,82,2006
2006-02-23,Kedah,201,5,196,2006
2006-02-24,Kedah,0,0,0,2006
2006-02-25,Kedah,151,1,150,2006
2006-02-26,Kedah,49,0,49,2006
2006-02-27,Kedah,184,0,184,2006
2006-02-28,Kedah,20,0,20,2006
2006-03-01,Kedah,73,3,70,2006
2006-03-02,Kedah,65,1,64,2006
2006-03-03,Kedah,96,4,92,2006
2006-03-04,Kedah,0,0,0,2006
2006-03-05,Kedah,86,0,86,2006
2006-03-06,Kedah,72,0,72,2006
2006-03-07,Kedah,92,0,92,2006
2006-03-08,Kedah,120,0,120,2006
2006-03-09,Kedah,38,0,38,2006
2006-03-10,Kedah,96,0,96,2006
2006-03-11,Kedah,0,0,0,2006
2006-03-12,Kedah,26,0,26,2006
2006-03-13,Kedah,24,0,24,2006
2006-03-14,Kedah,68,2,66,2006
2006-03-15,Kedah,14,0,14,2006
2006-03-16,Kedah,236,0,236,2006
2006-03-17,Kedah,104,0,104,2006
2006-03-18,Kedah,0,0,0,2006
2006-03-19,Kedah,78,0,78,2006
2006-03-20,Kedah,106,0,106,2006
2006-03-21,Kedah,8,0,8,2006
2006-03-22,Kedah,26,0,26,2006
2006-03-23,Kedah,92,0,92,2006
2006-03-24,Kedah,0,0,0,2006
2006-03-25,Kedah,46,2,44,2006
2006-03-26,Kedah,90,2,88,2006
2006-03-27,Kedah,20,0,20,2006
2006-03-28,Kedah,26,0,26,2006
2006-03-29,Kedah,24,0,24,2006
2006-03-30,Kedah,16,0,16,2006
2006-03-31,Kedah,82,1,81,2006
2006-04-01,Kedah,64,0,64,2006
2006-04-02,Kedah,38,0,38,2006
2006-04-03,Kedah,125,1,124,2006
2006-04-04,Kedah,78,2,76,2006
2006-04-05,Kedah,176,3,173,2006
2006-04-06,Kedah,22,0,22,2006
2006-04-07,Kedah,24,0,24,2006
2006-04-08,Kedah,96,0,96,2006
2006-04-09,Kedah,46,0,46,2006
2006-04-10,Kedah,100,0,100,2006
2006-04-11,Kedah,0,0,0,2006
2006-04-12,Kedah,22,0,22,2006
2006-04-13,Kedah,33,1,32,2006
2006-04-14,Kedah,203,14,189,2006
2006-04-15,Kedah,0,0,0,2006
2006-04-16,Kedah,21,3,18,2006
2006-04-17,Kedah,102,6,96,2006
2006-04-18,Kedah,154,2,152,2006
2006-04-19,Kedah,65,1,64,2006
2006-04-20,Kedah,29,0,29,2006
2006-04-21,Kedah,243,12,231,2006
2006-04-22,Kedah,66,0,66,2006
2006-04-23,Kedah,80,12,68,2006
2006-04-24,Kedah,66,2,64,2006
2006-04-25,Kedah,23,0,23,2006
2006-04-26,Kedah,354,14,340,2006
2006-04-27,Kedah,20,0,20,2006
2006-04-28,Kedah,110,2,108,2006
2006-04-29,Kedah,0,0,0,2006
2006-04-30,Kedah,68,0,68,2006
2006-05-01,Kedah,182,10,172,2006
2006-05-02,Kedah,63,1,62,2006
2006-05-03,Kedah,55,1,54,2006
2006-05-04,Kedah,25,0,25,2006
2006-05-05,Kedah,192,2,190,2006
2006-05-06,Kedah,166,6,160,2006
2006-05-07,Kedah,74,0,74,2006
2006-05-08,Kedah,92,0,92,2006
2006-05-09,Kedah,21,0,21,2006
2006-05-10,Kedah,12,0,12,2006
2006-05-11,Kedah,320,2,318,2006
2006-05-12,Kedah,159,1,158,2006
2006-05-13,Kedah,46,0,46,2006
2006-05-14,Kedah,370,6,364,2006
2006-05-15,Kedah,144,0,144,2006
2006-05-16,Kedah,38,0,38,2006
2006-05-17,Kedah,36,0,36,2006
2006-05-18,Kedah,16,0,16,2006
2006-05-19,Kedah,210,2,208,2006
2006-05-20,Kedah,60,0,60,2006
2006-05-21,Kedah,42,0,42,2006
2006-05-22,Kedah,8,0,8,2006
2006-05-23,Kedah,68,5,63,2006
2006-05-24,Kedah,28,0,28,2006
2006-05-25,Kedah,157,7,150,2006
2006-05-26,Kedah,243,1,242,2006
2006-05-27,Kedah,0,0,0,2006
2006-05-28,Kedah,43,0,43,2006
2006-05-29,Kedah,30,0,30,2006
2006-05-30,Kedah,14,0,14,2006
2006-05-31,Kedah,86,1,85,2006
2006-06-01,Kedah,32,0,32,2006
2006-06-02,Kedah,342,2,340,2006
2006-06-03,Kedah,77,0,77,2006
2006-06-04,Kedah,171,0,171,2006
2006-06-05,Kedah,22,0,22,2006
2006-06-06,Kedah,18,0,18,2006
2006-06-07,Kedah,6,0,6,2006
2006-06-08,Kedah,40,2,38,2006
2006-06-09,Kedah,0,0,0,2006
2006-06-10,Kedah,24,8,16,2006
2006-06-11,Kedah,78,0,78,2006
2006-06-12,Kedah,110,4,106,2006
2006-06-13,Kedah,96,0,96,2006
2006-06-14,Kedah,27,0,27,2006
2006-06-15,Kedah,182,2,180,2006
2006-06-16,Kedah,94,0,94,2006
2006-06-17,Kedah,106,0,106,2006
2006-06-18,Kedah,104,0,104,2006
2006-06-19,Kedah,12,0,12,2006
2006-06-20,Kedah,18,0,18,2006
2006-06-21,Kedah,166,0,166,2006
2006-06-22,Kedah,8,0,8,2006
2006-06-23,Kedah,156,6,150,2006
2006-06-24,Kedah,60,0,60,2006
2006-06-25,Kedah,82,0,82,2006
2006-06-26,Kedah,86,0,86,2006
2006-06-27,Kedah,83,1,82,2006
2006-06-28,Kedah,66,0,66,2006
2006-06-29,Kedah,6,0,6,2006
2006-06-30,Kedah,201,3,198,2006
2006-07-01,Kedah,132,0,132,2006
2006-07-02,Kedah,44,0,44,2006
2006-07-03,Kedah,26,0,26,2006
2006-07-04,Kedah,146,0,146,2006
2006-07-05,Kedah,100,4,96,2006
2006-07-06,Kedah,46,0,46,2006
2006-07-07,Kedah,0,0,0,2006
2006-07-08,Kedah,194,0,194,2006
2006-07-09,Kedah,97,0,97,2006
2006-07-10,Kedah,70,0,70,2006
2006-07-11,Kedah,74,0,74,2006
2006-07-12,Kedah,86,9,77,2006
2006-07-13,Kedah,55,0,55,2006
2006-07-14,Kedah,18,0,18,2006
2006-07-15,Kedah,0,0,0,2006
2006-07-16,Kedah,52,0,52,2006
2006-07-17,Kedah,32,0,32,2006
2006-07-18,Kedah,98,0,98,2006
2006-07-19,Kedah,73,0,73,2006
2006-07-20,Kedah,124,0,124,2006
2006-07-21,Kedah,0,0,0,2006
2006-07-22,Kedah,340,10,330,2006
2006-07-23,Kedah,50,0,50,2006
2006-07-24,Kedah,144,0,144,2006
2006-07-25,Kedah,108,2,106,2006
2006-07-26,Kedah,62,0,62,2006
2006-07-27,Kedah,70,6,64,2006
2006-07-28,Kedah,124,0,124,2006
2006-07-29,Kedah,10,0,10,2006
2006-07-30,Kedah,150,4,146,2006
2006-07-31,Kedah,20,0,20,2006
2006-08-01,Kedah,270,10,260,2006
2006-08-02,Kedah,112,0,112,2006
2006-08-03,Kedah,34,0,34,2006
2006-08-04,Kedah,0,0,0,2006
2006-08-05,Kedah,48,0,48,2006
2006-08-06,Kedah,44,0,44,2006
2006-08-07,Kedah,70,0,70,2006
2006-08-08,Kedah,73,8,65,2006
2006-08-09,Kedah,69,2,67,2006
2006-08-10,Kedah,75,5,70,2006
2006-08-11,Kedah,82,0,82,2006
2006-08-12,Kedah,94,0,94,2006
2006-08-13,Kedah,74,2,72,2006
2006-08-14,Kedah,78,4,74,2006
2006-08-15,Kedah,144,2,142,2006
2006-08-16,Kedah,84,4,80,2006
2006-08-17,Kedah,198,2,196,2006
2006-08-18,Kedah,2,0,2,2006
2006-08-19,Kedah,0,0,0,2006
2006-08-20,Kedah,171,9,162,2006
2006-08-21,Kedah,0,0,0,2006
2006-08-22,Kedah,18,0,18,2006
2006-08-23,Kedah,163,0,163,2006
2006-08-24,Kedah,32,0,32,2006
2006-08-25,Kedah,470,14,456,2006
2006-08-26,Kedah,28,0,28,2006
2006-08-27,Kedah,32,0,32,2006
2006-08-28,Kedah,30,0,30,2006
2006-08-29,Kedah,60,0,60,2006
2006-08-30,Kedah,60,2,58,2006
2006-08-31,Kedah,310,5,305,2006
2006-09-01,Kedah,0,0,0,2006
2006-09-02,Kedah,370,10,360,2006
2006-09-03,Kedah,30,0,30,2006
2006-09-04,Kedah,18,0,18,2006
2006-09-05,Kedah,212,2,210,2006
2006-09-06,Kedah,192,0,192,2006
2006-09-07,Kedah,88,0,88,2006
2006-09-08,Kedah,40,0,40,2006
2006-09-09,Kedah,22,0,22,2006
2006-09-10,Kedah,141,0,141,2006
2006-09-11,Kedah,80,0,80,2006
2006-09-12,Kedah,82,2,80,2006
2006-09-13,Kedah,22,0,22,2006
2006-09-14,Kedah,366,11,355,2006
2006-09-15,Kedah,72,0,72,2006
2006-09-16,Kedah,0,0,0,2006
2006-09-17,Kedah,122,0,122,2006
2006-09-18,Kedah,110,0,110,2006
2006-09-19,Kedah,172,0,172,2006
2006-09-20,Kedah,160,0,160,2006
2006-09-21,Kedah,106,0,106,2006
2006-09-22,Kedah,114,0,114,2006
2006-09-23,Kedah,0,0,0,2006
2006-09-24,Kedah,0,0,0,2006
2006-09-25,Kedah,6,0,6,2006
2006-09-26,Kedah,6,0,6,2006
2006-09-27,Kedah,12,0,12,2006
2006-09-28,Kedah,14,0,14,2006
2006-09-29,Kedah,441,4,437,2006
2006-09-30,Kedah,0,0,0,2006
2006-10-01,Kedah,214,0,214,2006
2006-10-02,Kedah,12,0,12,2006
2006-10-03,Kedah,12,0,12,2006
2006-10-04,Kedah,2,0,2,2006
2006-10-05,Kedah,38,0,38,2006
2006-10-06,Kedah,80,0,80,2006
2006-10-07,Kedah,0,0,0,2006
2006-10-08,Kedah,10,0,10,2006
2006-10-09,Kedah,70,2,68,2006
2006-10-10,Kedah,8,0,8,2006
2006-10-11,Kedah,202,0,202,2006
2006-10-12,Kedah,86,0,86,2006
2006-10-13,Kedah,401,0,401,2006
2006-10-14,Kedah,0,0,0,2006
2006-10-15,Kedah,22,0,22,2006
2006-10-16,Kedah,214,2,212,2006
2006-10-17,Kedah,144,0,144,2006
2006-10-18,Kedah,14,0,14,2006
2006-10-19,Kedah,6,0,6,2006
2006-10-20,Kedah,110,0,110,2006
2006-10-21,Kedah,10,0,10,2006
2006-10-22,Kedah,8,0,8,2006
2006-10-23,Kedah,6,0,6,2006
2006-10-24,Kedah,15,0,15,2006
2006-10-25,Kedah,40,0,40,2006
2006-10-26,Kedah,76,0,76,2006
2006-10-27,Kedah,20,0,20,2006
2006-10-28,Kedah,49,0,49,2006
2006-10-29,Kedah,144,0,144,2006
2006-10-30,Kedah,52,0,52,2006
2006-10-31,Kedah,104,0,104,2006
2006-11-01,Kedah,118,2,116,2006
2006-11-02,Kedah,30,2,28,2006
2006-11-03,Kedah,123,1,122,2006
2006-11-04,Kedah,12,0,12,2006
2006-11-05,Kedah,119,0,119,2006
2006-11-06,Kedah,37,0,37,2006
2006-11-07,Kedah,188,0,188,2006
2006-11-08,Kedah,24,0,24,2006
2006-11-09,Kedah,42,0,42,2006
2006-11-10,Kedah,226,0,226,2006
2006-11-11,Kedah,0,0,0,2006
2006-11-12,Kedah,38,0,38,2006
2006-11-13,Kedah,30,0,30,2006
2006-11-14,Kedah,70,0,70,2006
2006-11-15,Kedah,26,0,26,2006
2006-11-16,Kedah,14,0,14,2006
2006-11-17,Kedah,86,17,69,2006
2006-11-18,Kedah,0,0,0,2006
2006-11-19,Kedah,24,10,14,2006
2006-11-20,Kedah,16,6,10,2006
2006-11-21,Kedah,46,0,46,2006
2006-11-22,Kedah,255,0,255,2006
2006-11-23,Kedah,261,0,261,2006
2006-11-24,Kedah,142,0,142,2006
2006-11-25,Kedah,148,0,148,2006
2006-11-26,Kedah,35,0,35,2006
2006-11-27,Kedah,16,0,16,2006
2006-11-28,Kedah,195,0,195,2006
2006-11-29,Kedah,18,0,18,2006
2006-11-30,Kedah,159,3,156,2006
2006-12-01,Kedah,0,0,0,2006
2006-12-02,Kedah,0,0,0,2006
2006-12-03,Kedah,95,7,88,2006
2006-12-04,Kedah,32,0,32,2006
2006-12-05,Kedah,95,13,82,2006
2006-12-06,Kedah,37,0,37,2006
2006-12-07,Kedah,132,10,122,2006
2006-12-08,Kedah,58,14,44,2006
2006-12-09,Kedah,6,0,6,2006
2006-12-10,Kedah,36,0,36,2006
2006-12-11,Kedah,67,4,63,2006
2006-12-12,Kedah,56,2,54,2006
2006-12-13,Kedah,66,8,58,2006
2006-12-14,Kedah,56,0,56,2006
2006-12-15,Kedah,56,0,56,2006
2006-12-16,Kedah,0,0,0,2006
2006-12-17,Kedah,32,0,32,2006
2006-12-18,Kedah,25,0,25,2006
2006-12-19,Kedah,198,4,194,2006
2006-12-20,Kedah,90,6,84,2006
2006-12-21,Kedah,103,2,101,2006
2006-12-22,Kedah,46,0,46,2006
2006-12-23,Kedah,101,15,86,2006
2006-12-24,Kedah,66,4,62,2006
2006-12-25,Kedah,0,0,0,2006
2006-12-26,Kedah,52,3,49,2006
2006-12-27,Kedah,63,0,63,2006
2006-12-28,Kedah,76,0,76,2006
2006-12-29,Kedah,134,2,132,2006
2006-12-30,Kedah,82,0,82,2006
2006-12-31,Kedah,0,0,0,2006
2007-01-01,Kedah,0,0,0,2007
2007-01-02,Kedah,232,4,228,2007
2007-01-03,Kedah,36,0,36,2007
2007-01-04,Kedah,112,3,109,2007
2007-01-05,Kedah,28,4,24,2007
2007-01-06,Kedah,206,4,202,2007
2007-01-07,Kedah,72,0,72,2007
2007-01-08,Kedah,138,4,134,2007
2007-01-09,Kedah,42,4,38,2007
2007-01-10,Kedah,74,2,72,2007
2007-01-11,Kedah,72,0,72,2007
2007-01-12,Kedah,48,0,48,2007
2007-01-13,Kedah,55,0,55,2007
2007-01-14,Kedah,96,11,85,2007
2007-01-15,Kedah,72,0,72,2007
2007-01-16,Kedah,200,44,156,2007
2007-01-17,Kedah,88,0,88,2007
2007-01-18,Kedah,52,0,52,2007
2007-01-19,Kedah,264,4,260,2007
2007-01-20,Kedah,0,0,0,2007
2007-01-21,Kedah,0,0,0,2007
2007-01-22,Kedah,72,0,72,2007
2007-01-23,Kedah,217,119,98,2007
2007-01-24,Kedah,154,95,59,2007
2007-01-25,Kedah,69,35,34,2007
2007-01-26,Kedah,50,27,23,2007
2007-01-27,Kedah,0,0,0,2007
2007-01-28,Kedah,181,61,120,2007
2007-01-29,Kedah,73,35,38,2007
2007-01-30,Kedah,29,11,18,2007
2007-01-31,Kedah,118,0,118,2007
2007-02-01,Kedah,22,0,22,2007
2007-02-02,Kedah,28,0,28,2007
2007-02-03,Kedah,222,10,212,2007
2007-02-04,Kedah,76,14,62,2007
2007-02-05,Kedah,72,48,24,2007
2007-02-06,Kedah,18,12,6,2007
2007-02-07,Kedah,44,26,18,2007
2007-02-08,Kedah,250,202,48,2007
2007-02-09,Kedah,0,0,0,2007
2007-02-10,Kedah,0,0,0,2007
2007-02-11,Kedah,204,95,109,2007
2007-02-12,Kedah,218,129,89,2007
2007-02-13,Kedah,84,55,29,2007
2007-02-14,Kedah,69,35,34,2007
2007-02-15,Kedah,56,26,30,2007
2007-02-16,Kedah,409,330,79,2007
2007-02-17,Kedah,0,0,0,2007
2007-02-18,Kedah,42,37,5,2007
2007-02-19,Kedah,0,0,0,2007
2007-02-20,Kedah,44,15,29,2007
2007-02-21,Kedah,45,10,35,2007
2007-02-22,Kedah,97,57,40,2007
2007-02-23,Kedah,52,32,20,2007
2007-02-24,Kedah,178,166,12,2007
2007-02-25,Kedah,58,28,30,2007
2007-02-26,Kedah,34,6,28,2007
2007-02-27,Kedah,134,69,65,2007
2007-02-28,Kedah,136,103,33,2007
2007-03-01,Kedah,16,2,14,2007
2007-03-02,Kedah,98,65,33,2007
2007-03-03,Kedah,50,33,17,2007
2007-03-04,Kedah,96,49,47,2007
2007-03-05,Kedah,70,36,34,2007
2007-03-06,Kedah,26,2,24,2007
2007-03-07,Kedah,96,58,38,2007
2007-03-08,Kedah,26,6,20,2007
2007-03-09,Kedah,146,60,86,2007
2007-03-10,Kedah,92,46,46,2007
2007-03-11,Kedah,78,36,42,2007
2007-03-12,Kedah,26,4,22,2007
2007-03-13,Kedah,34,10,24,2007
2007-03-14,Kedah,100,83,17,2007
2007-03-15,Kedah,106,68,38,2007
2007-03-16,Kedah,112,67,45,2007
2007-03-17,Kedah,0,0,0,2007
2007-03-18,Kedah,43,10,33,2007
2007-03-19,Kedah,22,2,20,2007
2007-03-20,Kedah,14,6,8,2007
2007-03-21,Kedah,134,118,16,2007
2007-03-22,Kedah,158,88,70,2007
2007-03-23,Kedah,136,52,84,2007
2007-03-24,Kedah,4,0,4,2007
2007-03-25,Kedah,32,4,28,2007
2007-03-26,Kedah,26,6,20,2007
2007-03-27,Kedah,198,102,96,2007
2007-03-28,Kedah,28,6,22,2007
2007-03-29,Kedah,20,4,16,2007
2007-03-30,Kedah,144,60,84,2007
2007-03-31,Kedah,54,32,22,2007
2007-04-01,Kedah,28,2,26,2007
2007-04-02,Kedah,28,2,26,2007
2007-04-03,Kedah,34,22,12,2007
2007-04-04,Kedah,158,84,74,2007
2007-04-05,Kedah,22,2,20,2007
2007-04-06,Kedah,0,0,0,2007
2007-04-07,Kedah,14,10,4,2007
2007-04-08,Kedah,139,11,128,2007
2007-04-09,Kedah,22,5,17,2007
2007-04-10,Kedah,378,329,49,2007
2007-04-11,Kedah,18,6,12,2007
2007-04-12,Kedah,10,4,6,2007
2007-04-13,Kedah,138,24,114,2007
2007-04-14,Kedah,0,0,0,2007
2007-04-15,Kedah,38,7,31,2007
2007-04-16,Kedah,30,6,24,2007
2007-04-17,Kedah,112,68,44,2007
2007-04-18,Kedah,82,35,47,2007
2007-04-19,Kedah,12,4,8,2007
2007-04-20,Kedah,0,0,0,2007
2007-04-21,Kedah,28,15,13,2007
2007-04-22,Kedah,16,0,16,2007
2007-04-23,Kedah,18,4,14,2007
2007-04-24,Kedah,24,16,8,2007
2007-04-25,Kedah,219,193,26,2007
2007-04-26,Kedah,0,0,0,2007
2007-04-27,Kedah,0,0,0,2007
2007-04-28,Kedah,70,68,2,2007
2007-04-29,Kedah,88,59,29,2007
2007-04-30,Kedah,35,4,31,2007
2007-05-01,Kedah,252,92,160,2007
2007-05-02,Kedah,0,0,0,2007
2007-05-03,Kedah,10,0,10,2007
2007-05-04,Kedah,259,99,160,2007
2007-05-05,Kedah,248,119,129,2007
2007-05-06,Kedah,25,0,25,2007
2007-05-07,Kedah,16,0,16,2007
2007-05-08,Kedah,28,19,9,2007
2007-05-09,Kedah,20,6,14,2007
2007-05-10,Kedah,88,53,35,2007
2007-05-11,Kedah,177,54,123,2007
2007-05-12,Kedah,26,18,8,2007
2007-05-13,Kedah,32,4,28,2007
2007-05-14,Kedah,65,46,19,2007
2007-05-15,Kedah,14,2,12,2007
2007-05-16,Kedah,20,6,14,2007
2007-05-17,Kedah,24,6,18,2007
2007-05-18,Kedah,210,79,131,2007
2007-05-19,Kedah,147,129,18,2007
2007-05-20,Kedah,36,9,27,2007
2007-05-21,Kedah,16,3,13,2007
2007-05-22,Kedah,160,132,28,2007
2007-05-23,Kedah,22,8,14,2007
2007-05-24,Kedah,40,23,17,2007
2007-05-25,Kedah,104,15,89,2007
2007-05-26,Kedah,74,62,12,2007
2007-05-27,Kedah,102,61,41,2007
2007-05-28,Kedah,22,6,16,2007
2007-05-29,Kedah,14,2,12,2007
2007-05-30,Kedah,6,0,6,2007
2007-05-31,Kedah,14,4,10,2007
2007-06-01,Kedah,119,76,43,2007
2007-06-02,Kedah,134,34,100,2007
2007-06-03,Kedah,22,6,16,2007
2007-06-04,Kedah,18,4,14,2007
2007-06-05,Kedah,82,41,41,2007
2007-06-06,Kedah,54,8,46,2007
2007-06-07,Kedah,54,14,40,2007
2007-06-08,Kedah,140,113,27,2007
2007-06-09,Kedah,152,141,11,2007
2007-06-10,Kedah,128,102,26,2007
2007-06-11,Kedah,72,46,26,2007
2007-06-12,Kedah,22,8,14,2007
2007-06-13,Kedah,12,0,12,2007
2007-06-14,Kedah,54,30,24,2007
2007-06-15,Kedah,80,55,25,2007
2007-06-16,Kedah,0,0,0,2007
2007-06-17,Kedah,42,14,28,2007
2007-06-18,Kedah,98,65,33,2007
2007-06-19,Kedah,66,31,35,2007
2007-06-20,Kedah,30,10,20,2007
2007-06-21,Kedah,158,122,36,2007
2007-06-22,Kedah,70,25,45,2007
2007-06-23,Kedah,0,0,0,2007
2007-06-24,Kedah,24,3,21,2007
2007-06-25,Kedah,46,17,29,2007
2007-06-26,Kedah,16,6,10,2007
2007-06-27,Kedah,80,57,23,2007
2007-06-28,Kedah,32,6,26,2007
2007-06-29,Kedah,68,24,44,2007
2007-06-30,Kedah,10,9,1,2007
2007-07-01,Kedah,56,34,22,2007
2007-07-02,Kedah,258,203,55,2007
2007-07-03,Kedah,28,10,18,2007
2007-07-04,Kedah,214,161,53,2007
2007-07-05,Kedah,202,119,83,2007
2007-07-06,Kedah,214,86,128,2007
2007-07-07,Kedah,30,28,2,2007
2007-07-08,Kedah,20,3,17,2007
2007-07-09,Kedah,20,4,16,2007
2007-07-10,Kedah,12,3,9,2007
2007-07-11,Kedah,32,8,24,2007
2007-07-12,Kedah,70,52,18,2007
2007-07-13,Kedah,192,61,131,2007
2007-07-14,Kedah,22,16,6,2007
2007-07-15,Kedah,18,2,16,2007
2007-07-16,Kedah,62,29,33,2007
2007-07-17,Kedah,20,7,13,2007
2007-07-18,Kedah,57,25,32,2007
2007-07-19,Kedah,92,57,35,2007
2007-07-20,Kedah,137,58,79,2007
2007-07-21,Kedah,86,73,13,2007
2007-07-22,Kedah,22,4,18,2007
2007-07-23,Kedah,60,27,33,2007
2007-07-24,Kedah,320,284,36,2007
2007-07-25,Kedah,20,2,18,2007
2007-07-26,Kedah,46,22,24,2007
2007-07-27,Kedah,162,110,52,2007
2007-07-28,Kedah,24,12,12,2007
2007-07-29,Kedah,148,83,65,2007
2007-07-30,Kedah,14,2,12,2007
2007-07-31,Kedah,296,197,99,2007
2007-08-01,Kedah,4,0,4,2007
2007-08-02,Kedah,30,11,19,2007
2007-08-03,Kedah,0,0,0,2007
2007-08-04,Kedah,154,91,63,2007
2007-08-05,Kedah,130,98,32,2007
2007-08-06,Kedah,18,5,13,2007
2007-08-07,Kedah,224,120,104,2007
2007-08-08,Kedah,70,43,27,2007
2007-08-09,Kedah,78,67,11,2007
2007-08-10,Kedah,153,75,78,2007
2007-08-11,Kedah,6,2,4,2007
2007-08-12,Kedah,68,40,28,2007
2007-08-13,Kedah,7,0,7,2007
2007-08-14,Kedah,60,30,30,2007
2007-08-15,Kedah,88,48,40,2007
2007-08-16,Kedah,10,0,10,2007
2007-08-17,Kedah,114,88,26,2007
2007-08-18,Kedah,0,0,0,2007
2007-08-19,Kedah,106,65,41,2007
2007-08-20,Kedah,7,0,7,2007
2007-08-21,Kedah,180,124,56,2007
2007-08-22,Kedah,128,112,16,2007
2007-08-23,Kedah,192,160,32,2007
2007-08-24,Kedah,86,14,72,2007
2007-08-25,Kedah,28,25,3,2007
2007-08-26,Kedah,20,4,16,2007
2007-08-27,Kedah,22,4,18,2007
2007-08-28,Kedah,16,2,14,2007
2007-08-29,Kedah,44,18,26,2007
2007-08-30,Kedah,10,2,8,2007
2007-08-31,Kedah,248,68,180,2007
2007-09-01,Kedah,2,0,2,2007
2007-09-02,Kedah,42,16,26,2007
2007-09-03,Kedah,82,36,46,2007
2007-09-04,Kedah,48,18,30,2007
2007-09-05,Kedah,2,0,2,2007
2007-09-06,Kedah,12,2,10,2007
2007-09-07,Kedah,125,27,98,2007
2007-09-08,Kedah,54,31,23,2007
2007-09-09,Kedah,80,39,41,2007
2007-09-10,Kedah,218,145,73,2007
2007-09-11,Kedah,218,184,34,2007
2007-09-12,Kedah,120,88,32,2007
2007-09-13,Kedah,0,0,0,2007
2007-09-14,Kedah,0,0,0,2007
2007-09-15,Kedah,6,0,6,2007
2007-09-16,Kedah,14,2,12,2007
2007-09-17,Kedah,12,0,12,2007
2007-09-18,Kedah,2,0,2,2007
2007-09-19,Kedah,10,0,10,2007
2007-09-20,Kedah,16,8,8,2007
2007-09-21,Kedah,0,0,0,2007
2007-09-22,Kedah,8,4,4,2007
2007-09-23,Kedah,24,4,20,2007
2007-09-24,Kedah,5,3,2,2007
2007-09-25,Kedah,18,2,16,2007
2007-09-26,Kedah,6,0,6,2007
2007-09-27,Kedah,137,26,111,2007
2007-09-28,Kedah,221,108,113,2007
2007-09-29,Kedah,32,22,10,2007
2007-09-30,Kedah,16,3,13,2007
2007-10-01,Kedah,2,0,2,2007
2007-10-02,Kedah,8,1,7,2007
2007-10-03,Kedah,7,0,7,2007
2007-10-04,Kedah,74,48,26,2007
2007-10-05,Kedah,112,43,69,2007
2007-10-06,Kedah,16,15,1,2007
2007-10-07,Kedah,28,6,22,2007
2007-10-08,Kedah,23,8,15,2007
2007-10-09,Kedah,132,63,69,2007
2007-10-10,Kedah,27,5,22,2007
2007-10-11,Kedah,96,68,28,2007
2007-10-12,Kedah,16,7,9,2007
2007-10-13,Kedah,26,4,22,2007
2007-10-14,Kedah,28,8,20,2007
2007-10-15,Kedah,31,4,27,2007
2007-10-16,Kedah,42,20,22,2007
2007-10-17,Kedah,48,22,26,2007
2007-10-18,Kedah,150,117,33,2007
2007-10-19,Kedah,32,22,10,2007
2007-10-20,Kedah,0,0,0,2007
2007-10-21,Kedah,78,27,51,2007
2007-10-22,Kedah,64,43,21,2007
2007-10-23,Kedah,78,38,40,2007
2007-10-24,Kedah,24,9,15,2007
2007-10-25,Kedah,36,10,26,2007
2007-10-26,Kedah,142,28,114,2007
2007-10-27,Kedah,174,83,91,2007
2007-10-28,Kedah,206,135,71,2007
2007-10-29,Kedah,18,1,17,2007
2007-10-30,Kedah,8,2,6,2007
2007-10-31,Kedah,31,3,28,2007
2007-11-01,Kedah,18,4,14,2007
2007-11-02,Kedah,136,44,92,2007
2007-11-03,Kedah,43,33,10,2007
2007-11-04,Kedah,60,42,18,2007
2007-11-05,Kedah,24,11,13,2007
2007-11-06,Kedah,107,59,48,2007
2007-11-07,Kedah,16,0,16,2007
2007-11-08,Kedah,0,0,0,2007
2007-11-09,Kedah,0,0,0,2007
2007-11-10,Kedah,20,13,7,2007
2007-11-11,Kedah,24,6,18,2007
2007-11-12,Kedah,28,7,21,2007
2007-11-13,Kedah,38,4,34,2007
2007-11-14,Kedah,12,8,4,2007
2007-11-15,Kedah,15,2,13,2007
2007-11-16,Kedah,82,41,41,2007
2007-11-17,Kedah,0,0,0,2007
2007-11-18,Kedah,32,14,18,2007
2007-11-19,Kedah,10,4,6,2007
2007-11-20,Kedah,235,163,72,2007
2007-11-21,Kedah,13,2,11,2007
2007-11-22,Kedah,11,5,6,2007
2007-11-23,Kedah,476,228,248,2007
2007-11-24,Kedah,102,92,10,2007
2007-11-25,Kedah,86,56,30,2007
2007-11-26,Kedah,98,67,31,2007
2007-11-27,Kedah,45,33,12,2007
2007-11-28,Kedah,46,28,18,2007
2007-11-29,Kedah,63,43,20,2007
2007-11-30,Kedah,147,33,114,2007
2007-12-01,Kedah,0,0,0,2007
2007-12-02,Kedah,150,140,10,2007
2007-12-03,Kedah,68,35,33,2007
2007-12-04,Kedah,225,149,76,2007
2007-12-05,Kedah,90,69,21,2007
2007-12-06,Kedah,58,48,10,2007
2007-12-07,Kedah,336,131,205,2007
2007-12-08,Kedah,59,47,12,2007
2007-12-09,Kedah,263,172,91,2007
2007-12-10,Kedah,62,38,24,2007
2007-12-11,Kedah,56,39,17,2007
2007-12-12,Kedah,98,58,40,2007
2007-12-13,Kedah,226,116,110,2007
2007-12-14,Kedah,138,62,76,2007
2007-12-15,Kedah,122,118,4,2007
2007-12-16,Kedah,191,144,47,2007
2007-12-17,Kedah,38,30,8,2007
2007-12-18,Kedah,65,40,25,2007
2007-12-19,Kedah,38,24,14,2007
2007-12-20,Kedah,0,0,0,2007
2007-12-21,Kedah,153,27,126,2007
2007-12-22,Kedah,65,56,9,2007
2007-12-23,Kedah,0,0,0,2007
2007-12-24,Kedah,47,26,21,2007
2007-12-25,Kedah,8,0,8,2007
2007-12-26,Kedah,60,41,19,2007
2007-12-27,Kedah,43,26,17,2007
2007-12-28,Kedah,125,27,98,2007
2007-12-29,Kedah,64,34,30,2007
2007-12-30,Kedah,141,85,56,2007
2007-12-31,Kedah,66,34,32,2007
2008-01-01,Kedah,37,19,18,2008
2008-01-02,Kedah,36,23,13,2008
2008-01-03,Kedah,37,14,23,2008
2008-01-04,Kedah,71,52,19,2008
2008-01-05,Kedah,105,66,39,2008
2008-01-06,Kedah,147,94,53,2008
2008-01-07,Kedah,221,172,49,2008
2008-01-08,Kedah,63,51,12,2008
2008-01-09,Kedah,74,48,26,2008
2008-01-10,Kedah,33,6,27,2008
2008-01-11,Kedah,38,37,1,2008
2008-01-12,Kedah,98,86,12,2008
2008-01-13,Kedah,146,98,48,2008
2008-01-14,Kedah,187,99,88,2008
2008-01-15,Kedah,236,116,120,2008
2008-01-16,Kedah,211,97,114,2008
2008-01-17,Kedah,105,68,37,2008
2008-01-18,Kedah,37,18,19,2008
2008-01-19,Kedah,30,24,6,2008
2008-01-20,Kedah,239,197,42,2008
2008-01-21,Kedah,55,31,24,2008
2008-01-22,Kedah,243,184,59,2008
2008-01-23,Kedah,269,242,27,2008
2008-01-24,Kedah,47,22,25,2008
2008-01-25,Kedah,325,121,204,2008
2008-01-26,Kedah,324,143,181,2008
2008-01-27,Kedah,128,77,51,2008
2008-01-28,Kedah,49,35,14,2008
2008-01-29,Kedah,105,70,35,2008
2008-01-30,Kedah,26,19,7,2008
2008-01-31,Kedah,62,38,24,2008
2008-02-01,Kedah,16,14,2,2008
2008-02-02,Kedah,35,23,12,2008
2008-02-03,Kedah,151,106,45,2008
2008-02-04,Kedah,163,89,74,2008
2008-02-05,Kedah,210,144,66,2008
2008-02-06,Kedah,87,59,28,2008
2008-02-07,Kedah,73,60,13,2008
2008-02-08,Kedah,16,3,13,2008
2008-02-09,Kedah,10,8,2,2008
2008-02-10,Kedah,20,15,5,2008
2008-02-11,Kedah,92,57,35,2008
2008-02-12,Kedah,178,89,89,2008
2008-02-13,Kedah,301,181,120,2008
2008-02-14,Kedah,207,149,58,2008
2008-02-15,Kedah,74,37,37,2008
2008-02-16,Kedah,37,37,0,2008
2008-02-17,Kedah,185,143,42,2008
2008-02-18,Kedah,113,46,67,2008
2008-02-19,Kedah,245,173,72,2008
2008-02-20,Kedah,351,245,106,2008
2008-02-21,Kedah,75,49,26,2008
2008-02-22,Kedah,149,31,118,2008
2008-02-23,Kedah,393,367,26,2008
2008-02-24,Kedah,105,79,26,2008
2008-02-25,Kedah,27,20,7,2008
2008-02-26,Kedah,248,146,102,2008
2008-02-27,Kedah,91,43,48,2008
2008-02-28,Kedah,129,110,19,2008
2008-02-29,Kedah,118,83,35,2008
2008-03-01,Kedah,211,119,92,2008
2008-03-02,Kedah,94,59,35,2008
2008-03-03,Kedah,166,81,85,2008
2008-03-04,Kedah,137,67,70,2008
2008-03-05,Kedah,47,19,28,2008
2008-03-06,Kedah,37,22,15,2008
2008-03-07,Kedah,32,18,14,2008
2008-03-08,Kedah,6,1,5,2008
2008-03-09,Kedah,90,46,44,2008
2008-03-10,Kedah,96,55,41,2008
2008-03-11,Kedah,37,12,25,2008
2008-03-12,Kedah,169,124,45,2008
2008-03-13,Kedah,187,107,80,2008
2008-03-14,Kedah,88,16,72,2008
2008-03-15,Kedah,91,59,32,2008
2008-03-16,Kedah,219,158,61,2008
2008-03-17,Kedah,95,53,42,2008
2008-03-18,Kedah,41,20,21,2008
2008-03-19,Kedah,225,147,78,2008
2008-03-20,Kedah,0,0,0,2008
2008-03-21,Kedah,212,38,174,2008
2008-03-22,Kedah,0,0,0,2008
2008-03-23,Kedah,132,86,46,2008
2008-03-24,Kedah,109,61,48,2008
2008-03-25,Kedah,184,152,32,2008
2008-03-26,Kedah,170,134,36,2008
2008-03-27,Kedah,188,161,27,2008
2008-03-28,Kedah,107,89,18,2008
2008-03-29,Kedah,82,63,19,2008
2008-03-30,Kedah,48,25,23,2008
2008-03-31,Kedah,35,15,20,2008
2008-04-01,Kedah,195,75,120,2008
2008-04-02,Kedah,162,106,56,2008
2008-04-03,Kedah,55,23,32,2008
2008-04-04,Kedah,192,100,92,2008
2008-04-05,Kedah,0,0,0,2008
2008-04-06,Kedah,177,109,68,2008
2008-04-07,Kedah,72,33,39,2008
2008-04-08,Kedah,89,56,33,2008
2008-04-09,Kedah,102,69,33,2008
2008-04-10,Kedah,221,146,75,2008
2008-04-11,Kedah,46,19,27,2008
2008-04-12,Kedah,58,39,19,2008
2008-04-13,Kedah,194,93,101,2008
2008-04-14,Kedah,108,49,59,2008
2008-04-15,Kedah,142,49,93,2008
2008-04-16,Kedah,251,172,79,2008
2008-04-17,Kedah,104,80,24,2008
2008-04-18,Kedah,17,6,11,2008
2008-04-19,Kedah,173,157,16,2008
2008-04-20,Kedah,82,57,25,2008
2008-04-21,Kedah,105,72,33,2008
2008-04-22,Kedah,134,83,51,2008
2008-04-23,Kedah,90,24,66,2008
2008-04-24,Kedah,121,84,37,2008
2008-04-25,Kedah,201,52,149,2008
2008-04-26,Kedah,10,9,1,2008
2008-04-27,Kedah,124,77,47,2008
2008-04-28,Kedah,98,65,33,2008
2008-04-29,Kedah,177,130,47,2008
2008-04-30,Kedah,110,89,21,2008
2008-05-01,Kedah,293,118,175,2008
2008-05-02,Kedah,10,2,8,2008
2008-05-03,Kedah,31,18,13,2008
2008-05-04,Kedah,118,46,72,2008
2008-05-05,Kedah,204,105,99,2008
2008-05-06,Kedah,65,29,36,2008
2008-05-07,Kedah,51,21,30,2008
2008-05-08,Kedah,180,148,32,2008
2008-05-09,Kedah,247,206,41,2008
2008-05-10,Kedah,10,7,3,2008
2008-05-11,Kedah,145,74,71,2008
2008-05-12,Kedah,286,177,109,2008
2008-05-13,Kedah,223,170,53,2008
2008-05-14,Kedah,270,199,71,2008
2008-05-15,Kedah,67,40,27,2008
2008-05-16,Kedah,118,51,67,2008
2008-05-17,Kedah,363,316,47,2008
2008-05-18,Kedah,78,30,48,2008
2008-05-19,Kedah,103,87,16,2008
2008-05-20,Kedah,90,45,45,2008
2008-05-21,Kedah,30,10,20,2008
2008-05-22,Kedah,290,127,163,2008
2008-05-23,Kedah,139,71,68,2008
2008-05-24,Kedah,190,178,12,2008
2008-05-25,Kedah,255,122,133,2008
2008-05-26,Kedah,141,96,45,2008
2008-05-27,Kedah,26,9,17,2008
2008-05-28,Kedah,38,7,31,2008
2008-05-29,Kedah,56,19,37,2008
2008-05-30,Kedah,264,146,118,2008
2008-05-31,Kedah,12,12,0,2008
2008-06-01,Kedah,61,20,41,2008
2008-06-02,Kedah,47,14,33,2008
2008-06-03,Kedah,46,17,29,2008
2008-06-04,Kedah,52,24,28,2008
2008-06-05,Kedah,35,16,19,2008
2008-06-06,Kedah,228,43,185,2008
2008-06-07,Kedah,131,25,106,2008
2008-06-08,Kedah,191,96,95,2008
2008-06-09,Kedah,40,15,25,2008
2008-06-10,Kedah,45,18,27,2008
2008-06-11,Kedah,130,86,44,2008
2008-06-12,Kedah,456,142,314,2008
2008-06-13,Kedah,110,17,93,2008
2008-06-14,Kedah,21,17,4,2008
2008-06-15,Kedah,222,162,60,2008
2008-06-16,Kedah,130,72,58,2008
2008-06-17,Kedah,99,60,39,2008
2008-06-18,Kedah,70,41,29,2008
2008-06-19,Kedah,186,141,45,2008
2008-06-20,Kedah,200,89,111,2008
2008-06-21,Kedah,19,11,8,2008
2008-06-22,Kedah,213,137,76,2008
2008-06-23,Kedah,93,64,29,2008
2008-06-24,Kedah,143,106,37,2008
2008-06-25,Kedah,74,45,29,2008
2008-06-26,Kedah,167,122,45,2008
2008-06-27,Kedah,162,27,135,2008
2008-06-28,Kedah,113,80,33,2008
2008-06-29,Kedah,49,11,38,2008
2008-06-30,Kedah,45,22,23,2008
2008-07-01,Kedah,50,15,35,2008
2008-07-02,Kedah,39,14,25,2008
2008-07-03,Kedah,205,144,61,2008
2008-07-04,Kedah,16,15,1,2008
2008-07-05,Kedah,93,85,8,2008
2008-07-06,Kedah,64,31,33,2008
2008-07-07,Kedah,114,61,53,2008
2008-07-08,Kedah,66,29,37,2008
2008-07-09,Kedah,135,95,40,2008
2008-07-10,Kedah,91,68,23,2008
2008-07-11,Kedah,18,2,16,2008
2008-07-12,Kedah,34,16,18,2008
2008-07-13,Kedah,181,80,101,2008
2008-07-14,Kedah,172,106,66,2008
2008-07-15,Kedah,14,6,8,2008
2008-07-16,Kedah,38,5,33,2008
2008-07-17,Kedah,165,83,82,2008
2008-07-18,Kedah,9,3,6,2008
2008-07-19,Kedah,179,108,71,2008
2008-07-20,Kedah,196,167,29,2008
2008-07-21,Kedah,81,12,69,2008
2008-07-22,Kedah,165,61,104,2008
2008-07-23,Kedah,22,8,14,2008
2008-07-24,Kedah,60,29,31,2008
2008-07-25,Kedah,95,32,63,2008
2008-07-26,Kedah,92,66,26,2008
2008-07-27,Kedah,305,180,125,2008
2008-07-28,Kedah,141,93,48,2008
2008-07-29,Kedah,108,90,18,2008
2008-07-30,Kedah,168,106,62,2008
2008-07-31,Kedah,177,126,51,2008
2008-08-01,Kedah,100,40,60,2008
2008-08-02,Kedah,159,110,49,2008
2008-08-03,Kedah,124,74,50,2008
2008-08-04,Kedah,37,7,30,2008
2008-08-05,Kedah,118,89,29,2008
2008-08-06,Kedah,139,108,31,2008
2008-08-07,Kedah,282,215,67,2008
2008-08-08,Kedah,320,171,149,2008
2008-08-09,Kedah,107,65,42,2008
2008-08-10,Kedah,371,199,172,2008
2008-08-11,Kedah,126,77,49,2008
2008-08-12,Kedah,99,44,55,2008
2008-08-13,Kedah,93,58,35,2008
2008-08-14,Kedah,108,64,44,2008
2008-08-15,Kedah,16,8,8,2008
2008-08-16,Kedah,0,0,0,2008
2008-08-17,Kedah,85,44,41,2008
2008-08-18,Kedah,38,9,29,2008
2008-08-19,Kedah,67,25,42,2008
2008-08-20,Kedah,193,132,61,2008
2008-08-21,Kedah,24,7,17,2008
2008-08-22,Kedah,37,22,15,2008
2008-08-23,Kedah,101,81,20,2008
2008-08-24,Kedah,65,23,42,2008
2008-08-25,Kedah,257,112,145,2008
2008-08-26,Kedah,269,155,114,2008
2008-08-27,Kedah,244,136,108,2008
2008-08-28,Kedah,257,142,115,2008
2008-08-29,Kedah,124,62,62,2008
2008-08-30,Kedah,266,228,38,2008
2008-08-31,Kedah,277,116,161,2008
2008-09-01,Kedah,0,0,0,2008
2008-09-02,Kedah,19,5,14,2008
2008-09-03,Kedah,18,0,18,2008
2008-09-04,Kedah,31,13,18,2008
2008-09-05,Kedah,55,7,48,2008
2008-09-06,Kedah,101,53,48,2008
2008-09-07,Kedah,130,67,63,2008
2008-09-08,Kedah,60,29,31,2008
2008-09-09,Kedah,82,30,52,2008
2008-09-10,Kedah,36,18,18,2008
2008-09-11,Kedah,17,3,14,2008
2008-09-12,Kedah,108,47,61,2008
2008-09-13,Kedah,77,58,19,2008
2008-09-14,Kedah,116,45,71,2008
2008-09-15,Kedah,121,29,92,2008
2008-09-16,Kedah,74,45,29,2008
2008-09-17,Kedah,71,43,28,2008
2008-09-18,Kedah,104,50,54,2008
2008-09-19,Kedah,165,82,83,2008
2008-09-20,Kedah,72,43,29,2008
2008-09-21,Kedah,88,60,28,2008
2008-09-22,Kedah,64,23,41,2008
2008-09-23,Kedah,64,40,24,2008
2008-09-24,Kedah,16,3,13,2008
2008-09-25,Kedah,85,38,47,2008
2008-09-26,Kedah,108,14,94,2008
2008-09-27,Kedah,41,15,26,2008
2008-09-28,Kedah,146,71,75,2008
2008-09-29,Kedah,46,20,26,2008
2008-09-30,Kedah,13,1,12,2008
2008-10-01,Kedah,17,3,14,2008
2008-10-02,Kedah,29,5,24,2008
2008-10-03,Kedah,77,23,54,2008
2008-10-04,Kedah,16,2,14,2008
2008-10-05,Kedah,70,14,56,2008
2008-10-06,Kedah,61,14,47,2008
2008-10-07,Kedah,109,43,66,2008
2008-10-08,Kedah,208,122,86,2008
2008-10-09,Kedah,90,30,60,2008
2008-10-10,Kedah,267,59,208,2008
2008-10-11,Kedah,108,50,58,2008
2008-10-12,Kedah,426,222,204,2008
2008-10-13,Kedah,115,58,57,2008
2008-10-14,Kedah,37,7,30,2008
2008-10-15,Kedah,144,98,46,2008
2008-10-16,Kedah,246,157,89,2008
2008-10-17,Kedah,174,60,114,2008
2008-10-18,Kedah,64,26,38,2008
2008-10-19,Kedah,200,62,138,2008
2008-10-20,Kedah,84,14,70,2008
2008-10-21,Kedah,75,44,31,2008
2008-10-22,Kedah,152,76,76,2008
2008-10-23,Kedah,148,89,59,2008
2008-10-24,Kedah,63,27,36,2008
2008-10-25,Kedah,137,130,7,2008
2008-10-26,Kedah,46,11,35,2008
2008-10-27,Kedah,0,0,0,2008
2008-10-28,Kedah,73,11,62,2008
2008-10-29,Kedah,53,15,38,2008
2008-10-30,Kedah,132,67,65,2008
2008-10-31,Kedah,134,55,79,2008
2008-11-01,Kedah,10,7,3,2008
2008-11-02,Kedah,224,140,84,2008
2008-11-03,Kedah,55,14,41,2008
2008-11-04,Kedah,96,27,69,2008
2008-11-05,Kedah,193,131,62,2008
2008-11-06,Kedah,242,122,120,2008
2008-11-07,Kedah,63,26,37,2008
2008-11-08,Kedah,57,27,30,2008
2008-11-09,Kedah,228,76,152,2008
2008-11-10,Kedah,90,31,59,2008
2008-11-11,Kedah,80,50,30,2008
2008-11-12,Kedah,59,19,40,2008
2008-11-13,Kedah,111,81,30,2008
2008-11-14,Kedah,261,111,150,2008
2008-11-15,Kedah,36,21,15,2008
2008-11-16,Kedah,273,160,113,2008
2008-11-17,Kedah,123,42,81,2008
2008-11-18,Kedah,112,81,31,2008
2008-11-19,Kedah,147,78,69,2008
2008-11-20,Kedah,42,18,24,2008
2008-11-21,Kedah,64,25,39,2008
2008-11-22,Kedah,64,48,16,2008
2008-11-23,Kedah,281,131,150,2008
2008-11-24,Kedah,73,34,39,2008
2008-11-25,Kedah,40,13,27,2008
2008-11-26,Kedah,40,7,33,2008
2008-11-27,Kedah,111,65,46,2008
2008-11-28,Kedah,109,29,80,2008
2008-11-29,Kedah,28,21,7,2008
2008-11-30,Kedah,221,146,75,2008
2008-12-01,Kedah,131,63,68,2008
2008-12-02,Kedah,114,59,55,2008
2008-12-03,Kedah,240,93,147,2008
2008-12-04,Kedah,25,3,22,2008
2008-12-05,Kedah,31,14,17,2008
2008-12-06,Kedah,229,123,106,2008
2008-12-07,Kedah,38,10,28,2008
2008-12-08,Kedah,27,6,21,2008
2008-12-09,Kedah,32,12,20,2008
2008-12-10,Kedah,112,42,70,2008
2008-12-11,Kedah,139,65,74,2008
2008-12-12,Kedah,134,49,85,2008
2008-12-13,Kedah,54,21,33,2008
2008-12-14,Kedah,144,34,110,2008
2008-12-15,Kedah,153,76,77,2008
2008-12-16,Kedah,141,45,96,2008
2008-12-17,Kedah,124,57,67,2008
2008-12-18,Kedah,86,46,40,2008
2008-12-19,Kedah,104,11,93,2008
2008-12-20,Kedah,26,13,13,2008
2008-12-21,Kedah,213,127,86,2008
2008-12-22,Kedah,81,31,50,2008
2008-12-23,Kedah,86,33,53,2008
2008-12-24,Kedah,67,14,53,2008
2008-12-25,Kedah,9,4,5,2008
2008-12-26,Kedah,91,9,82,2008
2008-12-27,Kedah,13,10,3,2008
2008-12-28,Kedah,241,108,133,2008
2008-12-29,Kedah,24,12,12,2008
2008-12-30,Kedah,59,20,39,2008
2008-12-31,Kedah,160,57,103,2008
2009-01-01,Kedah,62,26,36,2009
2009-01-02,Kedah,317,64,253,2009
2009-01-03,Kedah,32,14,18,2009
2009-01-04,Kedah,95,28,67,2009
2009-01-05,Kedah,45,5,40,2009
2009-01-06,Kedah,78,42,36,2009
2009-01-07,Kedah,116,34,82,2009
2009-01-08,Kedah,110,45,65,2009
2009-01-09,Kedah,270,136,134,2009
2009-01-10,Kedah,127,75,52,2009
2009-01-11,Kedah,347,141,206,2009
2009-01-12,Kedah,189,108,81,2009
2009-01-13,Kedah,273,134,139,2009
2009-01-14,Kedah,148,73,75,2009
2009-01-15,Kedah,255,162,93,2009
2009-01-16,Kedah,43,24,19,2009
2009-01-17,Kedah,8,7,1,2009
2009-01-18,Kedah,135,74,61,2009
2009-01-19,Kedah,40,8,32,2009
2009-01-20,Kedah,102,43,59,2009
2009-01-21,Kedah,426,156,270,2009
2009-01-22,Kedah,174,81,93,2009
2009-01-23,Kedah,92,59,33,2009
2009-01-24,Kedah,27,12,15,2009
2009-01-25,Kedah,60,20,40,2009
2009-01-26,Kedah,4,0,4,2009
2009-01-27,Kedah,10,0,10,2009
2009-01-28,Kedah,125,64,61,2009
2009-01-29,Kedah,71,33,38,2009
2009-01-30,Kedah,43,18,25,2009
2009-01-31,Kedah,33,21,12,2009
2009-02-01,Kedah,108,33,75,2009
2009-02-02,Kedah,54,7,47,2009
2009-02-03,Kedah,90,23,67,2009
2009-02-04,Kedah,118,34,84,2009
2009-02-05,Kedah,307,165,142,2009
2009-02-06,Kedah,95,46,49,2009
2009-02-07,Kedah,119,73,46,2009
2009-02-08,Kedah,149,31,118,2009
2009-02-09,Kedah,291,159,132,2009
2009-02-10,Kedah,170,87,83,2009
2009-02-11,Kedah,121,75,46,2009
2009-02-12,Kedah,52,20,32,2009
2009-02-13,Kedah,30,7,23,2009
2009-02-14,Kedah,123,119,4,2009
2009-02-15,Kedah,126,62,64,2009
2009-02-16,Kedah,140,58,82,2009
2009-02-17,Kedah,98,38,60,2009
2009-02-18,Kedah,65,25,40,2009
2009-02-19,Kedah,82,36,46,2009
2009-02-20,Kedah,276,89,187,2009
2009-02-21,Kedah,403,385,18,2009
2009-02-22,Kedah,168,77,91,2009
2009-02-23,Kedah,201,123,78,2009
2009-02-24,Kedah,226,92,134,2009
2009-02-25,Kedah,144,83,61,2009
2009-02-26,Kedah,117,73,44,2009
2009-02-27,Kedah,54,33,21,2009
2009-02-28,Kedah,183,90,93,2009
2009-03-01,Kedah,131,56,75,2009
2009-03-02,Kedah,81,42,39,2009
2009-03-03,Kedah,92,42,50,2009
2009-03-04,Kedah,114,55,59,2009
2009-03-05,Kedah,101,28,73,2009
2009-03-06,Kedah,80,20,60,2009
2009-03-07,Kedah,112,78,34,2009
2009-03-08,Kedah,117,21,96,2009
2009-03-09,Kedah,0,0,0,2009
2009-03-10,Kedah,66,34,32,2009
2009-03-11,Kedah,132,61,71,2009
2009-03-12,Kedah,248,124,124,2009
2009-03-13,Kedah,107,64,43,2009
2009-03-14,Kedah,73,38,35,2009
2009-03-15,Kedah,195,102,93,2009
2009-03-16,Kedah,81,28,53,2009
2009-03-17,Kedah,85,22,63,2009
2009-03-18,Kedah,84,17,67,2009
2009-03-19,Kedah,74,15,59,2009
2009-03-20,Kedah,106,53,53,2009
2009-03-21,Kedah,18,11,7,2009
2009-03-22,Kedah,100,36,64,2009
2009-03-23,Kedah,161,60,101,2009
2009-03-24,Kedah,104,48,56,2009
2009-03-25,Kedah,85,22,63,2009
2009-03-26,Kedah,113,67,46,2009
2009-03-27,Kedah,212,46,166,2009
2009-03-28,Kedah,82,44,38,2009
2009-03-29,Kedah,89,27,62,2009
2009-03-30,Kedah,164,78,86,2009
2009-03-31,Kedah,77,36,41,2009
2009-04-01,Kedah,53,10,43,2009
2009-04-02,Kedah,47,19,28,2009
2009-04-03,Kedah,62,28,34,2009
2009-04-04,Kedah,53,33,20,2009
2009-04-05,Kedah,119,50,69,2009
2009-04-06,Kedah,65,27,38,2009
2009-04-07,Kedah,97,29,68,2009
2009-04-08,Kedah,24,4,20,2009
2009-04-09,Kedah,91,25,66,2009
2009-04-10,Kedah,121,31,90,2009
2009-04-11,Kedah,99,42,57,2009
2009-04-12,Kedah,201,42,159,2009
2009-04-13,Kedah,125,29,96,2009
2009-04-14,Kedah,93,27,66,2009
2009-04-15,Kedah,138,84,54,2009
2009-04-16,Kedah,150,52,98,2009
2009-04-17,Kedah,98,15,83,2009
2009-04-18,Kedah,69,58,11,2009
2009-04-19,Kedah,142,87,55,2009
2009-04-20,Kedah,112,27,85,2009
2009-04-21,Kedah,121,52,69,2009
2009-04-22,Kedah,150,80,70,2009
2009-04-23,Kedah,129,61,68,2009
2009-04-24,Kedah,154,18,136,2009
2009-04-25,Kedah,57,37,20,2009
2009-04-26,Kedah,202,77,125,2009
2009-04-27,Kedah,66,21,45,2009
2009-04-28,Kedah,107,28,79,2009
2009-04-29,Kedah,64,29,35,2009
2009-04-30,Kedah,55,21,34,2009
2009-05-01,Kedah,549,164,385,2009
2009-05-02,Kedah,64,30,34,2009
2009-05-03,Kedah,158,42,116,2009
2009-05-04,Kedah,138,67,71,2009
2009-05-05,Kedah,84,18,66,2009
2009-05-06,Kedah,172,49,123,2009
2009-05-07,Kedah,44,12,32,2009
2009-05-08,Kedah,70,13,57,2009
2009-05-09,Kedah,76,52,24,2009
2009-05-10,Kedah,402,152,250,2009
2009-05-11,Kedah,102,48,54,2009
2009-05-12,Kedah,58,11,47,2009
2009-05-13,Kedah,61,17,44,2009
2009-05-14,Kedah,106,43,63,2009
2009-05-15,Kedah,325,124,201,2009
2009-05-16,Kedah,196,183,13,2009
2009-05-17,Kedah,153,80,73,2009
2009-05-18,Kedah,71,20,51,2009
2009-05-19,Kedah,71,10,61,2009
2009-05-20,Kedah,35,8,27,2009
2009-05-21,Kedah,242,153,89,2009
2009-05-22,Kedah,110,30,80,2009
2009-05-23,Kedah,212,194,18,2009
2009-05-24,Kedah,138,84,54,2009
2009-05-25,Kedah,41,8,33,2009
2009-05-26,Kedah,78,34,44,2009
2009-05-27,Kedah,111,83,28,2009
2009-05-28,Kedah,67,9,58,2009
2009-05-29,Kedah,206,41,165,2009
2009-05-30,Kedah,216,148,68,2009
2009-05-31,Kedah,79,37,42,2009
2009-06-01,Kedah,36,4,32,2009
2009-06-02,Kedah,47,4,43,2009
2009-06-03,Kedah,60,19,41,2009
2009-06-04,Kedah,70,43,27,2009
2009-06-05,Kedah,194,47,147,2009
2009-06-06,Kedah,95,15,80,2009
2009-06-07,Kedah,55,24,31,2009
2009-06-08,Kedah,59,19,40,2009
2009-06-09,Kedah,93,44,49,2009
2009-06-10,Kedah,177,114,63,2009
2009-06-11,Kedah,270,119,151,2009
2009-06-12,Kedah,85,39,46,2009
2009-06-13,Kedah,47,17,30,2009
2009-06-14,Kedah,300,107,193,2009
2009-06-15,Kedah,45,13,32,2009
2009-06-16,Kedah,79,33,46,2009
2009-06-17,Kedah,72,23,49,2009
2009-06-18,Kedah,424,209,215,2009
2009-06-19,Kedah,118,22,96,2009
2009-06-20,Kedah,68,22,46,2009
2009-06-21,Kedah,175,85,90,2009
2009-06-22,Kedah,184,97,87,2009
2009-06-23,Kedah,153,87,66,2009
2009-06-24,Kedah,131,85,46,2009
2009-06-25,Kedah,310,146,164,2009
2009-06-26,Kedah,173,27,146,2009
2009-06-27,Kedah,67,46,21,2009
2009-06-28,Kedah,201,120,81,2009
2009-06-29,Kedah,156,94,62,2009
2009-06-30,Kedah,29,7,22,2009
2009-07-01,Kedah,33,7,26,2009
2009-07-02,Kedah,64,25,39,2009
2009-07-03,Kedah,135,109,26,2009
2009-07-04,Kedah,61,27,34,2009
2009-07-05,Kedah,141,70,71,2009
2009-07-06,Kedah,59,17,42,2009
2009-07-07,Kedah,61,19,42,2009
2009-07-08,Kedah,91,30,61,2009
2009-07-09,Kedah,72,27,45,2009
2009-07-10,Kedah,152,40,112,2009
2009-07-11,Kedah,19,4,15,2009
2009-07-12,Kedah,184,42,142,2009
2009-07-13,Kedah,50,9,41,2009
2009-07-14,Kedah,58,16,42,2009
2009-07-15,Kedah,143,86,57,2009
2009-07-16,Kedah,206,136,70,2009
2009-07-17,Kedah,204,63,141,2009
2009-07-18,Kedah,69,28,41,2009
2009-07-19,Kedah,133,65,68,2009
2009-07-20,Kedah,0,0,0,2009
2009-07-21,Kedah,108,33,75,2009
2009-07-22,Kedah,106,46,60,2009
2009-07-23,Kedah,95,41,54,2009
2009-07-24,Kedah,208,78,130,2009
2009-07-25,Kedah,7,4,3,2009
2009-07-26,Kedah,179,60,119,2009
2009-07-27,Kedah,65,24,41,2009
2009-07-28,Kedah,88,22,66,2009
2009-07-29,Kedah,61,17,44,2009
2009-07-30,Kedah,112,59,53,2009
2009-07-31,Kedah,297,53,244,2009
2009-08-01,Kedah,262,146,116,2009
2009-08-02,Kedah,224,92,132,2009
2009-08-03,Kedah,50,21,29,2009
2009-08-04,Kedah,129,52,77,2009
2009-08-05,Kedah,97,42,55,2009
2009-08-06,Kedah,211,111,100,2009
2009-08-07,Kedah,227,111,116,2009
2009-08-08,Kedah,126,102,24,2009
2009-08-09,Kedah,190,78,112,2009
2009-08-10,Kedah,154,75,79,2009
2009-08-11,Kedah,183,89,94,2009
2009-08-12,Kedah,189,125,64,2009
2009-08-13,Kedah,270,150,120,2009
2009-08-14,Kedah,188,69,119,2009
2009-08-15,Kedah,189,107,82,2009
2009-08-16,Kedah,374,116,258,2009
2009-08-17,Kedah,92,48,44,2009
2009-08-18,Kedah,199,55,144,2009
2009-08-19,Kedah,119,78,41,2009
2009-08-20,Kedah,303,152,151,2009
2009-08-21,Kedah,263,56,207,2009
2009-08-22,Kedah,0,0,0,2009
2009-08-23,Kedah,92,49,43,2009
2009-08-24,Kedah,15,5,10,2009
2009-08-25,Kedah,12,2,10,2009
2009-08-26,Kedah,8,0,8,2009
2009-08-27,Kedah,66,16,50,2009
2009-08-28,Kedah,77,10,67,2009
2009-08-29,Kedah,12,6,6,2009
2009-08-30,Kedah,33,5,28,2009
2009-08-31,Kedah,203,62,141,2009
2009-09-01,Kedah,53,14,39,2009
2009-09-02,Kedah,30,7,23,2009
2009-09-03,Kedah,52,8,44,2009
2009-09-04,Kedah,120,39,81,2009
2009-09-05,Kedah,39,25,14,2009
2009-09-06,Kedah,106,57,49,2009
2009-09-07,Kedah,17,7,10,2009
2009-09-08,Kedah,61,10,51,2009
2009-09-09,Kedah,153,68,85,2009
2009-09-10,Kedah,157,77,80,2009
2009-09-11,Kedah,63,21,42,2009
2009-09-12,Kedah,43,20,23,2009
2009-09-13,Kedah,115,30,85,2009
2009-09-14,Kedah,115,48,67,2009
2009-09-15,Kedah,53,18,35,2009
2009-09-16,Kedah,74,14,60,2009
2009-09-17,Kedah,213,115,98,2009
2009-09-18,Kedah,180,52,128,2009
2009-09-19,Kedah,0,0,0,2009
2009-09-20,Kedah,0,0,0,2009
2009-09-21,Kedah,31,0,31,2009
2009-09-22,Kedah,31,6,25,2009
2009-09-23,Kedah,90,34,56,2009
2009-09-24,Kedah,110,31,79,2009
2009-09-25,Kedah,131,20,111,2009
2009-09-26,Kedah,91,50,41,2009
2009-09-27,Kedah,257,124,133,2009
2009-09-28,Kedah,99,29,70,2009
2009-09-29,Kedah,174,82,92,2009
2009-09-30,Kedah,188,92,96,2009
2009-10-01,Kedah,73,26,47,2009
2009-10-02,Kedah,108,17,91,2009
2009-10-03,Kedah,44,18,26,2009
2009-10-04,Kedah,63,12,51,2009
2009-10-05,Kedah,84,23,61,2009
2009-10-06,Kedah,186,76,110,2009
2009-10-07,Kedah,307,137,170,2009
2009-10-08,Kedah,169,69,100,2009
2009-10-09,Kedah,138,74,64,2009
2009-10-10,Kedah,36,10,26,2009
2009-10-11,Kedah,263,79,184,2009
2009-10-12,Kedah,83,17,66,2009
2009-10-13,Kedah,239,122,117,2009
2009-10-14,Kedah,88,13,75,2009
2009-10-15,Kedah,67,23,44,2009
2009-10-16,Kedah,82,18,64,2009
2009-10-17,Kedah,393,121,272,2009
2009-10-18,Kedah,162,62,100,2009
2009-10-19,Kedah,105,25,80,2009
2009-10-20,Kedah,80,19,61,2009
2009-10-21,Kedah,188,84,104,2009
2009-10-22,Kedah,106,49,57,2009
2009-10-23,Kedah,105,19,86,2009
2009-10-24,Kedah,187,142,45,2009
2009-10-25,Kedah,114,71,43,2009
2009-10-26,Kedah,152,81,71,2009
2009-10-27,Kedah,62,13,49,2009
2009-10-28,Kedah,96,38,58,2009
2009-10-29,Kedah,382,115,267,2009
2009-10-30,Kedah,8,0,8,2009
2009-10-31,Kedah,132,49,83,2009
2009-11-01,Kedah,62,10,52,2009
2009-11-02,Kedah,109,17,92,2009
2009-11-03,Kedah,101,64,37,2009
2009-11-04,Kedah,157,84,73,2009
2009-11-05,Kedah,164,96,68,2009
2009-11-06,Kedah,135,57,78,2009
2009-11-07,Kedah,18,14,4,2009
2009-11-08,Kedah,352,106,246,2009
2009-11-09,Kedah,33,6,27,2009
2009-11-10,Kedah,30,6,24,2009
2009-11-11,Kedah,72,28,44,2009
2009-11-12,Kedah,147,59,88,2009
2009-11-13,Kedah,343,78,265,2009
2009-11-14,Kedah,112,75,37,2009
2009-11-15,Kedah,176,74,102,2009
2009-11-16,Kedah,155,87,68,2009
2009-11-17,Kedah,149,59,90,2009
2009-11-18,Kedah,132,59,73,2009
2009-11-19,Kedah,101,41,60,2009
2009-11-20,Kedah,148,33,115,2009
2009-11-21,Kedah,40,16,24,2009
2009-11-22,Kedah,66,30,36,2009
2009-11-23,Kedah,173,35,138,2009
2009-11-24,Kedah,134,28,106,2009
2009-11-25,Kedah,84,28,56,2009
2009-11-26,Kedah,35,6,29,2009
2009-11-27,Kedah,0,0,0,2009
2009-11-28,Kedah,26,4,22,2009
2009-11-29,Kedah,204,110,94,2009
2009-11-30,Kedah,90,42,48,2009
2009-12-01,Kedah,103,47,56,2009
2009-12-02,Kedah,103,35,68,2009
2009-12-03,Kedah,121,83,38,2009
2009-12-04,Kedah,121,28,93,2009
2009-12-05,Kedah,112,71,41,2009
2009-12-06,Kedah,89,47,42,2009
2009-12-07,Kedah,90,49,41,2009
2009-12-08,Kedah,241,131,110,2009
2009-12-09,Kedah,133,57,76,2009
2009-12-10,Kedah,133,77,56,2009
2009-12-11,Kedah,90,22,68,2009
2009-12-12,Kedah,70,34,36,2009
2009-12-13,Kedah,162,47,115,2009
2009-12-14,Kedah,135,55,80,2009
2009-12-15,Kedah,76,36,40,2009
2009-12-16,Kedah,267,56,211,2009
2009-12-17,Kedah,72,22,50,2009
2009-12-18,Kedah,231,32,199,2009
2009-12-19,Kedah,76,54,22,2009
2009-12-20,Kedah,60,30,30,2009
2009-12-21,Kedah,196,75,121,2009
2009-12-22,Kedah,51,12,39,2009
2009-12-23,Kedah,129,60,69,2009
2009-12-24,Kedah,110,43,67,2009
2009-12-25,Kedah,79,12,67,2009
2009-12-26,Kedah,44,31,13,2009
2009-12-27,Kedah,50,35,15,2009
2009-12-28,Kedah,113,25,88,2009
2009-12-29,Kedah,181,71,110,2009
2009-12-30,Kedah,97,25,72,2009
2009-12-31,Kedah,90,36,54,2009
2010-01-01,Kedah,18,5,13,2010
2010-01-02,Kedah,32,20,12,2010
2010-01-03,Kedah,194,66,128,2010
2010-01-04,Kedah,121,30,91,2010
2010-01-05,Kedah,102,31,71,2010
2010-01-06,Kedah,123,51,72,2010
2010-01-07,Kedah,118,63,55,2010
2010-01-08,Kedah,136,42,94,2010
2010-01-09,Kedah,134,80,54,2010
2010-01-10,Kedah,430,144,286,2010
2010-01-11,Kedah,55,9,46,2010
2010-01-12,Kedah,246,100,146,2010
2010-01-13,Kedah,83,26,57,2010
2010-01-14,Kedah,420,139,281,2010
2010-01-15,Kedah,37,8,29,2010
2010-01-16,Kedah,27,13,14,2010
2010-01-17,Kedah,126,64,62,2010
2010-01-18,Kedah,120,39,81,2010
2010-01-19,Kedah,125,51,74,2010
2010-01-20,Kedah,392,219,173,2010
2010-01-21,Kedah,122,44,78,2010
2010-01-22,Kedah,59,23,36,2010
2010-01-23,Kedah,100,51,49,2010
2010-01-24,Kedah,229,90,139,2010
2010-01-25,Kedah,225,134,91,2010
2010-01-26,Kedah,147,50,97,2010
2010-01-27,Kedah,32,3,29,2010
2010-01-28,Kedah,93,36,57,2010
2010-01-29,Kedah,47,17,30,2010
2010-01-30,Kedah,189,83,106,2010
2010-01-31,Kedah,164,97,67,2010
2010-02-01,Kedah,342,211,131,2010
2010-02-02,Kedah,208,138,70,2010
2010-02-03,Kedah,281,199,82,2010
2010-02-04,Kedah,171,89,82,2010
2010-02-05,Kedah,17,3,14,2010
2010-02-06,Kedah,151,72,79,2010
2010-02-07,Kedah,98,32,66,2010
2010-02-08,Kedah,166,54,112,2010
2010-02-09,Kedah,221,128,93,2010
2010-02-10,Kedah,95,31,64,2010
2010-02-11,Kedah,188,117,71,2010
2010-02-12,Kedah,8,0,8,2010
2010-02-13,Kedah,52,21,31,2010
2010-02-14,Kedah,0,0,0,2010
2010-02-15,Kedah,39,17,22,2010
2010-02-16,Kedah,96,47,49,2010
2010-02-17,Kedah,153,47,106,2010
2010-02-18,Kedah,112,35,77,2010
2010-02-19,Kedah,15,3,12,2010
2010-02-20,Kedah,12,11,1,2010
2010-02-21,Kedah,199,52,147,2010
2010-02-22,Kedah,155,76,79,2010
2010-02-23,Kedah,56,3,53,2010
2010-02-24,Kedah,144,49,95,2010
2010-02-25,Kedah,103,39,64,2010
2010-02-26,Kedah,103,32,71,2010
2010-02-27,Kedah,385,360,25,2010
2010-02-28,Kedah,101,57,44,2010
2010-03-01,Kedah,54,10,44,2010
2010-03-02,Kedah,40,5,35,2010
2010-03-03,Kedah,185,97,88,2010
2010-03-04,Kedah,124,76,48,2010
2010-03-05,Kedah,157,89,68,2010
2010-03-06,Kedah,131,108,23,2010
2010-03-07,Kedah,177,65,112,2010
2010-03-08,Kedah,90,18,72,2010
2010-03-09,Kedah,359,154,205,2010
2010-03-10,Kedah,372,229,143,2010
2010-03-11,Kedah,199,119,80,2010
2010-03-12,Kedah,79,43,36,2010
2010-03-13,Kedah,51,19,32,2010
2010-03-14,Kedah,165,56,109,2010
2010-03-15,Kedah,123,54,69,2010
2010-03-16,Kedah,173,65,108,2010
2010-03-17,Kedah,122,65,57,2010
2010-03-18,Kedah,51,8,43,2010
2010-03-19,Kedah,175,9,166,2010
2010-03-20,Kedah,37,21,16,2010
2010-03-21,Kedah,363,133,230,2010
2010-03-22,Kedah,91,22,69,2010
2010-03-23,Kedah,104,30,74,2010
2010-03-24,Kedah,55,4,51,2010
2010-03-25,Kedah,77,23,54,2010
2010-03-26,Kedah,289,61,228,2010
2010-03-27,Kedah,114,61,53,2010
2010-03-28,Kedah,61,6,55,2010
2010-03-29,Kedah,73,15,58,2010
2010-03-30,Kedah,122,19,103,2010
2010-03-31,Kedah,42,11,31,2010
2010-04-01,Kedah,75,11,64,2010
2010-04-02,Kedah,66,32,34,2010
2010-04-03,Kedah,0,0,0,2010
2010-04-04,Kedah,141,51,90,2010
2010-04-05,Kedah,78,18,60,2010
2010-04-06,Kedah,46,11,35,2010
2010-04-07,Kedah,117,37,80,2010
2010-04-08,Kedah,56,19,37,2010
2010-04-09,Kedah,82,39,43,2010
2010-04-10,Kedah,48,22,26,2010
2010-04-11,Kedah,185,26,159,2010
2010-04-12,Kedah,151,60,91,2010
2010-04-13,Kedah,138,34,104,2010
2010-04-14,Kedah,238,86,152,2010
2010-04-15,Kedah,76,27,49,2010
2010-04-16,Kedah,86,30,56,2010
2010-04-17,Kedah,26,14,12,2010
2010-04-18,Kedah,265,124,141,2010
2010-04-19,Kedah,49,15,34,2010
2010-04-20,Kedah,153,57,96,2010
2010-04-21,Kedah,122,49,73,2010
2010-04-22,Kedah,152,85,67,2010
2010-04-23,Kedah,57,22,35,2010
2010-04-24,Kedah,92,40,52,2010
2010-04-25,Kedah,118,36,82,2010
2010-04-26,Kedah,190,98,92,2010
2010-04-27,Kedah,24,7,17,2010
2010-04-28,Kedah,132,58,74,2010
2010-04-29,Kedah,183,73,110,2010
2010-04-30,Kedah,79,35,44,2010
2010-05-01,Kedah,570,148,422,2010
2010-05-02,Kedah,177,74,103,2010
2010-05-03,Kedah,64,24,40,2010
2010-05-04,Kedah,83,16,67,2010
2010-05-05,Kedah,143,61,82,2010
2010-05-06,Kedah,67,34,33,2010
2010-05-07,Kedah,117,46,71,2010
2010-05-08,Kedah,31,14,17,2010
2010-05-09,Kedah,138,31,107,2010
2010-05-10,Kedah,50,15,35,2010
2010-05-11,Kedah,105,38,67,2010
2010-05-12,Kedah,52,13,39,2010
2010-05-13,Kedah,249,99,150,2010
2010-05-14,Kedah,64,37,27,2010
2010-05-15,Kedah,69,51,18,2010
2010-05-16,Kedah,140,62,78,2010
2010-05-17,Kedah,52,9,43,2010
2010-05-18,Kedah,92,37,55,2010
2010-05-19,Kedah,135,54,81,2010
2010-05-20,Kedah,129,78,51,2010
2010-05-21,Kedah,383,57,326,2010
2010-05-22,Kedah,512,362,150,2010
2010-05-23,Kedah,69,27,42,2010
2010-05-24,Kedah,823,398,425,2010
2010-05-25,Kedah,122,52,70,2010
2010-05-26,Kedah,46,6,40,2010
2010-05-27,Kedah,139,65,74,2010
2010-05-28,Kedah,92,26,66,2010
2010-05-29,Kedah,58,52,6,2010
2010-05-30,Kedah,32,15,17,2010
2010-05-31,Kedah,50,6,44,2010
2010-06-01,Kedah,43,4,39,2010
2010-06-02,Kedah,301,95,206,2010
2010-06-03,Kedah,60,18,42,2010
2010-06-04,Kedah,239,63,176,2010
2010-06-05,Kedah,342,91,251,2010
2010-06-06,Kedah,134,32,102,2010
2010-06-07,Kedah,125,73,52,2010
2010-06-08,Kedah,83,26,57,2010
2010-06-09,Kedah,125,45,80,2010
2010-06-10,Kedah,43,11,32,2010
2010-06-11,Kedah,24,6,18,2010
2010-06-12,Kedah,24,15,9,2010
2010-06-13,Kedah,199,74,125,2010
2010-06-14,Kedah,57,12,45,2010
2010-06-15,Kedah,100,62,38,2010
2010-06-16,Kedah,64,21,43,2010
2010-06-17,Kedah,115,33,82,2010
2010-06-18,Kedah,159,26,133,2010
2010-06-19,Kedah,27,12,15,2010
2010-06-20,Kedah,209,87,122,2010
2010-06-21,Kedah,105,69,36,2010
2010-06-22,Kedah,76,28,48,2010
2010-06-23,Kedah,153,59,94,2010
2010-06-24,Kedah,290,153,137,2010
2010-06-25,Kedah,206,35,171,2010
2010-06-26,Kedah,135,78,57,2010
2010-06-27,Kedah,183,63,120,2010
2010-06-28,Kedah,153,58,95,2010
2010-06-29,Kedah,170,96,74,2010
2010-06-30,Kedah,94,54,40,2010
2010-07-01,Kedah,31,6,25,2010
2010-07-02,Kedah,57,16,41,2010
2010-07-03,Kedah,84,35,49,2010
2010-07-04,Kedah,108,39,69,2010
2010-07-05,Kedah,35,4,31,2010
2010-07-06,Kedah,76,30,46,2010
2010-07-07,Kedah,132,69,63,2010
2010-07-08,Kedah,182,64,118,2010
2010-07-09,Kedah,98,14,84,2010
2010-07-10,Kedah,149,81,68,2010
2010-07-11,Kedah,172,63,109,2010
2010-07-12,Kedah,109,42,67,2010
2010-07-13,Kedah,230,105,125,2010
2010-07-14,Kedah,172,64,108,2010
2010-07-15,Kedah,61,20,41,2010
2010-07-16,Kedah,264,94,170,2010
2010-07-17,Kedah,96,41,55,2010
2010-07-18,Kedah,166,51,115,2010
2010-07-19,Kedah,50,7,43,2010
2010-07-20,Kedah,150,74,76,2010
2010-07-21,Kedah,155,67,88,2010
2010-07-22,Kedah,164,85,79,2010
2010-07-23,Kedah,147,40,107,2010
2010-07-24,Kedah,92,54,38,2010
2010-07-25,Kedah,297,117,180,2010
2010-07-26,Kedah,149,73,76,2010
2010-07-27,Kedah,257,172,85,2010
2010-07-28,Kedah,163,84,79,2010
2010-07-29,Kedah,169,101,68,2010
2010-07-30,Kedah,111,20,91,2010
2010-07-31,Kedah,183,154,29,2010
2010-08-01,Kedah,120,35,85,2010
2010-08-02,Kedah,147,68,79,2010
2010-08-03,Kedah,258,168,90,2010
2010-08-04,Kedah,145,75,70,2010
2010-08-05,Kedah,240,119,121,2010
2010-08-06,Kedah,279,99,180,2010
2010-08-07,Kedah,209,116,93,2010
2010-08-08,Kedah,571,170,401,2010
2010-08-09,Kedah,201,69,132,2010
2010-08-10,Kedah,188,39,149,2010
2010-08-11,Kedah,0,0,0,2010
2010-08-12,Kedah,19,2,17,2010
2010-08-13,Kedah,183,37,146,2010
2010-08-14,Kedah,51,28,23,2010
2010-08-15,Kedah,115,63,52,2010
2010-08-16,Kedah,17,1,16,2010
2010-08-17,Kedah,28,5,23,2010
2010-08-18,Kedah,81,25,56,2010
2010-08-19,Kedah,43,14,29,2010
2010-08-20,Kedah,117,46,71,2010
2010-08-21,Kedah,0,0,0,2010
2010-08-22,Kedah,69,40,29,2010
2010-08-23,Kedah,155,70,85,2010
2010-08-24,Kedah,43,12,31,2010
2010-08-25,Kedah,103,47,56,2010
2010-08-26,Kedah,114,43,71,2010
2010-08-27,Kedah,42,8,34,2010
2010-08-28,Kedah,67,43,24,2010
2010-08-29,Kedah,94,12,82,2010
2010-08-30,Kedah,22,1,21,2010
2010-08-31,Kedah,153,28,125,2010
2010-09-01,Kedah,41,17,24,2010
2010-09-02,Kedah,112,25,87,2010
2010-09-03,Kedah,127,14,113,2010
2010-09-04,Kedah,45,28,17,2010
2010-09-05,Kedah,226,155,71,2010
2010-09-06,Kedah,116,37,79,2010
2010-09-07,Kedah,70,18,52,2010
2010-09-08,Kedah,49,16,33,2010
2010-09-09,Kedah,33,7,26,2010
2010-09-10,Kedah,0,0,0,2010
2010-09-11,Kedah,0,0,0,2010
2010-09-12,Kedah,31,8,23,2010
2010-09-13,Kedah,81,24,57,2010
2010-09-14,Kedah,115,35,80,2010
2010-09-15,Kedah,133,56,77,2010
2010-09-16,Kedah,19,3,16,2010
2010-09-17,Kedah,86,28,58,2010
2010-09-18,Kedah,40,23,17,2010
2010-09-19,Kedah,269,79,190,2010
2010-09-20,Kedah,136,59,77,2010
2010-09-21,Kedah,128,42,86,2010
2010-09-22,Kedah,127,53,74,2010
2010-09-23,Kedah,148,56,92,2010
2010-09-24,Kedah,222,41,181,2010
2010-09-25,Kedah,54,26,28,2010
2010-09-26,Kedah,192,69,123,2010
2010-09-27,Kedah,144,76,68,2010
2010-09-28,Kedah,123,33,90,2010
2010-09-29,Kedah,145,45,100,2010
2010-09-30,Kedah,131,58,73,2010
2010-10-01,Kedah,109,47,62,2010
2010-10-02,Kedah,232,178,54,2010
2010-10-03,Kedah,170,75,95,2010
2010-10-04,Kedah,199,106,93,2010
2010-10-05,Kedah,111,56,55,2010
2010-10-06,Kedah,329,150,179,2010
2010-10-07,Kedah,96,17,79,2010
2010-10-08,Kedah,66,22,44,2010
2010-10-09,Kedah,0,0,0,2010
2010-10-10,Kedah,217,62,155,2010
2010-10-11,Kedah,97,40,57,2010
2010-10-12,Kedah,46,7,39,2010
2010-10-13,Kedah,113,49,64,2010
2010-10-14,Kedah,106,42,64,2010
2010-10-15,Kedah,253,60,193,2010
2010-10-16,Kedah,115,55,60,2010
2010-10-17,Kedah,147,41,106,2010
2010-10-18,Kedah,225,101,124,2010
2010-10-19,Kedah,207,89,118,2010
2010-10-20,Kedah,183,84,99,2010
2010-10-21,Kedah,250,148,102,2010
2010-10-22,Kedah,51,13,38,2010
2010-10-23,Kedah,55,34,21,2010
2010-10-24,Kedah,194,71,123,2010
2010-10-25,Kedah,39,9,30,2010
2010-10-26,Kedah,121,54,67,2010
2010-10-27,Kedah,119,71,48,2010
2010-10-28,Kedah,131,46,85,2010
2010-10-29,Kedah,159,27,132,2010
2010-10-30,Kedah,37,13,24,2010
2010-10-31,Kedah,202,42,160,2010
2010-11-01,Kedah,77,30,47,2010
2010-11-02,Kedah,125,50,75,2010
2010-11-03,Kedah,89,27,62,2010
2010-11-04,Kedah,30,9,21,2010
2010-11-05,Kedah,253,47,206,2010
2010-11-06,Kedah,76,46,30,2010
2010-11-07,Kedah,99,22,77,2010
2010-11-08,Kedah,72,32,40,2010
2010-11-09,Kedah,72,38,34,2010
2010-11-10,Kedah,76,36,40,2010
2010-11-11,Kedah,89,31,58,2010
2010-11-12,Kedah,118,23,95,2010
2010-11-13,Kedah,40,20,20,2010
2010-11-14,Kedah,283,108,175,2010
2010-11-15,Kedah,132,47,85,2010
2010-11-16,Kedah,70,20,50,2010
2010-11-17,Kedah,0,0,0,2010
2010-11-18,Kedah,35,7,28,2010
2010-11-19,Kedah,165,45,120,2010
2010-11-20,Kedah,99,52,47,2010
2010-11-21,Kedah,211,52,159,2010
2010-11-22,Kedah,95,28,67,2010
2010-11-23,Kedah,127,18,109,2010
2010-11-24,Kedah,190,38,152,2010
2010-11-25,Kedah,83,32,51,2010
2010-11-26,Kedah,148,22,126,2010
2010-11-27,Kedah,48,19,29,2010
2010-11-28,Kedah,295,97,198,2010
2010-11-29,Kedah,140,42,98,2010
2010-11-30,Kedah,53,17,36,2010
2010-12-01,Kedah,88,43,45,2010
2010-12-02,Kedah,59,14,45,2010
2010-12-03,Kedah,288,78,210,2010
2010-12-04,Kedah,51,33,18,2010
2010-12-05,Kedah,81,32,49,2010
2010-12-06,Kedah,49,11,38,2010
2010-12-07,Kedah,45,25,20,2010
2010-12-08,Kedah,99,37,62,2010
2010-12-09,Kedah,167,78,89,2010
2010-12-10,Kedah,83,30,53,2010
2010-12-11,Kedah,35,24,11,2010
2010-12-12,Kedah,278,102,176,2010
2010-12-13,Kedah,117,31,86,2010
2010-12-14,Kedah,220,99,121,2010
2010-12-15,Kedah,180,86,94,2010
2010-12-16,Kedah,347,128,219,2010
2010-12-17,Kedah,135,13,122,2010
2010-12-18,Kedah,99,44,55,2010
2010-12-19,Kedah,121,46,75,2010
2010-12-20,Kedah,67,17,50,2010
2010-12-21,Kedah,90,36,54,2010
2010-12-22,Kedah,91,38,53,2010
2010-12-23,Kedah,149,57,92,2010
2010-12-24,Kedah,37,17,20,2010
2010-12-25,Kedah,34,26,8,2010
2010-12-26,Kedah,116,64,52,2010
2010-12-27,Kedah,183,62,121,2010
2010-12-28,Kedah,166,79,87,2010
2010-12-29,Kedah,104,35,69,2010
2010-12-30,Kedah,71,14,57,2010
2010-12-31,Kedah,68,30,38,2010
2011-01-01,Kedah,0,0,0,2011
2011-01-02,Kedah,47,22,25,2011
2011-01-03,Kedah,107,30,77,2011
2011-01-04,Kedah,131,51,80,2011
2011-01-05,Kedah,171,73,98,2011
2011-01-06,Kedah,199,83,116,2011
2011-01-07,Kedah,201,56,145,2011
2011-01-08,Kedah,147,72,75,2011
2011-01-09,Kedah,283,72,211,2011
2011-01-10,Kedah,286,143,143,2011
2011-01-11,Kedah,330,198,132,2011
2011-01-12,Kedah,204,133,71,2011
2011-01-13,Kedah,268,87,181,2011
2011-01-14,Kedah,49,11,38,2011
2011-01-15,Kedah,28,14,14,2011
2011-01-16,Kedah,109,60,49,2011
2011-01-17,Kedah,240,74,166,2011
2011-01-18,Kedah,150,48,102,2011
2011-01-19,Kedah,135,41,94,2011
2011-01-20,Kedah,178,82,96,2011
2011-01-21,Kedah,237,32,205,2011
2011-01-22,Kedah,33,18,15,2011
2011-01-23,Kedah,94,31,63,2011
2011-01-24,Kedah,174,79,95,2011
2011-01-25,Kedah,175,80,95,2011
2011-01-26,Kedah,263,132,131,2011
2011-01-27,Kedah,181,83,98,2011
2011-01-28,Kedah,144,53,91,2011
2011-01-29,Kedah,185,81,104,2011
2011-01-30,Kedah,126,47,79,2011
2011-01-31,Kedah,97,24,73,2011
2011-02-01,Kedah,149,57,92,2011
2011-02-02,Kedah,92,40,52,2011
2011-02-03,Kedah,0,0,0,2011
2011-02-04,Kedah,66,31,35,2011
2011-02-05,Kedah,31,17,14,2011
2011-02-06,Kedah,8,0,8,2011
2011-02-07,Kedah,179,63,116,2011
2011-02-08,Kedah,221,98,123,2011
2011-02-09,Kedah,122,47,75,2011
2011-02-10,Kedah,208,105,103,2011
2011-02-11,Kedah,63,39,24,2011
2011-02-12,Kedah,230,153,77,2011
2011-02-13,Kedah,343,129,214,2011
2011-02-14,Kedah,144,41,103,2011
2011-02-15,Kedah,164,87,77,2011
2011-02-16,Kedah,101,31,70,2011
2011-02-17,Kedah,370,148,222,2011
2011-02-18,Kedah,163,111,52,2011
2011-02-19,Kedah,134,101,33,2011
2011-02-20,Kedah,162,62,100,2011
2011-02-21,Kedah,219,72,147,2011
2011-02-22,Kedah,199,84,115,2011
2011-02-23,Kedah,178,70,108,2011
2011-02-24,Kedah,336,183,153,2011
2011-02-25,Kedah,144,71,73,2011
2011-02-26,Kedah,121,47,74,2011
2011-02-27,Kedah,81,24,57,2011
2011-02-28,Kedah,101,33,68,2011
2011-03-01,Kedah,160,80,80,2011
2011-03-02,Kedah,90,42,48,2011
2011-03-03,Kedah,146,76,70,2011
2011-03-04,Kedah,78,54,24,2011
2011-03-05,Kedah,656,613,43,2011
2011-03-06,Kedah,298,163,135,2011
2011-03-07,Kedah,180,109,71,2011
2011-03-08,Kedah,96,32,64,2011
2011-03-09,Kedah,133,56,77,2011
2011-03-10,Kedah,228,90,138,2011
2011-03-11,Kedah,82,27,55,2011
2011-03-12,Kedah,195,124,71,2011
2011-03-13,Kedah,250,95,155,2011
2011-03-14,Kedah,51,13,38,2011
2011-03-15,Kedah,185,90,95,2011
2011-03-16,Kedah,290,154,136,2011
2011-03-17,Kedah,293,178,115,2011
2011-03-18,Kedah,75,19,56,2011
2011-03-19,Kedah,63,33,30,2011
2011-03-20,Kedah,304,97,207,2011
2011-03-21,Kedah,30,3,27,2011
2011-03-22,Kedah,58,16,42,2011
2011-03-23,Kedah,122,29,93,2011
2011-03-24,Kedah,74,33,41,2011
2011-03-25,Kedah,284,48,236,2011
2011-03-26,Kedah,180,115,65,2011
2011-03-27,Kedah,285,125,160,2011
2011-03-28,Kedah,261,89,172,2011
2011-03-29,Kedah,42,12,30,2011
2011-03-30,Kedah,30,7,23,2011
2011-03-31,Kedah,94,36,58,2011
2011-04-01,Kedah,54,27,27,2011
2011-04-02,Kedah,24,13,11,2011
2011-04-03,Kedah,58,9,49,2011
2011-04-04,Kedah,86,31,55,2011
2011-04-05,Kedah,143,54,89,2011
2011-04-06,Kedah,122,42,80,2011
2011-04-07,Kedah,140,35,105,2011
2011-04-08,Kedah,120,41,79,2011
2011-04-09,Kedah,97,28,69,2011
2011-04-10,Kedah,162,35,127,2011
2011-04-11,Kedah,76,13,63,2011
2011-04-12,Kedah,140,32,108,2011
2011-04-13,Kedah,149,34,115,2011
2011-04-14,Kedah,58,6,52,2011
2011-04-15,Kedah,293,102,191,2011
2011-04-16,Kedah,102,39,63,2011
2011-04-17,Kedah,130,38,92,2011
2011-04-18,Kedah,193,69,124,2011
2011-04-19,Kedah,142,37,105,2011
2011-04-20,Kedah,136,45,91,2011
2011-04-21,Kedah,128,63,65,2011
2011-04-22,Kedah,191,47,144,2011
2011-04-23,Kedah,157,120,37,2011
2011-04-24,Kedah,143,38,105,2011
2011-04-25,Kedah,192,91,101,2011
2011-04-26,Kedah,79,18,61,2011
2011-04-27,Kedah,136,57,79,2011
2011-04-28,Kedah,238,105,133,2011
2011-04-29,Kedah,59,15,44,2011
2011-04-30,Kedah,95,47,48,2011
2011-05-01,Kedah,727,194,533,2011
2011-05-02,Kedah,49,7,42,2011
2011-05-03,Kedah,212,78,134,2011
2011-05-04,Kedah,255,74,181,2011
2011-05-05,Kedah,89,56,33,2011
2011-05-06,Kedah,214,32,182,2011
2011-05-07,Kedah,210,48,162,2011
2011-05-08,Kedah,108,22,86,2011
2011-05-09,Kedah,139,45,94,2011
2011-05-10,Kedah,135,34,101,2011
2011-05-11,Kedah,55,12,43,2011
2011-05-12,Kedah,124,45,79,2011
2011-05-13,Kedah,35,14,21,2011
2011-05-14,Kedah,118,56,62,2011
2011-05-15,Kedah,120,43,77,2011
2011-05-16,Kedah,38,5,33,2011
2011-05-17,Kedah,61,30,31,2011
2011-05-18,Kedah,143,52,91,2011
2011-05-19,Kedah,156,61,95,2011
2011-05-20,Kedah,360,87,273,2011
2011-05-21,Kedah,33,14,19,2011
2011-05-22,Kedah,228,86,142,2011
2011-05-23,Kedah,73,7,66,2011
2011-05-24,Kedah,70,22,48,2011
2011-05-25,Kedah,47,10,37,2011
2011-05-26,Kedah,99,54,45,2011
2011-05-27,Kedah,139,23,116,2011
2011-05-28,Kedah,55,31,24,2011
2011-05-29,Kedah,153,39,114,2011
2011-05-30,Kedah,65,16,49,2011
2011-05-31,Kedah,73,22,51,2011
2011-06-01,Kedah,121,42,79,2011
2011-06-02,Kedah,481,65,416,2011
2011-06-03,Kedah,160,36,124,2011
2011-06-04,Kedah,58,5,53,2011
2011-06-05,Kedah,125,18,107,2011
2011-06-06,Kedah,85,16,69,2011
2011-06-07,Kedah,115,36,79,2011
2011-06-08,Kedah,177,67,110,2011
2011-06-09,Kedah,65,27,38,2011
2011-06-10,Kedah,87,36,51,2011
2011-06-11,Kedah,11,7,4,2011
2011-06-12,Kedah,170,43,127,2011
2011-06-13,Kedah,87,36,51,2011
2011-06-14,Kedah,171,31,140,2011
2011-06-15,Kedah,274,134,140,2011
2011-06-16,Kedah,381,185,196,2011
2011-06-17,Kedah,123,55,68,2011
2011-06-18,Kedah,0,0,0,2011
2011-06-19,Kedah,292,142,150,2011
2011-06-20,Kedah,124,59,65,2011
2011-06-21,Kedah,147,71,76,2011
2011-06-22,Kedah,171,83,88,2011
2011-06-23,Kedah,138,51,87,2011
2011-06-24,Kedah,231,48,183,2011
2011-06-25,Kedah,95,47,48,2011
2011-06-26,Kedah,237,71,166,2011
2011-06-27,Kedah,134,78,56,2011
2011-06-28,Kedah,162,82,80,2011
2011-06-29,Kedah,145,91,54,2011
2011-06-30,Kedah,174,78,96,2011
2011-07-01,Kedah,135,28,107,2011
2011-07-02,Kedah,63,23,40,2011
2011-07-03,Kedah,75,20,55,2011
2011-07-04,Kedah,121,61,60,2011
2011-07-05,Kedah,154,82,72,2011
2011-07-06,Kedah,121,54,67,2011
2011-07-07,Kedah,246,160,86,2011
2011-07-08,Kedah,190,72,118,2011
2011-07-09,Kedah,325,275,50,2011
2011-07-10,Kedah,192,45,147,2011
2011-07-11,Kedah,142,63,79,2011
2011-07-12,Kedah,55,24,31,2011
2011-07-13,Kedah,137,63,74,2011
2011-07-14,Kedah,126,73,53,2011
2011-07-15,Kedah,71,22,49,2011
2011-07-16,Kedah,102,51,51,2011
2011-07-17,Kedah,368,103,265,2011
2011-07-18,Kedah,95,30,65,2011
2011-07-19,Kedah,83,29,54,2011
2011-07-20,Kedah,243,86,157,2011
2011-07-21,Kedah,80,17,63,2011
2011-07-22,Kedah,439,182,257,2011
2011-07-23,Kedah,303,117,186,2011
2011-07-24,Kedah,174,55,119,2011
2011-07-25,Kedah,176,88,88,2011
2011-07-26,Kedah,286,123,163,2011
2011-07-27,Kedah,334,169,165,2011
2011-07-28,Kedah,294,108,186,2011
2011-07-29,Kedah,148,40,108,2011
2011-07-30,Kedah,38,17,21,2011
2011-07-31,Kedah,320,155,165,2011
2011-08-01,Kedah,1,0,1,2011
2011-08-02,Kedah,25,3,22,2011
2011-08-03,Kedah,11,0,11,2011
2011-08-04,Kedah,24,7,17,2011
2011-08-05,Kedah,52,13,39,2011
2011-08-06,Kedah,47,22,25,2011
2011-08-07,Kedah,198,90,108,2011
2011-08-08,Kedah,28,2,26,2011
2011-08-09,Kedah,94,24,70,2011
2011-08-10,Kedah,20,2,18,2011
2011-08-11,Kedah,117,58,59,2011
2011-08-12,Kedah,39,25,14,2011
2011-08-13,Kedah,135,57,78,2011
2011-08-14,Kedah,77,15,62,2011
2011-08-15,Kedah,65,34,31,2011
2011-08-16,Kedah,44,3,41,2011
2011-08-17,Kedah,69,35,34,2011
2011-08-18,Kedah,87,26,61,2011
2011-08-19,Kedah,153,72,81,2011
2011-08-20,Kedah,64,27,37,2011
2011-08-21,Kedah,286,84,202,2011
2011-08-22,Kedah,19,3,16,2011
2011-08-23,Kedah,94,48,46,2011
2011-08-24,Kedah,137,25,112,2011
2011-08-25,Kedah,15,0,15,2011
2011-08-26,Kedah,395,55,340,2011
2011-08-27,Kedah,0,0,0,2011
2011-08-28,Kedah,79,31,48,2011
2011-08-29,Kedah,42,13,29,2011
2011-08-30,Kedah,0,0,0,2011
2011-08-31,Kedah,17,0,17,2011
2011-09-01,Kedah,32,6,26,2011
2011-09-02,Kedah,148,37,111,2011
2011-09-03,Kedah,36,16,20,2011
2011-09-04,Kedah,169,33,136,2011
2011-09-05,Kedah,113,28,85,2011
2011-09-06,Kedah,149,35,114,2011
2011-09-07,Kedah,71,11,60,2011
2011-09-08,Kedah,116,51,65,2011
2011-09-09,Kedah,141,48,93,2011
2011-09-10,Kedah,368,255,113,2011
2011-09-11,Kedah,259,97,162,2011
2011-09-12,Kedah,113,41,72,2011
2011-09-13,Kedah,214,72,142,2011
2011-09-14,Kedah,224,98,126,2011
2011-09-15,Kedah,145,99,46,2011
2011-09-16,Kedah,67,11,56,2011
2011-09-17,Kedah,49,18,31,2011
2011-09-18,Kedah,130,70,60,2011
2011-09-19,Kedah,128,25,103,2011
2011-09-20,Kedah,201,49,152,2011
2011-09-21,Kedah,237,97,140,2011
2011-09-22,Kedah,225,116,109,2011
2011-09-23,Kedah,157,16,141,2011
2011-09-24,Kedah,128,53,75,2011
2011-09-25,Kedah,230,87,143,2011
2011-09-26,Kedah,191,99,92,2011
2011-09-27,Kedah,156,52,104,2011
2011-09-28,Kedah,143,49,94,2011
2011-09-29,Kedah,117,47,70,2011
2011-09-30,Kedah,137,67,70,2011
2011-10-01,Kedah,61,31,30,2011
2011-10-02,Kedah,162,92,70,2011
2011-10-03,Kedah,92,27,65,2011
2011-10-04,Kedah,203,59,144,2011
2011-10-05,Kedah,249,94,155,2011
2011-10-06,Kedah,119,49,70,2011
2011-10-07,Kedah,148,43,105,2011
2011-10-08,Kedah,108,39,69,2011
2011-10-09,Kedah,245,69,176,2011
2011-10-10,Kedah,204,76,128,2011
2011-10-11,Kedah,181,69,112,2011
2011-10-12,Kedah,152,64,88,2011
2011-10-13,Kedah,166,50,116,2011
2011-10-14,Kedah,27,10,17,2011
2011-10-15,Kedah,90,40,50,2011
2011-10-16,Kedah,150,46,104,2011
2011-10-17,Kedah,138,33,105,2011
2011-10-18,Kedah,161,63,98,2011
2011-10-19,Kedah,215,89,126,2011
2011-10-20,Kedah,140,75,65,2011
2011-10-21,Kedah,93,31,62,2011
2011-10-22,Kedah,56,23,33,2011
2011-10-23,Kedah,174,49,125,2011
2011-10-24,Kedah,210,68,142,2011
2011-10-25,Kedah,106,43,63,2011
2011-10-26,Kedah,466,78,388,2011
2011-10-27,Kedah,101,32,69,2011
2011-10-28,Kedah,114,8,106,2011
2011-10-29,Kedah,84,44,40,2011
2011-10-30,Kedah,76,19,57,2011
2011-10-31,Kedah,98,27,71,2011
2011-11-01,Kedah,112,37,75,2011
2011-11-02,Kedah,118,32,86,2011
2011-11-03,Kedah,257,124,133,2011
2011-11-04,Kedah,106,30,76,2011
2011-11-05,Kedah,0,0,0,2011
2011-11-06,Kedah,0,0,0,2011
2011-11-07,Kedah,19,7,12,2011
2011-11-08,Kedah,106,32,74,2011
2011-11-09,Kedah,92,24,68,2011
2011-11-10,Kedah,149,53,96,2011
2011-11-11,Kedah,347,165,182,2011
2011-11-12,Kedah,311,264,47,2011
2011-11-13,Kedah,69,21,48,2011
2011-11-14,Kedah,134,53,81,2011
2011-11-15,Kedah,109,27,82,2011
2011-11-16,Kedah,148,46,102,2011
2011-11-17,Kedah,129,55,74,2011
2011-11-18,Kedah,217,67,150,2011
2011-11-19,Kedah,168,96,72,2011
2011-11-20,Kedah,65,20,45,2011
2011-11-21,Kedah,109,38,71,2011
2011-11-22,Kedah,131,60,71,2011
2011-11-23,Kedah,176,51,125,2011
2011-11-24,Kedah,128,64,64,2011
2011-11-25,Kedah,114,18,96,2011
2011-11-26,Kedah,62,27,35,2011
2011-11-27,Kedah,338,110,228,2011
2011-11-28,Kedah,53,11,42,2011
2011-11-29,Kedah,184,70,114,2011
2011-11-30,Kedah,87,45,42,2011
2011-12-01,Kedah,327,154,173,2011
2011-12-02,Kedah,149,83,66,2011
2011-12-03,Kedah,24,12,12,2011
2011-12-04,Kedah,204,72,132,2011
2011-12-05,Kedah,118,58,60,2011
2011-12-06,Kedah,155,48,107,2011
2011-12-07,Kedah,230,92,138,2011
2011-12-08,Kedah,221,111,110,2011
2011-12-09,Kedah,65,40,25,2011
2011-12-10,Kedah,55,22,33,2011
2011-12-11,Kedah,191,54,137,2011
2011-12-12,Kedah,103,38,65,2011
2011-12-13,Kedah,133,54,79,2011
2011-12-14,Kedah,134,40,94,2011
2011-12-15,Kedah,205,90,115,2011
2011-12-16,Kedah,98,37,61,2011
2011-12-17,Kedah,85,48,37,2011
2011-12-18,Kedah,351,83,268,2011
2011-12-19,Kedah,89,35,54,2011
2011-12-20,Kedah,210,82,128,2011
2011-12-21,Kedah,265,122,143,2011
2011-12-22,Kedah,137,41,96,2011
2011-12-23,Kedah,160,32,128,2011
2011-12-24,Kedah,53,20,33,2011
2011-12-25,Kedah,24,17,7,2011
2011-12-26,Kedah,102,21,81,2011
2011-12-27,Kedah,119,26,93,2011
2011-12-28,Kedah,138,56,82,2011
2011-12-29,Kedah,135,70,65,2011
2011-12-30,Kedah,135,15,120,2011
2011-12-31,Kedah,27,11,16,2011
2012-01-01,Kedah,54,10,44,2012
2012-01-02,Kedah,86,22,64,2012
2012-01-03,Kedah,143,39,104,2012
2012-01-04,Kedah,205,52,153,2012
2012-01-05,Kedah,150,90,60,2012
2012-01-06,Kedah,91,37,54,2012
2012-01-07,Kedah,80,37,43,2012
2012-01-08,Kedah,158,18,140,2012
2012-01-09,Kedah,206,88,118,2012
2012-01-10,Kedah,222,99,123,2012
2012-01-11,Kedah,140,50,90,2012
2012-01-12,Kedah,287,158,129,2012
2012-01-13,Kedah,29,11,18,2012
2012-01-14,Kedah,64,27,37,2012
2012-01-15,Kedah,77,44,33,2012
2012-01-16,Kedah,104,26,78,2012
2012-01-17,Kedah,175,56,119,2012
2012-01-18,Kedah,231,88,143,2012
2012-01-19,Kedah,543,157,386,2012
2012-01-20,Kedah,74,28,46,2012
2012-01-21,Kedah,20,5,15,2012
2012-01-22,Kedah,97,28,69,2012
2012-01-23,Kedah,80,36,44,2012
2012-01-24,Kedah,30,15,15,2012
2012-01-25,Kedah,154,40,114,2012
2012-01-26,Kedah,139,48,91,2012
2012-01-27,Kedah,89,49,40,2012
2012-01-28,Kedah,499,316,183,2012
2012-01-29,Kedah,124,29,95,2012
2012-01-30,Kedah,199,60,139,2012
2012-01-31,Kedah,158,62,96,2012
2012-02-01,Kedah,114,34,80,2012
2012-02-02,Kedah,255,93,162,2012
2012-02-03,Kedah,76,38,38,2012
2012-02-04,Kedah,97,46,51,2012
2012-02-05,Kedah,88,24,64,2012
2012-02-06,Kedah,126,46,80,2012
2012-02-07,Kedah,124,49,75,2012
2012-02-08,Kedah,168,65,103,2012
2012-02-09,Kedah,181,102,79,2012
2012-02-10,Kedah,154,59,95,2012
2012-02-11,Kedah,141,62,79,2012
2012-02-12,Kedah,161,72,89,2012
2012-02-13,Kedah,113,21,92,2012
2012-02-14,Kedah,135,47,88,2012
2012-02-15,Kedah,125,56,69,2012
2012-02-16,Kedah,241,161,80,2012
2012-02-17,Kedah,57,17,40,2012
2012-02-18,Kedah,131,72,59,2012
2012-02-19,Kedah,350,170,180,2012
2012-02-20,Kedah,102,33,69,2012
2012-02-21,Kedah,60,15,45,2012
2012-02-22,Kedah,139,66,73,2012
2012-02-23,Kedah,210,87,123,2012
2012-02-24,Kedah,367,146,221,2012
2012-02-25,Kedah,464,406,58,2012
2012-02-26,Kedah,242,106,136,2012
2012-02-27,Kedah,168,46,122,2012
2012-02-28,Kedah,150,41,109,2012
2012-02-29,Kedah,168,45,123,2012
2012-03-01,Kedah,92,24,68,2012
2012-03-02,Kedah,148,73,75,2012
2012-03-03,Kedah,173,57,116,2012
2012-03-04,Kedah,246,96,150,2012
2012-03-05,Kedah,124,30,94,2012
2012-03-06,Kedah,191,54,137,2012
2012-03-07,Kedah,163,65,98,2012
2012-03-08,Kedah,143,49,94,2012
2012-03-09,Kedah,73,24,49,2012
2012-03-10,Kedah,149,99,50,2012
2012-03-11,Kedah,232,78,154,2012
2012-03-12,Kedah,47,8,39,2012
2012-03-13,Kedah,80,24,56,2012
2012-03-14,Kedah,242,90,152,2012
2012-03-15,Kedah,63,25,38,2012
2012-03-16,Kedah,76,9,67,2012
2012-03-17,Kedah,101,33,68,2012
2012-03-18,Kedah,231,106,125,2012
2012-03-19,Kedah,88,38,50,2012
2012-03-20,Kedah,134,22,112,2012
2012-03-21,Kedah,137,47,90,2012
2012-03-22,Kedah,107,23,84,2012
2012-03-23,Kedah,264,31,233,2012
2012-03-24,Kedah,76,30,46,2012
2012-03-25,Kedah,242,66,176,2012
2012-03-26,Kedah,74,12,62,2012
2012-03-27,Kedah,221,77,144,2012
2012-03-28,Kedah,70,21,49,2012
2012-03-29,Kedah,132,72,60,2012
2012-03-30,Kedah,172,53,119,2012
2012-03-31,Kedah,101,46,55,2012
2012-04-01,Kedah,142,72,70,2012
2012-04-02,Kedah,101,30,71,2012
2012-04-03,Kedah,174,58,116,2012
2012-04-04,Kedah,65,18,47,2012
2012-04-05,Kedah,277,57,220,2012
2012-04-06,Kedah,53,21,32,2012
2012-04-07,Kedah,116,56,60,2012
2012-04-08,Kedah,248,25,223,2012
2012-04-09,Kedah,90,24,66,2012
2012-04-10,Kedah,136,48,88,2012
2012-04-11,Kedah,110,56,54,2012
2012-04-12,Kedah,63,11,52,2012
2012-04-13,Kedah,188,40,148,2012
2012-04-14,Kedah,20,14,6,2012
2012-04-15,Kedah,281,69,212,2012
2012-04-16,Kedah,87,28,59,2012
2012-04-17,Kedah,187,58,129,2012
2012-04-18,Kedah,92,32,60,2012
2012-04-19,Kedah,91,49,42,2012
2012-04-20,Kedah,137,47,90,2012
2012-04-21,Kedah,101,50,51,2012
2012-04-22,Kedah,271,74,197,2012
2012-04-23,Kedah,186,90,96,2012
2012-04-24,Kedah,58,12,46,2012
2012-04-25,Kedah,108,47,61,2012
2012-04-26,Kedah,85,27,58,2012
2012-04-27,Kedah,93,24,69,2012
2012-04-28,Kedah,119,58,61,2012
2012-04-29,Kedah,182,70,112,2012
2012-04-30,Kedah,156,67,89,2012
2012-05-01,Kedah,678,103,575,2012
2012-05-02,Kedah,79,16,63,2012
2012-05-03,Kedah,81,14,67,2012
2012-05-04,Kedah,202,50,152,2012
2012-05-05,Kedah,189,63,126,2012
2012-05-06,Kedah,84,23,61,2012
2012-05-07,Kedah,179,63,116,2012
2012-05-08,Kedah,75,15,60,2012
2012-05-09,Kedah,105,23,82,2012
2012-05-10,Kedah,131,44,87,2012
2012-05-11,Kedah,113,23,90,2012
2012-05-12,Kedah,94,55,39,2012
2012-05-13,Kedah,225,42,183,2012
2012-05-14,Kedah,286,91,195,2012
2012-05-15,Kedah,156,47,109,2012
2012-05-16,Kedah,142,63,79,2012
2012-05-17,Kedah,126,50,76,2012
2012-05-18,Kedah,139,27,112,2012
2012-05-19,Kedah,103,44,59,2012
2012-05-20,Kedah,190,88,102,2012
2012-05-21,Kedah,78,18,60,2012
2012-05-22,Kedah,102,26,76,2012
2012-05-23,Kedah,163,69,94,2012
2012-05-24,Kedah,146,98,48,2012
2012-05-25,Kedah,69,14,55,2012
2012-05-26,Kedah,92,35,57,2012
2012-05-27,Kedah,261,55,206,2012
2012-05-28,Kedah,78,22,56,2012
2012-05-29,Kedah,109,30,79,2012
2012-05-30,Kedah,69,19,50,2012
2012-05-31,Kedah,67,16,51,2012
2012-06-01,Kedah,144,15,129,2012
2012-06-02,Kedah,75,22,53,2012
2012-06-03,Kedah,116,51,65,2012
2012-06-04,Kedah,78,15,63,2012
2012-06-05,Kedah,80,29,51,2012
2012-06-06,Kedah,157,86,71,2012
2012-06-07,Kedah,125,45,80,2012
2012-06-08,Kedah,168,83,85,2012
2012-06-09,Kedah,69,38,31,2012
2012-06-10,Kedah,175,30,145,2012
2012-06-11,Kedah,90,40,50,2012
2012-06-12,Kedah,140,40,100,2012
2012-06-13,Kedah,162,37,125,2012
2012-06-14,Kedah,431,145,286,2012
2012-06-15,Kedah,141,24,117,2012
2012-06-16,Kedah,80,47,33,2012
2012-06-17,Kedah,106,46,60,2012
2012-06-18,Kedah,68,9,59,2012
2012-06-19,Kedah,191,71,120,2012
2012-06-20,Kedah,283,111,172,2012
2012-06-21,Kedah,422,213,209,2012
2012-06-22,Kedah,313,60,253,2012
2012-06-23,Kedah,350,313,37,2012
2012-06-24,Kedah,222,83,139,2012
2012-06-25,Kedah,130,66,64,2012
2012-06-26,Kedah,124,55,69,2012
2012-06-27,Kedah,77,32,45,2012
2012-06-28,Kedah,271,121,150,2012
2012-06-29,Kedah,170,63,107,2012
2012-06-30,Kedah,207,141,66,2012
2012-07-01,Kedah,105,35,70,2012
2012-07-02,Kedah,65,15,50,2012
2012-07-03,Kedah,227,108,119,2012
2012-07-04,Kedah,152,32,120,2012
2012-07-05,Kedah,119,57,62,2012
2012-07-06,Kedah,182,50,132,2012
2012-07-07,Kedah,270,129,141,2012
2012-07-08,Kedah,234,99,135,2012
2012-07-09,Kedah,109,51,58,2012
2012-07-10,Kedah,180,101,79,2012
2012-07-11,Kedah,252,138,114,2012
2012-07-12,Kedah,233,132,101,2012
2012-07-13,Kedah,205,40,165,2012
2012-07-14,Kedah,103,44,59,2012
2012-07-15,Kedah,308,94,214,2012
2012-07-16,Kedah,145,54,91,2012
2012-07-17,Kedah,269,110,159,2012
2012-07-18,Kedah,342,143,199,2012
2012-07-19,Kedah,169,68,101,2012
2012-07-20,Kedah,158,55,103,2012
2012-07-21,Kedah,0,0,0,2012
2012-07-22,Kedah,35,6,29,2012
2012-07-23,Kedah,50,14,36,2012
2012-07-24,Kedah,37,11,26,2012
2012-07-25,Kedah,95,46,49,2012
2012-07-26,Kedah,18,2,16,2012
2012-07-27,Kedah,128,21,107,2012
2012-07-28,Kedah,54,21,33,2012
2012-07-29,Kedah,276,125,151,2012
2012-07-30,Kedah,25,3,22,2012
2012-07-31,Kedah,56,8,48,2012
2012-08-01,Kedah,133,65,68,2012
2012-08-02,Kedah,11,2,9,2012
2012-08-03,Kedah,37,15,22,2012
2012-08-04,Kedah,61,22,39,2012
2012-08-05,Kedah,216,102,114,2012
2012-08-06,Kedah,40,12,28,2012
2012-08-07,Kedah,37,3,34,2012
2012-08-08,Kedah,151,65,86,2012
2012-08-09,Kedah,37,14,23,2012
2012-08-10,Kedah,26,15,11,2012
2012-08-11,Kedah,100,41,59,2012
2012-08-12,Kedah,317,64,253,2012
2012-08-13,Kedah,87,32,55,2012
2012-08-14,Kedah,243,105,138,2012
2012-08-15,Kedah,25,5,20,2012
2012-08-16,Kedah,15,1,14,2012
2012-08-17,Kedah,101,35,66,2012
2012-08-18,Kedah,0,0,0,2012
2012-08-19,Kedah,0,0,0,2012
2012-08-20,Kedah,25,4,21,2012
2012-08-21,Kedah,33,5,28,2012
2012-08-22,Kedah,91,27,64,2012
2012-08-23,Kedah,104,31,73,2012
2012-08-24,Kedah,223,23,200,2012
2012-08-25,Kedah,40,16,24,2012
2012-08-26,Kedah,250,78,172,2012
2012-08-27,Kedah,93,33,60,2012
2012-08-28,Kedah,143,36,107,2012
2012-08-29,Kedah,136,44,92,2012
2012-08-30,Kedah,123,52,71,2012
2012-08-31,Kedah,214,56,158,2012
2012-09-01,Kedah,61,24,37,2012
2012-09-02,Kedah,80,12,68,2012
2012-09-03,Kedah,123,42,81,2012
2012-09-04,Kedah,143,29,114,2012
2012-09-05,Kedah,249,113,136,2012
2012-09-06,Kedah,228,46,182,2012
2012-09-07,Kedah,135,34,101,2012
2012-09-08,Kedah,88,35,53,2012
2012-09-09,Kedah,460,121,339,2012
2012-09-10,Kedah,136,37,99,2012
2012-09-11,Kedah,893,568,325,2012
2012-09-12,Kedah,135,48,87,2012
2012-09-13,Kedah,56,10,46,2012
2012-09-14,Kedah,72,23,49,2012
2012-09-15,Kedah,98,47,51,2012
2012-09-16,Kedah,201,63,138,2012
2012-09-17,Kedah,56,4,52,2012
2012-09-18,Kedah,139,37,102,2012
2012-09-19,Kedah,109,33,76,2012
2012-09-20,Kedah,131,47,84,2012
2012-09-21,Kedah,65,21,44,2012
2012-09-22,Kedah,49,28,21,2012
2012-09-23,Kedah,255,102,153,2012
2012-09-24,Kedah,153,44,109,2012
2012-09-25,Kedah,33,2,31,2012
2012-09-26,Kedah,109,56,53,2012
2012-09-27,Kedah,163,93,70,2012
2012-09-28,Kedah,268,35,233,2012
2012-09-29,Kedah,103,31,72,2012
2012-09-30,Kedah,174,69,105,2012
2012-10-01,Kedah,97,27,70,2012
2012-10-02,Kedah,92,22,70,2012
2012-10-03,Kedah,118,27,91,2012
2012-10-04,Kedah,135,34,101,2012
2012-10-05,Kedah,60,15,45,2012
2012-10-06,Kedah,131,50,81,2012
2012-10-07,Kedah,233,76,157,2012
2012-10-08,Kedah,322,98,224,2012
2012-10-09,Kedah,284,94,190,2012
2012-10-10,Kedah,210,67,143,2012
2012-10-11,Kedah,222,69,153,2012
2012-10-12,Kedah,81,23,58,2012
2012-10-13,Kedah,128,61,67,2012
2012-10-14,Kedah,205,51,154,2012
2012-10-15,Kedah,112,46,66,2012
2012-10-16,Kedah,158,35,123,2012
2012-10-17,Kedah,204,58,146,2012
2012-10-18,Kedah,95,37,58,2012
2012-10-19,Kedah,149,20,129,2012
2012-10-20,Kedah,160,62,98,2012
2012-10-21,Kedah,148,31,117,2012
2012-10-22,Kedah,122,35,87,2012
2012-10-23,Kedah,185,75,110,2012
2012-10-24,Kedah,203,51,152,2012
2012-10-25,Kedah,50,14,36,2012
2012-10-26,Kedah,0,0,0,2012
2012-10-27,Kedah,0,0,0,2012
2012-10-28,Kedah,42,12,30,2012
2012-10-29,Kedah,71,10,61,2012
2012-10-30,Kedah,100,20,80,2012
2012-10-31,Kedah,108,23,85,2012
2012-11-01,Kedah,85,32,53,2012
2012-11-02,Kedah,335,94,241,2012
2012-11-03,Kedah,75,31,44,2012
2012-11-04,Kedah,158,66,92,2012
2012-11-05,Kedah,160,27,133,2012
2012-11-06,Kedah,276,115,161,2012
2012-11-07,Kedah,327,132,195,2012
2012-11-08,Kedah,220,59,161,2012
2012-11-09,Kedah,166,35,131,2012
2012-11-10,Kedah,261,242,19,2012
2012-11-11,Kedah,93,7,86,2012
2012-11-12,Kedah,42,9,33,2012
2012-11-13,Kedah,538,105,433,2012
2012-11-14,Kedah,84,12,72,2012
2012-11-15,Kedah,35,30,5,2012
2012-11-16,Kedah,51,7,44,2012
2012-11-17,Kedah,90,53,37,2012
2012-11-18,Kedah,86,24,62,2012
2012-11-19,Kedah,78,20,58,2012
2012-11-20,Kedah,112,41,71,2012
2012-11-21,Kedah,116,33,83,2012
2012-11-22,Kedah,99,42,57,2012
2012-11-23,Kedah,120,45,75,2012
2012-11-24,Kedah,67,29,38,2012
2012-11-25,Kedah,273,136,137,2012
2012-11-26,Kedah,110,55,55,2012
2012-11-27,Kedah,125,58,67,2012
2012-11-28,Kedah,159,71,88,2012
2012-11-29,Kedah,156,54,102,2012
2012-11-30,Kedah,175,17,158,2012
2012-12-01,Kedah,90,35,55,2012
2012-12-02,Kedah,286,69,217,2012
2012-12-03,Kedah,64,14,50,2012
2012-12-04,Kedah,67,25,42,2012
2012-12-05,Kedah,174,57,117,2012
2012-12-06,Kedah,39,6,33,2012
2012-12-07,Kedah,113,48,65,2012
2012-12-08,Kedah,166,87,79,2012
2012-12-09,Kedah,255,81,174,2012
2012-12-10,Kedah,130,50,80,2012
2012-12-11,Kedah,136,35,101,2012
2012-12-12,Kedah,182,100,82,2012
2012-12-13,Kedah,169,83,86,2012
2012-12-14,Kedah,75,40,35,2012
2012-12-15,Kedah,40,14,26,2012
2012-12-16,Kedah,378,122,256,2012
2012-12-17,Kedah,166,96,70,2012
2012-12-18,Kedah,202,64,138,2012
2012-12-19,Kedah,320,168,152,2012
2012-12-20,Kedah,56,9,47,2012
2012-12-21,Kedah,164,18,146,2012
2012-12-22,Kedah,19,10,9,2012
2012-12-23,Kedah,103,61,42,2012
2012-12-24,Kedah,134,49,85,2012
2012-12-25,Kedah,84,43,41,2012
2012-12-26,Kedah,88,24,64,2012
2012-12-27,Kedah,154,68,86,2012
2012-12-28,Kedah,66,22,44,2012
2012-12-29,Kedah,44,17,27,2012
2012-12-30,Kedah,222,50,172,2012
2012-12-31,Kedah,103,19,84,2012
2013-01-01,Kedah,98,26,72,2013
2013-01-02,Kedah,139,27,112,2013
2013-01-03,Kedah,185,80,105,2013
2013-01-04,Kedah,61,28,33,2013
2013-01-05,Kedah,70,36,34,2013
2013-01-06,Kedah,98,16,82,2013
2013-01-07,Kedah,173,47,126,2013
2013-01-08,Kedah,233,88,145,2013
2013-01-09,Kedah,128,42,86,2013
2013-01-10,Kedah,185,95,90,2013
2013-01-11,Kedah,53,14,39,2013
2013-01-12,Kedah,296,260,36,2013
2013-01-13,Kedah,164,25,139,2013
2013-01-14,Kedah,208,91,117,2013
2013-01-15,Kedah,119,28,91,2013
2013-01-16,Kedah,278,89,189,2013
2013-01-17,Kedah,266,121,145,2013
2013-01-18,Kedah,7,0,7,2013
2013-01-19,Kedah,94,40,54,2013
2013-01-20,Kedah,163,48,115,2013
2013-01-21,Kedah,103,30,73,2013
2013-01-22,Kedah,208,73,135,2013
2013-01-23,Kedah,232,90,142,2013
2013-01-24,Kedah,70,28,42,2013
2013-01-25,Kedah,159,10,149,2013
2013-01-26,Kedah,75,28,47,2013
2013-01-27,Kedah,72,23,49,2013
2013-01-28,Kedah,114,43,71,2013
2013-01-29,Kedah,218,108,110,2013
2013-01-30,Kedah,275,136,139,2013
2013-01-31,Kedah,235,117,118,2013
2013-02-01,Kedah,34,12,22,2013
2013-02-02,Kedah,62,27,35,2013
2013-02-03,Kedah,171,36,135,2013
2013-02-04,Kedah,92,22,70,2013
2013-02-05,Kedah,124,20,104,2013
2013-02-06,Kedah,236,100,136,2013
2013-02-07,Kedah,441,119,322,2013
2013-02-08,Kedah,25,16,9,2013
2013-02-09,Kedah,73,32,41,2013
2013-02-10,Kedah,51,32,19,2013
2013-02-11,Kedah,98,57,41,2013
2013-02-12,Kedah,74,10,64,2013
2013-02-13,Kedah,176,17,159,2013
2013-02-14,Kedah,141,45,96,2013
2013-02-15,Kedah,51,14,37,2013
2013-02-16,Kedah,113,80,33,2013
2013-02-17,Kedah,313,173,140,2013
2013-02-18,Kedah,193,48,145,2013
2013-02-19,Kedah,203,76,127,2013
2013-02-20,Kedah,180,94,86,2013
2013-02-21,Kedah,140,80,60,2013
2013-02-22,Kedah,82,36,46,2013
2013-02-23,Kedah,110,51,59,2013
2013-02-24,Kedah,171,47,124,2013
2013-02-25,Kedah,155,52,103,2013
2013-02-26,Kedah,171,60,111,2013
2013-02-27,Kedah,173,82,91,2013
2013-02-28,Kedah,171,50,121,2013
2013-03-01,Kedah,166,12,154,2013
2013-03-02,Kedah,621,568,53,2013
2013-03-03,Kedah,199,73,126,2013
2013-03-04,Kedah,113,33,80,2013
2013-03-05,Kedah,167,35,132,2013
2013-03-06,Kedah,152,35,117,2013
2013-03-07,Kedah,97,51,46,2013
2013-03-08,Kedah,98,35,63,2013
2013-03-09,Kedah,71,37,34,2013
2013-03-10,Kedah,258,58,200,2013
2013-03-11,Kedah,52,8,44,2013
2013-03-12,Kedah,194,55,139,2013
2013-03-13,Kedah,286,102,184,2013
2013-03-14,Kedah,274,88,186,2013
2013-03-15,Kedah,125,44,81,2013
2013-03-16,Kedah,126,66,60,2013
2013-03-17,Kedah,296,132,164,2013
2013-03-18,Kedah,130,31,99,2013
2013-03-19,Kedah,355,184,171,2013
2013-03-20,Kedah,117,28,89,2013
2013-03-21,Kedah,81,16,65,2013
2013-03-22,Kedah,90,33,57,2013
2013-03-23,Kedah,60,22,38,2013
2013-03-24,Kedah,111,35,76,2013
2013-03-25,Kedah,97,22,75,2013
2013-03-26,Kedah,166,54,112,2013
2013-03-27,Kedah,69,12,57,2013
2013-03-28,Kedah,114,51,63,2013
2013-03-29,Kedah,202,38,164,2013
2013-03-30,Kedah,7,3,4,2013
2013-03-31,Kedah,117,44,73,2013
2013-04-01,Kedah,82,9,73,2013
2013-04-02,Kedah,195,77,118,2013
2013-04-03,Kedah,69,11,58,2013
2013-04-04,Kedah,91,28,63,2013
2013-04-05,Kedah,81,26,55,2013
2013-04-06,Kedah,122,55,67,2013
2013-04-07,Kedah,421,124,297,2013
2013-04-08,Kedah,64,6,58,2013
2013-04-09,Kedah,121,31,90,2013
2013-04-10,Kedah,326,103,223,2013
2013-04-11,Kedah,179,55,124,2013
2013-04-12,Kedah,107,23,84,2013
2013-04-13,Kedah,124,78,46,2013
2013-04-14,Kedah,360,82,278,2013
2013-04-15,Kedah,94,22,72,2013
2013-04-16,Kedah,93,32,61,2013
2013-04-17,Kedah,49,4,45,2013
2013-04-18,Kedah,149,47,102,2013
2013-04-19,Kedah,180,48,132,2013
2013-04-20,Kedah,136,81,55,2013
2013-04-21,Kedah,264,77,187,2013
2013-04-22,Kedah,160,57,103,2013
2013-04-23,Kedah,120,43,77,2013
2013-04-24,Kedah,59,5,54,2013
2013-04-25,Kedah,186,94,92,2013
2013-04-26,Kedah,60,21,39,2013
2013-04-27,Kedah,107,51,56,2013
2013-04-28,Kedah,326,117,209,2013
2013-04-29,Kedah,105,21,84,2013
2013-04-30,Kedah,66,13,53,2013
2013-05-01,Kedah,695,78,617,2013
2013-05-02,Kedah,34,7,27,2013
2013-05-03,Kedah,165,38,127,2013
2013-05-04,Kedah,62,28,34,2013
2013-05-05,Kedah,0,0,0,2013
2013-05-06,Kedah,75,30,45,2013
2013-05-07,Kedah,135,31,104,2013
2013-05-08,Kedah,170,52,118,2013
2013-05-09,Kedah,102,53,49,2013
2013-05-10,Kedah,25,19,6,2013
2013-05-11,Kedah,81,29,52,2013
2013-05-12,Kedah,209,54,155,2013
2013-05-13,Kedah,119,53,66,2013
2013-05-14,Kedah,151,45,106,2013
2013-05-15,Kedah,83,13,70,2013
2013-05-16,Kedah,124,40,84,2013
2013-05-17,Kedah,25,12,13,2013
2013-05-18,Kedah,164,102,62,2013
2013-05-19,Kedah,147,40,107,2013
2013-05-20,Kedah,174,38,136,2013
2013-05-21,Kedah,151,37,114,2013
2013-05-22,Kedah,261,66,195,2013
2013-05-23,Kedah,92,38,54,2013
2013-05-24,Kedah,157,48,109,2013
2013-05-25,Kedah,432,403,29,2013
2013-05-26,Kedah,59,36,23,2013
2013-05-27,Kedah,181,52,129,2013
2013-05-28,Kedah,96,28,68,2013
2013-05-29,Kedah,85,26,59,2013
2013-05-30,Kedah,182,84,98,2013
2013-05-31,Kedah,444,82,362,2013
2013-06-01,Kedah,65,13,52,2013
2013-06-02,Kedah,122,13,109,2013
2013-06-03,Kedah,73,14,59,2013
2013-06-04,Kedah,86,13,73,2013
2013-06-05,Kedah,40,9,31,2013
2013-06-06,Kedah,50,17,33,2013
2013-06-07,Kedah,96,12,84,2013
2013-06-08,Kedah,68,31,37,2013
2013-06-09,Kedah,285,84,201,2013
2013-06-10,Kedah,115,30,85,2013
2013-06-11,Kedah,347,74,273,2013
2013-06-12,Kedah,270,93,177,2013
2013-06-13,Kedah,69,29,40,2013
2013-06-14,Kedah,94,39,55,2013
2013-06-15,Kedah,82,40,42,2013
2013-06-16,Kedah,259,53,206,2013
2013-06-17,Kedah,212,102,110,2013
2013-06-18,Kedah,229,75,154,2013
2013-06-19,Kedah,140,65,75,2013
2013-06-20,Kedah,267,143,124,2013
2013-06-21,Kedah,38,14,24,2013
2013-06-22,Kedah,51,19,32,2013
2013-06-23,Kedah,283,114,169,2013
2013-06-24,Kedah,108,52,56,2013
2013-06-25,Kedah,174,50,124,2013
2013-06-26,Kedah,230,63,167,2013
2013-06-27,Kedah,149,58,91,2013
2013-06-28,Kedah,303,45,258,2013
2013-06-29,Kedah,150,26,124,2013
2013-06-30,Kedah,157,59,98,2013
2013-07-01,Kedah,107,40,67,2013
2013-07-02,Kedah,239,116,123,2013
2013-07-03,Kedah,316,145,171,2013
2013-07-04,Kedah,119,34,85,2013
2013-07-05,Kedah,10,1,9,2013
2013-07-06,Kedah,184,57,127,2013
2013-07-07,Kedah,257,78,179,2013
2013-07-08,Kedah,218,78,140,2013
2013-07-09,Kedah,160,33,127,2013
2013-07-10,Kedah,1,0,1,2013
2013-07-11,Kedah,9,0,9,2013
2013-07-12,Kedah,107,10,97,2013
2013-07-13,Kedah,68,29,39,2013
2013-07-14,Kedah,383,101,282,2013
2013-07-15,Kedah,21,0,21,2013
2013-07-16,Kedah,86,33,53,2013
2013-07-17,Kedah,72,32,40,2013
2013-07-18,Kedah,10,0,10,2013
2013-07-19,Kedah,87,44,43,2013
2013-07-20,Kedah,50,18,32,2013
2013-07-21,Kedah,142,81,61,2013
2013-07-22,Kedah,90,38,52,2013
2013-07-23,Kedah,141,78,63,2013
2013-07-24,Kedah,179,81,98,2013
2013-07-25,Kedah,29,7,22,2013
2013-07-26,Kedah,251,47,204,2013
2013-07-27,Kedah,40,22,18,2013
2013-07-28,Kedah,295,107,188,2013
2013-07-29,Kedah,40,13,27,2013
2013-07-30,Kedah,97,49,48,2013
2013-07-31,Kedah,151,48,103,2013
2013-08-01,Kedah,100,58,42,2013
2013-08-02,Kedah,37,10,27,2013
2013-08-03,Kedah,95,34,61,2013
2013-08-04,Kedah,71,13,58,2013
2013-08-05,Kedah,108,43,65,2013
2013-08-06,Kedah,124,35,89,2013
2013-08-07,Kedah,42,4,38,2013
2013-08-08,Kedah,0,0,0,2013
2013-08-09,Kedah,0,0,0,2013
2013-08-10,Kedah,39,9,30,2013
2013-08-11,Kedah,115,29,86,2013
2013-08-12,Kedah,129,34,95,2013
2013-08-13,Kedah,110,37,73,2013
2013-08-14,Kedah,213,53,160,2013
2013-08-15,Kedah,86,28,58,2013
2013-08-16,Kedah,187,43,144,2013
2013-08-17,Kedah,66,16,50,2013
2013-08-18,Kedah,276,55,221,2013
2013-08-19,Kedah,125,53,72,2013
2013-08-20,Kedah,202,134,68,2013
2013-08-21,Kedah,171,105,66,2013
2013-08-22,Kedah,264,120,144,2013
2013-08-23,Kedah,190,32,158,2013
2013-08-24,Kedah,63,15,48,2013
2013-08-25,Kedah,175,58,117,2013
2013-08-26,Kedah,150,49,101,2013
2013-08-27,Kedah,103,22,81,2013
2013-08-28,Kedah,296,158,138,2013
2013-08-29,Kedah,75,22,53,2013
2013-08-30,Kedah,88,32,56,2013
2013-08-31,Kedah,135,52,83,2013
2013-09-01,Kedah,114,39,75,2013
2013-09-02,Kedah,146,47,99,2013
2013-09-03,Kedah,79,19,60,2013
2013-09-04,Kedah,166,58,108,2013
2013-09-05,Kedah,155,66,89,2013
2013-09-06,Kedah,61,30,31,2013
2013-09-07,Kedah,244,103,141,2013
2013-09-08,Kedah,275,61,214,2013
2013-09-09,Kedah,213,97,116,2013
2013-09-10,Kedah,184,70,114,2013
2013-09-11,Kedah,184,55,129,2013
2013-09-12,Kedah,136,47,89,2013
2013-09-13,Kedah,192,54,138,2013
2013-09-14,Kedah,71,29,42,2013
2013-09-15,Kedah,190,84,106,2013
2013-09-16,Kedah,469,151,318,2013
2013-09-17,Kedah,64,11,53,2013
2013-09-18,Kedah,217,94,123,2013
2013-09-19,Kedah,273,76,197,2013
2013-09-20,Kedah,162,68,94,2013
2013-09-21,Kedah,155,56,99,2013
2013-09-22,Kedah,325,137,188,2013
2013-09-23,Kedah,127,72,55,2013
2013-09-24,Kedah,170,109,61,2013
2013-09-25,Kedah,185,59,126,2013
2013-09-26,Kedah,123,39,84,2013
2013-09-27,Kedah,303,53,250,2013
2013-09-28,Kedah,156,108,48,2013
2013-09-29,Kedah,260,42,218,2013
2013-09-30,Kedah,136,55,81,2013
2013-10-01,Kedah,134,50,84,2013
2013-10-02,Kedah,199,81,118,2013
2013-10-03,Kedah,111,49,62,2013
2013-10-04,Kedah,253,118,135,2013
2013-10-05,Kedah,126,87,39,2013
2013-10-06,Kedah,183,74,109,2013
2013-10-07,Kedah,134,34,100,2013
2013-10-08,Kedah,226,79,147,2013
2013-10-09,Kedah,114,18,96,2013
2013-10-10,Kedah,156,46,110,2013
2013-10-11,Kedah,82,37,45,2013
2013-10-12,Kedah,246,162,84,2013
2013-10-13,Kedah,270,73,197,2013
2013-10-14,Kedah,45,6,39,2013
2013-10-15,Kedah,0,0,0,2013
2013-10-16,Kedah,0,0,0,2013
2013-10-17,Kedah,375,117,258,2013
2013-10-18,Kedah,95,24,71,2013
2013-10-19,Kedah,37,16,21,2013
2013-10-20,Kedah,305,137,168,2013
2013-10-21,Kedah,113,34,79,2013
2013-10-22,Kedah,146,39,107,2013
2013-10-23,Kedah,273,83,190,2013
2013-10-24,Kedah,212,95,117,2013
2013-10-25,Kedah,284,57,227,2013
2013-10-26,Kedah,85,51,34,2013
2013-10-27,Kedah,127,50,77,2013
2013-10-28,Kedah,104,41,63,2013
2013-10-29,Kedah,54,15,39,2013
2013-10-30,Kedah,189,45,144,2013
2013-10-31,Kedah,99,26,73,2013
2013-11-01,Kedah,64,13,51,2013
2013-11-02,Kedah,416,82,334,2013
2013-11-03,Kedah,117,75,42,2013
2013-11-04,Kedah,62,17,45,2013
2013-11-05,Kedah,66,32,34,2013
2013-11-06,Kedah,116,23,93,2013
2013-11-07,Kedah,90,21,69,2013
2013-11-08,Kedah,24,5,19,2013
2013-11-09,Kedah,57,21,36,2013
2013-11-10,Kedah,177,52,125,2013
2013-11-11,Kedah,169,38,131,2013
2013-11-12,Kedah,118,30,88,2013
2013-11-13,Kedah,114,39,75,2013
2013-11-14,Kedah,158,63,95,2013
2013-11-15,Kedah,207,43,164,2013
2013-11-16,Kedah,120,43,77,2013
2013-11-17,Kedah,278,62,216,2013
2013-11-18,Kedah,88,14,74,2013
2013-11-19,Kedah,253,115,138,2013
2013-11-20,Kedah,132,36,96,2013
2013-11-21,Kedah,125,51,74,2013
2013-11-22,Kedah,160,37,123,2013
2013-11-23,Kedah,146,41,105,2013
2013-11-24,Kedah,202,81,121,2013
2013-11-25,Kedah,176,39,137,2013
2013-11-26,Kedah,224,47,177,2013
2013-11-27,Kedah,129,39,90,2013
2013-11-28,Kedah,173,82,91,2013
2013-11-29,Kedah,177,18,159,2013
2013-11-30,Kedah,115,56,59,2013
2013-12-01,Kedah,317,110,207,2013
2013-12-02,Kedah,66,8,58,2013
2013-12-03,Kedah,114,39,75,2013
2013-12-04,Kedah,71,18,53,2013
2013-12-05,Kedah,154,68,86,2013
2013-12-06,Kedah,7,0,7,2013
2013-12-07,Kedah,145,67,78,2013
2013-12-08,Kedah,189,41,148,2013
2013-12-09,Kedah,72,16,56,2013
2013-12-10,Kedah,252,109,143,2013
2013-12-11,Kedah,206,71,135,2013
2013-12-12,Kedah,221,96,125,2013
2013-12-13,Kedah,77,35,42,2013
2013-12-14,Kedah,55,33,22,2013
2013-12-15,Kedah,436,93,343,2013
2013-12-16,Kedah,73,9,64,2013
2013-12-17,Kedah,159,43,116,2013
2013-12-18,Kedah,229,88,141,2013
2013-12-19,Kedah,141,49,92,2013
2013-12-20,Kedah,75,27,48,2013
2013-12-21,Kedah,82,30,52,2013
2013-12-22,Kedah,284,156,128,2013
2013-12-23,Kedah,148,48,100,2013
2013-12-24,Kedah,93,26,67,2013
2013-12-25,Kedah,70,22,48,2013
2013-12-26,Kedah,57,4,53,2013
2013-12-27,Kedah,234,44,190,2013
2013-12-28,Kedah,126,53,73,2013
2013-12-29,Kedah,204,71,133,2013
2013-12-30,Kedah,167,46,121,2013
2013-12-31,Kedah,104,26,78,2013
2014-01-01,Kedah,149,43,106,2014
2014-01-02,Kedah,130,34,96,2014
2014-01-03,Kedah,92,12,80,2014
2014-01-04,Kedah,176,102,74,2014
2014-01-05,Kedah,137,39,98,2014
2014-01-06,Kedah,139,29,110,2014
2014-01-07,Kedah,206,69,137,2014
2014-01-08,Kedah,336,113,223,2014
2014-01-09,Kedah,89,48,41,2014
2014-01-10,Kedah,144,44,100,2014
2014-01-11,Kedah,107,41,66,2014
2014-01-12,Kedah,250,56,194,2014
2014-01-13,Kedah,74,18,56,2014
2014-01-14,Kedah,63,21,42,2014
2014-01-15,Kedah,129,48,81,2014
2014-01-16,Kedah,240,53,187,2014
2014-01-17,Kedah,70,19,51,2014
2014-01-18,Kedah,34,9,25,2014
2014-01-19,Kedah,147,19,128,2014
2014-01-20,Kedah,205,93,112,2014
2014-01-21,Kedah,289,133,156,2014
2014-01-22,Kedah,126,46,80,2014
2014-01-23,Kedah,189,99,90,2014
2014-01-24,Kedah,29,11,18,2014
2014-01-25,Kedah,258,181,77,2014
2014-01-26,Kedah,196,37,159,2014
2014-01-27,Kedah,180,69,111,2014
2014-01-28,Kedah,352,173,179,2014
2014-01-29,Kedah,330,154,176,2014
2014-01-30,Kedah,158,71,87,2014
2014-01-31,Kedah,66,30,36,2014
2014-02-01,Kedah,75,34,41,2014
2014-02-02,Kedah,64,31,33,2014
2014-02-03,Kedah,114,32,82,2014
2014-02-04,Kedah,85,15,70,2014
2014-02-05,Kedah,221,98,123,2014
2014-02-06,Kedah,148,77,71,2014
2014-02-07,Kedah,53,29,24,2014
2014-02-08,Kedah,47,27,20,2014
2014-02-09,Kedah,253,61,192,2014
2014-02-10,Kedah,168,74,94,2014
2014-02-11,Kedah,176,81,95,2014
2014-02-12,Kedah,210,132,78,2014
2014-02-13,Kedah,127,56,71,2014
2014-02-14,Kedah,128,41,87,2014
2014-02-15,Kedah,317,260,57,2014
2014-02-16,Kedah,151,80,71,2014
2014-02-17,Kedah,140,29,111,2014
2014-02-18,Kedah,139,24,115,2014
2014-02-19,Kedah,123,33,90,2014
2014-02-20,Kedah,125,54,71,2014
2014-02-21,Kedah,34,6,28,2014
2014-02-22,Kedah,134,62,72,2014
2014-02-23,Kedah,411,174,237,2014
2014-02-24,Kedah,94,23,71,2014
2014-02-25,Kedah,230,89,141,2014
2014-02-26,Kedah,312,129,183,2014
2014-02-27,Kedah,312,106,206,2014
2014-02-28,Kedah,231,28,203,2014
2014-03-01,Kedah,162,123,39,2014
2014-03-02,Kedah,123,30,93,2014
2014-03-03,Kedah,96,21,75,2014
2014-03-04,Kedah,127,40,87,2014
2014-03-05,Kedah,173,44,129,2014
2014-03-06,Kedah,100,23,77,2014
2014-03-07,Kedah,274,93,181,2014
2014-03-08,Kedah,658,605,53,2014
2014-03-09,Kedah,196,29,167,2014
2014-03-10,Kedah,175,50,125,2014
2014-03-11,Kedah,72,19,53,2014
2014-03-12,Kedah,188,57,131,2014
2014-03-13,Kedah,93,35,58,2014
2014-03-14,Kedah,144,33,111,2014
2014-03-15,Kedah,140,53,87,2014
2014-03-16,Kedah,380,106,274,2014
2014-03-17,Kedah,72,17,55,2014
2014-03-18,Kedah,111,29,82,2014
2014-03-19,Kedah,221,86,135,2014
2014-03-20,Kedah,141,45,96,2014
2014-03-21,Kedah,266,47,219,2014
2014-03-22,Kedah,220,116,104,2014
2014-03-23,Kedah,112,29,83,2014
2014-03-24,Kedah,118,34,84,2014
2014-03-25,Kedah,214,74,140,2014
2014-03-26,Kedah,110,20,90,2014
2014-03-27,Kedah,365,239,126,2014
2014-03-28,Kedah,115,50,65,2014
2014-03-29,Kedah,90,28,62,2014
2014-03-30,Kedah,139,33,106,2014
2014-03-31,Kedah,250,79,171,2014
2014-04-01,Kedah,165,31,134,2014
2014-04-02,Kedah,149,41,108,2014
2014-04-03,Kedah,268,79,189,2014
2014-04-04,Kedah,63,21,42,2014
2014-04-05,Kedah,71,23,48,2014
2014-04-06,Kedah,75,11,64,2014
2014-04-07,Kedah,164,38,126,2014
2014-04-08,Kedah,148,41,107,2014
2014-04-09,Kedah,126,33,93,2014
2014-04-10,Kedah,162,92,70,2014
2014-04-11,Kedah,121,34,87,2014
2014-04-12,Kedah,150,51,99,2014
2014-04-13,Kedah,263,77,186,2014
2014-04-14,Kedah,55,12,43,2014
2014-04-15,Kedah,280,101,179,2014
2014-04-16,Kedah,105,34,71,2014
2014-04-17,Kedah,83,32,51,2014
2014-04-18,Kedah,179,46,133,2014
2014-04-19,Kedah,99,30,69,2014
2014-04-20,Kedah,229,99,130,2014
2014-04-21,Kedah,125,37,88,2014
2014-04-22,Kedah,167,43,124,2014
2014-04-23,Kedah,238,111,127,2014
2014-04-24,Kedah,116,42,74,2014
2014-04-25,Kedah,278,82,196,2014
2014-04-26,Kedah,94,34,60,2014
2014-04-27,Kedah,249,77,172,2014
2014-04-28,Kedah,130,30,100,2014
2014-04-29,Kedah,268,123,145,2014
2014-04-30,Kedah,117,42,75,2014
2014-05-01,Kedah,714,106,608,2014
2014-05-02,Kedah,19,9,10,2014
2014-05-03,Kedah,125,47,78,2014
2014-05-04,Kedah,124,21,103,2014
2014-05-05,Kedah,201,50,151,2014
2014-05-06,Kedah,204,50,154,2014
2014-05-07,Kedah,100,23,77,2014
2014-05-08,Kedah,110,31,79,2014
2014-05-09,Kedah,58,12,46,2014
2014-05-10,Kedah,161,56,105,2014
2014-05-11,Kedah,239,37,202,2014
2014-05-12,Kedah,98,22,76,2014
2014-05-13,Kedah,88,24,64,2014
2014-05-14,Kedah,48,2,46,2014
2014-05-15,Kedah,95,36,59,2014
2014-05-16,Kedah,105,26,79,2014
2014-05-17,Kedah,60,18,42,2014
2014-05-18,Kedah,173,66,107,2014
2014-05-19,Kedah,88,15,73,2014
2014-05-20,Kedah,140,39,101,2014
2014-05-21,Kedah,113,15,98,2014
2014-05-22,Kedah,80,20,60,2014
2014-05-23,Kedah,339,55,284,2014
2014-05-24,Kedah,81,29,52,2014
2014-05-25,Kedah,175,52,123,2014
2014-05-26,Kedah,96,27,69,2014
2014-05-27,Kedah,37,11,26,2014
2014-05-28,Kedah,154,34,120,2014
2014-05-29,Kedah,140,35,105,2014
2014-05-30,Kedah,100,10,90,2014
2014-05-31,Kedah,141,29,112,2014
2014-06-01,Kedah,190,52,138,2014
2014-06-02,Kedah,97,21,76,2014
2014-06-03,Kedah,98,33,65,2014
2014-06-04,Kedah,132,31,101,2014
2014-06-05,Kedah,390,77,313,2014
2014-06-06,Kedah,220,42,178,2014
2014-06-07,Kedah,220,159,61,2014
2014-06-08,Kedah,256,48,208,2014
2014-06-09,Kedah,90,22,68,2014
2014-06-10,Kedah,99,25,74,2014
2014-06-11,Kedah,119,52,67,2014
2014-06-12,Kedah,245,130,115,2014
2014-06-13,Kedah,216,47,169,2014
2014-06-14,Kedah,295,257,38,2014
2014-06-15,Kedah,400,96,304,2014
2014-06-16,Kedah,112,21,91,2014
2014-06-17,Kedah,143,45,98,2014
2014-06-18,Kedah,280,129,151,2014
2014-06-19,Kedah,202,81,121,2014
2014-06-20,Kedah,68,10,58,2014
2014-06-21,Kedah,23,6,17,2014
2014-06-22,Kedah,336,108,228,2014
2014-06-23,Kedah,262,86,176,2014
2014-06-24,Kedah,151,73,78,2014
2014-06-25,Kedah,149,30,119,2014
2014-06-26,Kedah,255,57,198,2014
2014-06-27,Kedah,190,43,147,2014
2014-06-28,Kedah,154,39,115,2014
2014-06-29,Kedah,0,0,0,2014
2014-06-30,Kedah,20,4,16,2014
2014-07-01,Kedah,31,5,26,2014
2014-07-02,Kedah,93,24,69,2014
2014-07-03,Kedah,79,30,49,2014
2014-07-04,Kedah,45,25,20,2014
2014-07-05,Kedah,51,25,26,2014
2014-07-06,Kedah,113,20,93,2014
2014-07-07,Kedah,48,15,33,2014
2014-07-08,Kedah,196,111,85,2014
2014-07-09,Kedah,125,45,80,2014
2014-07-10,Kedah,66,23,43,2014
2014-07-11,Kedah,98,30,68,2014
2014-07-12,Kedah,65,27,38,2014
2014-07-13,Kedah,279,113,166,2014
2014-07-14,Kedah,119,40,79,2014
2014-07-15,Kedah,96,37,59,2014
2014-07-16,Kedah,95,47,48,2014
2014-07-17,Kedah,135,68,67,2014
2014-07-18,Kedah,129,26,103,2014
2014-07-19,Kedah,90,49,41,2014
2014-07-20,Kedah,282,45,237,2014
2014-07-21,Kedah,105,47,58,2014
2014-07-22,Kedah,68,21,47,2014
2014-07-23,Kedah,272,105,167,2014
2014-07-24,Kedah,112,18,94,2014
2014-07-25,Kedah,105,14,91,2014
2014-07-26,Kedah,32,6,26,2014
2014-07-27,Kedah,49,11,38,2014
2014-07-28,Kedah,0,0,0,2014
2014-07-29,Kedah,16,3,13,2014
2014-07-30,Kedah,59,15,44,2014
2014-07-31,Kedah,122,32,90,2014
2014-08-01,Kedah,90,33,57,2014
2014-08-02,Kedah,83,25,58,2014
2014-08-03,Kedah,140,30,110,2014
2014-08-04,Kedah,107,29,78,2014
2014-08-05,Kedah,154,50,104,2014
2014-08-06,Kedah,162,45,117,2014
2014-08-07,Kedah,240,132,108,2014
2014-08-08,Kedah,194,73,121,2014
2014-08-09,Kedah,164,129,35,2014
2014-08-10,Kedah,150,19,131,2014
2014-08-11,Kedah,175,53,122,2014
2014-08-12,Kedah,136,41,95,2014
2014-08-13,Kedah,360,170,190,2014
2014-08-14,Kedah,99,20,79,2014
2014-08-15,Kedah,132,52,80,2014
2014-08-16,Kedah,100,51,49,2014
2014-08-17,Kedah,195,50,145,2014
2014-08-18,Kedah,140,60,80,2014
2014-08-19,Kedah,141,53,88,2014
2014-08-20,Kedah,188,84,104,2014
2014-08-21,Kedah,112,49,63,2014
2014-08-22,Kedah,72,14,58,2014
2014-08-23,Kedah,212,96,116,2014
2014-08-24,Kedah,172,50,122,2014
2014-08-25,Kedah,162,64,98,2014
2014-08-26,Kedah,190,89,101,2014
2014-08-27,Kedah,254,130,124,2014
2014-08-28,Kedah,129,66,63,2014
2014-08-29,Kedah,191,17,174,2014
2014-08-30,Kedah,70,29,41,2014
2014-08-31,Kedah,143,64,79,2014
2014-09-01,Kedah,122,22,100,2014
2014-09-02,Kedah,146,47,99,2014
2014-09-03,Kedah,135,51,84,2014
2014-09-04,Kedah,199,84,115,2014
2014-09-05,Kedah,69,9,60,2014
2014-09-06,Kedah,182,84,98,2014
2014-09-07,Kedah,201,45,156,2014
2014-09-08,Kedah,142,45,97,2014
2014-09-09,Kedah,153,55,98,2014
2014-09-10,Kedah,178,87,91,2014
2014-09-11,Kedah,132,43,89,2014
2014-09-12,Kedah,35,9,26,2014
2014-09-13,Kedah,110,36,74,2014
2014-09-14,Kedah,215,40,175,2014
2014-09-15,Kedah,126,30,96,2014
2014-09-16,Kedah,260,90,170,2014
2014-09-17,Kedah,146,30,116,2014
2014-09-18,Kedah,212,79,133,2014
2014-09-19,Kedah,228,72,156,2014
2014-09-20,Kedah,154,78,76,2014
2014-09-21,Kedah,347,129,218,2014
2014-09-22,Kedah,126,44,82,2014
2014-09-23,Kedah,166,43,123,2014
2014-09-24,Kedah,238,92,146,2014
2014-09-25,Kedah,253,79,174,2014
2014-09-26,Kedah,184,33,151,2014
2014-09-27,Kedah,325,129,196,2014
2014-09-28,Kedah,183,55,128,2014
2014-09-29,Kedah,181,56,125,2014
2014-09-30,Kedah,153,45,108,2014
2014-10-01,Kedah,126,52,74,2014
2014-10-02,Kedah,111,27,84,2014
2014-10-03,Kedah,140,35,105,2014
2014-10-04,Kedah,58,11,47,2014
2014-10-05,Kedah,0,0,0,2014
2014-10-06,Kedah,0,0,0,2014
2014-10-07,Kedah,60,16,44,2014
2014-10-08,Kedah,181,100,81,2014
2014-10-09,Kedah,63,9,54,2014
2014-10-10,Kedah,180,35,145,2014
2014-10-11,Kedah,69,47,22,2014
2014-10-12,Kedah,253,77,176,2014
2014-10-13,Kedah,171,86,85,2014
2014-10-14,Kedah,373,114,259,2014
2014-10-15,Kedah,172,59,113,2014
2014-10-16,Kedah,94,19,75,2014
2014-10-17,Kedah,155,24,131,2014
2014-10-18,Kedah,370,289,81,2014
2014-10-19,Kedah,173,43,130,2014
2014-10-20,Kedah,123,32,91,2014
2014-10-21,Kedah,144,66,78,2014
2014-10-22,Kedah,562,77,485,2014
2014-10-23,Kedah,102,25,77,2014
2014-10-24,Kedah,17,4,13,2014
2014-10-25,Kedah,78,24,54,2014
2014-10-26,Kedah,165,64,101,2014
2014-10-27,Kedah,201,65,136,2014
2014-10-28,Kedah,106,26,80,2014
2014-10-29,Kedah,243,111,132,2014
2014-10-30,Kedah,134,29,105,2014
2014-10-31,Kedah,51,10,41,2014
2014-11-01,Kedah,120,51,69,2014
2014-11-02,Kedah,108,31,77,2014
2014-11-03,Kedah,127,41,86,2014
2014-11-04,Kedah,280,62,218,2014
2014-11-05,Kedah,184,46,138,2014
2014-11-06,Kedah,159,82,77,2014
2014-11-07,Kedah,136,38,98,2014
2014-11-08,Kedah,74,29,45,2014
2014-11-09,Kedah,284,58,226,2014
2014-11-10,Kedah,102,22,80,2014
2014-11-11,Kedah,126,34,92,2014
2014-11-12,Kedah,135,29,106,2014
2014-11-13,Kedah,127,40,87,2014
2014-11-14,Kedah,116,39,77,2014
2014-11-15,Kedah,154,58,96,2014
2014-11-16,Kedah,296,51,245,2014
2014-11-17,Kedah,74,15,59,2014
2014-11-18,Kedah,83,18,65,2014
2014-11-19,Kedah,151,48,103,2014
2014-11-20,Kedah,104,38,66,2014
2014-11-21,Kedah,64,16,48,2014
2014-11-22,Kedah,29,13,16,2014
2014-11-23,Kedah,230,66,164,2014
2014-11-24,Kedah,103,23,80,2014
2014-11-25,Kedah,178,45,133,2014
2014-11-26,Kedah,317,68,249,2014
2014-11-27,Kedah,138,30,108,2014
2014-11-28,Kedah,238,33,205,2014
2014-11-29,Kedah,139,59,80,2014
2014-11-30,Kedah,168,42,126,2014
2014-12-01,Kedah,78,20,58,2014
2014-12-02,Kedah,129,42,87,2014
2014-12-03,Kedah,162,48,114,2014
2014-12-04,Kedah,152,63,89,2014
2014-12-05,Kedah,155,36,119,2014
2014-12-06,Kedah,76,21,55,2014
2014-12-07,Kedah,310,68,242,2014
2014-12-08,Kedah,148,65,83,2014
2014-12-09,Kedah,230,63,167,2014
2014-12-10,Kedah,149,49,100,2014
2014-12-11,Kedah,212,102,110,2014
2014-12-12,Kedah,37,6,31,2014
2014-12-13,Kedah,93,33,60,2014
2014-12-14,Kedah,166,21,145,2014
2014-12-15,Kedah,78,14,64,2014
2014-12-16,Kedah,230,92,138,2014
2014-12-17,Kedah,271,130,141,2014
2014-12-18,Kedah,122,41,81,2014
2014-12-19,Kedah,92,26,66,2014
2014-12-20,Kedah,47,15,32,2014
2014-12-21,Kedah,219,50,169,2014
2014-12-22,Kedah,145,34,111,2014
2014-12-23,Kedah,106,40,66,2014
2014-12-24,Kedah,155,63,92,2014
2014-12-25,Kedah,65,18,47,2014
2014-12-26,Kedah,162,16,146,2014
2014-12-27,Kedah,8,1,7,2014
2014-12-28,Kedah,353,193,160,2014
2014-12-29,Kedah,115,21,94,2014
2014-12-30,Kedah,128,28,100,2014
2014-12-31,Kedah,157,54,103,2014
2015-01-01,Kedah,129,56,73,2015
2015-01-02,Kedah,143,28,115,2015
2015-01-03,Kedah,200,23,177,2015
2015-01-04,Kedah,162,46,116,2015
2015-01-05,Kedah,99,20,79,2015
2015-01-06,Kedah,125,39,86,2015
2015-01-07,Kedah,189,72,117,2015
2015-01-08,Kedah,207,90,117,2015
2015-01-09,Kedah,84,17,67,2015
2015-01-10,Kedah,180,55,125,2015
2015-01-11,Kedah,240,58,182,2015
2015-01-12,Kedah,84,20,64,2015
2015-01-13,Kedah,181,60,121,2015
2015-01-14,Kedah,244,68,176,2015
2015-01-15,Kedah,293,125,168,2015
2015-01-16,Kedah,118,18,100,2015
2015-01-17,Kedah,323,263,60,2015
2015-01-18,Kedah,23,8,15,2015
2015-01-19,Kedah,83,15,68,2015
2015-01-20,Kedah,196,46,150,2015
2015-01-21,Kedah,260,81,179,2015
2015-01-22,Kedah,107,33,74,2015
2015-01-23,Kedah,30,15,15,2015
2015-01-24,Kedah,491,426,65,2015
2015-01-25,Kedah,276,51,225,2015
2015-01-26,Kedah,136,53,83,2015
2015-01-27,Kedah,89,30,59,2015
2015-01-28,Kedah,161,64,97,2015
2015-01-29,Kedah,138,72,66,2015
2015-01-30,Kedah,192,30,162,2015
2015-01-31,Kedah,135,95,40,2015
2015-02-01,Kedah,98,25,73,2015
2015-02-02,Kedah,86,19,67,2015
2015-02-03,Kedah,60,23,37,2015
2015-02-04,Kedah,145,52,93,2015
2015-02-05,Kedah,149,85,64,2015
2015-02-06,Kedah,60,29,31,2015
2015-02-07,Kedah,202,132,70,2015
2015-02-08,Kedah,257,107,150,2015
2015-02-09,Kedah,206,84,122,2015
2015-02-10,Kedah,222,85,137,2015
2015-02-11,Kedah,147,80,67,2015
2015-02-12,Kedah,276,162,114,2015
2015-02-13,Kedah,82,44,38,2015
2015-02-14,Kedah,102,46,56,2015
2015-02-15,Kedah,168,52,116,2015
2015-02-16,Kedah,228,76,152,2015
2015-02-17,Kedah,139,65,74,2015
2015-02-18,Kedah,226,56,170,2015
2015-02-19,Kedah,16,7,9,2015
2015-02-20,Kedah,39,9,30,2015
2015-02-21,Kedah,35,8,27,2015
2015-02-22,Kedah,100,26,74,2015
2015-02-23,Kedah,95,13,82,2015
2015-02-24,Kedah,184,67,117,2015
2015-02-25,Kedah,254,117,137,2015
2015-02-26,Kedah,233,123,110,2015
2015-02-27,Kedah,98,40,58,2015
2015-02-28,Kedah,123,74,49,2015
2015-03-01,Kedah,207,55,152,2015
2015-03-02,Kedah,112,21,91,2015
2015-03-03,Kedah,159,36,123,2015
2015-03-04,Kedah,234,56,178,2015
2015-03-05,Kedah,181,61,120,2015
2015-03-06,Kedah,124,22,102,2015
2015-03-07,Kedah,122,40,82,2015
2015-03-08,Kedah,417,68,349,2015
2015-03-09,Kedah,102,26,76,2015
2015-03-10,Kedah,230,85,145,2015
2015-03-11,Kedah,263,97,166,2015
2015-03-12,Kedah,126,30,96,2015
2015-03-13,Kedah,210,10,200,2015
2015-03-14,Kedah,60,20,40,2015
2015-03-15,Kedah,187,56,131,2015
2015-03-16,Kedah,148,33,115,2015
2015-03-17,Kedah,203,55,148,2015
2015-03-18,Kedah,217,79,138,2015
2015-03-19,Kedah,150,39,111,2015
2015-03-20,Kedah,75,22,53,2015
2015-03-21,Kedah,78,19,59,2015
2015-03-22,Kedah,388,82,306,2015
2015-03-23,Kedah,173,44,129,2015
2015-03-24,Kedah,252,67,185,2015
2015-03-25,Kedah,346,137,209,2015
2015-03-26,Kedah,75,16,59,2015
2015-03-27,Kedah,136,36,100,2015
2015-03-28,Kedah,200,82,118,2015
2015-03-29,Kedah,163,50,113,2015
2015-03-30,Kedah,127,35,92,2015
2015-03-31,Kedah,117,28,89,2015
2015-04-01,Kedah,74,14,60,2015
2015-04-02,Kedah,127,50,77,2015
2015-04-03,Kedah,74,31,43,2015
2015-04-04,Kedah,132,56,76,2015
2015-04-05,Kedah,140,40,100,2015
2015-04-06,Kedah,158,31,127,2015
2015-04-07,Kedah,194,41,153,2015
2015-04-08,Kedah,406,154,252,2015
2015-04-09,Kedah,143,38,105,2015
2015-04-10,Kedah,229,48,181,2015
2015-04-11,Kedah,92,36,56,2015
2015-04-12,Kedah,210,35,175,2015
2015-04-13,Kedah,74,12,62,2015
2015-04-14,Kedah,193,65,128,2015
2015-04-15,Kedah,237,78,159,2015
2015-04-16,Kedah,187,57,130,2015
2015-04-17,Kedah,178,59,119,2015
2015-04-18,Kedah,83,38,45,2015
2015-04-19,Kedah,228,54,174,2015
2015-04-20,Kedah,208,80,128,2015
2015-04-21,Kedah,151,39,112,2015
2015-04-22,Kedah,249,43,206,2015
2015-04-23,Kedah,144,58,86,2015
2015-04-24,Kedah,225,36,189,2015
2015-04-25,Kedah,127,44,83,2015
2015-04-26,Kedah,225,96,129,2015
2015-04-27,Kedah,64,12,52,2015
2015-04-28,Kedah,75,23,52,2015
2015-04-29,Kedah,152,55,97,2015
2015-04-30,Kedah,160,48,112,2015
2015-05-01,Kedah,646,88,558,2015
2015-05-02,Kedah,35,11,24,2015
2015-05-03,Kedah,314,91,223,2015
2015-05-04,Kedah,18,7,11,2015
2015-05-05,Kedah,259,82,177,2015
2015-05-06,Kedah,98,29,69,2015
2015-05-07,Kedah,86,24,62,2015
2015-05-08,Kedah,63,33,30,2015
2015-05-09,Kedah,210,87,123,2015
2015-05-10,Kedah,352,65,287,2015
2015-05-11,Kedah,89,13,76,2015
2015-05-12,Kedah,139,26,113,2015
2015-05-13,Kedah,180,45,135,2015
2015-05-14,Kedah,99,24,75,2015
2015-05-15,Kedah,161,20,141,2015
2015-05-16,Kedah,158,60,98,2015
2015-05-17,Kedah,275,56,219,2015
2015-05-18,Kedah,71,13,58,2015
2015-05-19,Kedah,163,45,118,2015
2015-05-20,Kedah,186,57,129,2015
2015-05-21,Kedah,492,128,364,2015
2015-05-22,Kedah,179,68,111,2015
2015-05-23,Kedah,51,25,26,2015
2015-05-24,Kedah,154,60,94,2015
2015-05-25,Kedah,151,24,127,2015
2015-05-26,Kedah,126,43,83,2015
2015-05-27,Kedah,171,105,66,2015
2015-05-28,Kedah,171,33,138,2015
2015-05-29,Kedah,222,19,203,2015
2015-05-30,Kedah,216,76,140,2015
2015-05-31,Kedah,100,19,81,2015
2015-06-01,Kedah,98,29,69,2015
2015-06-02,Kedah,107,25,82,2015
2015-06-03,Kedah,126,32,94,2015
2015-06-04,Kedah,90,24,66,2015
2015-06-05,Kedah,408,117,291,2015
2015-06-06,Kedah,177,60,117,2015
2015-06-07,Kedah,216,41,175,2015
2015-06-08,Kedah,65,7,58,2015
2015-06-09,Kedah,143,26,117,2015
2015-06-10,Kedah,181,41,140,2015
2015-06-11,Kedah,205,103,102,2015
2015-06-12,Kedah,237,83,154,2015
2015-06-13,Kedah,154,68,86,2015
2015-06-14,Kedah,539,169,370,2015
2015-06-15,Kedah,180,57,123,2015
2015-06-16,Kedah,306,100,206,2015
2015-06-17,Kedah,201,52,149,2015
2015-06-18,Kedah,0,0,0,2015
2015-06-19,Kedah,20,5,15,2015
2015-06-20,Kedah,20,2,18,2015
2015-06-21,Kedah,134,24,110,2015
2015-06-22,Kedah,54,17,37,2015
2015-06-23,Kedah,69,19,50,2015
2015-06-24,Kedah,88,33,55,2015
2015-06-25,Kedah,61,15,46,2015
2015-06-26,Kedah,207,32,175,2015
2015-06-27,Kedah,49,22,27,2015
2015-06-28,Kedah,182,47,135,2015
2015-06-29,Kedah,62,21,41,2015
2015-06-30,Kedah,112,42,70,2015
2015-07-01,Kedah,149,104,45,2015
2015-07-02,Kedah,82,24,58,2015
2015-07-03,Kedah,70,28,42,2015
2015-07-04,Kedah,139,55,84,2015
2015-07-05,Kedah,226,68,158,2015
2015-07-06,Kedah,228,122,106,2015
2015-07-07,Kedah,103,43,60,2015
2015-07-08,Kedah,181,77,104,2015
2015-07-09,Kedah,253,172,81,2015
2015-07-10,Kedah,133,31,102,2015
2015-07-11,Kedah,213,92,121,2015
2015-07-12,Kedah,264,78,186,2015
2015-07-13,Kedah,311,194,117,2015
2015-07-14,Kedah,219,69,150,2015
2015-07-15,Kedah,141,28,113,2015
2015-07-16,Kedah,38,5,33,2015
2015-07-17,Kedah,0,0,0,2015
2015-07-18,Kedah,0,0,0,2015
2015-07-19,Kedah,13,6,7,2015
2015-07-20,Kedah,74,16,58,2015
2015-07-21,Kedah,115,41,74,2015
2015-07-22,Kedah,142,39,103,2015
2015-07-23,Kedah,83,20,63,2015
2015-07-24,Kedah,182,24,158,2015
2015-07-25,Kedah,111,61,50,2015
2015-07-26,Kedah,355,95,260,2015
2015-07-27,Kedah,142,43,99,2015
2015-07-28,Kedah,232,73,159,2015
2015-07-29,Kedah,170,62,108,2015
2015-07-30,Kedah,64,28,36,2015
2015-07-31,Kedah,54,16,38,2015
2015-08-01,Kedah,133,55,78,2015
2015-08-02,Kedah,212,65,147,2015
2015-08-03,Kedah,103,25,78,2015
2015-08-04,Kedah,233,107,126,2015
2015-08-05,Kedah,164,45,119,2015
2015-08-06,Kedah,239,111,128,2015
2015-08-07,Kedah,201,48,153,2015
2015-08-08,Kedah,111,46,65,2015
2015-08-09,Kedah,186,30,156,2015
2015-08-10,Kedah,164,48,116,2015
2015-08-11,Kedah,132,50,82,2015
2015-08-12,Kedah,538,308,230,2015
2015-08-13,Kedah,207,99,108,2015
2015-08-14,Kedah,167,87,80,2015
2015-08-15,Kedah,81,24,57,2015
2015-08-16,Kedah,334,140,194,2015
2015-08-17,Kedah,124,38,86,2015
2015-08-18,Kedah,241,119,122,2015
2015-08-19,Kedah,184,83,101,2015
2015-08-20,Kedah,171,76,95,2015
2015-08-21,Kedah,299,52,247,2015
2015-08-22,Kedah,97,48,49,2015
2015-08-23,Kedah,287,96,191,2015
2015-08-24,Kedah,139,33,106,2015
2015-08-25,Kedah,175,57,118,2015
2015-08-26,Kedah,150,30,120,2015
2015-08-27,Kedah,238,169,69,2015
2015-08-28,Kedah,92,17,75,2015
2015-08-29,Kedah,24,4,20,2015
2015-08-30,Kedah,115,55,60,2015
2015-08-31,Kedah,91,32,59,2015
2015-09-01,Kedah,87,22,65,2015
2015-09-02,Kedah,94,15,79,2015
2015-09-03,Kedah,103,30,73,2015
2015-09-04,Kedah,98,21,77,2015
2015-09-05,Kedah,91,31,60,2015
2015-09-06,Kedah,214,51,163,2015
2015-09-07,Kedah,131,32,99,2015
2015-09-08,Kedah,194,75,119,2015
2015-09-09,Kedah,305,158,147,2015
2015-09-10,Kedah,234,41,193,2015
2015-09-11,Kedah,257,163,94,2015
2015-09-12,Kedah,176,93,83,2015
2015-09-13,Kedah,264,61,203,2015
2015-09-14,Kedah,218,109,109,2015
2015-09-15,Kedah,211,66,145,2015
2015-09-16,Kedah,172,73,99,2015
2015-09-17,Kedah,195,87,108,2015
2015-09-18,Kedah,396,129,267,2015
2015-09-19,Kedah,215,63,152,2015
2015-09-20,Kedah,294,69,225,2015
2015-09-21,Kedah,166,41,125,2015
2015-09-22,Kedah,154,41,113,2015
2015-09-23,Kedah,60,14,46,2015
2015-09-24,Kedah,0,0,0,2015
2015-09-25,Kedah,26,10,16,2015
2015-09-26,Kedah,29,7,22,2015
2015-09-27,Kedah,123,56,67,2015
2015-09-28,Kedah,202,100,102,2015
2015-09-29,Kedah,101,14,87,2015
2015-09-30,Kedah,179,32,147,2015
2015-10-01,Kedah,104,32,72,2015
2015-10-02,Kedah,108,54,54,2015
2015-10-03,Kedah,201,87,114,2015
2015-10-04,Kedah,213,34,179,2015
2015-10-05,Kedah,127,13,114,2015
2015-10-06,Kedah,222,50,172,2015
2015-10-07,Kedah,156,46,110,2015
2015-10-08,Kedah,202,70,132,2015
2015-10-09,Kedah,50,10,40,2015
2015-10-10,Kedah,88,43,45,2015
2015-10-11,Kedah,226,43,183,2015
2015-10-12,Kedah,146,33,113,2015
2015-10-13,Kedah,134,41,93,2015
2015-10-14,Kedah,73,22,51,2015
2015-10-15,Kedah,162,36,126,2015
2015-10-16,Kedah,181,49,132,2015
2015-10-17,Kedah,125,58,67,2015
2015-10-18,Kedah,294,104,190,2015
2015-10-19,Kedah,153,80,73,2015
2015-10-20,Kedah,188,91,97,2015
2015-10-21,Kedah,116,21,95,2015
2015-10-22,Kedah,68,14,54,2015
2015-10-23,Kedah,163,22,141,2015
2015-10-24,Kedah,63,23,40,2015
2015-10-25,Kedah,111,30,81,2015
2015-10-26,Kedah,170,41,129,2015
2015-10-27,Kedah,162,40,122,2015
2015-10-28,Kedah,233,78,155,2015
2015-10-29,Kedah,197,51,146,2015
2015-10-30,Kedah,193,43,150,2015
2015-10-31,Kedah,462,170,292,2015
2015-11-01,Kedah,274,77,197,2015
2015-11-02,Kedah,93,18,75,2015
2015-11-03,Kedah,117,29,88,2015
2015-11-04,Kedah,210,113,97,2015
2015-11-05,Kedah,181,52,129,2015
2015-11-06,Kedah,44,13,31,2015
2015-11-07,Kedah,59,21,38,2015
2015-11-08,Kedah,273,62,211,2015
2015-11-09,Kedah,116,35,81,2015
2015-11-10,Kedah,447,48,399,2015
2015-11-11,Kedah,136,42,94,2015
2015-11-12,Kedah,183,52,131,2015
2015-11-13,Kedah,157,24,133,2015
2015-11-14,Kedah,79,36,43,2015
2015-11-15,Kedah,227,64,163,2015
2015-11-16,Kedah,116,32,84,2015
2015-11-17,Kedah,242,71,171,2015
2015-11-18,Kedah,211,70,141,2015
2015-11-19,Kedah,216,89,127,2015
2015-11-20,Kedah,153,57,96,2015
2015-11-21,Kedah,157,62,95,2015
2015-11-22,Kedah,202,47,155,2015
2015-11-23,Kedah,97,17,80,2015
2015-11-24,Kedah,154,44,110,2015
2015-11-25,Kedah,179,72,107,2015
2015-11-26,Kedah,160,51,109,2015
2015-11-27,Kedah,156,26,130,2015
2015-11-28,Kedah,47,17,30,2015
2015-11-29,Kedah,358,90,268,2015
2015-11-30,Kedah,89,12,77,2015
2015-12-01,Kedah,107,25,82,2015
2015-12-02,Kedah,164,49,115,2015
2015-12-03,Kedah,183,104,79,2015
2015-12-04,Kedah,98,55,43,2015
2015-12-05,Kedah,235,114,121,2015
2015-12-06,Kedah,211,64,147,2015
2015-12-07,Kedah,75,17,58,2015
2015-12-08,Kedah,194,46,148,2015
2015-12-09,Kedah,151,41,110,2015
2015-12-10,Kedah,143,47,96,2015
2015-12-11,Kedah,297,95,202,2015
2015-12-12,Kedah,67,31,36,2015
2015-12-13,Kedah,319,124,195,2015
2015-12-14,Kedah,95,22,73,2015
2015-12-15,Kedah,114,28,86,2015
2015-12-16,Kedah,160,52,108,2015
2015-12-17,Kedah,179,99,80,2015
2015-12-18,Kedah,155,29,126,2015
2015-12-19,Kedah,50,9,41,2015
2015-12-20,Kedah,296,52,244,2015
2015-12-21,Kedah,125,35,90,2015
2015-12-22,Kedah,139,28,111,2015
2015-12-23,Kedah,78,19,59,2015
2015-12-24,Kedah,69,16,53,2015
2015-12-25,Kedah,239,59,180,2015
2015-12-26,Kedah,52,19,33,2015
2015-12-27,Kedah,111,41,70,2015
2015-12-28,Kedah,112,26,86,2015
2015-12-29,Kedah,121,27,94,2015
2015-12-30,Kedah,105,27,78,2015
2015-12-31,Kedah,117,23,94,2015
2016-01-01,Kedah,191,43,148,2016
2016-01-02,Kedah,56,18,38,2016
2016-01-03,Kedah,93,32,61,2016
2016-01-04,Kedah,200,48,152,2016
2016-01-05,Kedah,254,88,166,2016
2016-01-06,Kedah,211,93,118,2016
2016-01-07,Kedah,195,93,102,2016
2016-01-08,Kedah,96,23,73,2016
2016-01-09,Kedah,115,42,73,2016
2016-01-10,Kedah,242,41,201,2016
2016-01-11,Kedah,116,17,99,2016
2016-01-12,Kedah,237,72,165,2016
2016-01-13,Kedah,145,52,93,2016
2016-01-14,Kedah,102,43,59,2016
2016-01-15,Kedah,76,21,55,2016
2016-01-16,Kedah,38,6,32,2016
2016-01-17,Kedah,169,39,130,2016
2016-01-18,Kedah,103,15,88,2016
2016-01-19,Kedah,196,52,144,2016
2016-01-20,Kedah,193,49,144,2016
2016-01-21,Kedah,117,41,76,2016
2016-01-22,Kedah,158,52,106,2016
2016-01-23,Kedah,219,42,177,2016
2016-01-24,Kedah,115,37,78,2016
2016-01-25,Kedah,123,33,90,2016
2016-01-26,Kedah,143,46,97,2016
2016-01-27,Kedah,186,49,137,2016
2016-01-28,Kedah,380,101,279,2016
2016-01-29,Kedah,154,8,146,2016
2016-01-30,Kedah,55,23,32,2016
2016-01-31,Kedah,156,35,121,2016
2016-02-01,Kedah,164,73,91,2016
2016-02-02,Kedah,112,34,78,2016
2016-02-03,Kedah,114,33,81,2016
2016-02-04,Kedah,215,75,140,2016
2016-02-05,Kedah,75,19,56,2016
2016-02-06,Kedah,109,33,76,2016
2016-02-07,Kedah,109,19,90,2016
2016-02-08,Kedah,23,5,18,2016
2016-02-09,Kedah,45,9,36,2016
2016-02-10,Kedah,182,44,138,2016
2016-02-11,Kedah,194,76,118,2016
2016-02-12,Kedah,62,16,46,2016
2016-02-13,Kedah,86,35,51,2016
2016-02-14,Kedah,324,59,265,2016
2016-02-15,Kedah,193,44,149,2016
2016-02-16,Kedah,145,43,102,2016
2016-02-17,Kedah,102,23,79,2016
2016-02-18,Kedah,194,85,109,2016
2016-02-19,Kedah,60,27,33,2016
2016-02-20,Kedah,92,21,71,2016
2016-02-21,Kedah,268,62,206,2016
2016-02-22,Kedah,158,57,101,2016
2016-02-23,Kedah,254,84,170,2016
2016-02-24,Kedah,189,69,120,2016
2016-02-25,Kedah,249,90,159,2016
2016-02-26,Kedah,178,16,162,2016
2016-02-27,Kedah,297,209,88,2016
2016-02-28,Kedah,124,30,94,2016
2016-02-29,Kedah,145,36,109,2016
2016-03-01,Kedah,198,58,140,2016
2016-03-02,Kedah,236,72,164,2016
2016-03-03,Kedah,145,50,95,2016
2016-03-04,Kedah,44,14,30,2016
2016-03-05,Kedah,132,48,84,2016
2016-03-06,Kedah,270,54,216,2016
2016-03-07,Kedah,124,24,100,2016
2016-03-08,Kedah,208,59,149,2016
2016-03-09,Kedah,259,98,161,2016
2016-03-10,Kedah,221,60,161,2016
2016-03-11,Kedah,51,13,38,2016
2016-03-12,Kedah,43,16,27,2016
2016-03-13,Kedah,266,76,190,2016
2016-03-14,Kedah,122,19,103,2016
2016-03-15,Kedah,150,28,122,2016
2016-03-16,Kedah,136,37,99,2016
2016-03-17,Kedah,158,57,101,2016
2016-03-18,Kedah,179,34,145,2016
2016-03-19,Kedah,144,48,96,2016
2016-03-20,Kedah,348,94,254,2016
2016-03-21,Kedah,125,30,95,2016
2016-03-22,Kedah,197,48,149,2016
2016-03-23,Kedah,131,31,100,2016
2016-03-24,Kedah,77,13,64,2016
2016-03-25,Kedah,180,22,158,2016
2016-03-26,Kedah,173,56,117,2016
2016-03-27,Kedah,184,54,130,2016
2016-03-28,Kedah,190,63,127,2016
2016-03-29,Kedah,131,36,95,2016
2016-03-30,Kedah,251,82,169,2016
2016-03-31,Kedah,199,56,143,2016
2016-04-01,Kedah,39,3,36,2016
2016-04-02,Kedah,216,92,124,2016
2016-04-03,Kedah,139,47,92,2016
2016-04-04,Kedah,99,14,85,2016
2016-04-05,Kedah,172,72,100,2016
2016-04-06,Kedah,270,79,191,2016
2016-04-07,Kedah,278,179,99,2016
2016-04-08,Kedah,98,35,63,2016
2016-04-09,Kedah,47,20,27,2016
2016-04-10,Kedah,196,39,157,2016
2016-04-11,Kedah,102,17,85,2016
2016-04-12,Kedah,72,7,65,2016
2016-04-13,Kedah,183,36,147,2016
2016-04-14,Kedah,167,33,134,2016
2016-04-15,Kedah,96,10,86,2016
2016-04-16,Kedah,101,43,58,2016
2016-04-17,Kedah,192,49,143,2016
2016-04-18,Kedah,165,44,121,2016
2016-04-19,Kedah,273,77,196,2016
2016-04-20,Kedah,142,43,99,2016
2016-04-21,Kedah,309,154,155,2016
2016-04-22,Kedah,150,10,140,2016
2016-04-23,Kedah,90,35,55,2016
2016-04-24,Kedah,232,91,141,2016
2016-04-25,Kedah,99,36,63,2016
2016-04-26,Kedah,199,76,123,2016
2016-04-27,Kedah,158,78,80,2016
2016-04-28,Kedah,139,49,90,2016
2016-04-29,Kedah,23,5,18,2016
2016-04-30,Kedah,70,15,55,2016
2016-05-01,Kedah,860,178,682,2016
2016-05-02,Kedah,82,10,72,2016
2016-05-03,Kedah,92,17,75,2016
2016-05-04,Kedah,174,57,117,2016
2016-05-05,Kedah,55,29,26,2016
2016-05-06,Kedah,61,12,49,2016
2016-05-07,Kedah,140,72,68,2016
2016-05-08,Kedah,230,65,165,2016
2016-05-09,Kedah,295,112,183,2016
2016-05-10,Kedah,116,21,95,2016
2016-05-11,Kedah,178,104,74,2016
2016-05-12,Kedah,226,81,145,2016
2016-05-13,Kedah,200,33,167,2016
2016-05-14,Kedah,303,128,175,2016
2016-05-15,Kedah,380,107,273,2016
2016-05-16,Kedah,65,9,56,2016
2016-05-17,Kedah,113,29,84,2016
2016-05-18,Kedah,205,38,167,2016
2016-05-19,Kedah,114,41,73,2016
2016-05-20,Kedah,201,66,135,2016
2016-05-21,Kedah,226,123,103,2016
2016-05-22,Kedah,234,58,176,2016
2016-05-23,Kedah,140,35,105,2016
2016-05-24,Kedah,262,88,174,2016
2016-05-25,Kedah,333,146,187,2016
2016-05-26,Kedah,394,149,245,2016
2016-05-27,Kedah,193,12,181,2016
2016-05-28,Kedah,156,52,104,2016
2016-05-29,Kedah,212,40,172,2016
2016-05-30,Kedah,90,23,67,2016
2016-05-31,Kedah,134,20,114,2016
2016-06-01,Kedah,177,57,120,2016
2016-06-02,Kedah,188,54,134,2016
2016-06-03,Kedah,296,51,245,2016
2016-06-04,Kedah,321,98,223,2016
2016-06-05,Kedah,205,65,140,2016
2016-06-06,Kedah,4,1,3,2016
2016-06-07,Kedah,64,5,59,2016
2016-06-08,Kedah,84,15,69,2016
2016-06-09,Kedah,150,60,90,2016
2016-06-10,Kedah,232,48,184,2016
2016-06-11,Kedah,13,1,12,2016
2016-06-12,Kedah,218,62,156,2016
2016-06-13,Kedah,108,31,77,2016
2016-06-14,Kedah,106,30,76,2016
2016-06-15,Kedah,71,23,48,2016
2016-06-16,Kedah,41,14,27,2016
2016-06-17,Kedah,120,35,85,2016
2016-06-18,Kedah,80,23,57,2016
2016-06-19,Kedah,138,56,82,2016
2016-06-20,Kedah,117,57,60,2016
2016-06-21,Kedah,106,23,83,2016
2016-06-22,Kedah,112,47,65,2016
2016-06-23,Kedah,329,244,85,2016
2016-06-24,Kedah,155,16,139,2016
2016-06-25,Kedah,75,20,55,2016
2016-06-26,Kedah,324,93,231,2016
2016-06-27,Kedah,147,52,95,2016
2016-06-28,Kedah,119,49,70,2016
2016-06-29,Kedah,218,82,136,2016
2016-06-30,Kedah,61,19,42,2016
2016-07-01,Kedah,89,31,58,2016
2016-07-02,Kedah,95,39,56,2016
2016-07-03,Kedah,186,57,129,2016
2016-07-04,Kedah,100,25,75,2016
2016-07-05,Kedah,41,7,34,2016
2016-07-06,Kedah,0,0,0,2016
2016-07-07,Kedah,0,0,0,2016
2016-07-08,Kedah,23,3,20,2016
2016-07-09,Kedah,52,11,41,2016
2016-07-10,Kedah,96,40,56,2016
2016-07-11,Kedah,123,22,101,2016
2016-07-12,Kedah,195,58,137,2016
2016-07-13,Kedah,158,49,109,2016
2016-07-14,Kedah,180,50,130,2016
2016-07-15,Kedah,127,43,84,2016
2016-07-16,Kedah,138,47,91,2016
2016-07-17,Kedah,365,104,261,2016
2016-07-18,Kedah,160,40,120,2016
2016-07-19,Kedah,274,92,182,2016
2016-07-20,Kedah,259,154,105,2016
2016-07-21,Kedah,264,129,135,2016
2016-07-22,Kedah,41,5,36,2016
2016-07-23,Kedah,83,42,41,2016
2016-07-24,Kedah,287,49,238,2016
2016-07-25,Kedah,123,28,95,2016
2016-07-26,Kedah,184,44,140,2016
2016-07-27,Kedah,215,90,125,2016
2016-07-28,Kedah,146,81,65,2016
2016-07-29,Kedah,178,16,162,2016
2016-07-30,Kedah,194,85,109,2016
2016-07-31,Kedah,210,82,128,2016
2016-08-01,Kedah,51,6,45,2016
2016-08-02,Kedah,165,45,120,2016
2016-08-03,Kedah,171,47,124,2016
2016-08-04,Kedah,218,132,86,2016
2016-08-05,Kedah,266,79,187,2016
2016-08-06,Kedah,363,138,225,2016
2016-08-07,Kedah,309,54,255,2016
2016-08-08,Kedah,120,39,81,2016
2016-08-09,Kedah,184,33,151,2016
2016-08-10,Kedah,141,57,84,2016
2016-08-11,Kedah,189,67,122,2016
2016-08-12,Kedah,129,44,85,2016
2016-08-13,Kedah,98,39,59,2016
2016-08-14,Kedah,144,28,116,2016
2016-08-15,Kedah,177,34,143,2016
2016-08-16,Kedah,298,125,173,2016
2016-08-17,Kedah,132,40,92,2016
2016-08-18,Kedah,166,94,72,2016
2016-08-19,Kedah,170,86,84,2016
2016-08-20,Kedah,153,55,98,2016
2016-08-21,Kedah,306,46,260,2016
2016-08-22,Kedah,82,12,70,2016
2016-08-23,Kedah,158,33,125,2016
2016-08-24,Kedah,155,58,97,2016
2016-08-25,Kedah,213,119,94,2016
2016-08-26,Kedah,170,28,142,2016
2016-08-27,Kedah,70,26,44,2016
2016-08-28,Kedah,164,41,123,2016
2016-08-29,Kedah,142,42,100,2016
2016-08-30,Kedah,291,123,168,2016
2016-08-31,Kedah,273,56,217,2016
2016-09-01,Kedah,117,44,73,2016
2016-09-02,Kedah,88,31,57,2016
2016-09-03,Kedah,34,11,23,2016
2016-09-04,Kedah,183,52,131,2016
2016-09-05,Kedah,61,10,51,2016
2016-09-06,Kedah,121,28,93,2016
2016-09-07,Kedah,203,78,125,2016
2016-09-08,Kedah,106,14,92,2016
2016-09-09,Kedah,51,22,29,2016
2016-09-10,Kedah,67,12,55,2016
2016-09-11,Kedah,253,46,207,2016
2016-09-12,Kedah,0,0,0,2016
2016-09-13,Kedah,0,0,0,2016
2016-09-14,Kedah,117,22,95,2016
2016-09-15,Kedah,96,18,78,2016
2016-09-16,Kedah,447,80,367,2016
2016-09-17,Kedah,148,54,94,2016
2016-09-18,Kedah,291,44,247,2016
2016-09-19,Kedah,122,19,103,2016
2016-09-20,Kedah,199,55,144,2016
2016-09-21,Kedah,122,24,98,2016
2016-09-22,Kedah,126,52,74,2016
2016-09-23,Kedah,261,31,230,2016
2016-09-24,Kedah,88,30,58,2016
2016-09-25,Kedah,309,54,255,2016
2016-09-26,Kedah,186,72,114,2016
2016-09-27,Kedah,149,18,131,2016
2016-09-28,Kedah,206,60,146,2016
2016-09-29,Kedah,177,68,109,2016
2016-09-30,Kedah,450,192,258,2016
2016-10-01,Kedah,167,53,114,2016
2016-10-02,Kedah,131,46,85,2016
2016-10-03,Kedah,93,20,73,2016
2016-10-04,Kedah,254,78,176,2016
2016-10-05,Kedah,135,49,86,2016
2016-10-06,Kedah,86,37,49,2016
2016-10-07,Kedah,88,46,42,2016
2016-10-08,Kedah,117,41,76,2016
2016-10-09,Kedah,238,34,204,2016
2016-10-10,Kedah,76,13,63,2016
2016-10-11,Kedah,210,57,153,2016
2016-10-12,Kedah,226,61,165,2016
2016-10-13,Kedah,207,66,141,2016
2016-10-14,Kedah,62,16,46,2016
2016-10-15,Kedah,121,61,60,2016
2016-10-16,Kedah,226,50,176,2016
2016-10-17,Kedah,112,20,92,2016
2016-10-18,Kedah,206,55,151,2016
2016-10-19,Kedah,140,46,94,2016
2016-10-20,Kedah,220,82,138,2016
2016-10-21,Kedah,233,37,196,2016
2016-10-22,Kedah,157,44,113,2016
2016-10-23,Kedah,241,69,172,2016
2016-10-24,Kedah,96,18,78,2016
2016-10-25,Kedah,88,15,73,2016
2016-10-26,Kedah,199,48,151,2016
2016-10-27,Kedah,114,26,88,2016
2016-10-28,Kedah,42,11,31,2016
2016-10-29,Kedah,312,46,266,2016
2016-10-30,Kedah,96,16,80,2016
2016-10-31,Kedah,39,8,31,2016
2016-11-01,Kedah,84,14,70,2016
2016-11-02,Kedah,183,65,118,2016
2016-11-03,Kedah,233,90,143,2016
2016-11-04,Kedah,67,25,42,2016
2016-11-05,Kedah,190,63,127,2016
2016-11-06,Kedah,111,21,90,2016
2016-11-07,Kedah,57,8,49,2016
2016-11-08,Kedah,157,69,88,2016
2016-11-09,Kedah,200,61,139,2016
2016-11-10,Kedah,73,19,54,2016
2016-11-11,Kedah,105,35,70,2016
2016-11-12,Kedah,149,54,95,2016
2016-11-13,Kedah,268,57,211,2016
2016-11-14,Kedah,68,11,57,2016
2016-11-15,Kedah,206,38,168,2016
2016-11-16,Kedah,201,36,165,2016
2016-11-17,Kedah,108,22,86,2016
2016-11-18,Kedah,302,42,260,2016
2016-11-19,Kedah,66,25,41,2016
2016-11-20,Kedah,136,38,98,2016
2016-11-21,Kedah,67,11,56,2016
2016-11-22,Kedah,205,67,138,2016
2016-11-23,Kedah,156,45,111,2016
2016-11-24,Kedah,176,63,113,2016
2016-11-25,Kedah,306,44,262,2016
2016-11-26,Kedah,70,26,44,2016
2016-11-27,Kedah,286,76,210,2016
2016-11-28,Kedah,59,10,49,2016
2016-11-29,Kedah,119,24,95,2016
2016-11-30,Kedah,166,34,132,2016
2016-12-01,Kedah,84,14,70,2016
2016-12-02,Kedah,188,68,120,2016
2016-12-03,Kedah,45,8,37,2016
2016-12-04,Kedah,251,71,180,2016
2016-12-05,Kedah,117,19,98,2016
2016-12-06,Kedah,112,27,85,2016
2016-12-07,Kedah,105,32,73,2016
2016-12-08,Kedah,200,60,140,2016
2016-12-09,Kedah,88,10,78,2016
2016-12-10,Kedah,95,45,50,2016
2016-12-11,Kedah,95,29,66,2016
2016-12-12,Kedah,83,35,48,2016
2016-12-13,Kedah,159,40,119,2016
2016-12-14,Kedah,148,36,112,2016
2016-12-15,Kedah,93,21,72,2016
2016-12-16,Kedah,75,14,61,2016
2016-12-17,Kedah,223,93,130,2016
2016-12-18,Kedah,412,105,307,2016
2016-12-19,Kedah,127,26,101,2016
2016-12-20,Kedah,137,39,98,2016
2016-12-21,Kedah,179,53,126,2016
2016-12-22,Kedah,180,53,127,2016
2016-12-23,Kedah,257,51,206,2016
2016-12-24,Kedah,58,19,39,2016
2016-12-25,Kedah,447,118,329,2016
2016-12-26,Kedah,69,14,55,2016
2016-12-27,Kedah,110,23,87,2016
2016-12-28,Kedah,84,20,64,2016
2016-12-29,Kedah,138,36,102,2016
2016-12-30,Kedah,57,11,46,2016
2016-12-31,Kedah,69,23,46,2016
2017-01-01,Kedah,101,17,84,2017
2017-01-02,Kedah,133,26,107,2017
2017-01-03,Kedah,181,34,147,2017
2017-01-04,Kedah,216,73,143,2017
2017-01-05,Kedah,179,49,130,2017
2017-01-06,Kedah,274,45,229,2017
2017-01-07,Kedah,118,31,87,2017
2017-01-08,Kedah,240,43,197,2017
2017-01-09,Kedah,162,42,120,2017
2017-01-10,Kedah,269,68,201,2017
2017-01-11,Kedah,303,95,208,2017
2017-01-12,Kedah,355,125,230,2017
2017-01-13,Kedah,154,31,123,2017
2017-01-14,Kedah,52,17,35,2017
2017-01-15,Kedah,182,41,141,2017
2017-01-16,Kedah,108,20,88,2017
2017-01-17,Kedah,116,16,100,2017
2017-01-18,Kedah,213,92,121,2017
2017-01-19,Kedah,77,15,62,2017
2017-01-20,Kedah,165,13,152,2017
2017-01-21,Kedah,128,59,69,2017
2017-01-22,Kedah,174,46,128,2017
2017-01-23,Kedah,182,65,117,2017
2017-01-24,Kedah,107,34,73,2017
2017-01-25,Kedah,369,157,212,2017
2017-01-26,Kedah,116,38,78,2017
2017-01-27,Kedah,319,241,78,2017
2017-01-28,Kedah,46,12,34,2017
2017-01-29,Kedah,82,24,58,2017
2017-01-30,Kedah,92,13,79,2017
2017-01-31,Kedah,129,32,97,2017
2017-02-01,Kedah,141,54,87,2017
2017-02-02,Kedah,128,56,72,2017
2017-02-03,Kedah,41,6,35,2017
2017-02-04,Kedah,104,39,65,2017
2017-02-05,Kedah,187,24,163,2017
2017-02-06,Kedah,93,22,71,2017
2017-02-07,Kedah,125,22,103,2017
2017-02-08,Kedah,116,29,87,2017
2017-02-09,Kedah,102,45,57,2017
2017-02-10,Kedah,215,116,99,2017
2017-02-11,Kedah,250,150,100,2017
2017-02-12,Kedah,299,61,238,2017
2017-02-13,Kedah,100,21,79,2017
2017-02-14,Kedah,130,27,103,2017
2017-02-15,Kedah,248,72,176,2017
2017-02-16,Kedah,258,140,118,2017
2017-02-17,Kedah,97,24,73,2017
2017-02-18,Kedah,198,81,117,2017
2017-02-19,Kedah,169,45,124,2017
2017-02-20,Kedah,128,42,86,2017
2017-02-21,Kedah,128,34,94,2017
2017-02-22,Kedah,420,108,312,2017
2017-02-23,Kedah,171,58,113,2017
2017-02-24,Kedah,208,31,177,2017
2017-02-25,Kedah,229,65,164,2017
2017-02-26,Kedah,279,67,212,2017
2017-02-27,Kedah,117,22,95,2017
2017-02-28,Kedah,194,61,133,2017
2017-03-01,Kedah,118,17,101,2017
2017-03-02,Kedah,138,49,89,2017
2017-03-03,Kedah,62,10,52,2017
2017-03-04,Kedah,135,53,82,2017
2017-03-05,Kedah,170,27,143,2017
2017-03-06,Kedah,182,31,151,2017
2017-03-07,Kedah,186,68,118,2017
2017-03-08,Kedah,321,100,221,2017
2017-03-09,Kedah,283,129,154,2017
2017-03-10,Kedah,127,29,98,2017
2017-03-11,Kedah,107,38,69,2017
2017-03-12,Kedah,353,48,305,2017
2017-03-13,Kedah,246,83,163,2017
2017-03-14,Kedah,93,21,72,2017
2017-03-15,Kedah,292,91,201,2017
2017-03-16,Kedah,258,103,155,2017
2017-03-17,Kedah,96,36,60,2017
2017-03-18,Kedah,110,46,64,2017
2017-03-19,Kedah,238,76,162,2017
2017-03-20,Kedah,178,63,115,2017
2017-03-21,Kedah,164,32,132,2017
2017-03-22,Kedah,149,54,95,2017
2017-03-23,Kedah,102,34,68,2017
2017-03-24,Kedah,238,34,204,2017
2017-03-25,Kedah,167,65,102,2017
2017-03-26,Kedah,285,54,231,2017
2017-03-27,Kedah,99,17,82,2017
2017-03-28,Kedah,152,19,133,2017
2017-03-29,Kedah,196,39,157,2017
2017-03-30,Kedah,203,77,126,2017
2017-03-31,Kedah,60,13,47,2017
2017-04-01,Kedah,95,25,70,2017
2017-04-02,Kedah,157,36,121,2017
2017-04-03,Kedah,114,45,69,2017
2017-04-04,Kedah,129,36,93,2017
2017-04-05,Kedah,273,76,197,2017
2017-04-06,Kedah,246,57,189,2017
2017-04-07,Kedah,69,9,60,2017
2017-04-08,Kedah,196,81,115,2017
2017-04-09,Kedah,120,23,97,2017
2017-04-10,Kedah,160,48,112,2017
2017-04-11,Kedah,380,99,281,2017
2017-04-12,Kedah,132,33,99,2017
2017-04-13,Kedah,66,12,54,2017
2017-04-14,Kedah,100,28,72,2017
2017-04-15,Kedah,61,22,39,2017
2017-04-16,Kedah,455,113,342,2017
2017-04-17,Kedah,269,105,164,2017
2017-04-18,Kedah,197,33,164,2017
2017-04-19,Kedah,118,31,87,2017
2017-04-20,Kedah,200,52,148,2017
2017-04-21,Kedah,170,37,133,2017
2017-04-22,Kedah,116,36,80,2017
2017-04-23,Kedah,252,51,201,2017
2017-04-24,Kedah,164,31,133,2017
2017-04-25,Kedah,43,2,41,2017
2017-04-26,Kedah,188,56,132,2017
2017-04-27,Kedah,94,25,69,2017
2017-04-28,Kedah,199,11,188,2017
2017-04-29,Kedah,78,23,55,2017
2017-04-30,Kedah,273,112,161,2017
2017-05-01,Kedah,641,93,548,2017
2017-05-02,Kedah,143,48,95,2017
2017-05-03,Kedah,130,37,93,2017
2017-05-04,Kedah,82,12,70,2017
2017-05-05,Kedah,149,36,113,2017
2017-05-06,Kedah,150,66,84,2017
2017-05-07,Kedah,241,65,176,2017
2017-05-08,Kedah,163,54,109,2017
2017-05-09,Kedah,183,56,127,2017
2017-05-10,Kedah,51,12,39,2017
2017-05-11,Kedah,128,34,94,2017
2017-05-12,Kedah,116,34,82,2017
2017-05-13,Kedah,104,37,67,2017
2017-05-14,Kedah,219,50,169,2017
2017-05-15,Kedah,158,33,125,2017
2017-05-16,Kedah,302,87,215,2017
2017-05-17,Kedah,161,32,129,2017
2017-05-18,Kedah,301,75,226,2017
2017-05-19,Kedah,232,37,195,2017
2017-05-20,Kedah,224,61,163,2017
2017-05-21,Kedah,332,72,260,2017
2017-05-22,Kedah,136,18,118,2017
2017-05-23,Kedah,229,72,157,2017
2017-05-24,Kedah,97,5,92,2017
2017-05-25,Kedah,322,97,225,2017
2017-05-26,Kedah,190,23,167,2017
2017-05-27,Kedah,0,0,0,2017
2017-05-28,Kedah,158,32,126,2017
2017-05-29,Kedah,65,4,61,2017
2017-05-30,Kedah,53,4,49,2017
2017-05-31,Kedah,61,20,41,2017
2017-06-01,Kedah,90,25,65,2017
2017-06-02,Kedah,185,37,148,2017
2017-06-03,Kedah,27,17,10,2017
2017-06-04,Kedah,229,42,187,2017
2017-06-05,Kedah,51,14,37,2017
2017-06-06,Kedah,72,13,59,2017
2017-06-07,Kedah,134,55,79,2017
2017-06-08,Kedah,216,62,154,2017
2017-06-09,Kedah,39,16,23,2017
2017-06-10,Kedah,55,34,21,2017
2017-06-11,Kedah,164,35,129,2017
2017-06-12,Kedah,101,34,67,2017
2017-06-13,Kedah,196,92,104,2017
2017-06-14,Kedah,164,80,84,2017
2017-06-15,Kedah,178,45,133,2017
2017-06-16,Kedah,190,52,138,2017
2017-06-17,Kedah,90,12,78,2017
2017-06-18,Kedah,252,49,203,2017
2017-06-19,Kedah,268,102,166,2017
2017-06-20,Kedah,242,87,155,2017
2017-06-21,Kedah,171,56,115,2017
2017-06-22,Kedah,128,27,101,2017
2017-06-23,Kedah,171,47,124,2017
2017-06-24,Kedah,0,0,0,2017
2017-06-25,Kedah,0,0,0,2017
2017-06-26,Kedah,0,0,0,2017
2017-06-27,Kedah,85,14,71,2017
2017-06-28,Kedah,115,30,85,2017
2017-06-29,Kedah,130,24,106,2017
2017-06-30,Kedah,195,22,173,2017
2017-07-01,Kedah,140,43,97,2017
2017-07-02,Kedah,189,32,157,2017
2017-07-03,Kedah,142,16,126,2017
2017-07-04,Kedah,156,37,119,2017
2017-07-05,Kedah,190,25,165,2017
2017-07-06,Kedah,204,74,130,2017
2017-07-07,Kedah,60,11,49,2017
2017-07-08,Kedah,122,36,86,2017
2017-07-09,Kedah,304,66,238,2017
2017-07-10,Kedah,261,128,133,2017
2017-07-11,Kedah,260,112,148,2017
2017-07-12,Kedah,194,64,130,2017
2017-07-13,Kedah,64,9,55,2017
2017-07-14,Kedah,227,74,153,2017
2017-07-15,Kedah,127,35,92,2017
2017-07-16,Kedah,223,45,178,2017
2017-07-17,Kedah,119,29,90,2017
2017-07-18,Kedah,159,42,117,2017
2017-07-19,Kedah,170,93,77,2017
2017-07-20,Kedah,176,73,103,2017
2017-07-21,Kedah,229,54,175,2017
2017-07-22,Kedah,196,92,104,2017
2017-07-23,Kedah,240,92,148,2017
2017-07-24,Kedah,71,6,65,2017
2017-07-25,Kedah,200,86,114,2017
2017-07-26,Kedah,230,86,144,2017
2017-07-27,Kedah,248,98,150,2017
2017-07-28,Kedah,213,37,176,2017
2017-07-29,Kedah,101,23,78,2017
2017-07-30,Kedah,187,58,129,2017
2017-07-31,Kedah,107,27,80,2017
2017-08-01,Kedah,118,63,55,2017
2017-08-02,Kedah,151,49,102,2017
2017-08-03,Kedah,184,121,63,2017
2017-08-04,Kedah,358,99,259,2017
2017-08-05,Kedah,366,87,279,2017
2017-08-06,Kedah,151,37,114,2017
2017-08-07,Kedah,91,7,84,2017
2017-08-08,Kedah,176,41,135,2017
2017-08-09,Kedah,250,96,154,2017
2017-08-10,Kedah,256,135,121,2017
2017-08-11,Kedah,72,21,51,2017
2017-08-12,Kedah,102,35,67,2017
2017-08-13,Kedah,203,45,158,2017
2017-08-14,Kedah,64,13,51,2017
2017-08-15,Kedah,175,71,104,2017
2017-08-16,Kedah,182,94,88,2017
2017-08-17,Kedah,163,30,133,2017
2017-08-18,Kedah,143,23,120,2017
2017-08-19,Kedah,101,29,72,2017
2017-08-20,Kedah,284,39,245,2017
2017-08-21,Kedah,203,71,132,2017
2017-08-22,Kedah,141,41,100,2017
2017-08-23,Kedah,131,34,97,2017
2017-08-24,Kedah,231,68,163,2017
2017-08-25,Kedah,171,18,153,2017
2017-08-26,Kedah,164,99,65,2017
2017-08-27,Kedah,367,68,299,2017
2017-08-28,Kedah,166,39,127,2017
2017-08-29,Kedah,141,34,107,2017
2017-08-30,Kedah,124,18,106,2017
2017-08-31,Kedah,233,58,175,2017
2017-09-01,Kedah,0,0,0,2017
2017-09-02,Kedah,26,5,21,2017
2017-09-03,Kedah,122,25,97,2017
2017-09-04,Kedah,70,21,49,2017
2017-09-05,Kedah,83,18,65,2017
2017-09-06,Kedah,145,26,119,2017
2017-09-07,Kedah,161,46,115,2017
2017-09-08,Kedah,53,15,38,2017
2017-09-09,Kedah,232,77,155,2017
2017-09-10,Kedah,356,117,239,2017
2017-09-11,Kedah,193,35,158,2017
2017-09-12,Kedah,120,41,79,2017
2017-09-13,Kedah,263,60,203,2017
2017-09-14,Kedah,204,61,143,2017
2017-09-15,Kedah,235,122,113,2017
2017-09-16,Kedah,137,39,98,2017
2017-09-17,Kedah,224,62,162,2017
2017-09-18,Kedah,191,50,141,2017
2017-09-19,Kedah,226,82,144,2017
2017-09-20,Kedah,206,70,136,2017
2017-09-21,Kedah,136,30,106,2017
2017-09-22,Kedah,105,15,90,2017
2017-09-23,Kedah,143,40,103,2017
2017-09-24,Kedah,93,25,68,2017
2017-09-25,Kedah,193,38,155,2017
2017-09-26,Kedah,209,48,161,2017
2017-09-27,Kedah,284,130,154,2017
2017-09-28,Kedah,172,58,114,2017
2017-09-29,Kedah,304,29,275,2017
2017-09-30,Kedah,177,61,116,2017
2017-10-01,Kedah,171,46,125,2017
2017-10-02,Kedah,60,4,56,2017
2017-10-03,Kedah,142,19,123,2017
2017-10-04,Kedah,119,30,89,2017
2017-10-05,Kedah,108,21,87,2017
2017-10-06,Kedah,151,35,116,2017
2017-10-07,Kedah,171,82,89,2017
2017-10-08,Kedah,276,56,220,2017
2017-10-09,Kedah,156,50,106,2017
2017-10-10,Kedah,200,43,157,2017
2017-10-11,Kedah,180,69,111,2017
2017-10-12,Kedah,433,154,279,2017
2017-10-13,Kedah,112,23,89,2017
2017-10-14,Kedah,71,21,50,2017
2017-10-15,Kedah,144,21,123,2017
2017-10-16,Kedah,115,18,97,2017
2017-10-17,Kedah,119,27,92,2017
2017-10-18,Kedah,252,40,212,2017
2017-10-19,Kedah,60,11,49,2017
2017-10-20,Kedah,57,11,46,2017
2017-10-21,Kedah,124,33,91,2017
2017-10-22,Kedah,243,48,195,2017
2017-10-23,Kedah,115,17,98,2017
2017-10-24,Kedah,148,18,130,2017
2017-10-25,Kedah,204,76,128,2017
2017-10-26,Kedah,200,75,125,2017
2017-10-27,Kedah,212,43,169,2017
2017-10-28,Kedah,185,110,75,2017
2017-10-29,Kedah,461,128,333,2017
2017-10-30,Kedah,95,14,81,2017
2017-10-31,Kedah,184,41,143,2017
2017-11-01,Kedah,91,30,61,2017
2017-11-02,Kedah,120,50,70,2017
2017-11-03,Kedah,128,26,102,2017
2017-11-04,Kedah,226,108,118,2017
2017-11-05,Kedah,118,16,102,2017
2017-11-06,Kedah,106,39,67,2017
2017-11-07,Kedah,161,41,120,2017
2017-11-08,Kedah,137,33,104,2017
2017-11-09,Kedah,180,67,113,2017
2017-11-10,Kedah,52,10,42,2017
2017-11-11,Kedah,76,26,50,2017
2017-11-12,Kedah,212,39,173,2017
2017-11-13,Kedah,131,31,100,2017
2017-11-14,Kedah,264,75,189,2017
2017-11-15,Kedah,166,48,118,2017
2017-11-16,Kedah,258,96,162,2017
2017-11-17,Kedah,250,44,206,2017
2017-11-18,Kedah,162,58,104,2017
2017-11-19,Kedah,133,21,112,2017
2017-11-20,Kedah,113,29,84,2017
2017-11-21,Kedah,143,27,116,2017
2017-11-22,Kedah,162,44,118,2017
2017-11-23,Kedah,308,100,208,2017
2017-11-24,Kedah,165,28,137,2017
2017-11-25,Kedah,106,32,74,2017
2017-11-26,Kedah,356,49,307,2017
2017-11-27,Kedah,72,11,61,2017
2017-11-28,Kedah,144,41,103,2017
2017-11-29,Kedah,127,28,99,2017
2017-11-30,Kedah,137,27,110,2017
2017-12-01,Kedah,49,12,37,2017
2017-12-02,Kedah,59,21,38,2017
2017-12-03,Kedah,153,24,129,2017
2017-12-04,Kedah,68,8,60,2017
2017-12-05,Kedah,152,22,130,2017
2017-12-06,Kedah,269,84,185,2017
2017-12-07,Kedah,170,42,128,2017
2017-12-08,Kedah,42,9,33,2017
2017-12-09,Kedah,178,71,107,2017
2017-12-10,Kedah,219,40,179,2017
2017-12-11,Kedah,173,42,131,2017
2017-12-12,Kedah,242,82,160,2017
2017-12-13,Kedah,159,35,124,2017
2017-12-14,Kedah,161,58,103,2017
2017-12-15,Kedah,161,35,126,2017
2017-12-16,Kedah,365,267,98,2017
2017-12-17,Kedah,277,54,223,2017
2017-12-18,Kedah,112,18,94,2017
2017-12-19,Kedah,235,63,172,2017
2017-12-20,Kedah,218,71,147,2017
2017-12-21,Kedah,181,84,97,2017
2017-12-22,Kedah,24,3,21,2017
2017-12-23,Kedah,89,28,61,2017
2017-12-24,Kedah,252,70,182,2017
2017-12-25,Kedah,34,17,17,2017
2017-12-26,Kedah,94,24,70,2017
2017-12-27,Kedah,80,13,67,2017
2017-12-28,Kedah,142,28,114,2017
2017-12-29,Kedah,151,20,131,2017
2017-12-30,Kedah,125,38,87,2017
2017-12-31,Kedah,148,23,125,2017
2018-01-01,Kedah,80,10,70,2018
2018-01-02,Kedah,148,25,123,2018
2018-01-03,Kedah,222,64,158,2018
2018-01-04,Kedah,151,66,85,2018
2018-01-05,Kedah,230,31,199,2018
2018-01-06,Kedah,89,26,63,2018
2018-01-07,Kedah,256,60,196,2018
2018-01-08,Kedah,87,24,63,2018
2018-01-09,Kedah,111,27,84,2018
2018-01-10,Kedah,257,65,192,2018
2018-01-11,Kedah,226,76,150,2018
2018-01-12,Kedah,64,7,57,2018
2018-01-13,Kedah,226,102,124,2018
2018-01-14,Kedah,264,50,214,2018
2018-01-15,Kedah,136,48,88,2018
2018-01-16,Kedah,195,45,150,2018
2018-01-17,Kedah,288,115,173,2018
2018-01-18,Kedah,169,71,98,2018
2018-01-19,Kedah,72,9,63,2018
2018-01-20,Kedah,119,31,88,2018
2018-01-21,Kedah,130,38,92,2018
2018-01-22,Kedah,178,39,139,2018
2018-01-23,Kedah,286,97,189,2018
2018-01-24,Kedah,182,29,153,2018
2018-01-25,Kedah,173,65,108,2018
2018-01-26,Kedah,293,28,265,2018
2018-01-27,Kedah,143,45,98,2018
2018-01-28,Kedah,247,45,202,2018
2018-01-29,Kedah,130,26,104,2018
2018-01-30,Kedah,161,43,118,2018
2018-01-31,Kedah,182,78,104,2018
2018-02-01,Kedah,77,8,69,2018
2018-02-02,Kedah,80,17,63,2018
2018-02-03,Kedah,203,112,91,2018
2018-02-04,Kedah,182,34,148,2018
2018-02-05,Kedah,132,37,95,2018
2018-02-06,Kedah,268,83,185,2018
2018-02-07,Kedah,241,71,170,2018
2018-02-08,Kedah,202,47,155,2018
2018-02-09,Kedah,42,10,32,2018
2018-02-10,Kedah,217,97,120,2018
2018-02-11,Kedah,211,43,168,2018
2018-02-12,Kedah,148,26,122,2018
2018-02-13,Kedah,133,28,105,2018
2018-02-14,Kedah,219,66,153,2018
2018-02-15,Kedah,198,58,140,2018
2018-02-16,Kedah,44,12,32,2018
2018-02-17,Kedah,62,26,36,2018
2018-02-18,Kedah,91,22,69,2018
2018-02-19,Kedah,148,30,118,2018
2018-02-20,Kedah,119,37,82,2018
2018-02-21,Kedah,236,61,175,2018
2018-02-22,Kedah,328,110,218,2018
2018-02-23,Kedah,108,11,97,2018
2018-02-24,Kedah,133,43,90,2018
2018-02-25,Kedah,472,75,397,2018
2018-02-26,Kedah,52,7,45,2018
2018-02-27,Kedah,140,26,114,2018
2018-02-28,Kedah,322,107,215,2018
2018-03-01,Kedah,142,49,93,2018
2018-03-02,Kedah,82,23,59,2018
2018-03-03,Kedah,68,22,46,2018
2018-03-04,Kedah,174,29,145,2018
2018-03-05,Kedah,114,14,100,2018
2018-03-06,Kedah,151,51,100,2018
2018-03-07,Kedah,248,70,178,2018
2018-03-08,Kedah,241,58,183,2018
2018-03-09,Kedah,49,5,44,2018
2018-03-10,Kedah,293,86,207,2018
2018-03-11,Kedah,307,51,256,2018
2018-03-12,Kedah,148,18,130,2018
2018-03-13,Kedah,216,86,130,2018
2018-03-14,Kedah,170,46,124,2018
2018-03-15,Kedah,248,57,191,2018
2018-03-16,Kedah,32,6,26,2018
2018-03-17,Kedah,107,53,54,2018
2018-03-18,Kedah,237,68,169,2018
2018-03-19,Kedah,161,44,117,2018
2018-03-20,Kedah,134,28,106,2018
2018-03-21,Kedah,143,34,109,2018
2018-03-22,Kedah,138,37,101,2018
2018-03-23,Kedah,253,46,207,2018
2018-03-24,Kedah,140,31,109,2018
2018-03-25,Kedah,157,48,109,2018
2018-03-26,Kedah,155,48,107,2018
2018-03-27,Kedah,189,51,138,2018
2018-03-28,Kedah,191,35,156,2018
2018-03-29,Kedah,245,72,173,2018
2018-03-30,Kedah,60,11,49,2018
2018-03-31,Kedah,159,80,79,2018
2018-04-01,Kedah,192,58,134,2018
2018-04-02,Kedah,138,27,111,2018
2018-04-03,Kedah,192,50,142,2018
2018-04-04,Kedah,249,66,183,2018
2018-04-05,Kedah,272,81,191,2018
2018-04-06,Kedah,72,25,47,2018
2018-04-07,Kedah,189,77,112,2018
2018-04-08,Kedah,263,34,229,2018
2018-04-09,Kedah,141,24,117,2018
2018-04-10,Kedah,332,94,238,2018
2018-04-11,Kedah,185,70,115,2018
2018-04-12,Kedah,207,89,118,2018
2018-04-13,Kedah,109,16,93,2018
2018-04-14,Kedah,128,50,78,2018
2018-04-15,Kedah,286,73,213,2018
2018-04-16,Kedah,167,24,143,2018
2018-04-17,Kedah,286,148,138,2018
2018-04-18,Kedah,193,55,138,2018
2018-04-19,Kedah,141,58,83,2018
2018-04-20,Kedah,363,65,298,2018
2018-04-21,Kedah,169,56,113,2018
2018-04-22,Kedah,175,75,100,2018
2018-04-23,Kedah,186,80,106,2018
2018-04-24,Kedah,182,37,145,2018
2018-04-25,Kedah,222,51,171,2018
2018-04-26,Kedah,183,44,139,2018
2018-04-27,Kedah,149,18,131,2018
2018-04-28,Kedah,43,13,30,2018
2018-04-29,Kedah,193,33,160,2018
2018-04-30,Kedah,107,16,91,2018
2018-05-01,Kedah,749,101,648,2018
2018-05-02,Kedah,62,9,53,2018
2018-05-03,Kedah,147,43,104,2018
2018-05-04,Kedah,49,7,42,2018
2018-05-05,Kedah,85,28,57,2018
2018-05-06,Kedah,168,25,143,2018
2018-05-07,Kedah,192,27,165,2018
2018-05-08,Kedah,106,8,98,2018
2018-05-09,Kedah,0,0,0,2018
2018-05-10,Kedah,68,13,55,2018
2018-05-11,Kedah,127,24,103,2018
2018-05-12,Kedah,207,74,133,2018
2018-05-13,Kedah,463,80,383,2018
2018-05-14,Kedah,163,32,131,2018
2018-05-15,Kedah,482,141,341,2018
2018-05-16,Kedah,185,33,152,2018
2018-05-17,Kedah,2,0,2,2018
2018-05-18,Kedah,193,26,167,2018
2018-05-19,Kedah,54,13,41,2018
2018-05-20,Kedah,355,51,304,2018
2018-05-21,Kedah,105,28,77,2018
2018-05-22,Kedah,120,32,88,2018
2018-05-23,Kedah,85,29,56,2018
2018-05-24,Kedah,90,14,76,2018
2018-05-25,Kedah,215,31,184,2018
2018-05-26,Kedah,252,170,82,2018
2018-05-27,Kedah,213,24,189,2018
2018-05-28,Kedah,178,52,126,2018
2018-05-29,Kedah,60,13,47,2018
2018-05-30,Kedah,91,25,66,2018
2018-05-31,Kedah,123,48,75,2018
2018-06-01,Kedah,160,33,127,2018
2018-06-02,Kedah,76,18,58,2018
2018-06-03,Kedah,334,60,274,2018
2018-06-04,Kedah,131,53,78,2018
2018-06-05,Kedah,96,20,76,2018
2018-06-06,Kedah,168,46,122,2018
2018-06-07,Kedah,85,29,56,2018
2018-06-08,Kedah,204,56,148,2018
2018-06-09,Kedah,23,12,11,2018
2018-06-10,Kedah,104,32,72,2018
2018-06-11,Kedah,110,20,90,2018
2018-06-12,Kedah,71,14,57,2018
2018-06-13,Kedah,119,35,84,2018
2018-06-14,Kedah,12,1,11,2018
2018-06-15,Kedah,0,0,0,2018
2018-06-16,Kedah,6,0,6,2018
2018-06-17,Kedah,108,24,84,2018
2018-06-18,Kedah,111,19,92,2018
2018-06-19,Kedah,145,26,119,2018
2018-06-20,Kedah,156,17,139,2018
2018-06-21,Kedah,136,48,88,2018
2018-06-22,Kedah,149,66,83,2018
2018-06-23,Kedah,103,30,73,2018
2018-06-24,Kedah,264,65,199,2018
2018-06-25,Kedah,113,15,98,2018
2018-06-26,Kedah,161,30,131,2018
2018-06-27,Kedah,233,85,148,2018
2018-06-28,Kedah,245,102,143,2018
2018-06-29,Kedah,406,81,325,2018
2018-06-30,Kedah,93,30,63,2018
2018-07-01,Kedah,240,81,159,2018
2018-07-02,Kedah,226,56,170,2018
2018-07-03,Kedah,207,65,142,2018
2018-07-04,Kedah,185,49,136,2018
2018-07-05,Kedah,175,72,103,2018
2018-07-06,Kedah,41,15,26,2018
2018-07-07,Kedah,163,62,101,2018
2018-07-08,Kedah,336,96,240,2018
2018-07-09,Kedah,102,13,89,2018
2018-07-10,Kedah,128,26,102,2018
2018-07-11,Kedah,199,81,118,2018
2018-07-12,Kedah,79,17,62,2018
2018-07-13,Kedah,43,3,40,2018
2018-07-14,Kedah,180,48,132,2018
2018-07-15,Kedah,313,108,205,2018
2018-07-16,Kedah,118,27,91,2018
2018-07-17,Kedah,119,18,101,2018
2018-07-18,Kedah,195,72,123,2018
2018-07-19,Kedah,127,39,88,2018
2018-07-20,Kedah,425,93,332,2018
2018-07-21,Kedah,127,55,72,2018
2018-07-22,Kedah,145,29,116,2018
2018-07-23,Kedah,100,39,61,2018
2018-07-24,Kedah,225,83,142,2018
2018-07-25,Kedah,293,124,169,2018
2018-07-26,Kedah,122,42,80,2018
2018-07-27,Kedah,69,11,58,2018
2018-07-28,Kedah,112,35,77,2018
2018-07-29,Kedah,389,88,301,2018
2018-07-30,Kedah,81,19,62,2018
2018-07-31,Kedah,227,78,149,2018
2018-08-01,Kedah,210,40,170,2018
2018-08-02,Kedah,227,54,173,2018
2018-08-03,Kedah,61,10,51,2018
2018-08-04,Kedah,85,20,65,2018
2018-08-05,Kedah,167,36,131,2018
2018-08-06,Kedah,148,25,123,2018
2018-08-07,Kedah,258,118,140,2018
2018-08-08,Kedah,334,138,196,2018
2018-08-09,Kedah,250,181,69,2018
2018-08-10,Kedah,293,220,73,2018
2018-08-11,Kedah,201,88,113,2018
2018-08-12,Kedah,359,103,256,2018
2018-08-13,Kedah,284,146,138,2018
2018-08-14,Kedah,136,41,95,2018
2018-08-15,Kedah,312,163,149,2018
2018-08-16,Kedah,243,122,121,2018
2018-08-17,Kedah,246,76,170,2018
2018-08-18,Kedah,341,116,225,2018
2018-08-19,Kedah,165,32,133,2018
2018-08-20,Kedah,224,85,139,2018
2018-08-21,Kedah,115,15,100,2018
2018-08-22,Kedah,0,0,0,2018
2018-08-23,Kedah,10,1,9,2018
2018-08-24,Kedah,155,21,134,2018
2018-08-25,Kedah,57,16,41,2018
2018-08-26,Kedah,208,14,194,2018
2018-08-27,Kedah,108,51,57,2018
2018-08-28,Kedah,153,39,114,2018
2018-08-29,Kedah,216,62,154,2018
2018-08-30,Kedah,147,51,96,2018
2018-08-31,Kedah,113,20,93,2018
2018-09-01,Kedah,112,21,91,2018
2018-09-02,Kedah,144,39,105,2018
2018-09-03,Kedah,116,54,62,2018
2018-09-04,Kedah,165,40,125,2018
2018-09-05,Kedah,169,35,134,2018
2018-09-06,Kedah,208,69,139,2018
2018-09-07,Kedah,197,45,152,2018
2018-09-08,Kedah,60,23,37,2018
2018-09-09,Kedah,218,56,162,2018
2018-09-10,Kedah,178,20,158,2018
2018-09-11,Kedah,35,16,19,2018
2018-09-12,Kedah,195,48,147,2018
2018-09-13,Kedah,223,118,105,2018
2018-09-14,Kedah,25,5,20,2018
2018-09-15,Kedah,163,109,54,2018
2018-09-16,Kedah,199,34,165,2018
2018-09-17,Kedah,130,25,105,2018
2018-09-18,Kedah,201,57,144,2018
2018-09-19,Kedah,271,53,218,2018
2018-09-20,Kedah,169,77,92,2018
2018-09-21,Kedah,75,27,48,2018
2018-09-22,Kedah,115,22,93,2018
2018-09-23,Kedah,358,80,278,2018
2018-09-24,Kedah,79,15,64,2018
2018-09-25,Kedah,223,63,160,2018
2018-09-26,Kedah,166,62,104,2018
2018-09-27,Kedah,412,234,178,2018
2018-09-28,Kedah,207,29,178,2018
2018-09-29,Kedah,195,48,147,2018
2018-09-30,Kedah,344,88,256,2018
2018-10-01,Kedah,144,44,100,2018
2018-10-02,Kedah,205,63,142,2018
2018-10-03,Kedah,150,47,103,2018
2018-10-04,Kedah,217,52,165,2018
2018-10-05,Kedah,271,54,217,2018
2018-10-06,Kedah,300,156,144,2018
2018-10-07,Kedah,176,29,147,2018
2018-10-08,Kedah,97,16,81,2018
2018-10-09,Kedah,96,28,68,2018
2018-10-10,Kedah,192,82,110,2018
2018-10-11,Kedah,159,54,105,2018
2018-10-12,Kedah,177,29,148,2018
2018-10-13,Kedah,140,21,119,2018
2018-10-14,Kedah,184,38,146,2018
2018-10-15,Kedah,114,33,81,2018
2018-10-16,Kedah,77,12,65,2018
2018-10-17,Kedah,150,36,114,2018
2018-10-18,Kedah,196,42,154,2018
2018-10-19,Kedah,133,58,75,2018
2018-10-20,Kedah,123,36,87,2018
2018-10-21,Kedah,142,29,113,2018
2018-10-22,Kedah,72,23,49,2018
2018-10-23,Kedah,120,26,94,2018
2018-10-24,Kedah,165,59,106,2018
2018-10-25,Kedah,180,52,128,2018
2018-10-26,Kedah,211,29,182,2018
2018-10-27,Kedah,110,30,80,2018
2018-10-28,Kedah,265,76,189,2018
2018-10-29,Kedah,191,35,156,2018
2018-10-30,Kedah,188,62,126,2018
2018-10-31,Kedah,81,15,66,2018
2018-11-01,Kedah,119,38,81,2018
2018-11-02,Kedah,153,45,108,2018
2018-11-03,Kedah,70,19,51,2018
2018-11-04,Kedah,118,17,101,2018
2018-11-05,Kedah,103,8,95,2018
2018-11-06,Kedah,249,25,224,2018
2018-11-07,Kedah,137,30,107,2018
2018-11-08,Kedah,249,37,212,2018
2018-11-09,Kedah,134,27,107,2018
2018-11-10,Kedah,55,17,38,2018
2018-11-11,Kedah,477,75,402,2018
2018-11-12,Kedah,168,53,115,2018
2018-11-13,Kedah,212,48,164,2018
2018-11-14,Kedah,204,60,144,2018
2018-11-15,Kedah,138,50,88,2018
2018-11-16,Kedah,274,166,108,2018
2018-11-17,Kedah,64,25,39,2018
2018-11-18,Kedah,403,89,314,2018
2018-11-19,Kedah,112,22,90,2018
2018-11-20,Kedah,147,58,89,2018
2018-11-21,Kedah,216,41,175,2018
2018-11-22,Kedah,64,6,58,2018
2018-11-23,Kedah,235,29,206,2018
2018-11-24,Kedah,57,23,34,2018
2018-11-25,Kedah,192,34,158,2018
2018-11-26,Kedah,131,29,102,2018
2018-11-27,Kedah,116,25,91,2018
2018-11-28,Kedah,226,65,161,2018
2018-11-29,Kedah,169,56,113,2018
2018-11-30,Kedah,72,9,63,2018
2018-12-01,Kedah,35,15,20,2018
2018-12-02,Kedah,177,36,141,2018
2018-12-03,Kedah,113,18,95,2018
2018-12-04,Kedah,154,32,122,2018
2018-12-05,Kedah,204,35,169,2018
2018-12-06,Kedah,127,32,95,2018
2018-12-07,Kedah,109,30,79,2018
2018-12-08,Kedah,62,24,38,2018
2018-12-09,Kedah,222,30,192,2018
2018-12-10,Kedah,152,33,119,2018
2018-12-11,Kedah,223,48,175,2018
2018-12-12,Kedah,225,44,181,2018
2018-12-13,Kedah,124,46,78,2018
2018-12-14,Kedah,50,11,39,2018
2018-12-15,Kedah,96,24,72,2018
2018-12-16,Kedah,193,24,169,2018
2018-12-17,Kedah,137,20,117,2018
2018-12-18,Kedah,184,42,142,2018
2018-12-19,Kedah,157,41,116,2018
2018-12-20,Kedah,167,58,109,2018
2018-12-21,Kedah,176,81,95,2018
2018-12-22,Kedah,33,12,21,2018
2018-12-23,Kedah,140,29,111,2018
2018-12-24,Kedah,109,23,86,2018
2018-12-25,Kedah,105,30,75,2018
2018-12-26,Kedah,170,36,134,2018
2018-12-27,Kedah,132,12,120,2018
2018-12-28,Kedah,254,25,229,2018
2018-12-29,Kedah,88,19,69,2018
2018-12-30,Kedah,174,41,133,2018
2018-12-31,Kedah,138,31,107,2018
2019-01-01,Kedah,136,30,106,2019
2019-01-02,Kedah,196,31,165,2019
2019-01-03,Kedah,320,81,239,2019
2019-01-04,Kedah,309,111,198,2019
2019-01-05,Kedah,54,21,33,2019
2019-01-06,Kedah,246,38,208,2019
2019-01-07,Kedah,92,18,74,2019
2019-01-08,Kedah,204,49,155,2019
2019-01-09,Kedah,240,93,147,2019
2019-01-10,Kedah,94,14,80,2019
2019-01-11,Kedah,204,41,163,2019
2019-01-12,Kedah,68,19,49,2019
2019-01-13,Kedah,254,44,210,2019
2019-01-14,Kedah,159,52,107,2019
2019-01-15,Kedah,106,13,93,2019
2019-01-16,Kedah,148,45,103,2019
2019-01-17,Kedah,212,72,140,2019
2019-01-18,Kedah,89,22,67,2019
2019-01-19,Kedah,167,54,113,2019
2019-01-20,Kedah,114,17,97,2019
2019-01-21,Kedah,163,53,110,2019
2019-01-22,Kedah,139,28,111,2019
2019-01-23,Kedah,390,190,200,2019
2019-01-24,Kedah,162,42,120,2019
2019-01-25,Kedah,360,146,214,2019
2019-01-26,Kedah,237,132,105,2019
2019-01-27,Kedah,348,79,269,2019
2019-01-28,Kedah,100,15,85,2019
2019-01-29,Kedah,112,22,90,2019
2019-01-30,Kedah,124,18,106,2019
2019-01-31,Kedah,149,33,116,2019
2019-02-01,Kedah,68,7,61,2019
2019-02-02,Kedah,96,19,77,2019
2019-02-03,Kedah,224,44,180,2019
2019-02-04,Kedah,180,34,146,2019
2019-02-05,Kedah,127,33,94,2019
2019-02-06,Kedah,68,22,46,2019
2019-02-07,Kedah,117,34,83,2019
2019-02-08,Kedah,100,20,80,2019
2019-02-09,Kedah,73,14,59,2019
2019-02-10,Kedah,530,71,459,2019
2019-02-11,Kedah,176,33,143,2019
2019-02-12,Kedah,159,22,137,2019
2019-02-13,Kedah,212,44,168,2019
2019-02-14,Kedah,134,51,83,2019
2019-02-15,Kedah,75,21,54,2019
2019-02-16,Kedah,93,23,70,2019
2019-02-17,Kedah,191,42,149,2019
2019-02-18,Kedah,140,38,102,2019
2019-02-19,Kedah,137,28,109,2019
2019-02-20,Kedah,320,126,194,2019
2019-02-21,Kedah,147,37,110,2019
2019-02-22,Kedah,165,16,149,2019
2019-02-23,Kedah,140,50,90,2019
2019-02-24,Kedah,357,96,261,2019
2019-02-25,Kedah,184,46,138,2019
2019-02-26,Kedah,248,56,192,2019
2019-02-27,Kedah,207,64,143,2019
2019-02-28,Kedah,149,38,111,2019
2019-03-01,Kedah,59,6,53,2019
2019-03-02,Kedah,62,19,43,2019
2019-03-03,Kedah,197,53,144,2019
2019-03-04,Kedah,189,59,130,2019
2019-03-05,Kedah,371,93,278,2019
2019-03-06,Kedah,364,106,258,2019
2019-03-07,Kedah,46,6,40,2019
2019-03-08,Kedah,138,37,101,2019
2019-03-09,Kedah,118,41,77,2019
2019-03-10,Kedah,389,89,300,2019
2019-03-11,Kedah,121,38,83,2019
2019-03-12,Kedah,268,66,202,2019
2019-03-13,Kedah,312,81,231,2019
2019-03-14,Kedah,216,75,141,2019
2019-03-15,Kedah,147,46,101,2019
2019-03-16,Kedah,152,62,90,2019
2019-03-17,Kedah,205,32,173,2019
2019-03-18,Kedah,231,51,180,2019
2019-03-19,Kedah,315,107,208,2019
2019-03-20,Kedah,354,93,261,2019
2019-03-21,Kedah,128,25,103,2019
2019-03-22,Kedah,304,57,247,2019
2019-03-23,Kedah,115,35,80,2019
2019-03-24,Kedah,143,21,122,2019
2019-03-25,Kedah,82,9,73,2019
2019-03-26,Kedah,221,53,168,2019
2019-03-27,Kedah,242,61,181,2019
2019-03-28,Kedah,172,43,129,2019
2019-03-29,Kedah,81,12,69,2019
2019-03-30,Kedah,108,32,76,2019
2019-03-31,Kedah,136,26,110,2019
2019-04-01,Kedah,74,12,62,2019
2019-04-02,Kedah,146,29,117,2019
2019-04-03,Kedah,32,11,21,2019
2019-04-04,Kedah,237,71,166,2019
2019-04-05,Kedah,112,35,77,2019
2019-04-06,Kedah,141,41,100,2019
2019-04-07,Kedah,175,37,138,2019
2019-04-08,Kedah,119,20,99,2019
2019-04-09,Kedah,146,43,103,2019
2019-04-10,Kedah,192,54,138,2019
2019-04-11,Kedah,191,52,139,2019
2019-04-12,Kedah,90,20,70,2019
2019-04-13,Kedah,257,71,186,2019
2019-04-14,Kedah,335,50,285,2019
2019-04-15,Kedah,79,14,65,2019
2019-04-16,Kedah,197,53,144,2019
2019-04-17,Kedah,421,133,288,2019
2019-04-18,Kedah,159,56,103,2019
2019-04-19,Kedah,192,38,154,2019
2019-04-20,Kedah,174,82,92,2019
2019-04-21,Kedah,208,45,163,2019
2019-04-22,Kedah,271,62,209,2019
2019-04-23,Kedah,156,48,108,2019
2019-04-24,Kedah,190,48,142,2019
2019-04-25,Kedah,272,99,173,2019
2019-04-26,Kedah,310,56,254,2019
2019-04-27,Kedah,164,49,115,2019
2019-04-28,Kedah,439,93,346,2019
2019-04-29,Kedah,190,43,147,2019
2019-04-30,Kedah,387,90,297,2019
2019-05-01,Kedah,731,110,621,2019
2019-05-02,Kedah,255,55,200,2019
2019-05-03,Kedah,448,107,341,2019
2019-05-04,Kedah,267,66,201,2019
2019-05-05,Kedah,289,57,232,2019
2019-05-06,Kedah,3,2,1,2019
2019-05-07,Kedah,77,17,60,2019
2019-05-08,Kedah,104,35,69,2019
2019-05-09,Kedah,111,39,72,2019
2019-05-10,Kedah,167,26,141,2019
2019-05-11,Kedah,19,3,16,2019
2019-05-12,Kedah,264,43,221,2019
2019-05-13,Kedah,36,11,25,2019
2019-05-14,Kedah,74,15,59,2019
2019-05-15,Kedah,57,21,36,2019
2019-05-16,Kedah,106,20,86,2019
2019-05-17,Kedah,192,37,155,2019
2019-05-18,Kedah,22,10,12,2019
2019-05-19,Kedah,158,47,111,2019
2019-05-20,Kedah,122,40,82,2019
2019-05-21,Kedah,119,31,88,2019
2019-05-22,Kedah,72,43,29,2019
2019-05-23,Kedah,69,17,52,2019
2019-05-24,Kedah,249,33,216,2019
2019-05-25,Kedah,39,4,35,2019
2019-05-26,Kedah,330,34,296,2019
2019-05-27,Kedah,32,2,30,2019
2019-05-28,Kedah,91,23,68,2019
2019-05-29,Kedah,92,30,62,2019
2019-05-30,Kedah,103,39,64,2019
2019-05-31,Kedah,75,22,53,2019
2019-06-01,Kedah,6,1,5,2019
2019-06-02,Kedah,107,25,82,2019
2019-06-03,Kedah,68,15,53,2019
2019-06-04,Kedah,47,8,39,2019
2019-06-05,Kedah,0,0,0,2019
2019-06-06,Kedah,0,0,0,2019
2019-06-07,Kedah,41,3,38,2019
2019-06-08,Kedah,65,8,57,2019
2019-06-09,Kedah,198,23,175,2019
2019-06-10,Kedah,123,19,104,2019
2019-06-11,Kedah,177,25,152,2019
2019-06-12,Kedah,142,26,116,2019
2019-06-13,Kedah,166,75,91,2019
2019-06-14,Kedah,133,23,110,2019
2019-06-15,Kedah,68,17,51,2019
2019-06-16,Kedah,363,68,295,2019
2019-06-17,Kedah,80,8,72,2019
2019-06-18,Kedah,150,26,124,2019
2019-06-19,Kedah,195,37,158,2019
2019-06-20,Kedah,392,104,288,2019
2019-06-21,Kedah,81,27,54,2019
2019-06-22,Kedah,99,35,64,2019
2019-06-23,Kedah,239,52,187,2019
2019-06-24,Kedah,192,65,127,2019
2019-06-25,Kedah,193,76,117,2019
2019-06-26,Kedah,81,3,78,2019
2019-06-27,Kedah,21,2,19,2019
2019-06-28,Kedah,184,21,163,2019
2019-06-29,Kedah,0,0,0,2019
2019-06-30,Kedah,78,12,66,2019
2019-07-01,Kedah,50,9,41,2019
2019-07-02,Kedah,30,8,22,2019
2019-07-03,Kedah,92,50,42,2019
2019-07-04,Kedah,51,26,25,2019
2019-07-05,Kedah,18,3,15,2019
2019-07-06,Kedah,96,77,19,2019
2019-07-07,Kedah,50,8,42,2019
2019-07-08,Kedah,52,10,42,2019
2019-07-09,Kedah,46,12,34,2019
2019-07-10,Kedah,111,52,59,2019
2019-07-11,Kedah,51,17,34,2019
2019-07-12,Kedah,32,9,23,2019
2019-07-13,Kedah,32,7,25,2019
2019-07-14,Kedah,123,75,48,2019
2019-07-15,Kedah,101,38,63,2019
2019-07-16,Kedah,35,4,31,2019
2019-07-17,Kedah,85,41,44,2019
2019-07-18,Kedah,36,16,20,2019
2019-07-19,Kedah,57,36,21,2019
2019-07-20,Kedah,152,52,100,2019
2019-07-21,Kedah,176,31,145,2019
2019-07-22,Kedah,51,13,38,2019
2019-07-23,Kedah,42,7,35,2019
2019-07-24,Kedah,69,29,40,2019
2019-07-25,Kedah,63,28,35,2019
2019-07-26,Kedah,148,62,86,2019
2019-07-27,Kedah,109,62,47,2019
2019-07-28,Kedah,52,16,36,2019
2019-07-29,Kedah,70,28,42,2019
2019-07-30,Kedah,38,1,37,2019
2019-07-31,Kedah,67,41,26,2019
2019-08-01,Kedah,75,18,57,2019
2019-08-02,Kedah,106,23,83,2019
2019-08-03,Kedah,117,23,94,2019
2019-08-04,Kedah,98,20,78,2019
2019-08-05,Kedah,56,31,25,2019
2019-08-06,Kedah,56,31,25,2019
2019-08-07,Kedah,101,32,69,2019
2019-08-08,Kedah,71,36,35,2019
2019-08-09,Kedah,25,2,23,2019
2019-08-10,Kedah,34,11,23,2019
2019-08-11,Kedah,0,0,0,2019
2019-08-12,Kedah,55,8,47,2019
2019-08-13,Kedah,61,9,52,2019
2019-08-14,Kedah,37,4,33,2019
2019-08-15,Kedah,77,27,50,2019
2019-08-16,Kedah,32,10,22,2019
2019-08-17,Kedah,54,37,17,2019
2019-08-18,Kedah,53,3,50,2019
2019-08-19,Kedah,33,4,29,2019
2019-08-20,Kedah,28,3,25,2019
2019-08-21,Kedah,16,4,12,2019
2019-08-22,Kedah,64,39,25,2019
2019-08-23,Kedah,190,42,148,2019
2019-08-24,Kedah,31,10,21,2019
2019-08-25,Kedah,57,8,49,2019
2019-08-26,Kedah,48,11,37,2019
2019-08-27,Kedah,25,7,18,2019
2019-08-28,Kedah,26,9,17,2019
2019-08-29,Kedah,73,29,44,2019
2019-08-30,Kedah,27,4,23,2019
2019-08-31,Kedah,128,23,105,2019
2019-09-01,Kedah,41,7,34,2019
2019-09-02,Kedah,37,9,28,2019
2019-09-03,Kedah,24,5,19,2019
2019-09-04,Kedah,54,32,22,2019
2019-09-05,Kedah,77,43,34,2019
2019-09-06,Kedah,15,2,13,2019
2019-09-07,Kedah,41,10,31,2019
2019-09-08,Kedah,40,3,37,2019
2019-09-09,Kedah,40,6,34,2019
2019-09-10,Kedah,69,37,32,2019
2019-09-11,Kedah,74,26,48,2019
2019-09-12,Kedah,69,37,32,2019
2019-09-13,Kedah,21,3,18,2019
2019-09-14,Kedah,182,85,97,2019
2019-09-15,Kedah,92,22,70,2019
2019-09-16,Kedah,72,9,63,2019
2019-09-17,Kedah,100,42,58,2019
2019-09-18,Kedah,70,32,38,2019
2019-09-19,Kedah,63,22,41,2019
2019-09-20,Kedah,141,14,127,2019
2019-09-21,Kedah,25,6,19,2019
2019-09-22,Kedah,53,10,43,2019
2019-09-23,Kedah,51,14,37,2019
2019-09-24,Kedah,55,9,46,2019
2019-09-25,Kedah,75,30,45,2019
2019-09-26,Kedah,30,5,25,2019
2019-09-27,Kedah,35,0,35,2019
2019-09-28,Kedah,51,11,40,2019
2019-09-29,Kedah,124,26,98,2019
2019-09-30,Kedah,28,3,25,2019
2019-10-01,Kedah,91,21,70,2019
2019-10-02,Kedah,126,55,71,2019
2019-10-03,Kedah,79,23,56,2019
2019-10-04,Kedah,28,2,26,2019
2019-10-05,Kedah,25,4,21,2019
2019-10-06,Kedah,57,8,49,2019
2019-10-07,Kedah,35,8,27,2019
2019-10-08,Kedah,68,19,49,2019
2019-10-09,Kedah,76,25,51,2019
2019-10-10,Kedah,40,20,20,2019
2019-10-11,Kedah,37,6,31,2019
2019-10-12,Kedah,32,4,28,2019
2019-10-13,Kedah,86,12,74,2019
2019-10-14,Kedah,48,7,41,2019
2019-10-15,Kedah,76,29,47,2019
2019-10-16,Kedah,75,28,47,2019
2019-10-17,Kedah,65,20,45,2019
2019-10-18,Kedah,28,3,25,2019
2019-10-19,Kedah,14,6,8,2019
2019-10-20,Kedah,101,12,89,2019
2019-10-21,Kedah,23,1,22,2019
2019-10-22,Kedah,33,7,26,2019
2019-10-23,Kedah,31,2,29,2019
2019-10-24,Kedah,48,14,34,2019
2019-10-25,Kedah,98,6,92,2019
2019-10-26,Kedah,32,6,26,2019
2019-10-27,Kedah,172,4,168,2019
2019-10-28,Kedah,33,3,30,2019
2019-10-29,Kedah,30,2,28,2019
2019-10-30,Kedah,30,2,28,2019
2019-10-31,Kedah,70,5,65,2019
2019-11-01,Kedah,25,9,16,2019
2019-11-02,Kedah,28,5,23,2019
2019-11-03,Kedah,49,13,36,2019
2019-11-04,Kedah,29,5,24,2019
2019-11-05,Kedah,24,4,20,2019
2019-11-06,Kedah,28,5,23,2019
2019-11-07,Kedah,37,11,26,2019
2019-11-08,Kedah,164,32,132,2019
2019-11-09,Kedah,0,0,0,2019
2019-11-10,Kedah,34,4,30,2019
2019-11-11,Kedah,81,28,53,2019
2019-11-12,Kedah,40,4,36,2019
2019-11-13,Kedah,127,27,100,2019
2019-11-14,Kedah,54,12,42,2019
2019-11-15,Kedah,28,5,23,2019
2019-11-16,Kedah,75,20,55,2019
2019-11-17,Kedah,141,57,84,2019
2019-11-18,Kedah,32,7,25,2019
2019-11-19,Kedah,71,23,48,2019
2019-11-20,Kedah,43,12,31,2019
2019-11-21,Kedah,52,16,36,2019
2019-11-22,Kedah,82,39,43,2019
2019-11-23,Kedah,50,9,41,2019
2019-11-24,Kedah,92,34,58,2019
2019-11-25,Kedah,87,39,48,2019
2019-11-26,Kedah,115,54,61,2019
2019-11-27,Kedah,56,29,27,2019
2019-11-28,Kedah,75,22,53,2019
2019-11-29,Kedah,107,18,89,2019
2019-11-30,Kedah,44,11,33,2019
2019-12-01,Kedah,65,12,53,2019
2019-12-02,Kedah,36,12,24,2019
2019-12-03,Kedah,49,9,40,2019
2019-12-04,Kedah,45,5,40,2019
2019-12-05,Kedah,31,4,27,2019
2019-12-06,Kedah,58,31,27,2019
2019-12-07,Kedah,2,1,1,2019
2019-12-08,Kedah,108,10,98,2019
2019-12-09,Kedah,54,14,40,2019
2019-12-10,Kedah,60,23,37,2019
2019-12-11,Kedah,40,8,32,2019
2019-12-12,Kedah,36,9,27,2019
2019-12-13,Kedah,36,3,33,2019
2019-12-14,Kedah,43,7,36,2019
2019-12-15,Kedah,78,25,53,2019
2019-12-16,Kedah,95,29,66,2019
2019-12-17,Kedah,84,29,55,2019
2019-12-18,Kedah,93,60,33,2019
2019-12-19,Kedah,71,25,46,2019
2019-12-20,Kedah,115,8,107,2019
2019-12-21,Kedah,51,8,43,2019
2019-12-22,Kedah,92,12,80,2019
2019-12-23,Kedah,34,2,32,2019
2019-12-24,Kedah,31,2,29,2019
2019-12-25,Kedah,50,7,43,2019
2019-12-26,Kedah,113,65,48,2019
2019-12-27,Kedah,99,25,74,2019
2019-12-28,Kedah,56,7,49,2019
2019-12-29,Kedah,110,58,52,2019
2019-12-30,Kedah,65,24,41,2019
2019-12-31,Kedah,44,6,38,2019
2020-01-01,Kedah,112,20,92,2020
2020-01-02,Kedah,69,10,59,2020
2020-01-03,Kedah,173,25,148,2020
2020-01-04,Kedah,48,8,40,2020
2020-01-05,Kedah,81,20,61,2020
2020-01-06,Kedah,38,22,16,2020
2020-01-07,Kedah,58,12,46,2020
2020-01-08,Kedah,37,6,31,2020
2020-01-09,Kedah,48,22,26,2020
2020-01-10,Kedah,33,3,30,2020
2020-01-11,Kedah,52,8,44,2020
2020-01-12,Kedah,48,10,38,2020
2020-01-13,Kedah,59,16,43,2020
2020-01-14,Kedah,39,9,30,2020
2020-01-15,Kedah,58,19,39,2020
2020-01-16,Kedah,81,30,51,2020
2020-01-17,Kedah,65,18,47,2020
2020-01-18,Kedah,71,17,54,2020
2020-01-19,Kedah,181,64,117,2020
2020-01-20,Kedah,78,16,62,2020
2020-01-21,Kedah,66,26,40,2020
2020-01-22,Kedah,108,22,86,2020
2020-01-23,Kedah,81,44,37,2020
2020-01-24,Kedah,60,23,37,2020
2020-01-25,Kedah,84,19,65,2020
2020-01-26,Kedah,26,11,15,2020
2020-01-27,Kedah,64,9,55,2020
2020-01-28,Kedah,71,18,53,2020
2020-01-29,Kedah,71,38,33,2020
2020-01-30,Kedah,64,30,34,2020
2020-01-31,Kedah,107,46,61,2020
2020-02-01,Kedah,68,20,48,2020
2020-02-02,Kedah,70,18,52,2020
2020-02-03,Kedah,77,21,56,2020
2020-02-04,Kedah,87,18,69,2020
2020-02-05,Kedah,104,82,22,2020
2020-02-06,Kedah,55,26,29,2020
2020-02-07,Kedah,110,7,103,2020
2020-02-08,Kedah,47,9,38,2020
2020-02-09,Kedah,249,41,208,2020
2020-02-10,Kedah,47,16,31,2020
2020-02-11,Kedah,44,20,24,2020
2020-02-12,Kedah,177,67,110,2020
2020-02-13,Kedah,101,82,19,2020
2020-02-14,Kedah,32,5,27,2020
2020-02-15,Kedah,115,40,75,2020
2020-02-16,Kedah,103,40,63,2020
2020-02-17,Kedah,151,72,79,2020
2020-02-18,Kedah,125,62,63,2020
2020-02-19,Kedah,80,45,35,2020
2020-02-20,Kedah,13,1,12,2020
2020-02-21,Kedah,44,12,32,2020
2020-02-22,Kedah,102,32,70,2020
2020-02-23,Kedah,67,20,47,2020
2020-02-24,Kedah,53,22,31,2020
2020-02-25,Kedah,71,37,34,2020
2020-02-26,Kedah,64,41,23,2020
2020-02-27,Kedah,43,11,32,2020
2020-02-28,Kedah,152,8,144,2020
2020-02-29,Kedah,35,7,28,2020
2020-03-01,Kedah,58,5,53,2020
2020-03-02,Kedah,7,2,5,2020
2020-03-03,Kedah,89,26,63,2020
2020-03-04,Kedah,73,33,40,2020
2020-03-05,Kedah,66,38,28,2020
2020-03-06,Kedah,30,5,25,2020
2020-03-07,Kedah,42,9,33,2020
2020-03-08,Kedah,99,27,72,2020
2020-03-09,Kedah,40,13,27,2020
2020-03-10,Kedah,141,25,116,2020
2020-03-11,Kedah,130,51,79,2020
2020-03-12,Kedah,48,15,33,2020
2020-03-13,Kedah,46,14,32,2020
2020-03-14,Kedah,43,13,30,2020
2020-03-15,Kedah,56,15,41,2020
2020-03-16,Kedah,28,11,17,2020
2020-03-17,Kedah,11,2,9,2020
2020-03-18,Kedah,9,3,6,2020
2020-03-19,Kedah,15,4,11,2020
2020-03-20,Kedah,19,7,12,2020
2020-03-21,Kedah,6,1,5,2020
2020-03-22,Kedah,22,2,20,2020
2020-03-23,Kedah,24,1,23,2020
2020-03-24,Kedah,30,7,23,2020
2020-03-25,Kedah,42,12,30,2020
2020-03-26,Kedah,33,5,28,2020
2020-03-27,Kedah,4,0,4,2020
2020-03-28,Kedah,12,4,8,2020
2020-03-29,Kedah,23,6,17,2020
2020-03-30,Kedah,29,4,25,2020
2020-03-31,Kedah,49,11,38,2020
2020-04-01,Kedah,76,23,53,2020
2020-04-02,Kedah,32,4,28,2020
2020-04-03,Kedah,11,2,9,2020
2020-04-04,Kedah,18,1,17,2020
2020-04-05,Kedah,32,5,27,2020
2020-04-06,Kedah,25,4,21,2020
2020-04-07,Kedah,31,7,24,2020
2020-04-08,Kedah,35,8,27,2020
2020-04-09,Kedah,38,8,30,2020
2020-04-10,Kedah,37,10,27,2020
2020-04-11,Kedah,8,1,7,2020
2020-04-12,Kedah,59,23,36,2020
2020-04-13,Kedah,74,19,55,2020
2020-04-14,Kedah,31,2,29,2020
2020-04-15,Kedah,45,6,39,2020
2020-04-16,Kedah,63,8,55,2020
2020-04-17,Kedah,43,15,28,2020
2020-04-18,Kedah,34,11,23,2020
2020-04-19,Kedah,64,14,50,2020
2020-04-20,Kedah,74,11,63,2020
2020-04-21,Kedah,67,14,53,2020
2020-04-22,Kedah,82,28,54,2020
2020-04-23,Kedah,79,7,72,2020
2020-04-24,Kedah,0,0,0,2020
2020-04-25,Kedah,20,4,16,2020
2020-04-26,Kedah,24,5,19,2020
2020-04-27,Kedah,10,0,10,2020
2020-04-28,Kedah,16,3,13,2020
2020-04-29,Kedah,17,2,15,2020
2020-04-30,Kedah,25,5,20,2020
2020-05-01,Kedah,28,7,21,2020
2020-05-02,Kedah,39,6,33,2020
2020-05-03,Kedah,18,1,17,2020
2020-05-04,Kedah,18,5,13,2020
2020-05-05,Kedah,19,3,16,2020
2020-05-06,Kedah,8,0,8,2020
2020-05-07,Kedah,297,32,265,2020
2020-05-08,Kedah,6,0,6,2020
2020-05-09,Kedah,15,3,12,2020
2020-05-10,Kedah,30,6,24,2020
2020-05-11,Kedah,58,6,52,2020
2020-05-12,Kedah,33,7,26,2020
2020-05-13,Kedah,42,8,34,2020
2020-05-14,Kedah,12,2,10,2020
2020-05-15,Kedah,17,4,13,2020
2020-05-16,Kedah,24,7,17,2020
2020-05-17,Kedah,11,3,8,2020
2020-05-18,Kedah,12,3,9,2020
2020-05-19,Kedah,26,3,23,2020
2020-05-20,Kedah,42,15,27,2020
2020-05-21,Kedah,19,2,17,2020
2020-05-22,Kedah,108,18,90,2020
2020-05-23,Kedah,21,1,20,2020
2020-05-24,Kedah,0,0,0,2020
2020-05-25,Kedah,0,0,0,2020
2020-05-26,Kedah,33,5,28,2020
2020-05-27,Kedah,44,8,36,2020
2020-05-28,Kedah,69,15,54,2020
2020-05-29,Kedah,86,24,62,2020
2020-05-30,Kedah,66,18,48,2020
2020-05-31,Kedah,77,7,70,2020
2020-06-01,Kedah,66,36,30,2020
2020-06-02,Kedah,70,27,43,2020
2020-06-03,Kedah,77,30,47,2020
2020-06-04,Kedah,80,22,58,2020
2020-06-05,Kedah,113,15,98,2020
2020-06-06,Kedah,57,18,39,2020
2020-06-07,Kedah,72,18,54,2020
2020-06-08,Kedah,58,19,39,2020
2020-06-09,Kedah,40,9,31,2020
2020-06-10,Kedah,42,20,22,2020
2020-06-11,Kedah,48,11,37,2020
2020-06-12,Kedah,101,18,83,2020
2020-06-13,Kedah,66,12,54,2020
2020-06-14,Kedah,104,11,93,2020
2020-06-15,Kedah,99,22,77,2020
2020-06-16,Kedah,100,12,88,2020
2020-06-17,Kedah,44,13,31,2020
2020-06-18,Kedah,41,14,27,2020
2020-06-19,Kedah,126,22,104,2020
2020-06-20,Kedah,45,14,31,2020
2020-06-21,Kedah,51,11,40,2020
2020-06-22,Kedah,58,20,38,2020
2020-06-23,Kedah,51,13,38,2020
2020-06-24,Kedah,44,6,38,2020
2020-06-25,Kedah,34,5,29,2020
2020-06-26,Kedah,127,6,121,2020
2020-06-27,Kedah,53,16,37,2020
2020-06-28,Kedah,57,5,52,2020
2020-06-29,Kedah,52,15,37,2020
2020-06-30,Kedah,27,7,20,2020
2020-07-01,Kedah,89,18,71,2020
2020-07-02,Kedah,27,4,23,2020
2020-07-03,Kedah,30,3,27,2020
2020-07-04,Kedah,64,17,47,2020
2020-07-05,Kedah,86,23,63,2020
2020-07-06,Kedah,68,22,46,2020
2020-07-07,Kedah,63,15,48,2020
2020-07-08,Kedah,61,18,43,2020
2020-07-09,Kedah,37,8,29,2020
2020-07-10,Kedah,41,7,34,2020
2020-07-11,Kedah,48,9,39,2020
2020-07-12,Kedah,152,21,131,2020
2020-07-13,Kedah,26,6,20,2020
2020-07-14,Kedah,51,12,39,2020
2020-07-15,Kedah,112,36,76,2020
2020-07-16,Kedah,31,11,20,2020
2020-07-17,Kedah,65,14,51,2020
2020-07-18,Kedah,57,9,48,2020
2020-07-19,Kedah,71,20,51,2020
2020-07-20,Kedah,62,16,46,2020
2020-07-21,Kedah,48,11,37,2020
2020-07-22,Kedah,85,4,81,2020
2020-07-23,Kedah,35,7,28,2020
2020-07-24,Kedah,125,23,102,2020
2020-07-25,Kedah,48,8,40,2020
2020-07-26,Kedah,56,11,45,2020
2020-07-27,Kedah,46,14,32,2020
2020-07-28,Kedah,53,10,43,2020
2020-07-29,Kedah,51,13,38,2020
2020-07-30,Kedah,35,4,31,2020
2020-07-31,Kedah,0,0,0,2020
2020-08-01,Kedah,61,21,40,2020
2020-08-02,Kedah,44,15,29,2020
2020-08-03,Kedah,50,15,35,2020
2020-08-04,Kedah,22,5,17,2020
2020-08-05,Kedah,46,11,35,2020
2020-08-06,Kedah,49,8,41,2020
2020-08-07,Kedah,45,11,34,2020
2020-08-08,Kedah,89,27,62,2020
2020-08-09,Kedah,77,10,67,2020
2020-08-10,Kedah,34,5,29,2020
2020-08-11,Kedah,36,2,34,2020
2020-08-12,Kedah,35,7,28,2020
2020-08-13,Kedah,55,32,23,2020
2020-08-14,Kedah,91,41,50,2020
2020-08-15,Kedah,43,6,37,2020
2020-08-16,Kedah,44,11,33,2020
2020-08-17,Kedah,52,10,42,2020
2020-08-18,Kedah,61,13,48,2020
2020-08-19,Kedah,51,14,37,2020
2020-08-20,Kedah,45,11,34,2020
2020-08-21,Kedah,25,3,22,2020
2020-08-22,Kedah,32,5,27,2020
2020-08-23,Kedah,42,6,36,2020
2020-08-24,Kedah,29,7,22,2020
2020-08-25,Kedah,0,0,0,2020
2020-08-26,Kedah,0,0,0,2020
2020-08-27,Kedah,0,0,0,2020
2020-08-28,Kedah,0,0,0,2020
2020-08-29,Kedah,0,0,0,2020
2020-08-30,Kedah,0,0,0,2020
2020-08-31,Kedah,0,0,0,2020
2020-09-01,Kedah,0,0,0,2020
2020-09-02,Kedah,0,0,0,2020
2020-09-03,Kedah,0,0,0,2020
2020-09-04,Kedah,0,0,0,2020
2020-09-05,Kedah,0,0,0,2020
2020-09-06,Kedah,6,0,6,2020
2020-09-07,Kedah,17,4,13,2020
2020-09-08,Kedah,44,1,43,2020
2020-09-09,Kedah,26,5,21,2020
2020-09-10,Kedah,0,0,0,2020
2020-09-11,Kedah,0,0,0,2020
2020-09-12,Kedah,0,0,0,2020
2020-09-13,Kedah,0,0,0,2020
2020-09-14,Kedah,0,0,0,2020
2020-09-15,Kedah,0,0,0,2020
2020-09-16,Kedah,0,0,0,2020
2020-09-17,Kedah,0,0,0,2020
2020-09-18,Kedah,0,0,0,2020
2020-09-19,Kedah,0,0,0,2020
2020-09-20,Kedah,0,0,0,2020
2020-09-21,Kedah,1,0,1,2020
2020-09-22,Kedah,2,2,0,2020
2020-09-23,Kedah,0,0,0,2020
2020-09-24,Kedah,0,0,0,2020
2020-09-25,Kedah,0,0,0,2020
2020-09-26,Kedah,43,3,40,2020
2020-09-27,Kedah,49,4,45,2020
2020-09-28,Kedah,37,6,31,2020
2020-09-29,Kedah,51,4,47,2020
2020-09-30,Kedah,39,2,37,2020
2020-10-01,Kedah,26,3,23,2020
2020-10-02,Kedah,22,1,21,2020
2020-10-03,Kedah,8,0,8,2020
2020-10-04,Kedah,26,2,24,2020
2020-10-05,Kedah,39,6,33,2020
2020-10-06,Kedah,29,4,25,2020
2020-10-07,Kedah,26,5,21,2020
2020-10-08,Kedah,27,4,23,2020
2020-10-09,Kedah,57,8,49,2020
2020-10-10,Kedah,64,10,54,2020
2020-10-11,Kedah,52,7,45,2020
2020-10-12,Kedah,79,19,60,2020
2020-10-13,Kedah,36,7,29,2020
2020-10-14,Kedah,58,10,48,2020
2020-10-15,Kedah,40,15,25,2020
2020-10-16,Kedah,59,10,49,2020
2020-10-17,Kedah,56,11,45,2020
2020-10-18,Kedah,63,8,55,2020
2020-10-19,Kedah,51,4,47,2020
2020-10-20,Kedah,44,8,36,2020
2020-10-21,Kedah,37,7,30,2020
2020-10-22,Kedah,40,10,30,2020
2020-10-23,Kedah,103,49,54,2020
2020-10-24,Kedah,63,12,51,2020
2020-10-25,Kedah,69,16,53,2020
2020-10-26,Kedah,34,1,33,2020
2020-10-27,Kedah,110,67,43,2020
2020-10-28,Kedah,114,67,47,2020
2020-10-29,Kedah,48,11,37,2020
2020-10-30,Kedah,39,5,34,2020
2020-10-31,Kedah,47,6,41,2020
2020-11-01,Kedah,59,8,51,2020
2020-11-02,Kedah,30,8,22,2020
2020-11-03,Kedah,35,7,28,2020
2020-11-04,Kedah,80,20,60,2020
2020-11-05,Kedah,29,5,24,2020
2020-11-06,Kedah,41,5,36,2020
2020-11-07,Kedah,72,14,58,2020
2020-11-08,Kedah,38,2,36,2020
2020-11-09,Kedah,23,6,17,2020
2020-11-10,Kedah,31,6,25,2020
2020-11-11,Kedah,24,5,19,2020
2020-11-12,Kedah,27,6,21,2020
2020-11-13,Kedah,51,4,47,2020
2020-11-14,Kedah,407,51,356,2020
2020-11-15,Kedah,8,0,8,2020
2020-11-16,Kedah,58,22,36,2020
2020-11-17,Kedah,25,6,19,2020
2020-11-18,Kedah,54,3,51,2020
2020-11-19,Kedah,24,4,20,2020
2020-11-20,Kedah,135,19,116,2020
2020-11-21,Kedah,60,17,43,2020
2020-11-22,Kedah,58,7,51,2020
2020-11-23,Kedah,27,4,23,2020
2020-11-24,Kedah,26,3,23,2020
2020-11-25,Kedah,20,6,14,2020
2020-11-26,Kedah,36,5,31,2020
2020-11-27,Kedah,28,2,26,2020
2020-11-28,Kedah,37,8,29,2020
2020-11-29,Kedah,53,10,43,2020
2020-11-30,Kedah,37,4,33,2020
2020-12-01,Kedah,35,12,23,2020
2020-12-02,Kedah,76,20,56,2020
2020-12-03,Kedah,62,14,48,2020
2020-12-04,Kedah,123,19,104,2020
2020-12-05,Kedah,54,15,39,2020
2020-12-06,Kedah,40,6,34,2020
2020-12-07,Kedah,48,8,40,2020
2020-12-08,Kedah,52,14,38,2020
2020-12-09,Kedah,49,18,31,2020
2020-12-10,Kedah,37,8,29,2020
2020-12-11,Kedah,106,22,84,2020
2020-12-12,Kedah,66,14,52,2020
2020-12-13,Kedah,63,14,49,2020
2020-12-14,Kedah,57,16,41,2020
2020-12-15,Kedah,101,16,85,2020
2020-12-16,Kedah,64,19,45,2020
2020-12-17,Kedah,34,6,28,2020
2020-12-18,Kedah,104,7,97,2020
2020-12-19,Kedah,62,18,44,2020
2020-12-20,Kedah,60,11,49,2020
2020-12-21,Kedah,67,15,52,2020
2020-12-22,Kedah,82,28,54,2020
2020-12-23,Kedah,98,43,55,2020
2020-12-24,Kedah,45,8,37,2020
2020-12-25,Kedah,40,9,31,2020
2020-12-26,Kedah,39,8,31,2020
2020-12-27,Kedah,36,4,32,2020
2020-12-28,Kedah,63,9,54,2020
2020-12-29,Kedah,49,17,32,2020
2020-12-30,Kedah,38,12,26,2020
2020-12-31,Kedah,39,6,33,2020
2021-01-01,Kedah,45,13,32,2021
2021-01-02,Kedah,51,20,31,2021
2021-01-03,Kedah,47,9,38,2021
2021-01-04,Kedah,66,16,50,2021
2021-01-05,Kedah,54,9,45,2021
2021-01-06,Kedah,71,8,63,2021
2021-01-07,Kedah,39,7,32,2021
2021-01-08,Kedah,78,19,59,2021
2021-01-09,Kedah,53,12,41,2021
2021-01-10,Kedah,111,8,103,2021
2021-01-11,Kedah,39,12,27,2021
2021-01-12,Kedah,55,12,43,2021
2021-01-13,Kedah,32,3,29,2021
2021-01-14,Kedah,41,7,34,2021
2021-01-15,Kedah,122,30,92,2021
2021-01-16,Kedah,133,56,77,2021
2021-01-17,Kedah,46,4,42,2021
2021-01-18,Kedah,118,51,67,2021
2021-01-19,Kedah,23,2,21,2021
2021-01-20,Kedah,98,47,51,2021
2021-01-21,Kedah,26,3,23,2021
2021-01-22,Kedah,61,30,31,2021
2021-01-23,Kedah,28,2,26,2021
2021-01-24,Kedah,65,14,51,2021
2021-01-25,Kedah,52,5,47,2021
2021-01-26,Kedah,20,3,17,2021
2021-01-27,Kedah,28,3,25,2021
2021-01-28,Kedah,0,0,0,2021
2021-01-29,Kedah,1,0,1,2021
2021-01-30,Kedah,0,0,0,2021
2021-01-31,Kedah,0,0,0,2021
2021-02-01,Kedah,20,5,15,2021
2021-02-02,Kedah,36,6,30,2021
2021-02-03,Kedah,33,7,26,2021
2021-02-04,Kedah,54,5,49,2021
2021-02-05,Kedah,43,9,34,2021
2021-02-06,Kedah,90,24,66,2021
2021-02-07,Kedah,49,9,40,2021
2021-02-08,Kedah,45,4,41,2021
2021-02-09,Kedah,28,3,25,2021
2021-02-10,Kedah,92,48,44,2021
2021-02-11,Kedah,98,60,38,2021
2021-02-12,Kedah,36,6,30,2021
2021-02-13,Kedah,48,6,42,2021
2021-02-14,Kedah,41,10,31,2021
2021-02-15,Kedah,33,2,31,2021
2021-02-16,Kedah,98,71,27,2021
2021-02-17,Kedah,105,67,38,2021
2021-02-18,Kedah,56,19,37,2021
2021-02-19,Kedah,55,14,41,2021
2021-02-20,Kedah,54,10,44,2021
2021-02-21,Kedah,48,5,43,2021
2021-02-22,Kedah,67,8,59,2021
2021-02-23,Kedah,24,3,21,2021
2021-02-24,Kedah,44,8,36,2021
2021-02-25,Kedah,38,7,31,2021
2021-02-26,Kedah,122,7,115,2021
2021-02-27,Kedah,122,105,17,2021
2021-02-28,Kedah,101,24,77,2021
2021-03-01,Kedah,16,0,16,2021
2021-03-02,Kedah,30,0,30,2021
2021-03-03,Kedah,38,7,31,2021
2021-03-04,Kedah,28,4,24,2021
2021-03-05,Kedah,148,91,57,2021
2021-03-06,Kedah,24,4,20,2021
2021-03-07,Kedah,32,3,29,2021
2021-03-08,Kedah,35,6,29,2021
2021-03-09,Kedah,44,8,36,2021
2021-03-10,Kedah,44,4,40,2021
2021-03-11,Kedah,55,10,45,2021
2021-03-12,Kedah,49,5,44,2021
2021-03-13,Kedah,59,33,26,2021
2021-03-14,Kedah,196,23,173,2021
2021-03-15,Kedah,32,6,26,2021
2021-03-16,Kedah,44,11,33,2021
2021-03-17,Kedah,19,2,17,2021
2021-03-18,Kedah,28,3,25,2021
2021-03-19,Kedah,87,38,49,2021
2021-03-20,Kedah,20,1,19,2021
2021-03-21,Kedah,69,18,51,2021
2021-03-22,Kedah,35,3,32,2021
2021-03-23,Kedah,27,1,26,2021
2021-03-24,Kedah,36,3,33,2021
2021-03-25,Kedah,75,17,58,2021
2021-03-26,Kedah,105,5,100,2021
2021-03-27,Kedah,38,3,35,2021
2021-03-28,Kedah,49,7,42,2021
2021-03-29,Kedah,31,2,29,2021
2021-03-30,Kedah,24,1,23,2021
2021-03-31,Kedah,44,4,40,2021
2021-04-01,Kedah,75,38,37,2021
2021-04-02,Kedah,78,17,61,2021
2021-04-03,Kedah,50,19,31,2021
2021-04-04,Kedah,51,12,39,2021
2021-04-05,Kedah,103,34,69,2021
2021-04-06,Kedah,127,63,64,2021
2021-04-07,Kedah,157,82,75,2021
2021-04-08,Kedah,76,27,49,2021
2021-04-09,Kedah,116,19,97,2021
2021-04-10,Kedah,41,24,17,2021
2021-04-11,Kedah,85,21,64,2021
2021-04-12,Kedah,73,16,57,2021
2021-04-13,Kedah,0,0,0,2021
2021-04-14,Kedah,22,3,19,2021
2021-04-15,Kedah,20,3,17,2021
2021-04-16,Kedah,16,6,10,2021
2021-04-17,Kedah,28,5,23,2021
2021-04-18,Kedah,165,29,136,2021
2021-04-19,Kedah,35,7,28,2021
2021-04-20,Kedah,35,10,25,2021
2021-04-21,Kedah,52,15,37,2021
2021-04-22,Kedah,37,7,30,2021
2021-04-23,Kedah,79,9,70,2021
2021-04-24,Kedah,13,5,8,2021
2021-04-25,Kedah,18,2,16,2021
2021-04-26,Kedah,10,2,8,2021
2021-04-27,Kedah,18,4,14,2021
2021-04-28,Kedah,17,4,13,2021
2021-04-29,Kedah,28,10,18,2021
2021-04-30,Kedah,58,6,52,2021
2021-05-01,Kedah,358,40,318,2021
2021-05-02,Kedah,9,0,9,2021
2021-05-03,Kedah,14,2,12,2021
2021-05-04,Kedah,15,3,12,2021
2021-05-05,Kedah,5,2,3,2021
2021-05-06,Kedah,18,3,15,2021
2021-05-07,Kedah,45,3,42,2021
2021-05-08,Kedah,10,2,8,2021
2021-05-09,Kedah,14,2,12,2021
2021-05-10,Kedah,20,1,19,2021
2021-05-11,Kedah,15,1,14,2021
2021-05-12,Kedah,14,0,14,2021
2021-05-13,Kedah,0,0,0,2021
2021-05-14,Kedah,2,0,2,2021
2021-05-15,Kedah,106,16,90,2021
2021-05-16,Kedah,96,16,80,2021
2021-05-17,Kedah,24,5,19,2021
2021-05-18,Kedah,37,3,34,2021
2021-05-19,Kedah,31,2,29,2021
2021-05-20,Kedah,33,6,27,2021
2021-05-21,Kedah,15,2,13,2021
2021-05-22,Kedah,44,4,40,2021
2021-05-23,Kedah,57,4,53,2021
2021-05-24,Kedah,26,3,23,2021
2021-05-25,Kedah,23,5,18,2021
2021-05-26,Kedah,31,12,19,2021
2021-05-27,Kedah,42,6,36,2021
2021-05-28,Kedah,46,12,34,2021
2021-05-29,Kedah,113,22,91,2021
2021-05-30,Kedah,83,14,69,2021
2021-05-31,Kedah,54,8,46,2021
2021-06-01,Kedah,58,13,45,2021
2021-06-02,Kedah,112,20,92,2021
2021-06-03,Kedah,76,20,56,2021
2021-06-04,Kedah,54,14,40,2021
2021-06-05,Kedah,46,9,37,2021
2021-06-06,Kedah,74,13,61,2021
2021-06-07,Kedah,92,34,58,2021
2021-06-08,Kedah,54,10,44,2021
2021-06-09,Kedah,46,8,38,2021
2021-06-10,Kedah,37,3,34,2021
2021-06-11,Kedah,38,8,30,2021
2021-06-12,Kedah,79,21,58,2021
2021-06-13,Kedah,65,15,50,2021
2021-06-14,Kedah,92,9,83,2021
2021-06-15,Kedah,41,7,34,2021
2021-06-16,Kedah,49,6,43,2021
2021-06-17,Kedah,29,5,24,2021
2021-06-18,Kedah,61,9,52,2021
2021-06-19,Kedah,61,21,40,2021
2021-06-20,Kedah,49,21,28,2021
2021-06-21,Kedah,47,9,38,2021
2021-06-22,Kedah,40,5,35,2021
2021-06-23,Kedah,26,3,23,2021
2021-06-24,Kedah,46,10,36,2021
2021-06-25,Kedah,65,16,49,2021
2021-06-26,Kedah,90,44,46,2021
2021-06-27,Kedah,45,4,41,2021
2021-06-28,Kedah,60,9,51,2021
2021-06-29,Kedah,27,4,23,2021
2021-06-30,Kedah,23,5,18,2021
2021-07-01,Kedah,70,29,41,2021
2021-07-02,Kedah,52,11,41,2021
2021-07-03,Kedah,52,12,40,2021
2021-07-04,Kedah,44,1,43,2021
2021-07-05,Kedah,55,14,41,2021
2021-07-06,Kedah,39,8,31,2021
2021-07-07,Kedah,31,12,19,2021
2021-07-08,Kedah,74,14,60,2021
2021-07-09,Kedah,121,33,88,2021
2021-07-10,Kedah,106,39,67,2021
2021-07-11,Kedah,50,11,39,2021
2021-07-12,Kedah,76,24,52,2021
2021-07-13,Kedah,47,8,39,2021
2021-07-14,Kedah,49,12,37,2021
2021-07-15,Kedah,41,7,34,2021
2021-07-16,Kedah,40,7,33,2021
2021-07-17,Kedah,77,26,51,2021
2021-07-18,Kedah,48,8,40,2021
2021-07-19,Kedah,36,2,34,2021
2021-07-20,Kedah,0,0,0,2021
2021-07-21,Kedah,31,8,23,2021
2021-07-22,Kedah,31,3,28,2021
2021-07-23,Kedah,34,12,22,2021
2021-07-24,Kedah,111,29,82,2021
2021-07-25,Kedah,51,10,41,2021
2021-07-26,Kedah,38,6,32,2021
2021-07-27,Kedah,34,3,31,2021
2021-07-28,Kedah,47,16,31,2021
2021-07-29,Kedah,46,8,38,2021
2021-07-30,Kedah,39,4,35,2021
2021-07-31,Kedah,95,23,72,2021
2021-08-01,Kedah,85,16,69,2021
2021-08-02,Kedah,59,16,43,2021
2021-08-03,Kedah,46,12,34,2021
2021-08-04,Kedah,73,7,66,2021
2021-08-05,Kedah,76,17,59,2021
2021-08-06,Kedah,198,29,169,2021
2021-08-07,Kedah,61,15,46,2021
2021-08-08,Kedah,51,11,40,2021
2021-08-09,Kedah,61,15,46,2021
2021-08-10,Kedah,49,16,33,2021
2021-08-11,Kedah,28,6,22,2021
2021-08-12,Kedah,40,7,33,2021
2021-08-13,Kedah,80,11,69,2021
2021-08-14,Kedah,66,14,52,2021
2021-08-15,Kedah,36,7,29,2021
2021-08-16,Kedah,23,2,21,2021
2021-08-17,Kedah,36,4,32,2021
2021-08-18,Kedah,34,2,32,2021
2021-08-19,Kedah,52,18,34,2021
2021-08-20,Kedah,66,8,58,2021
2021-08-21,Kedah,66,14,52,2021
2021-08-22,Kedah,38,7,31,2021
2021-08-23,Kedah,29,4,25,2021
2021-08-24,Kedah,28,2,26,2021
2021-08-25,Kedah,20,3,17,2021
2021-08-26,Kedah,53,10,43,2021
2021-08-27,Kedah,50,4,46,2021
2021-08-28,Kedah,40,7,33,2021
2021-08-29,Kedah,27,6,21,2021
2021-08-30,Kedah,32,9,23,2021
2021-08-31,Kedah,83,15,68,2021
2021-09-01,Kedah,43,7,36,2021
2021-09-02,Kedah,42,14,28,2021
2021-09-03,Kedah,30,10,20,2021
2021-09-04,Kedah,67,26,41,2021
2021-09-05,Kedah,41,8,33,2021
2021-09-06,Kedah,39,10,29,2021
2021-09-07,Kedah,44,5,39,2021
2021-09-08,Kedah,37,8,29,2021
2021-09-09,Kedah,33,5,28,2021
2021-09-10,Kedah,50,12,38,2021
2021-09-11,Kedah,72,14,58,2021
2021-09-12,Kedah,97,35,62,2021
2021-09-13,Kedah,76,8,68,2021
2021-09-14,Kedah,51,12,39,2021
2021-09-15,Kedah,34,8,26,2021
2021-09-16,Kedah,92,13,79,2021
2021-09-17,Kedah,52,17,35,2021
2021-09-18,Kedah,60,17,43,2021
2021-09-19,Kedah,58,8,50,2021
2021-09-20,Kedah,42,5,37,2021
2021-09-21,Kedah,29,4,25,2021
2021-09-22,Kedah,37,7,30,2021
2021-09-23,Kedah,20,1,19,2021
2021-09-24,Kedah,55,5,50,2021
2021-09-25,Kedah,63,11,52,2021
2021-09-26,Kedah,51,13,38,2021
2021-09-27,Kedah,43,11,32,2021
2021-09-28,Kedah,31,4,27,2021
2021-09-29,Kedah,52,9,43,2021
2021-09-30,Kedah,30,3,27,2021
2021-10-01,Kedah,91,27,64,2021
2021-10-02,Kedah,73,15,58,2021
2021-10-03,Kedah,92,10,82,2021
2021-10-04,Kedah,45,6,39,2021
2021-10-05,Kedah,40,8,32,2021
2021-10-06,Kedah,29,0,29,2021
2021-10-07,Kedah,45,9,36,2021
2021-10-08,Kedah,58,22,36,2021
2021-10-09,Kedah,72,13,59,2021
2021-10-10,Kedah,49,6,43,2021
2021-10-11,Kedah,33,6,27,2021
2021-10-12,Kedah,44,13,31,2021
2021-10-13,Kedah,39,12,27,2021
2021-10-14,Kedah,155,56,99,2021
2021-10-15,Kedah,37,6,31,2021
2021-10-16,Kedah,42,10,32,2021
2021-10-17,Kedah,44,7,37,2021
2021-10-18,Kedah,48,8,40,2021
2021-10-19,Kedah,50,14,36,2021
2021-10-20,Kedah,49,6,43,2021
2021-10-21,Kedah,23,4,19,2021
2021-10-22,Kedah,48,4,44,2021
2021-10-23,Kedah,31,6,25,2021
2021-10-24,Kedah,118,16,102,2021
2021-10-25,Kedah,34,9,25,2021
2021-10-26,Kedah,32,5,27,2021
2021-10-27,Kedah,37,10,27,2021
2021-10-28,Kedah,31,5,26,2021
2021-10-29,Kedah,118,27,91,2021
2021-10-30,Kedah,60,9,51,2021
2021-10-31,Kedah,40,6,34,2021
2021-11-01,Kedah,37,7,30,2021
2021-11-02,Kedah,29,7,22,2021
2021-11-03,Kedah,50,10,40,2021
2021-11-04,Kedah,357,31,326,2021
2021-11-05,Kedah,53,5,48,2021
2021-11-06,Kedah,52,12,40,2021
2021-11-07,Kedah,33,4,29,2021
2021-11-08,Kedah,64,28,36,2021
2021-11-09,Kedah,39,13,26,2021
2021-11-10,Kedah,37,4,33,2021
2021-11-11,Kedah,37,2,35,2021
2021-11-12,Kedah,41,2,39,2021
2021-11-13,Kedah,55,11,44,2021
2021-11-14,Kedah,109,12,97,2021
2021-11-15,Kedah,51,11,40,2021
2021-11-16,Kedah,72,25,47,2021
2021-11-17,Kedah,64,17,47,2021
2021-11-18,Kedah,84,28,56,2021
2021-11-19,Kedah,65,15,50,2021
2021-11-20,Kedah,52,12,40,2021
2021-11-21,Kedah,78,19,59,2021
2021-11-22,Kedah,48,14,34,2021
2021-11-23,Kedah,107,34,73,2021
2021-11-24,Kedah,74,22,52,2021
2021-11-25,Kedah,44,13,31,2021
2021-11-26,Kedah,54,3,51,2021
2021-11-27,Kedah,45,13,32,2021
2021-11-28,Kedah,59,17,42,2021
2021-11-29,Kedah,51,12,39,2021
2021-11-30,Kedah,50,11,39,2021
2021-12-01,Kedah,37,12,25,2021
2021-12-02,Kedah,53,12,41,2021
2021-12-03,Kedah,46,18,28,2021
2021-12-04,Kedah,41,16,25,2021
2021-12-05,Kedah,51,8,43,2021
2021-12-06,Kedah,35,4,31,2021
2021-12-07,Kedah,36,6,30,2021
2021-12-08,Kedah,34,1,33,2021
2021-12-09,Kedah,83,8,75,2021
2021-12-10,Kedah,128,16,112,2021
2021-12-11,Kedah,137,25,112,2021
2021-12-12,Kedah,66,15,51,2021
2021-12-13,Kedah,66,11,55,2021
2021-12-14,Kedah,72,19,53,2021
2021-12-15,Kedah,42,11,31,2021
2021-12-16,Kedah,40,12,28,2021
2021-12-17,Kedah,49,9,40,2021
2021-12-18,Kedah,35,2,33,2021
2021-12-19,Kedah,33,4,29,2021
2021-12-20,Kedah,77,30,47,2021
2021-12-21,Kedah,51,25,26,2021
2021-12-22,Kedah,58,17,41,2021
2021-12-23,Kedah,38,8,30,2021
2021-12-24,Kedah,101,15,86,2021
2021-12-25,Kedah,144,31,113,2021
2021-12-26,Kedah,45,6,39,2021
2021-12-27,Kedah,42,4,38,2021
2021-12-28,Kedah,25,7,18,2021
2021-12-29,Kedah,47,17,30,2021
2021-12-30,Kedah,37,5,32,2021
2021-12-31,Kedah,68,15,53,2021
2022-01-01,Kedah,85,29,56,2022
2022-01-02,Kedah,47,4,43,2022
2022-01-03,Kedah,55,8,47,2022
2022-01-04,Kedah,36,7,29,2022
2022-01-05,Kedah,31,7,24,2022
2022-01-06,Kedah,56,15,41,2022
2022-01-07,Kedah,127,18,109,2022
2022-01-08,Kedah,62,17,45,2022
2022-01-09,Kedah,53,9,44,2022
2022-01-10,Kedah,29,2,27,2022
2022-01-11,Kedah,59,16,43,2022
2022-01-12,Kedah,113,67,46,2022
2022-01-13,Kedah,44,12,32,2022
2022-01-14,Kedah,246,52,194,2022
2022-01-15,Kedah,32,5,27,2022
2022-01-16,Kedah,44,8,36,2022
2022-01-17,Kedah,36,4,32,2022
2022-01-18,Kedah,53,5,48,2022
2022-01-19,Kedah,24,4,20,2022
2022-01-20,Kedah,28,6,22,2022
2022-01-21,Kedah,64,21,43,2022
2022-01-22,Kedah,69,15,54,2022
2022-01-23,Kedah,60,7,53,2022
2022-01-24,Kedah,34,7,27,2022
2022-01-25,Kedah,53,8,45,2022
2022-01-26,Kedah,36,7,29,2022
2022-01-27,Kedah,46,12,34,2022
2022-01-28,Kedah,32,3,29,2022
2022-01-29,Kedah,67,10,57,2022
2022-01-30,Kedah,62,10,52,2022
2022-01-31,Kedah,47,9,38,2022
2022-02-01,Kedah,61,10,51,2022
2022-02-02,Kedah,63,17,46,2022
2022-02-03,Kedah,45,8,37,2022
2022-02-04,Kedah,44,3,41,2022
2022-02-05,Kedah,46,12,34,2022
2022-02-06,Kedah,55,26,29,2022
2022-02-07,Kedah,31,5,26,2022
2022-02-08,Kedah,34,5,29,2022
2022-02-09,Kedah,59,12,47,2022
2022-02-10,Kedah,65,7,58,2022
2022-02-11,Kedah,49,4,45,2022
2022-02-12,Kedah,61,12,49,2022
2022-02-13,Kedah,68,11,57,2022
2022-02-14,Kedah,58,17,41,2022
2022-02-15,Kedah,62,24,38,2022
2022-02-16,Kedah,55,22,33,2022
2022-02-17,Kedah,36,5,31,2022
2022-02-18,Kedah,40,3,37,2022
2022-02-19,Kedah,86,16,70,2022
2022-02-20,Kedah,55,7,48,2022
2022-02-21,Kedah,34,4,30,2022
2022-02-22,Kedah,50,6,44,2022
2022-02-23,Kedah,53,9,44,2022
2022-02-24,Kedah,45,9,36,2022
2022-02-25,Kedah,97,11,86,2022
2022-02-26,Kedah,90,13,77,2022
2022-02-27,Kedah,93,9,84,2022
2022-02-28,Kedah,39,7,32,2022
2022-03-01,Kedah,28,5,23,2022
2022-03-02,Kedah,31,13,18,2022
2022-03-03,Kedah,27,10,17,2022
2022-03-04,Kedah,37,3,34,2022
2022-03-05,Kedah,40,12,28,2022
2022-03-06,Kedah,28,1,27,2022
2022-03-07,Kedah,54,10,44,2022
2022-03-08,Kedah,69,10,59,2022
2022-03-09,Kedah,52,27,25,2022
2022-03-10,Kedah,69,29,40,2022
2022-03-11,Kedah,47,3,44,2022
2022-03-12,Kedah,43,4,39,2022
2022-03-13,Kedah,38,0,38,2022
2022-03-14,Kedah,31,6,25,2022
2022-03-15,Kedah,31,6,25,2022
2022-03-16,Kedah,45,9,36,2022
2022-03-17,Kedah,68,5,63,2022
2022-03-18,Kedah,133,10,123,2022
2022-03-19,Kedah,93,19,74,2022
2022-03-20,Kedah,50,6,44,2022
2022-03-21,Kedah,57,14,43,2022
2022-03-22,Kedah,56,6,50,2022
2022-03-23,Kedah,58,27,31,2022
2022-03-24,Kedah,78,20,58,2022
2022-03-25,Kedah,126,29,97,2022
2022-03-26,Kedah,62,5,57,2022
2022-03-27,Kedah,52,3,49,2022
2022-03-28,Kedah,91,23,68,2022
2022-03-29,Kedah,63,12,51,2022
2022-03-30,Kedah,51,6,45,2022
2022-03-31,Kedah,89,30,59,2022
2022-04-01,Kedah,88,43,45,2022
2022-04-02,Kedah,100,48,52,2022
2022-04-03,Kedah,13,1,12,2022
2022-04-04,Kedah,28,5,23,2022
2022-04-05,Kedah,24,4,20,2022
2022-04-06,Kedah,34,8,26,2022
2022-04-07,Kedah,20,3,17,2022
2022-04-08,Kedah,36,10,26,2022
2022-04-09,Kedah,55,21,34,2022
2022-04-10,Kedah,42,11,31,2022
2022-04-11,Kedah,24,8,16,2022
2022-04-12,Kedah,24,2,22,2022
2022-04-13,Kedah,17,4,13,2022
2022-04-14,Kedah,23,4,19,2022
2022-04-15,Kedah,61,7,54,2022
2022-04-16,Kedah,33,8,25,2022
2022-04-17,Kedah,33,3,30,2022
2022-04-18,Kedah,36,12,24,2022
2022-04-19,Kedah,35,6,29,2022
2022-04-20,Kedah,32,3,29,2022
2022-04-21,Kedah,9,0,9,2022
2022-04-22,Kedah,28,8,20,2022
2022-04-23,Kedah,21,15,6,2022
2022-04-24,Kedah,64,20,44,2022
2022-04-25,Kedah,16,2,14,2022
2022-04-26,Kedah,21,1,20,2022
2022-04-27,Kedah,25,2,23,2022
2022-04-28,Kedah,25,4,21,2022
2022-04-29,Kedah,62,4,58,2022
2022-04-30,Kedah,22,3,19,2022
2022-05-01,Kedah,397,34,363,2022
2022-05-02,Kedah,0,0,0,2022
2022-05-03,Kedah,0,0,0,2022
2022-05-04,Kedah,11,2,9,2022
2022-05-05,Kedah,35,6,29,2022
2022-05-06,Kedah,81,16,65,2022
2022-05-07,Kedah,32,7,25,2022
2022-05-08,Kedah,40,3,37,2022
2022-05-09,Kedah,44,5,39,2022
2022-05-10,Kedah,37,5,32,2022
2022-05-11,Kedah,44,9,35,2022
2022-05-12,Kedah,68,15,53,2022
2022-05-13,Kedah,174,41,133,2022
2022-05-14,Kedah,56,8,48,2022
2022-05-15,Kedah,80,20,60,2022
2022-05-16,Kedah,39,16,23,2022
2022-05-17,Kedah,60,20,40,2022
2022-05-18,Kedah,55,26,29,2022
2022-05-19,Kedah,84,19,65,2022
2022-05-20,Kedah,116,28,88,2022
2022-05-21,Kedah,80,24,56,2022
2022-05-22,Kedah,51,6,45,2022
2022-05-23,Kedah,39,4,35,2022
2022-05-24,Kedah,46,16,30,2022
2022-05-25,Kedah,56,22,34,2022
2022-05-26,Kedah,54,23,31,2022
2022-05-27,Kedah,103,33,70,2022
2022-05-28,Kedah,110,59,51,2022
2022-05-29,Kedah,122,15,107,2022
2022-05-30,Kedah,16,1,15,2022
2022-05-31,Kedah,57,14,43,2022
2022-06-01,Kedah,83,37,46,2022
2022-06-02,Kedah,46,14,32,2022
2022-06-03,Kedah,49,3,46,2022
2022-06-04,Kedah,84,36,48,2022
2022-06-05,Kedah,52,3,49,2022
2022-06-06,Kedah,75,9,66,2022
2022-06-07,Kedah,41,7,34,2022
2022-06-08,Kedah,51,5,46,2022
2022-06-09,Kedah,82,18,64,2022
2022-06-10,Kedah,68,14,54,2022
2022-06-11,Kedah,76,10,66,2022
2022-06-12,Kedah,87,5,82,2022
2022-06-13,Kedah,24,3,21,2022
2022-06-14,Kedah,154,22,132,2022
2022-06-15,Kedah,81,10,71,2022
2022-06-16,Kedah,53,25,28,2022
2022-06-17,Kedah,76,8,68,2022
2022-06-18,Kedah,62,13,49,2022
2022-06-19,Kedah,106,32,74,2022
2022-06-20,Kedah,46,10,36,2022
2022-06-21,Kedah,69,35,34,2022
2022-06-22,Kedah,36,4,32,2022
2022-06-23,Kedah,48,26,22,2022
2022-06-24,Kedah,71,14,57,2022
2022-06-25,Kedah,73,12,61,2022
2022-06-26,Kedah,42,10,32,2022
2022-06-27,Kedah,31,4,27,2022
2022-06-28,Kedah,34,4,30,2022
2022-06-29,Kedah,40,4,36,2022
2022-06-30,Kedah,20,0,20,2022
2022-07-01,Kedah,97,22,75,2022
2022-07-02,Kedah,45,3,42,2022
2022-07-03,Kedah,46,5,41,2022
2022-07-04,Kedah,36,10,26,2022
2022-07-05,Kedah,31,2,29,2022
2022-07-06,Kedah,43,5,38,2022
2022-07-07,Kedah,60,42,18,2022
2022-07-08,Kedah,81,9,72,2022
2022-07-09,Kedah,31,4,27,2022
2022-07-10,Kedah,0,0,0,2022
2022-07-11,Kedah,0,0,0,2022
2022-07-12,Kedah,39,8,31,2022
2022-07-13,Kedah,15,0,15,2022
2022-07-14,Kedah,125,22,103,2022
2022-07-15,Kedah,214,34,180,2022
2022-07-16,Kedah,48,8,40,2022
2022-07-17,Kedah,103,21,82,2022
2022-07-18,Kedah,75,18,57,2022
2022-07-19,Kedah,37,12,25,2022
2022-07-20,Kedah,40,13,27,2022
2022-07-21,Kedah,45,7,38,2022
2022-07-22,Kedah,92,21,71,2022
2022-07-23,Kedah,44,17,27,2022
2022-07-24,Kedah,36,5,31,2022
2022-07-25,Kedah,60,13,47,2022
2022-07-26,Kedah,27,6,21,2022
2022-07-27,Kedah,24,7,17,2022
2022-07-28,Kedah,38,13,25,2022
2022-07-29,Kedah,68,9,59,2022
2022-07-30,Kedah,48,9,39,2022
2022-07-31,Kedah,66,8,58,2022
2022-08-01,Kedah,18,2,16,2022
2022-08-02,Kedah,24,6,18,2022
2022-08-03,Kedah,31,10,21,2022
2022-08-04,Kedah,50,32,18,2022
2022-08-05,Kedah,104,19,85,2022
2022-08-06,Kedah,72,14,58,2022
2022-08-07,Kedah,73,7,66,2022
2022-08-08,Kedah,26,10,16,2022
2022-08-09,Kedah,35,13,22,2022
2022-08-10,Kedah,58,18,40,2022
2022-08-11,Kedah,41,8,33,2022
2022-08-12,Kedah,55,10,45,2022
2022-08-13,Kedah,97,56,41,2022
2022-08-14,Kedah,40,9,31,2022
2022-08-15,Kedah,39,7,32,2022
2022-08-16,Kedah,31,2,29,2022
2022-08-17,Kedah,92,27,65,2022
2022-08-18,Kedah,61,14,47,2022
2022-08-19,Kedah,100,14,86,2022
2022-08-20,Kedah,36,6,30,2022
2022-08-21,Kedah,36,5,31,2022
2022-08-22,Kedah,57,29,28,2022
2022-08-23,Kedah,52,24,28,2022
2022-08-24,Kedah,114,76,38,2022
2022-08-25,Kedah,52,6,46,2022
2022-08-26,Kedah,79,10,69,2022
2022-08-27,Kedah,45,15,30,2022
2022-08-28,Kedah,102,18,84,2022
2022-08-29,Kedah,71,26,45,2022
2022-08-30,Kedah,102,16,86,2022
2022-08-31,Kedah,95,7,88,2022
2022-09-01,Kedah,40,8,32,2022
2022-09-02,Kedah,39,6,33,2022
2022-09-03,Kedah,64,15,49,2022
2022-09-04,Kedah,72,22,50,2022
2022-09-05,Kedah,32,4,28,2022
2022-09-06,Kedah,60,24,36,2022
2022-09-07,Kedah,81,36,45,2022
2022-09-08,Kedah,29,6,23,2022
2022-09-09,Kedah,104,15,89,2022
2022-09-10,Kedah,42,7,35,2022
2022-09-11,Kedah,61,5,56,2022
2022-09-12,Kedah,38,7,31,2022
2022-09-13,Kedah,57,22,35,2022
2022-09-14,Kedah,85,65,20,2022
2022-09-15,Kedah,21,6,15,2022
2022-09-16,Kedah,229,26,203,2022
2022-09-17,Kedah,37,6,31,2022
2022-09-18,Kedah,49,12,37,2022
2022-09-19,Kedah,36,9,27,2022
2022-09-20,Kedah,22,2,20,2022
2022-09-21,Kedah,76,51,25,2022
2022-09-22,Kedah,24,2,22,2022
2022-09-23,Kedah,85,22,63,2022
2022-09-24,Kedah,140,108,32,2022
2022-09-25,Kedah,35,8,27,2022
2022-09-26,Kedah,27,4,23,2022
2022-09-27,Kedah,18,1,17,2022
2022-09-28,Kedah,29,5,24,2022
2022-09-29,Kedah,70,39,31,2022
2022-09-30,Kedah,57,6,51,2022
2022-10-01,Kedah,70,8,62,2022
2022-10-02,Kedah,40,7,33,2022
2022-10-03,Kedah,36,6,30,2022
2022-10-04,Kedah,43,5,38,2022
2022-10-05,Kedah,41,17,24,2022
2022-10-06,Kedah,46,21,25,2022
2022-10-07,Kedah,50,5,45,2022
2022-10-08,Kedah,52,9,43,2022
2022-10-09,Kedah,86,28,58,2022
2022-10-10,Kedah,37,8,29,2022
2022-10-11,Kedah,67,40,27,2022
2022-10-12,Kedah,81,64,17,2022
2022-10-13,Kedah,36,4,32,2022
2022-10-14,Kedah,66,13,53,2022
2022-10-15,Kedah,71,14,57,2022
2022-10-16,Kedah,55,26,29,2022
2022-10-17,Kedah,55,23,32,2022
2022-10-18,Kedah,56,26,30,2022
2022-10-19,Kedah,58,11,47,2022
2022-10-20,Kedah,35,10,25,2022
2022-10-21,Kedah,95,37,58,2022
2022-10-22,Kedah,84,33,51,2022
2022-10-23,Kedah,22,0,22,2022
2022-10-24,Kedah,315,32,283,2022
2022-10-25,Kedah,10,2,8,2022
2022-10-26,Kedah,64,32,32,2022
2022-10-27,Kedah,57,3,54,2022
2022-10-28,Kedah,62,5,57,2022
2022-10-29,Kedah,58,8,50,2022
2022-10-30,Kedah,34,2,32,2022
2022-10-31,Kedah,130,13,117,2022
2022-11-01,Kedah,40,11,29,2022
2022-11-02,Kedah,69,18,51,2022
2022-11-03,Kedah,44,19,25,2022
2022-11-04,Kedah,70,26,44,2022
2022-11-05,Kedah,97,31,66,2022
2022-11-06,Kedah,76,35,41,2022
2022-11-07,Kedah,56,13,43,2022
2022-11-08,Kedah,77,30,47,2022
2022-11-09,Kedah,65,15,50,2022
2022-11-10,Kedah,59,23,36,2022
2022-11-11,Kedah,88,56,32,2022
2022-11-12,Kedah,131,67,64,2022
2022-11-13,Kedah,48,2,46,2022
2022-11-14,Kedah,44,13,31,2022
2022-11-15,Kedah,64,20,44,2022
2022-11-16,Kedah,58,37,21,2022
2022-11-17,Kedah,26,3,23,2022
2022-11-18,Kedah,45,3,42,2022
2022-11-19,Kedah,0,0,0,2022
2022-11-20,Kedah,85,32,53,2022
2022-11-21,Kedah,40,1,39,2022
2022-11-22,Kedah,33,3,30,2022
2022-11-23,Kedah,19,0,19,2022
2022-11-24,Kedah,24,2,22,2022
2022-11-25,Kedah,67,5,62,2022
2022-11-26,Kedah,53,10,43,2022
2022-11-27,Kedah,40,7,33,2022
2022-11-28,Kedah,27,4,23,2022
2022-11-29,Kedah,21,4,17,2022
2022-11-30,Kedah,76,28,48,2022
2022-12-01,Kedah,34,10,24,2022
2022-12-02,Kedah,90,49,41,2022
2022-12-03,Kedah,106,45,61,2022
2022-12-04,Kedah,75,26,49,2022
2022-12-05,Kedah,61,4,57,2022
2022-12-06,Kedah,44,12,32,2022
2022-12-07,Kedah,48,7,41,2022
2022-12-08,Kedah,39,10,29,2022
2022-12-09,Kedah,67,29,38,2022
2022-12-10,Kedah,75,26,49,2022
2022-12-11,Kedah,66,16,50,2022
2022-12-12,Kedah,33,5,28,2022
2022-12-13,Kedah,41,12,29,2022
2022-12-14,Kedah,29,6,23,2022
2022-12-15,Kedah,33,5,28,2022
2022-12-16,Kedah,33,6,27,2022
2022-12-17,Kedah,51,10,41,2022
2022-12-18,Kedah,114,17,97,2022
2022-12-19,Kedah,21,8,13,2022
2022-12-20,Kedah,40,17,23,2022
2022-12-21,Kedah,45,9,36,2022
2022-12-22,Kedah,44,5,39,2022
2022-12-23,Kedah,72,5,67,2022
2022-12-24,Kedah,70,9,61,2022
2022-12-25,Kedah,98,33,65,2022
2022-12-26,Kedah,52,9,43,2022
2022-12-27,Kedah,37,7,30,2022
2022-12-28,Kedah,42,7,35,2022
2022-12-29,Kedah,65,18,47,2022
2022-12-30,Kedah,129,3,126,2022
2022-12-31,Kedah,60,3,57,2022
2023-01-01,Kedah,51,5,46,2023
2023-01-02,Kedah,47,8,39,2023
2023-01-03,Kedah,87,32,55,2023
2023-01-04,Kedah,55,15,40,2023
2023-01-05,Kedah,32,12,20,2023
2023-01-06,Kedah,149,10,139,2023
2023-01-07,Kedah,54,8,46,2023
2023-01-08,Kedah,79,5,74,2023
2023-01-09,Kedah,45,11,34,2023
2023-01-10,Kedah,57,10,47,2023
2023-01-11,Kedah,108,32,76,2023
2023-01-12,Kedah,112,54,58,2023
2023-01-13,Kedah,94,21,73,2023
2023-01-14,Kedah,67,6,61,2023
2023-01-15,Kedah,90,37,53,2023
2023-01-16,Kedah,87,44,43,2023
2023-01-17,Kedah,86,45,41,2023
2023-01-18,Kedah,60,31,29,2023
2023-01-19,Kedah,80,52,28,2023
2023-01-20,Kedah,69,6,63,2023
2023-01-21,Kedah,69,9,60,2023
2023-01-22,Kedah,45,7,38,2023
2023-01-23,Kedah,38,8,30,2023
2023-01-24,Kedah,54,9,45,2023
2023-01-25,Kedah,66,8,58,2023
2023-01-26,Kedah,44,8,36,2023
2023-01-27,Kedah,47,4,43,2023
2023-01-28,Kedah,80,24,56,2023
2023-01-29,Kedah,53,8,45,2023
2023-01-30,Kedah,35,6,29,2023
2023-01-31,Kedah,46,6,40,2023
2023-02-01,Kedah,47,9,38,2023
2023-02-02,Kedah,31,2,29,2023
2023-02-03,Kedah,34,3,31,2023
2023-02-04,Kedah,59,12,47,2023
2023-02-05,Kedah,165,20,145,2023
2023-02-06,Kedah,44,6,38,2023
2023-02-07,Kedah,36,6,30,2023
2023-02-08,Kedah,55,2,53,2023
2023-02-09,Kedah,46,14,32,2023
2023-02-10,Kedah,82,19,63,2023
2023-02-11,Kedah,44,7,37,2023
2023-02-12,Kedah,47,5,42,2023
2023-02-13,Kedah,68,5,63,2023
2023-02-14,Kedah,82,17,65,2023
2023-02-15,Kedah,59,18,41,2023
2023-02-16,Kedah,27,10,17,2023
2023-02-17,Kedah,148,12,136,2023
2023-02-18,Kedah,119,15,104,2023
2023-02-19,Kedah,77,17,60,2023
2023-02-20,Kedah,38,10,28,2023
2023-02-21,Kedah,78,9,69,2023
2023-02-22,Kedah,94,44,50,2023
2023-02-23,Kedah,64,29,35,2023
2023-02-24,Kedah,53,4,49,2023
2023-02-25,Kedah,93,7,86,2023
2023-02-26,Kedah,37,7,30,2023
2023-02-27,Kedah,47,10,37,2023
2023-02-28,Kedah,52,11,41,2023
2023-03-01,Kedah,42,4,38,2023
2023-03-02,Kedah,55,15,40,2023
2023-03-03,Kedah,72,8,64,2023
2023-03-04,Kedah,49,7,42,2023
2023-03-05,Kedah,34,0,34,2023
2023-03-06,Kedah,61,13,48,2023
2023-03-07,Kedah,71,25,46,2023
2023-03-08,Kedah,209,91,118,2023
2023-03-09,Kedah,31,8,23,2023
2023-03-10,Kedah,235,39,196,2023
2023-03-11,Kedah,19,5,14,2023
2023-03-12,Kedah,198,24,174,2023
2023-03-13,Kedah,50,5,45,2023
2023-03-14,Kedah,60,5,55,2023
2023-03-15,Kedah,62,7,55,2023
2023-03-16,Kedah,39,9,30,2023
2023-03-17,Kedah,78,10,68,2023
2023-03-18,Kedah,37,6,31,2023
2023-03-19,Kedah,60,7,53,2023
2023-03-20,Kedah,68,13,55,2023
2023-03-21,Kedah,49,11,38,2023
2023-03-22,Kedah,89,13,76,2023
2023-03-23,Kedah,0,0,0,2023
2023-03-24,Kedah,66,4,62,2023
2023-03-25,Kedah,37,6,31,2023
2023-03-26,Kedah,90,13,77,2023
2023-03-27,Kedah,24,1,23,2023
2023-03-28,Kedah,32,7,25,2023
2023-03-29,Kedah,36,7,29,2023
2023-03-30,Kedah,33,1,32,2023
2023-03-31,Kedah,106,15,91,2023
2023-04-01,Kedah,30,7,23,2023
2023-04-02,Kedah,17,4,13,2023
2023-04-03,Kedah,25,4,21,2023
2023-04-04,Kedah,32,7,25,2023
2023-04-05,Kedah,14,2,12,2023
2023-04-06,Kedah,21,3,18,2023
2023-04-07,Kedah,27,4,23,2023
2023-04-08,Kedah,17,1,16,2023
2023-04-09,Kedah,130,20,110,2023
2023-04-10,Kedah,25,3,22,2023
2023-04-11,Kedah,32,8,24,2023
2023-04-12,Kedah,27,2,25,2023
2023-04-13,Kedah,22,7,15,2023
2023-04-14,Kedah,73,7,66,2023
2023-04-15,Kedah,17,3,14,2023
2023-04-16,Kedah,94,23,71,2023
2023-04-17,Kedah,14,0,14,2023
2023-04-18,Kedah,11,1,10,2023
2023-04-19,Kedah,16,0,16,2023
2023-04-20,Kedah,7,0,7,2023
2023-04-21,Kedah,15,0,15,2023
2023-04-22,Kedah,0,0,0,2023
2023-04-23,Kedah,0,0,0,2023
2023-04-24,Kedah,35,9,26,2023
2023-04-25,Kedah,46,10,36,2023
2023-04-26,Kedah,38,2,36,2023
2023-04-27,Kedah,45,8,37,2023
2023-04-28,Kedah,185,37,148,2023
2023-04-29,Kedah,44,7,37,2023
2023-04-30,Kedah,43,7,36,2023
2023-05-01,Kedah,453,32,421,2023
2023-05-02,Kedah,9,0,9,2023
2023-05-03,Kedah,33,3,30,2023
2023-05-04,Kedah,50,6,44,2023
2023-05-05,Kedah,49,4,45,2023
2023-05-06,Kedah,42,4,38,2023
2023-05-07,Kedah,137,23,114,2023
2023-05-08,Kedah,34,3,31,2023
2023-05-09,Kedah,47,12,35,2023
2023-05-10,Kedah,49,7,42,2023
2023-05-11,Kedah,51,23,28,2023
2023-05-12,Kedah,75,17,58,2023
2023-05-13,Kedah,80,19,61,2023
2023-05-14,Kedah,48,5,43,2023
2023-05-15,Kedah,60,16,44,2023
2023-05-16,Kedah,69,22,47,2023
2023-05-17,Kedah,42,4,38,2023
2023-05-18,Kedah,43,17,26,2023
2023-05-19,Kedah,74,22,52,2023
2023-05-20,Kedah,51,17,34,2023
2023-05-21,Kedah,77,16,61,2023
2023-05-22,Kedah,41,8,33,2023
2023-05-23,Kedah,69,20,49,2023
2023-05-24,Kedah,53,14,39,2023
2023-05-25,Kedah,33,8,25,2023
2023-05-26,Kedah,93,3,90,2023
2023-05-27,Kedah,44,7,37,2023
2023-05-28,Kedah,45,9,36,2023
2023-05-29,Kedah,46,5,41,2023
2023-05-30,Kedah,30,6,24,2023
2023-05-31,Kedah,41,7,34,2023
2023-06-01,Kedah,64,7,57,2023
2023-06-02,Kedah,41,3,38,2023
2023-06-03,Kedah,57,10,47,2023
2023-06-04,Kedah,59,37,22,2023
2023-06-05,Kedah,48,9,39,2023
2023-06-06,Kedah,27,8,19,2023
2023-06-07,Kedah,27,0,27,2023
2023-06-08,Kedah,55,12,43,2023
2023-06-09,Kedah,118,29,89,2023
2023-06-10,Kedah,51,11,40,2023
2023-06-11,Kedah,54,12,42,2023
2023-06-12,Kedah,38,4,34,2023
2023-06-13,Kedah,20,3,17,2023
2023-06-14,Kedah,227,41,186,2023
2023-06-15,Kedah,26,2,24,2023
2023-06-16,Kedah,118,28,90,2023
2023-06-17,Kedah,45,17,28,2023
2023-06-18,Kedah,0,0,0,2023
2023-06-19,Kedah,24,4,20,2023
2023-06-20,Kedah,134,23,111,2023
2023-06-21,Kedah,25,5,20,2023
2023-06-22,Kedah,41,3,38,2023
2023-06-23,Kedah,112,9,103,2023
2023-06-24,Kedah,95,42,53,2023
2023-06-25,Kedah,67,17,50,2023
2023-06-26,Kedah,115,12,103,2023
2023-06-27,Kedah,40,23,17,2023
2023-06-28,Kedah,31,2,29,2023
2023-06-29,Kedah,0,0,0,2023
2023-06-30,Kedah,69,4,65,2023
2023-07-01,Kedah,0,0,0,2023
2023-07-02,Kedah,86,18,68,2023
2023-07-03,Kedah,32,8,24,2023
2023-07-04,Kedah,31,3,28,2023
2023-07-05,Kedah,44,15,29,2023
2023-07-06,Kedah,46,14,32,2023
2023-07-07,Kedah,63,31,32,2023
2023-07-08,Kedah,48,15,33,2023
2023-07-09,Kedah,45,12,33,2023
2023-07-10,Kedah,49,17,32,2023
2023-07-11,Kedah,66,12,54,2023
2023-07-12,Kedah,42,5,37,2023
2023-07-13,Kedah,28,4,24,2023
2023-07-14,Kedah,53,14,39,2023
2023-07-15,Kedah,59,16,43,2023
2023-07-16,Kedah,50,4,46,2023
2023-07-17,Kedah,25,4,21,2023
2023-07-18,Kedah,44,17,27,2023
2023-07-19,Kedah,36,4,32,2023
2023-07-20,Kedah,31,10,21,2023
2023-07-21,Kedah,37,3,34,2023
2023-07-22,Kedah,32,2,30,2023
2023-07-23,Kedah,39,9,30,2023
2023-07-24,Kedah,42,14,28,2023
2023-07-25,Kedah,44,3,41,2023
2023-07-26,Kedah,46,7,39,2023
2023-07-27,Kedah,49,14,35,2023
2023-07-28,Kedah,121,6,115,2023
2023-07-29,Kedah,49,4,45,2023
2023-07-30,Kedah,54,8,46,2023
2023-07-31,Kedah,31,2,29,2023
2023-08-01,Kedah,29,8,21,2023
2023-08-02,Kedah,46,14,32,2023
2023-08-03,Kedah,27,17,10,2023
2023-08-04,Kedah,51,5,46,2023
2023-08-05,Kedah,54,7,47,2023
2023-08-06,Kedah,95,19,76,2023
2023-08-07,Kedah,34,3,31,2023
2023-08-08,Kedah,95,13,82,2023
2023-08-09,Kedah,44,26,18,2023
2023-08-10,Kedah,66,14,52,2023
2023-08-11,Kedah,58,10,48,2023
2023-08-12,Kedah,0,0,0,2023
2023-08-13,Kedah,34,5,29,2023
2023-08-14,Kedah,29,2,27,2023
2023-08-15,Kedah,34,6,28,2023
2023-08-16,Kedah,93,59,34,2023
2023-08-17,Kedah,41,6,35,2023
2023-08-18,Kedah,47,3,44,2023
2023-08-19,Kedah,62,12,50,2023
2023-08-20,Kedah,63,11,52,2023
2023-08-21,Kedah,49,28,21,2023
2023-08-22,Kedah,151,105,46,2023
2023-08-23,Kedah,59,42,17,2023
2023-08-24,Kedah,59,43,16,2023
2023-08-25,Kedah,170,12,158,2023
2023-08-26,Kedah,45,5,40,2023
2023-08-27,Kedah,68,11,57,2023
2023-08-28,Kedah,64,38,26,2023
2023-08-29,Kedah,35,5,30,2023
2023-08-30,Kedah,57,10,47,2023
2023-08-31,Kedah,128,20,108,2023
2023-09-01,Kedah,35,4,31,2023
2023-09-02,Kedah,36,4,32,2023
2023-09-03,Kedah,31,4,27,2023
2023-09-04,Kedah,47,12,35,2023
2023-09-05,Kedah,74,10,64,2023
2023-09-06,Kedah,48,13,35,2023
2023-09-07,Kedah,28,17,11,2023
2023-09-08,Kedah,55,10,45,2023
2023-09-09,Kedah,77,26,51,2023
2023-09-10,Kedah,27,2,25,2023
2023-09-11,Kedah,27,6,21,2023
2023-09-12,Kedah,33,11,22,2023
2023-09-13,Kedah,46,8,38,2023
2023-09-14,Kedah,39,24,15,2023
2023-09-15,Kedah,69,4,65,2023
2023-09-16,Kedah,151,16,135,2023
2023-09-17,Kedah,128,24,104,2023
2023-09-18,Kedah,76,19,57,2023
2023-09-19,Kedah,68,26,42,2023
2023-09-20,Kedah,107,15,92,2023
2023-09-21,Kedah,105,35,70,2023
2023-09-22,Kedah,133,11,122,2023
2023-09-23,Kedah,93,30,63,2023
2023-09-24,Kedah,43,4,39,2023
2023-09-25,Kedah,48,11,37,2023
2023-09-26,Kedah,44,8,36,2023
2023-09-27,Kedah,30,4,26,2023
2023-09-28,Kedah,62,9,53,2023
2023-09-29,Kedah,61,9,52,2023
2023-09-30,Kedah,59,7,52,2023
2023-10-01,Kedah,45,5,40,2023
2023-10-02,Kedah,40,6,34,2023
2023-10-03,Kedah,40,6,34,2023
2023-10-04,Kedah,48,29,19,2023
2023-10-05,Kedah,39,4,35,2023
2023-10-06,Kedah,39,8,31,2023
2023-10-07,Kedah,45,7,38,2023
2023-10-08,Kedah,42,6,36,2023
2023-10-09,Kedah,50,12,38,2023
2023-10-10,Kedah,41,12,29,2023
2023-10-11,Kedah,84,49,35,2023
2023-10-12,Kedah,66,31,35,2023
2023-10-13,Kedah,39,7,32,2023
2023-10-14,Kedah,54,14,40,2023
2023-10-15,Kedah,189,160,29,2023
2023-10-16,Kedah,32,4,28,2023
2023-10-17,Kedah,39,24,15,2023
2023-10-18,Kedah,69,34,35,2023
2023-10-19,Kedah,55,11,44,2023
2023-10-20,Kedah,30,8,22,2023
2023-10-21,Kedah,59,11,48,2023
2023-10-22,Kedah,56,5,51,2023
2023-10-23,Kedah,47,22,25,2023
2023-10-24,Kedah,44,20,24,2023
2023-10-25,Kedah,88,36,52,2023
2023-10-26,Kedah,87,32,55,2023
2023-10-27,Kedah,101,4,97,2023
2023-10-28,Kedah,99,46,53,2023
2023-10-29,Kedah,142,21,121,2023
2023-10-30,Kedah,36,8,28,2023
2023-10-31,Kedah,90,56,34,2023
2023-11-01,Kedah,29,3,26,2023
2023-11-02,Kedah,45,8,37,2023
2023-11-03,Kedah,35,6,29,2023
2023-11-04,Kedah,54,5,49,2023
2023-11-05,Kedah,118,26,92,2023
2023-11-06,Kedah,27,2,25,2023
2023-11-07,Kedah,155,21,134,2023
2023-11-08,Kedah,57,13,44,2023
2023-11-09,Kedah,41,3,38,2023
2023-11-10,Kedah,51,8,43,2023
2023-11-11,Kedah,13,2,11,2023
2023-11-12,Kedah,278,17,261,2023
2023-11-13,Kedah,21,1,20,2023
2023-11-14,Kedah,52,11,41,2023
2023-11-15,Kedah,54,33,21,2023
2023-11-16,Kedah,9,0,9,2023
2023-11-17,Kedah,80,29,51,2023
2023-11-18,Kedah,63,23,40,2023
2023-11-19,Kedah,73,28,45,2023
2023-11-20,Kedah,49,23,26,2023
2023-11-21,Kedah,66,28,38,2023
2023-11-22,Kedah,39,20,19,2023
2023-11-23,Kedah,42,7,35,2023
2023-11-24,Kedah,84,5,79,2023
2023-11-25,Kedah,50,12,38,2023
2023-11-26,Kedah,89,12,77,2023
2023-11-27,Kedah,20,5,15,2023
2023-11-28,Kedah,17,5,12,2023
2023-11-29,Kedah,37,1,36,2023
2023-11-30,Kedah,19,2,17,2023
2023-12-01,Kedah,127,5,122,2023
2023-12-02,Kedah,66,14,52,2023
2023-12-03,Kedah,18,1,17,2023
2023-12-04,Kedah,65,11,54,2023
2023-12-05,Kedah,22,4,18,2023
2023-12-06,Kedah,48,2,46,2023
2023-12-07,Kedah,26,7,19,2023
2023-12-08,Kedah,49,10,39,2023
2023-12-09,Kedah,30,10,20,2023
2023-12-10,Kedah,23,2,21,2023
2023-12-11,Kedah,37,5,32,2023
2023-12-12,Kedah,65,9,56,2023
2023-12-13,Kedah,58,10,48,2023
2023-12-14,Kedah,24,3,21,2023
2023-12-15,Kedah,32,2,30,2023
2023-12-16,Kedah,65,18,47,2023
2023-12-17,Kedah,77,16,61,2023
2023-12-18,Kedah,32,9,23,2023
2023-12-19,Kedah,30,1,29,2023
2023-12-20,Kedah,71,10,61,2023
2023-12-21,Kedah,34,4,30,2023
2023-12-22,Kedah,45,4,41,2023
2023-12-23,Kedah,43,12,31,2023
2023-12-24,Kedah,175,25,150,2023
2023-12-25,Kedah,71,13,58,2023
2023-12-26,Kedah,39,4,35,2023
2023-12-27,Kedah,49,7,42,2023
2023-12-28,Kedah,30,6,24,2023
2023-12-29,Kedah,93,7,86,2023
2023-12-30,Kedah,58,4,54,2023
2023-12-31,Kedah,69,28,41,2023
2024-01-01,Kedah,66,19,47,2024
2024-01-02,Kedah,37,6,31,2024
2024-01-03,Kedah,47,8,39,2024
2024-01-04,Kedah,50,21,29,2024
2024-01-05,Kedah,124,18,106,2024
2024-01-06,Kedah,60,18,42,2024
2024-01-07,Kedah,35,5,30,2024
2024-01-08,Kedah,42,7,35,2024
2024-01-09,Kedah,82,22,60,2024
2024-01-10,Kedah,25,5,20,2024
2024-01-11,Kedah,41,7,34,2024
2024-01-12,Kedah,95,29,66,2024
2024-01-13,Kedah,57,16,41,2024
2024-01-14,Kedah,36,1,35,2024
2024-01-15,Kedah,96,50,46,2024
2024-01-16,Kedah,67,25,42,2024
2024-01-17,Kedah,57,13,44,2024
2024-01-18,Kedah,24,1,23,2024
2024-01-19,Kedah,82,27,55,2024
2024-01-20,Kedah,55,23,32,2024
2024-01-21,Kedah,53,12,41,2024
2024-01-22,Kedah,52,18,34,2024
2024-01-23,Kedah,86,36,50,2024
2024-01-24,Kedah,51,5,46,2024
2024-01-25,Kedah,44,11,33,2024
2024-01-26,Kedah,79,7,72,2024
2024-01-27,Kedah,29,2,27,2024
2024-01-28,Kedah,56,5,51,2024
2024-01-29,Kedah,29,3,26,2024
2024-01-30,Kedah,33,3,30,2024
2024-01-31,Kedah,31,4,27,2024
2024-02-01,Kedah,56,15,41,2024
2024-02-02,Kedah,39,7,32,2024
2006-01-01,Kelantan,0,0,0,2006
2006-01-02,Kelantan,0,0,0,2006
2006-01-03,Kelantan,0,0,0,2006
2006-01-04,Kelantan,0,0,0,2006
2006-01-05,Kelantan,11,10,1,2006
2006-01-06,Kelantan,0,0,0,2006
2006-01-07,Kelantan,0,0,0,2006
2006-01-08,Kelantan,0,0,0,2006
2006-01-09,Kelantan,0,0,0,2006
2006-01-10,Kelantan,0,0,0,2006
2006-01-11,Kelantan,0,0,0,2006
2006-01-12,Kelantan,0,0,0,2006
2006-01-13,Kelantan,0,0,0,2006
2006-01-14,Kelantan,0,0,0,2006
2006-01-15,Kelantan,0,0,0,2006
2006-01-16,Kelantan,0,0,0,2006
2006-01-17,Kelantan,8,6,2,2006
2006-01-18,Kelantan,1,1,0,2006
2006-01-19,Kelantan,0,0,0,2006
2006-01-20,Kelantan,0,0,0,2006
2006-01-21,Kelantan,0,0,0,2006
2006-01-22,Kelantan,0,0,0,2006
2006-01-23,Kelantan,0,0,0,2006
2006-01-24,Kelantan,1,1,0,2006
2006-01-25,Kelantan,0,0,0,2006
2006-01-26,Kelantan,0,0,0,2006
2006-01-27,Kelantan,0,0,0,2006
2006-01-28,Kelantan,0,0,0,2006
2006-01-29,Kelantan,0,0,0,2006
2006-01-30,Kelantan,0,0,0,2006
2006-01-31,Kelantan,0,0,0,2006
2006-02-01,Kelantan,0,0,0,2006
2006-02-02,Kelantan,0,0,0,2006
2006-02-03,Kelantan,0,0,0,2006
2006-02-04,Kelantan,0,0,0,2006
2006-02-05,Kelantan,0,0,0,2006
2006-02-06,Kelantan,0,0,0,2006
2006-02-07,Kelantan,0,0,0,2006
2006-02-08,Kelantan,0,0,0,2006
2006-02-09,Kelantan,0,0,0,2006
2006-02-10,Kelantan,0,0,0,2006
2006-02-11,Kelantan,0,0,0,2006
2006-02-12,Kelantan,0,0,0,2006
2006-02-13,Kelantan,0,0,0,2006
2006-02-14,Kelantan,0,0,0,2006
2006-02-15,Kelantan,0,0,0,2006
2006-02-16,Kelantan,0,0,0,2006
2006-02-17,Kelantan,1,0,1,2006
2006-02-18,Kelantan,0,0,0,2006
2006-02-19,Kelantan,0,0,0,2006
2006-02-20,Kelantan,0,0,0,2006
2006-02-21,Kelantan,0,0,0,2006
2006-02-22,Kelantan,0,0,0,2006
2006-02-23,Kelantan,0,0,0,2006
2006-02-24,Kelantan,0,0,0,2006
2006-02-25,Kelantan,0,0,0,2006
2006-02-26,Kelantan,0,0,0,2006
2006-02-27,Kelantan,0,0,0,2006
2006-02-28,Kelantan,0,0,0,2006
2006-03-01,Kelantan,0,0,0,2006
2006-03-02,Kelantan,0,0,0,2006
2006-03-03,Kelantan,1,1,0,2006
2006-03-04,Kelantan,1,1,0,2006
2006-03-05,Kelantan,0,0,0,2006
2006-03-06,Kelantan,0,0,0,2006
2006-03-07,Kelantan,0,0,0,2006
2006-03-08,Kelantan,0,0,0,2006
2006-03-09,Kelantan,0,0,0,2006
2006-03-10,Kelantan,0,0,0,2006
2006-03-11,Kelantan,0,0,0,2006
2006-03-12,Kelantan,0,0,0,2006
2006-03-13,Kelantan,0,0,0,2006
2006-03-14,Kelantan,0,0,0,2006
2006-03-15,Kelantan,0,0,0,2006
2006-03-16,Kelantan,0,0,0,2006
2006-03-17,Kelantan,0,0,0,2006
2006-03-18,Kelantan,0,0,0,2006
2006-03-19,Kelantan,0,0,0,2006
2006-03-20,Kelantan,111,87,24,2006
2006-03-21,Kelantan,91,81,10,2006
2006-03-22,Kelantan,0,0,0,2006
2006-03-23,Kelantan,5,3,2,2006
2006-03-24,Kelantan,134,122,12,2006
2006-03-25,Kelantan,47,43,4,2006
2006-03-26,Kelantan,91,66,25,2006
2006-03-27,Kelantan,5,1,4,2006
2006-03-28,Kelantan,5,2,3,2006
2006-03-29,Kelantan,89,84,5,2006
2006-03-30,Kelantan,22,18,4,2006
2006-03-31,Kelantan,17,16,1,2006
2006-04-01,Kelantan,2,2,0,2006
2006-04-02,Kelantan,0,0,0,2006
2006-04-03,Kelantan,5,4,1,2006
2006-04-04,Kelantan,9,7,2,2006
2006-04-05,Kelantan,8,5,3,2006
2006-04-06,Kelantan,4,1,3,2006
2006-04-07,Kelantan,7,6,1,2006
2006-04-08,Kelantan,1,1,0,2006
2006-04-09,Kelantan,20,18,2,2006
2006-04-10,Kelantan,19,14,5,2006
2006-04-11,Kelantan,0,0,0,2006
2006-04-12,Kelantan,16,12,4,2006
2006-04-13,Kelantan,51,44,7,2006
2006-04-14,Kelantan,0,0,0,2006
2006-04-15,Kelantan,65,58,7,2006
2006-04-16,Kelantan,4,3,1,2006
2006-04-17,Kelantan,7,6,1,2006
2006-04-18,Kelantan,23,19,4,2006
2006-04-19,Kelantan,1,0,1,2006
2006-04-20,Kelantan,2,1,1,2006
2006-04-21,Kelantan,0,0,0,2006
2006-04-22,Kelantan,22,21,1,2006
2006-04-23,Kelantan,99,79,20,2006
2006-04-24,Kelantan,16,11,5,2006
2006-04-25,Kelantan,28,22,6,2006
2006-04-26,Kelantan,2,1,1,2006
2006-04-27,Kelantan,18,17,1,2006
2006-04-28,Kelantan,57,56,1,2006
2006-04-29,Kelantan,0,0,0,2006
2006-04-30,Kelantan,6,4,2,2006
2006-05-01,Kelantan,202,158,44,2006
2006-05-02,Kelantan,35,30,5,2006
2006-05-03,Kelantan,22,18,4,2006
2006-05-04,Kelantan,38,29,9,2006
2006-05-05,Kelantan,1,0,1,2006
2006-05-06,Kelantan,50,30,20,2006
2006-05-07,Kelantan,7,5,2,2006
2006-05-08,Kelantan,20,17,3,2006
2006-05-09,Kelantan,0,0,0,2006
2006-05-10,Kelantan,25,25,0,2006
2006-05-11,Kelantan,20,19,1,2006
2006-05-12,Kelantan,10,7,3,2006
2006-05-13,Kelantan,18,16,2,2006
2006-05-14,Kelantan,24,12,12,2006
2006-05-15,Kelantan,7,6,1,2006
2006-05-16,Kelantan,29,22,7,2006
2006-05-17,Kelantan,54,36,18,2006
2006-05-18,Kelantan,33,28,5,2006
2006-05-19,Kelantan,0,0,0,2006
2006-05-20,Kelantan,3,3,0,2006
2006-05-21,Kelantan,8,3,5,2006
2006-05-22,Kelantan,4,3,1,2006
2006-05-23,Kelantan,41,40,1,2006
2006-05-24,Kelantan,5,4,1,2006
2006-05-25,Kelantan,52,46,6,2006
2006-05-26,Kelantan,1,1,0,2006
2006-05-27,Kelantan,0,0,0,2006
2006-05-28,Kelantan,4,2,2,2006
2006-05-29,Kelantan,2,2,0,2006
2006-05-30,Kelantan,12,5,7,2006
2006-05-31,Kelantan,3,1,2,2006
2006-06-01,Kelantan,4,2,2,2006
2006-06-02,Kelantan,0,0,0,2006
2006-06-03,Kelantan,0,0,0,2006
2006-06-04,Kelantan,25,23,2,2006
2006-06-05,Kelantan,12,9,3,2006
2006-06-06,Kelantan,12,9,3,2006
2006-06-07,Kelantan,7,7,0,2006
2006-06-08,Kelantan,4,3,1,2006
2006-06-09,Kelantan,0,0,0,2006
2006-06-10,Kelantan,14,12,2,2006
2006-06-11,Kelantan,8,6,2,2006
2006-06-12,Kelantan,9,7,2,2006
2006-06-13,Kelantan,4,2,2,2006
2006-06-14,Kelantan,1,0,1,2006
2006-06-15,Kelantan,58,52,6,2006
2006-06-16,Kelantan,1,1,0,2006
2006-06-17,Kelantan,93,74,19,2006
2006-06-18,Kelantan,6,4,2,2006
2006-06-19,Kelantan,32,28,4,2006
2006-06-20,Kelantan,26,20,6,2006
2006-06-21,Kelantan,4,3,1,2006
2006-06-22,Kelantan,66,63,3,2006
2006-06-23,Kelantan,0,0,0,2006
2006-06-24,Kelantan,8,8,0,2006
2006-06-25,Kelantan,2,1,1,2006
2006-06-26,Kelantan,19,14,5,2006
2006-06-27,Kelantan,46,38,8,2006
2006-06-28,Kelantan,9,6,3,2006
2006-06-29,Kelantan,7,1,6,2006
2006-06-30,Kelantan,22,19,3,2006
2006-07-01,Kelantan,21,18,3,2006
2006-07-02,Kelantan,0,0,0,2006
2006-07-03,Kelantan,39,35,4,2006
2006-07-04,Kelantan,10,9,1,2006
2006-07-05,Kelantan,48,48,0,2006
2006-07-06,Kelantan,1,0,1,2006
2006-07-07,Kelantan,34,25,9,2006
2006-07-08,Kelantan,62,48,14,2006
2006-07-09,Kelantan,0,0,0,2006
2006-07-10,Kelantan,0,0,0,2006
2006-07-11,Kelantan,9,3,6,2006
2006-07-12,Kelantan,1,1,0,2006
2006-07-13,Kelantan,28,18,10,2006
2006-07-14,Kelantan,18,16,2,2006
2006-07-15,Kelantan,12,9,3,2006
2006-07-16,Kelantan,1,0,1,2006
2006-07-17,Kelantan,3,0,3,2006
2006-07-18,Kelantan,3,3,0,2006
2006-07-19,Kelantan,42,39,3,2006
2006-07-20,Kelantan,7,4,3,2006
2006-07-21,Kelantan,37,33,4,2006
2006-07-22,Kelantan,8,7,1,2006
2006-07-23,Kelantan,4,1,3,2006
2006-07-24,Kelantan,45,37,8,2006
2006-07-25,Kelantan,10,5,5,2006
2006-07-26,Kelantan,26,24,2,2006
2006-07-27,Kelantan,47,43,4,2006
2006-07-28,Kelantan,2,1,1,2006
2006-07-29,Kelantan,8,7,1,2006
2006-07-30,Kelantan,5,3,2,2006
2006-07-31,Kelantan,28,26,2,2006
2006-08-01,Kelantan,88,63,25,2006
2006-08-02,Kelantan,11,6,5,2006
2006-08-03,Kelantan,5,1,4,2006
2006-08-04,Kelantan,0,0,0,2006
2006-08-05,Kelantan,48,46,2,2006
2006-08-06,Kelantan,13,9,4,2006
2006-08-07,Kelantan,16,11,5,2006
2006-08-08,Kelantan,15,9,6,2006
2006-08-09,Kelantan,16,15,1,2006
2006-08-10,Kelantan,4,3,1,2006
2006-08-11,Kelantan,9,8,1,2006
2006-08-12,Kelantan,0,0,0,2006
2006-08-13,Kelantan,6,1,5,2006
2006-08-14,Kelantan,2,1,1,2006
2006-08-15,Kelantan,2,1,1,2006
2006-08-16,Kelantan,6,4,2,2006
2006-08-17,Kelantan,76,67,9,2006
2006-08-18,Kelantan,0,0,0,2006
2006-08-19,Kelantan,33,29,4,2006
2006-08-20,Kelantan,50,41,9,2006
2006-08-21,Kelantan,9,4,5,2006
2006-08-22,Kelantan,0,0,0,2006
2006-08-23,Kelantan,43,38,5,2006
2006-08-24,Kelantan,165,155,10,2006
2006-08-25,Kelantan,0,0,0,2006
2006-08-26,Kelantan,23,17,6,2006
2006-08-27,Kelantan,5,4,1,2006
2006-08-28,Kelantan,15,14,1,2006
2006-08-29,Kelantan,7,1,6,2006
2006-08-30,Kelantan,1,0,1,2006
2006-08-31,Kelantan,21,19,2,2006
2006-09-01,Kelantan,25,17,8,2006
2006-09-02,Kelantan,66,52,14,2006
2006-09-03,Kelantan,5,1,4,2006
2006-09-04,Kelantan,1,0,1,2006
2006-09-05,Kelantan,5,2,3,2006
2006-09-06,Kelantan,1,1,0,2006
2006-09-07,Kelantan,27,21,6,2006
2006-09-08,Kelantan,0,0,0,2006
2006-09-09,Kelantan,2,2,0,2006
2006-09-10,Kelantan,77,73,4,2006
2006-09-11,Kelantan,61,54,7,2006
2006-09-12,Kelantan,1,0,1,2006
2006-09-13,Kelantan,2,1,1,2006
2006-09-14,Kelantan,4,3,1,2006
2006-09-15,Kelantan,9,7,2,2006
2006-09-16,Kelantan,22,22,0,2006
2006-09-17,Kelantan,5,1,4,2006
2006-09-18,Kelantan,6,2,4,2006
2006-09-19,Kelantan,5,2,3,2006
2006-09-20,Kelantan,5,1,4,2006
2006-09-21,Kelantan,67,52,15,2006
2006-09-22,Kelantan,16,11,5,2006
2006-09-23,Kelantan,31,25,6,2006
2006-09-24,Kelantan,3,2,1,2006
2006-09-25,Kelantan,5,5,0,2006
2006-09-26,Kelantan,5,2,3,2006
2006-09-27,Kelantan,5,5,0,2006
2006-09-28,Kelantan,17,13,4,2006
2006-09-29,Kelantan,0,0,0,2006
2006-09-30,Kelantan,0,0,0,2006
2006-10-01,Kelantan,0,0,0,2006
2006-10-02,Kelantan,10,2,8,2006
2006-10-03,Kelantan,45,37,8,2006
2006-10-04,Kelantan,4,4,0,2006
2006-10-05,Kelantan,20,16,4,2006
2006-10-06,Kelantan,15,15,0,2006
2006-10-07,Kelantan,14,12,2,2006
2006-10-08,Kelantan,1,0,1,2006
2006-10-09,Kelantan,0,0,0,2006
2006-10-10,Kelantan,0,0,0,2006
2006-10-11,Kelantan,1,1,0,2006
2006-10-12,Kelantan,0,0,0,2006
2006-10-13,Kelantan,1,1,0,2006
2006-10-14,Kelantan,0,0,0,2006
2006-10-15,Kelantan,1,0,1,2006
2006-10-16,Kelantan,0,0,0,2006
2006-10-17,Kelantan,3,3,0,2006
2006-10-18,Kelantan,2,1,1,2006
2006-10-19,Kelantan,0,0,0,2006
2006-10-20,Kelantan,0,0,0,2006
2006-10-21,Kelantan,1,0,1,2006
2006-10-22,Kelantan,0,0,0,2006
2006-10-23,Kelantan,0,0,0,2006
2006-10-24,Kelantan,0,0,0,2006
2006-10-25,Kelantan,0,0,0,2006
2006-10-26,Kelantan,0,0,0,2006
2006-10-27,Kelantan,0,0,0,2006
2006-10-28,Kelantan,1,1,0,2006
2006-10-29,Kelantan,16,10,6,2006
2006-10-30,Kelantan,1,1,0,2006
2006-10-31,Kelantan,49,30,19,2006
2006-11-01,Kelantan,21,16,5,2006
2006-11-02,Kelantan,17,11,6,2006
2006-11-03,Kelantan,19,18,1,2006
2006-11-04,Kelantan,9,6,3,2006
2006-11-05,Kelantan,22,14,8,2006
2006-11-06,Kelantan,15,10,5,2006
2006-11-07,Kelantan,18,10,8,2006
2006-11-08,Kelantan,1,1,0,2006
2006-11-09,Kelantan,64,33,31,2006
2006-11-10,Kelantan,17,16,1,2006
2006-11-11,Kelantan,29,22,7,2006
2006-11-12,Kelantan,4,3,1,2006
2006-11-13,Kelantan,28,18,10,2006
2006-11-14,Kelantan,14,9,5,2006
2006-11-15,Kelantan,20,14,6,2006
2006-11-16,Kelantan,30,11,19,2006
2006-11-17,Kelantan,10,8,2,2006
2006-11-18,Kelantan,14,12,2,2006
2006-11-19,Kelantan,50,31,19,2006
2006-11-20,Kelantan,15,14,1,2006
2006-11-21,Kelantan,91,47,44,2006
2006-11-22,Kelantan,20,10,10,2006
2006-11-23,Kelantan,3,0,3,2006
2006-11-24,Kelantan,11,11,0,2006
2006-11-25,Kelantan,25,19,6,2006
2006-11-26,Kelantan,22,19,3,2006
2006-11-27,Kelantan,16,10,6,2006
2006-11-28,Kelantan,10,6,4,2006
2006-11-29,Kelantan,17,11,6,2006
2006-11-30,Kelantan,23,17,6,2006
2006-12-01,Kelantan,10,8,2,2006
2006-12-02,Kelantan,21,14,7,2006
2006-12-03,Kelantan,0,0,0,2006
2006-12-04,Kelantan,3,1,2,2006
2006-12-05,Kelantan,25,18,7,2006
2006-12-06,Kelantan,2,2,0,2006
2006-12-07,Kelantan,0,0,0,2006
2006-12-08,Kelantan,0,0,0,2006
2006-12-09,Kelantan,11,8,3,2006
2006-12-10,Kelantan,3,1,2,2006
2006-12-11,Kelantan,13,10,3,2006
2006-12-12,Kelantan,27,12,15,2006
2006-12-13,Kelantan,7,2,5,2006
2006-12-14,Kelantan,0,0,0,2006
2006-12-15,Kelantan,0,0,0,2006
2006-12-16,Kelantan,18,11,7,2006
2006-12-17,Kelantan,12,5,7,2006
2006-12-18,Kelantan,1,0,1,2006
2006-12-19,Kelantan,10,5,5,2006
2006-12-20,Kelantan,0,0,0,2006
2006-12-21,Kelantan,15,6,9,2006
2006-12-22,Kelantan,13,11,2,2006
2006-12-23,Kelantan,45,30,15,2006
2006-12-24,Kelantan,28,17,11,2006
2006-12-25,Kelantan,18,13,5,2006
2006-12-26,Kelantan,19,10,9,2006
2006-12-27,Kelantan,20,8,12,2006
2006-12-28,Kelantan,32,21,11,2006
2006-12-29,Kelantan,9,7,2,2006
2006-12-30,Kelantan,1,1,0,2006
2006-12-31,Kelantan,37,28,9,2006
2007-01-01,Kelantan,31,21,10,2007
2007-01-02,Kelantan,26,13,13,2007
2007-01-03,Kelantan,24,5,19,2007
2007-01-04,Kelantan,36,18,18,2007
2007-01-05,Kelantan,0,0,0,2007
2007-01-06,Kelantan,16,14,2,2007
2007-01-07,Kelantan,8,3,5,2007
2007-01-08,Kelantan,13,9,4,2007
2007-01-09,Kelantan,3,1,2,2007
2007-01-10,Kelantan,72,62,10,2007
2007-01-11,Kelantan,66,53,13,2007
2007-01-12,Kelantan,16,15,1,2007
2007-01-13,Kelantan,11,8,3,2007
2007-01-14,Kelantan,8,6,2,2007
2007-01-15,Kelantan,12,10,2,2007
2007-01-16,Kelantan,63,56,7,2007
2007-01-17,Kelantan,17,11,6,2007
2007-01-18,Kelantan,9,5,4,2007
2007-01-19,Kelantan,17,13,4,2007
2007-01-20,Kelantan,13,11,2,2007
2007-01-21,Kelantan,10,7,3,2007
2007-01-22,Kelantan,26,19,7,2007
2007-01-23,Kelantan,65,44,21,2007
2007-01-24,Kelantan,57,48,9,2007
2007-01-25,Kelantan,6,4,2,2007
2007-01-26,Kelantan,44,24,20,2007
2007-01-27,Kelantan,16,10,6,2007
2007-01-28,Kelantan,9,8,1,2007
2007-01-29,Kelantan,7,4,3,2007
2007-01-30,Kelantan,15,8,7,2007
2007-01-31,Kelantan,33,15,18,2007
2007-02-01,Kelantan,8,5,3,2007
2007-02-02,Kelantan,7,6,1,2007
2007-02-03,Kelantan,16,15,1,2007
2007-02-04,Kelantan,21,17,4,2007
2007-02-05,Kelantan,9,3,6,2007
2007-02-06,Kelantan,9,5,4,2007
2007-02-07,Kelantan,3,1,2,2007
2007-02-08,Kelantan,4,1,3,2007
2007-02-09,Kelantan,12,6,6,2007
2007-02-10,Kelantan,36,32,4,2007
2007-02-11,Kelantan,9,5,4,2007
2007-02-12,Kelantan,12,4,8,2007
2007-02-13,Kelantan,14,11,3,2007
2007-02-14,Kelantan,7,5,2,2007
2007-02-15,Kelantan,28,24,4,2007
2007-02-16,Kelantan,0,0,0,2007
2007-02-17,Kelantan,0,0,0,2007
2007-02-18,Kelantan,37,19,18,2007
2007-02-19,Kelantan,24,13,11,2007
2007-02-20,Kelantan,22,15,7,2007
2007-02-21,Kelantan,19,13,6,2007
2007-02-22,Kelantan,24,17,7,2007
2007-02-23,Kelantan,19,18,1,2007
2007-02-24,Kelantan,3,2,1,2007
2007-02-25,Kelantan,10,4,6,2007
2007-02-26,Kelantan,0,0,0,2007
2007-02-27,Kelantan,47,43,4,2007
2007-02-28,Kelantan,65,53,12,2007
2007-03-01,Kelantan,129,95,34,2007
2007-03-02,Kelantan,16,14,2,2007
2007-03-03,Kelantan,7,6,1,2007
2007-03-04,Kelantan,23,14,9,2007
2007-03-05,Kelantan,36,20,16,2007
2007-03-06,Kelantan,31,24,7,2007
2007-03-07,Kelantan,22,17,5,2007
2007-03-08,Kelantan,36,29,7,2007
2007-03-09,Kelantan,1,1,0,2007
2007-03-10,Kelantan,10,7,3,2007
2007-03-11,Kelantan,11,11,0,2007
2007-03-12,Kelantan,16,12,4,2007
2007-03-13,Kelantan,10,6,4,2007
2007-03-14,Kelantan,17,12,5,2007
2007-03-15,Kelantan,24,18,6,2007
2007-03-16,Kelantan,17,12,5,2007
2007-03-17,Kelantan,66,57,9,2007
2007-03-18,Kelantan,10,4,6,2007
2007-03-19,Kelantan,27,22,5,2007
2007-03-20,Kelantan,21,20,1,2007
2007-03-21,Kelantan,14,8,6,2007
2007-03-22,Kelantan,30,28,2,2007
2007-03-23,Kelantan,23,17,6,2007
2007-03-24,Kelantan,19,14,5,2007
2007-03-25,Kelantan,53,43,10,2007
2007-03-26,Kelantan,15,6,9,2007
2007-03-27,Kelantan,65,61,4,2007
2007-03-28,Kelantan,10,6,4,2007
2007-03-29,Kelantan,13,7,6,2007
2007-03-30,Kelantan,0,0,0,2007
2007-03-31,Kelantan,34,23,11,2007
2007-04-01,Kelantan,32,26,6,2007
2007-04-02,Kelantan,23,15,8,2007
2007-04-03,Kelantan,15,6,9,2007
2007-04-04,Kelantan,8,1,7,2007
2007-04-05,Kelantan,41,34,7,2007
2007-04-06,Kelantan,0,0,0,2007
2007-04-07,Kelantan,0,0,0,2007
2007-04-08,Kelantan,47,33,14,2007
2007-04-09,Kelantan,2,1,1,2007
2007-04-10,Kelantan,7,3,4,2007
2007-04-11,Kelantan,50,45,5,2007
2007-04-12,Kelantan,4,1,3,2007
2007-04-13,Kelantan,31,19,12,2007
2007-04-14,Kelantan,30,20,10,2007
2007-04-15,Kelantan,22,13,9,2007
2007-04-16,Kelantan,40,29,11,2007
2007-04-17,Kelantan,11,4,7,2007
2007-04-18,Kelantan,20,15,5,2007
2007-04-19,Kelantan,9,3,6,2007
2007-04-20,Kelantan,4,3,1,2007
2007-04-21,Kelantan,3,1,2,2007
2007-04-22,Kelantan,17,15,2,2007
2007-04-23,Kelantan,44,37,7,2007
2007-04-24,Kelantan,35,20,15,2007
2007-04-25,Kelantan,59,32,27,2007
2007-04-26,Kelantan,39,29,10,2007
2007-04-27,Kelantan,74,37,37,2007
2007-04-28,Kelantan,46,39,7,2007
2007-04-29,Kelantan,22,15,7,2007
2007-04-30,Kelantan,7,2,5,2007
2007-05-01,Kelantan,68,55,13,2007
2007-05-02,Kelantan,0,0,0,2007
2007-05-03,Kelantan,43,30,13,2007
2007-05-04,Kelantan,28,26,2,2007
2007-05-05,Kelantan,24,16,8,2007
2007-05-06,Kelantan,9,3,6,2007
2007-05-07,Kelantan,11,3,8,2007
2007-05-08,Kelantan,8,1,7,2007
2007-05-09,Kelantan,16,11,5,2007
2007-05-10,Kelantan,13,8,5,2007
2007-05-11,Kelantan,0,0,0,2007
2007-05-12,Kelantan,44,25,19,2007
2007-05-13,Kelantan,7,3,4,2007
2007-05-14,Kelantan,8,3,5,2007
2007-05-15,Kelantan,13,7,6,2007
2007-05-16,Kelantan,13,6,7,2007
2007-05-17,Kelantan,32,27,5,2007
2007-05-18,Kelantan,15,14,1,2007
2007-05-19,Kelantan,47,44,3,2007
2007-05-20,Kelantan,55,29,26,2007
2007-05-21,Kelantan,68,62,6,2007
2007-05-22,Kelantan,9,3,6,2007
2007-05-23,Kelantan,59,43,16,2007
2007-05-24,Kelantan,76,45,31,2007
2007-05-25,Kelantan,0,0,0,2007
2007-05-26,Kelantan,20,16,4,2007
2007-05-27,Kelantan,48,37,11,2007
2007-05-28,Kelantan,17,10,7,2007
2007-05-29,Kelantan,3,1,2,2007
2007-05-30,Kelantan,3,0,3,2007
2007-05-31,Kelantan,7,2,5,2007
2007-06-01,Kelantan,42,37,5,2007
2007-06-02,Kelantan,54,42,12,2007
2007-06-03,Kelantan,40,33,7,2007
2007-06-04,Kelantan,54,29,25,2007
2007-06-05,Kelantan,88,59,29,2007
2007-06-06,Kelantan,33,21,12,2007
2007-06-07,Kelantan,20,16,4,2007
2007-06-08,Kelantan,32,25,7,2007
2007-06-09,Kelantan,40,31,9,2007
2007-06-10,Kelantan,6,2,4,2007
2007-06-11,Kelantan,7,0,7,2007
2007-06-12,Kelantan,41,38,3,2007
2007-06-13,Kelantan,10,6,4,2007
2007-06-14,Kelantan,9,4,5,2007
2007-06-15,Kelantan,1,1,0,2007
2007-06-16,Kelantan,106,78,28,2007
2007-06-17,Kelantan,9,4,5,2007
2007-06-18,Kelantan,14,8,6,2007
2007-06-19,Kelantan,15,9,6,2007
2007-06-20,Kelantan,13,8,5,2007
2007-06-21,Kelantan,34,28,6,2007
2007-06-22,Kelantan,21,18,3,2007
2007-06-23,Kelantan,22,18,4,2007
2007-06-24,Kelantan,10,2,8,2007
2007-06-25,Kelantan,23,15,8,2007
2007-06-26,Kelantan,16,8,8,2007
2007-06-27,Kelantan,47,46,1,2007
2007-06-28,Kelantan,141,129,12,2007
2007-06-29,Kelantan,22,15,7,2007
2007-06-30,Kelantan,26,20,6,2007
2007-07-01,Kelantan,65,52,13,2007
2007-07-02,Kelantan,30,20,10,2007
2007-07-03,Kelantan,6,4,2,2007
2007-07-04,Kelantan,13,5,8,2007
2007-07-05,Kelantan,25,8,17,2007
2007-07-06,Kelantan,30,24,6,2007
2007-07-07,Kelantan,44,34,10,2007
2007-07-08,Kelantan,18,11,7,2007
2007-07-09,Kelantan,18,6,12,2007
2007-07-10,Kelantan,19,11,8,2007
2007-07-11,Kelantan,14,6,8,2007
2007-07-12,Kelantan,8,3,5,2007
2007-07-13,Kelantan,51,47,4,2007
2007-07-14,Kelantan,0,0,0,2007
2007-07-15,Kelantan,9,3,6,2007
2007-07-16,Kelantan,6,1,5,2007
2007-07-17,Kelantan,153,78,75,2007
2007-07-18,Kelantan,0,0,0,2007
2007-07-19,Kelantan,9,5,4,2007
2007-07-20,Kelantan,0,0,0,2007
2007-07-21,Kelantan,0,0,0,2007
2007-07-22,Kelantan,3,1,2,2007
2007-07-23,Kelantan,104,100,4,2007
2007-07-24,Kelantan,58,36,22,2007
2007-07-25,Kelantan,109,80,29,2007
2007-07-26,Kelantan,121,90,31,2007
2007-07-27,Kelantan,35,30,5,2007
2007-07-28,Kelantan,39,33,6,2007
2007-07-29,Kelantan,3,0,3,2007
2007-07-30,Kelantan,0,0,0,2007
2007-07-31,Kelantan,0,0,0,2007
2007-08-01,Kelantan,3,2,1,2007
2007-08-02,Kelantan,2,1,1,2007
2007-08-03,Kelantan,62,47,15,2007
2007-08-04,Kelantan,89,75,14,2007
2007-08-05,Kelantan,14,8,6,2007
2007-08-06,Kelantan,9,6,3,2007
2007-08-07,Kelantan,39,35,4,2007
2007-08-08,Kelantan,1,0,1,2007
2007-08-09,Kelantan,44,38,6,2007
2007-08-10,Kelantan,0,0,0,2007
2007-08-11,Kelantan,24,17,7,2007
2007-08-12,Kelantan,4,2,2,2007
2007-08-13,Kelantan,6,5,1,2007
2007-08-14,Kelantan,0,0,0,2007
2007-08-15,Kelantan,28,17,11,2007
2007-08-16,Kelantan,34,25,9,2007
2007-08-17,Kelantan,69,47,22,2007
2007-08-18,Kelantan,60,42,18,2007
2007-08-19,Kelantan,31,24,7,2007
2007-08-20,Kelantan,41,25,16,2007
2007-08-21,Kelantan,42,31,11,2007
2007-08-22,Kelantan,31,12,19,2007
2007-08-23,Kelantan,37,24,13,2007
2007-08-24,Kelantan,31,19,12,2007
2007-08-25,Kelantan,51,32,19,2007
2007-08-26,Kelantan,1,0,1,2007
2007-08-27,Kelantan,7,3,4,2007
2007-08-28,Kelantan,1,0,1,2007
2007-08-29,Kelantan,163,148,15,2007
2007-08-30,Kelantan,67,37,30,2007
2007-08-31,Kelantan,1,0,1,2007
2007-09-01,Kelantan,64,59,5,2007
2007-09-02,Kelantan,27,18,9,2007
2007-09-03,Kelantan,3,1,2,2007
2007-09-04,Kelantan,8,3,5,2007
2007-09-05,Kelantan,5,3,2,2007
2007-09-06,Kelantan,3,1,2,2007
2007-09-07,Kelantan,90,73,17,2007
2007-09-08,Kelantan,69,57,12,2007
2007-09-09,Kelantan,58,50,8,2007
2007-09-10,Kelantan,97,70,27,2007
2007-09-11,Kelantan,13,4,9,2007
2007-09-12,Kelantan,20,13,7,2007
2007-09-13,Kelantan,0,0,0,2007
2007-09-14,Kelantan,113,66,47,2007
2007-09-15,Kelantan,0,0,0,2007
2007-09-16,Kelantan,9,2,7,2007
2007-09-17,Kelantan,5,2,3,2007
2007-09-18,Kelantan,2,0,2,2007
2007-09-19,Kelantan,18,11,7,2007
2007-09-20,Kelantan,10,1,9,2007
2007-09-21,Kelantan,49,36,13,2007
2007-09-22,Kelantan,0,0,0,2007
2007-09-23,Kelantan,3,0,3,2007
2007-09-24,Kelantan,3,2,1,2007
2007-09-25,Kelantan,24,13,11,2007
2007-09-26,Kelantan,35,24,11,2007
2007-09-27,Kelantan,0,0,0,2007
2007-09-28,Kelantan,10,5,5,2007
2007-09-29,Kelantan,16,11,5,2007
2007-09-30,Kelantan,5,2,3,2007
2007-10-01,Kelantan,44,39,5,2007
2007-10-02,Kelantan,12,6,6,2007
2007-10-03,Kelantan,47,23,24,2007
2007-10-04,Kelantan,8,3,5,2007
2007-10-05,Kelantan,19,16,3,2007
2007-10-06,Kelantan,7,4,3,2007
2007-10-07,Kelantan,36,21,15,2007
2007-10-08,Kelantan,54,50,4,2007
2007-10-09,Kelantan,8,2,6,2007
2007-10-10,Kelantan,4,2,2,2007
2007-10-11,Kelantan,20,13,7,2007
2007-10-12,Kelantan,1,1,0,2007
2007-10-13,Kelantan,1,0,1,2007
2007-10-14,Kelantan,0,0,0,2007
2007-10-15,Kelantan,6,3,3,2007
2007-10-16,Kelantan,18,8,10,2007
2007-10-17,Kelantan,29,20,9,2007
2007-10-18,Kelantan,43,28,15,2007
2007-10-19,Kelantan,24,17,7,2007
2007-10-20,Kelantan,53,41,12,2007
2007-10-21,Kelantan,49,30,19,2007
2007-10-22,Kelantan,23,17,6,2007
2007-10-23,Kelantan,21,12,9,2007
2007-10-24,Kelantan,92,52,40,2007
2007-10-25,Kelantan,57,32,25,2007
2007-10-26,Kelantan,57,34,23,2007
2007-10-27,Kelantan,64,48,16,2007
2007-10-28,Kelantan,25,18,7,2007
2007-10-29,Kelantan,49,43,6,2007
2007-10-30,Kelantan,59,24,35,2007
2007-10-31,Kelantan,57,41,16,2007
2007-11-01,Kelantan,24,16,8,2007
2007-11-02,Kelantan,57,44,13,2007
2007-11-03,Kelantan,24,19,5,2007
2007-11-04,Kelantan,10,7,3,2007
2007-11-05,Kelantan,16,6,10,2007
2007-11-06,Kelantan,18,13,5,2007
2007-11-07,Kelantan,26,14,12,2007
2007-11-08,Kelantan,38,26,12,2007
2007-11-09,Kelantan,36,27,9,2007
2007-11-10,Kelantan,26,19,7,2007
2007-11-11,Kelantan,17,8,9,2007
2007-11-12,Kelantan,88,75,13,2007
2007-11-13,Kelantan,10,6,4,2007
2007-11-14,Kelantan,18,8,10,2007
2007-11-15,Kelantan,26,17,9,2007
2007-11-16,Kelantan,22,14,8,2007
2007-11-17,Kelantan,24,20,4,2007
2007-11-18,Kelantan,29,15,14,2007
2007-11-19,Kelantan,30,16,14,2007
2007-11-20,Kelantan,15,11,4,2007
2007-11-21,Kelantan,22,11,11,2007
2007-11-22,Kelantan,16,13,3,2007
2007-11-23,Kelantan,14,10,4,2007
2007-11-24,Kelantan,9,8,1,2007
2007-11-25,Kelantan,42,19,23,2007
2007-11-26,Kelantan,14,7,7,2007
2007-11-27,Kelantan,17,15,2,2007
2007-11-28,Kelantan,51,39,12,2007
2007-11-29,Kelantan,36,23,13,2007
2007-11-30,Kelantan,41,34,7,2007
2007-12-01,Kelantan,8,5,3,2007
2007-12-02,Kelantan,7,3,4,2007
2007-12-03,Kelantan,14,5,9,2007
2007-12-04,Kelantan,5,2,3,2007
2007-12-05,Kelantan,65,55,10,2007
2007-12-06,Kelantan,7,1,6,2007
2007-12-07,Kelantan,8,4,4,2007
2007-12-08,Kelantan,61,40,21,2007
2007-12-09,Kelantan,10,3,7,2007
2007-12-10,Kelantan,9,5,4,2007
2007-12-11,Kelantan,25,16,9,2007
2007-12-12,Kelantan,29,16,13,2007
2007-12-13,Kelantan,36,19,17,2007
2007-12-14,Kelantan,0,0,0,2007
2007-12-15,Kelantan,0,0,0,2007
2007-12-16,Kelantan,18,10,8,2007
2007-12-17,Kelantan,12,3,9,2007
2007-12-18,Kelantan,29,11,18,2007
2007-12-19,Kelantan,11,5,6,2007
2007-12-20,Kelantan,0,0,0,2007
2007-12-21,Kelantan,0,0,0,2007
2007-12-22,Kelantan,30,19,11,2007
2007-12-23,Kelantan,43,29,14,2007
2007-12-24,Kelantan,32,20,12,2007
2007-12-25,Kelantan,52,47,5,2007
2007-12-26,Kelantan,43,27,16,2007
2007-12-27,Kelantan,70,53,17,2007
2007-12-28,Kelantan,31,24,7,2007
2007-12-29,Kelantan,30,24,6,2007
2007-12-30,Kelantan,19,9,10,2007
2007-12-31,Kelantan,16,10,6,2007
2008-01-01,Kelantan,13,3,10,2008
2008-01-02,Kelantan,14,3,11,2008
2008-01-03,Kelantan,7,3,4,2008
2008-01-04,Kelantan,30,18,12,2008
2008-01-05,Kelantan,25,21,4,2008
2008-01-06,Kelantan,13,7,6,2008
2008-01-07,Kelantan,58,46,12,2008
2008-01-08,Kelantan,15,10,5,2008
2008-01-09,Kelantan,10,3,7,2008
2008-01-10,Kelantan,44,27,17,2008
2008-01-11,Kelantan,27,24,3,2008
2008-01-12,Kelantan,15,7,8,2008
2008-01-13,Kelantan,7,3,4,2008
2008-01-14,Kelantan,7,3,4,2008
2008-01-15,Kelantan,25,11,14,2008
2008-01-16,Kelantan,42,30,12,2008
2008-01-17,Kelantan,103,96,7,2008
2008-01-18,Kelantan,24,18,6,2008
2008-01-19,Kelantan,19,13,6,2008
2008-01-20,Kelantan,18,5,13,2008
2008-01-21,Kelantan,11,6,5,2008
2008-01-22,Kelantan,74,43,31,2008
2008-01-23,Kelantan,104,85,19,2008
2008-01-24,Kelantan,54,49,5,2008
2008-01-25,Kelantan,14,11,3,2008
2008-01-26,Kelantan,14,13,1,2008
2008-01-27,Kelantan,13,3,10,2008
2008-01-28,Kelantan,63,46,17,2008
2008-01-29,Kelantan,47,38,9,2008
2008-01-30,Kelantan,10,8,2,2008
2008-01-31,Kelantan,36,31,5,2008
2008-02-01,Kelantan,62,45,17,2008
2008-02-02,Kelantan,24,18,6,2008
2008-02-03,Kelantan,24,18,6,2008
2008-02-04,Kelantan,31,23,8,2008
2008-02-05,Kelantan,44,29,15,2008
2008-02-06,Kelantan,154,105,49,2008
2008-02-07,Kelantan,10,7,3,2008
2008-02-08,Kelantan,23,16,7,2008
2008-02-09,Kelantan,28,14,14,2008
2008-02-10,Kelantan,12,3,9,2008
2008-02-11,Kelantan,9,6,3,2008
2008-02-12,Kelantan,36,27,9,2008
2008-02-13,Kelantan,8,5,3,2008
2008-02-14,Kelantan,93,64,29,2008
2008-02-15,Kelantan,39,24,15,2008
2008-02-16,Kelantan,78,54,24,2008
2008-02-17,Kelantan,42,29,13,2008
2008-02-18,Kelantan,11,6,5,2008
2008-02-19,Kelantan,157,125,32,2008
2008-02-20,Kelantan,0,0,0,2008
2008-02-21,Kelantan,53,47,6,2008
2008-02-22,Kelantan,55,33,22,2008
2008-02-23,Kelantan,100,94,6,2008
2008-02-24,Kelantan,3,1,2,2008
2008-02-25,Kelantan,5,3,2,2008
2008-02-26,Kelantan,36,31,5,2008
2008-02-27,Kelantan,6,1,5,2008
2008-02-28,Kelantan,8,2,6,2008
2008-02-29,Kelantan,6,2,4,2008
2008-03-01,Kelantan,8,4,4,2008
2008-03-02,Kelantan,9,4,5,2008
2008-03-03,Kelantan,47,36,11,2008
2008-03-04,Kelantan,62,47,15,2008
2008-03-05,Kelantan,62,44,18,2008
2008-03-06,Kelantan,4,2,2,2008
2008-03-07,Kelantan,30,18,12,2008
2008-03-08,Kelantan,0,0,0,2008
2008-03-09,Kelantan,12,9,3,2008
2008-03-10,Kelantan,4,2,2,2008
2008-03-11,Kelantan,17,11,6,2008
2008-03-12,Kelantan,73,53,20,2008
2008-03-13,Kelantan,100,70,30,2008
2008-03-14,Kelantan,12,9,3,2008
2008-03-15,Kelantan,69,41,28,2008
2008-03-16,Kelantan,6,2,4,2008
2008-03-17,Kelantan,11,8,3,2008
2008-03-18,Kelantan,2,1,1,2008
2008-03-19,Kelantan,56,46,10,2008
2008-03-20,Kelantan,0,0,0,2008
2008-03-21,Kelantan,13,8,5,2008
2008-03-22,Kelantan,15,13,2,2008
2008-03-23,Kelantan,13,6,7,2008
2008-03-24,Kelantan,94,60,34,2008
2008-03-25,Kelantan,40,32,8,2008
2008-03-26,Kelantan,9,4,5,2008
2008-03-27,Kelantan,91,80,11,2008
2008-03-28,Kelantan,8,4,4,2008
2008-03-29,Kelantan,18,13,5,2008
2008-03-30,Kelantan,0,0,0,2008
2008-03-31,Kelantan,18,15,3,2008
2008-04-01,Kelantan,9,2,7,2008
2008-04-02,Kelantan,7,2,5,2008
2008-04-03,Kelantan,8,3,5,2008
2008-04-04,Kelantan,10,5,5,2008
2008-04-05,Kelantan,5,4,1,2008
2008-04-06,Kelantan,15,6,9,2008
2008-04-07,Kelantan,64,54,10,2008
2008-04-08,Kelantan,8,2,6,2008
2008-04-09,Kelantan,7,3,4,2008
2008-04-10,Kelantan,8,1,7,2008
2008-04-11,Kelantan,17,11,6,2008
2008-04-12,Kelantan,16,10,6,2008
2008-04-13,Kelantan,13,2,11,2008
2008-04-14,Kelantan,26,10,16,2008
2008-04-15,Kelantan,21,10,11,2008
2008-04-16,Kelantan,16,12,4,2008
2008-04-17,Kelantan,13,8,5,2008
2008-04-18,Kelantan,5,3,2,2008
2008-04-19,Kelantan,57,38,19,2008
2008-04-20,Kelantan,4,2,2,2008
2008-04-21,Kelantan,11,2,9,2008
2008-04-22,Kelantan,4,1,3,2008
2008-04-23,Kelantan,29,27,2,2008
2008-04-24,Kelantan,27,16,11,2008
2008-04-25,Kelantan,90,50,40,2008
2008-04-26,Kelantan,6,5,1,2008
2008-04-27,Kelantan,62,31,31,2008
2008-04-28,Kelantan,24,13,11,2008
2008-04-29,Kelantan,28,15,13,2008
2008-04-30,Kelantan,6,1,5,2008
2008-05-01,Kelantan,25,15,10,2008
2008-05-02,Kelantan,20,15,5,2008
2008-05-03,Kelantan,13,12,1,2008
2008-05-04,Kelantan,3,1,2,2008
2008-05-05,Kelantan,16,11,5,2008
2008-05-06,Kelantan,5,1,4,2008
2008-05-07,Kelantan,62,45,17,2008
2008-05-08,Kelantan,82,61,21,2008
2008-05-09,Kelantan,18,13,5,2008
2008-05-10,Kelantan,19,11,8,2008
2008-05-11,Kelantan,12,2,10,2008
2008-05-12,Kelantan,36,31,5,2008
2008-05-13,Kelantan,95,51,44,2008
2008-05-14,Kelantan,33,16,17,2008
2008-05-15,Kelantan,54,28,26,2008
2008-05-16,Kelantan,36,18,18,2008
2008-05-17,Kelantan,113,113,0,2008
2008-05-18,Kelantan,12,4,8,2008
2008-05-19,Kelantan,3,1,2,2008
2008-05-20,Kelantan,37,33,4,2008
2008-05-21,Kelantan,8,2,6,2008
2008-05-22,Kelantan,10,6,4,2008
2008-05-23,Kelantan,7,6,1,2008
2008-05-24,Kelantan,12,10,2,2008
2008-05-25,Kelantan,36,25,11,2008
2008-05-26,Kelantan,6,1,5,2008
2008-05-27,Kelantan,8,3,5,2008
2008-05-28,Kelantan,8,4,4,2008
2008-05-29,Kelantan,5,1,4,2008
2008-05-30,Kelantan,15,10,5,2008
2008-05-31,Kelantan,49,40,9,2008
2008-06-01,Kelantan,3,0,3,2008
2008-06-02,Kelantan,9,1,8,2008
2008-06-03,Kelantan,92,60,32,2008
2008-06-04,Kelantan,14,6,8,2008
2008-06-05,Kelantan,16,7,9,2008
2008-06-06,Kelantan,12,7,5,2008
2008-06-07,Kelantan,13,7,6,2008
2008-06-08,Kelantan,6,3,3,2008
2008-06-09,Kelantan,55,43,12,2008
2008-06-10,Kelantan,24,11,13,2008
2008-06-11,Kelantan,6,2,4,2008
2008-06-12,Kelantan,43,28,15,2008
2008-06-13,Kelantan,20,11,9,2008
2008-06-14,Kelantan,22,11,11,2008
2008-06-15,Kelantan,16,6,10,2008
2008-06-16,Kelantan,18,6,12,2008
2008-06-17,Kelantan,5,3,2,2008
2008-06-18,Kelantan,154,144,10,2008
2008-06-19,Kelantan,11,3,8,2008
2008-06-20,Kelantan,0,0,0,2008
2008-06-21,Kelantan,48,42,6,2008
2008-06-22,Kelantan,9,5,4,2008
2008-06-23,Kelantan,42,30,12,2008
2008-06-24,Kelantan,18,2,16,2008
2008-06-25,Kelantan,69,41,28,2008
2008-06-26,Kelantan,25,12,13,2008
2008-06-27,Kelantan,67,63,4,2008
2008-06-28,Kelantan,18,14,4,2008
2008-06-29,Kelantan,12,4,8,2008
2008-06-30,Kelantan,13,6,7,2008
2008-07-01,Kelantan,56,35,21,2008
2008-07-02,Kelantan,9,3,6,2008
2008-07-03,Kelantan,38,34,4,2008
2008-07-04,Kelantan,8,6,2,2008
2008-07-05,Kelantan,119,66,53,2008
2008-07-06,Kelantan,9,1,8,2008
2008-07-07,Kelantan,44,35,9,2008
2008-07-08,Kelantan,24,21,3,2008
2008-07-09,Kelantan,42,41,1,2008
2008-07-10,Kelantan,57,52,5,2008
2008-07-11,Kelantan,21,15,6,2008
2008-07-12,Kelantan,0,0,0,2008
2008-07-13,Kelantan,7,1,6,2008
2008-07-14,Kelantan,31,13,18,2008
2008-07-15,Kelantan,28,25,3,2008
2008-07-16,Kelantan,81,58,23,2008
2008-07-17,Kelantan,71,63,8,2008
2008-07-18,Kelantan,0,0,0,2008
2008-07-19,Kelantan,14,9,5,2008
2008-07-20,Kelantan,59,40,19,2008
2008-07-21,Kelantan,8,2,6,2008
2008-07-22,Kelantan,5,2,3,2008
2008-07-23,Kelantan,4,1,3,2008
2008-07-24,Kelantan,66,40,26,2008
2008-07-25,Kelantan,70,45,25,2008
2008-07-26,Kelantan,41,37,4,2008
2008-07-27,Kelantan,10,3,7,2008
2008-07-28,Kelantan,26,23,3,2008
2008-07-29,Kelantan,5,1,4,2008
2008-07-30,Kelantan,54,51,3,2008
2008-07-31,Kelantan,19,4,15,2008
2008-08-01,Kelantan,0,0,0,2008
2008-08-02,Kelantan,22,14,8,2008
2008-08-03,Kelantan,6,2,4,2008
2008-08-04,Kelantan,3,1,2,2008
2008-08-05,Kelantan,834,728,106,2008
2008-08-06,Kelantan,4,1,3,2008
2008-08-07,Kelantan,54,54,0,2008
2008-08-08,Kelantan,1,0,1,2008
2008-08-09,Kelantan,43,32,11,2008
2008-08-10,Kelantan,3,1,2,2008
2008-08-11,Kelantan,62,54,8,2008
2008-08-12,Kelantan,15,4,11,2008
2008-08-13,Kelantan,3,2,1,2008
2008-08-14,Kelantan,3,1,2,2008
2008-08-15,Kelantan,6,4,2,2008
2008-08-16,Kelantan,26,19,7,2008
2008-08-17,Kelantan,26,16,10,2008
2008-08-18,Kelantan,11,6,5,2008
2008-08-19,Kelantan,24,14,10,2008
2008-08-20,Kelantan,34,25,9,2008
2008-08-21,Kelantan,216,198,18,2008
2008-08-22,Kelantan,25,17,8,2008
2008-08-23,Kelantan,69,66,3,2008
2008-08-24,Kelantan,9,5,4,2008
2008-08-25,Kelantan,21,14,7,2008
2008-08-26,Kelantan,178,155,23,2008
2008-08-27,Kelantan,12,6,6,2008
2008-08-28,Kelantan,20,13,7,2008
2008-08-29,Kelantan,71,48,23,2008
2008-08-30,Kelantan,14,8,6,2008
2008-08-31,Kelantan,0,0,0,2008
2008-09-01,Kelantan,2,0,2,2008
2008-09-02,Kelantan,6,2,4,2008
2008-09-03,Kelantan,10,3,7,2008
2008-09-04,Kelantan,12,4,8,2008
2008-09-05,Kelantan,125,47,78,2008
2008-09-06,Kelantan,0,0,0,2008
2008-09-07,Kelantan,11,4,7,2008
2008-09-08,Kelantan,9,4,5,2008
2008-09-09,Kelantan,8,2,6,2008
2008-09-10,Kelantan,7,1,6,2008
2008-09-11,Kelantan,6,3,3,2008
2008-09-12,Kelantan,0,0,0,2008
2008-09-13,Kelantan,0,0,0,2008
2008-09-14,Kelantan,11,3,8,2008
2008-09-15,Kelantan,98,58,40,2008
2008-09-16,Kelantan,42,16,26,2008
2008-09-17,Kelantan,0,0,0,2008
2008-09-18,Kelantan,9,4,5,2008
2008-09-19,Kelantan,0,0,0,2008
2008-09-20,Kelantan,0,0,0,2008
2008-09-21,Kelantan,2,1,1,2008
2008-09-22,Kelantan,79,50,29,2008
2008-09-23,Kelantan,2,0,2,2008
2008-09-24,Kelantan,6,1,5,2008
2008-09-25,Kelantan,5,1,4,2008
2008-09-26,Kelantan,21,10,11,2008
2008-09-27,Kelantan,0,0,0,2008
2008-09-28,Kelantan,17,10,7,2008
2008-09-29,Kelantan,10,1,9,2008
2008-09-30,Kelantan,8,5,3,2008
2008-10-01,Kelantan,0,0,0,2008
2008-10-02,Kelantan,0,0,0,2008
2008-10-03,Kelantan,9,5,4,2008
2008-10-04,Kelantan,38,28,10,2008
2008-10-05,Kelantan,29,13,16,2008
2008-10-06,Kelantan,29,21,8,2008
2008-10-07,Kelantan,71,58,13,2008
2008-10-08,Kelantan,36,19,17,2008
2008-10-09,Kelantan,20,9,11,2008
2008-10-10,Kelantan,20,15,5,2008
2008-10-11,Kelantan,15,12,3,2008
2008-10-12,Kelantan,12,8,4,2008
2008-10-13,Kelantan,13,4,9,2008
2008-10-14,Kelantan,67,23,44,2008
2008-10-15,Kelantan,70,25,45,2008
2008-10-16,Kelantan,44,28,16,2008
2008-10-17,Kelantan,11,5,6,2008
2008-10-18,Kelantan,160,83,77,2008
2008-10-19,Kelantan,14,5,9,2008
2008-10-20,Kelantan,50,26,24,2008
2008-10-21,Kelantan,7,4,3,2008
2008-10-22,Kelantan,12,6,6,2008
2008-10-23,Kelantan,83,63,20,2008
2008-10-24,Kelantan,49,33,16,2008
2008-10-25,Kelantan,91,60,31,2008
2008-10-26,Kelantan,52,33,19,2008
2008-10-27,Kelantan,59,33,26,2008
2008-10-28,Kelantan,7,4,3,2008
2008-10-29,Kelantan,9,5,4,2008
2008-10-30,Kelantan,7,1,6,2008
2008-10-31,Kelantan,12,5,7,2008
2008-11-01,Kelantan,45,31,14,2008
2008-11-02,Kelantan,5,0,5,2008
2008-11-03,Kelantan,8,5,3,2008
2008-11-04,Kelantan,24,12,12,2008
2008-11-05,Kelantan,6,1,5,2008
2008-11-06,Kelantan,8,2,6,2008
2008-11-07,Kelantan,19,11,8,2008
2008-11-08,Kelantan,11,5,6,2008
2008-11-09,Kelantan,43,33,10,2008
2008-11-10,Kelantan,14,9,5,2008
2008-11-11,Kelantan,11,2,9,2008
2008-11-12,Kelantan,26,11,15,2008
2008-11-13,Kelantan,43,20,23,2008
2008-11-14,Kelantan,0,0,0,2008
2008-11-15,Kelantan,16,11,5,2008
2008-11-16,Kelantan,11,7,4,2008
2008-11-17,Kelantan,13,8,5,2008
2008-11-18,Kelantan,109,68,41,2008
2008-11-19,Kelantan,11,9,2,2008
2008-11-20,Kelantan,30,24,6,2008
2008-11-21,Kelantan,0,0,0,2008
2008-11-22,Kelantan,32,19,13,2008
2008-11-23,Kelantan,30,7,23,2008
2008-11-24,Kelantan,19,11,8,2008
2008-11-25,Kelantan,18,9,9,2008
2008-11-26,Kelantan,4,1,3,2008
2008-11-27,Kelantan,138,56,82,2008
2008-11-28,Kelantan,7,6,1,2008
2008-11-29,Kelantan,86,75,11,2008
2008-11-30,Kelantan,19,10,9,2008
2008-12-01,Kelantan,8,1,7,2008
2008-12-02,Kelantan,6,0,6,2008
2008-12-03,Kelantan,7,5,2,2008
2008-12-04,Kelantan,32,20,12,2008
2008-12-05,Kelantan,28,19,9,2008
2008-12-06,Kelantan,17,14,3,2008
2008-12-07,Kelantan,20,8,12,2008
2008-12-08,Kelantan,0,0,0,2008
2008-12-09,Kelantan,0,0,0,2008
2008-12-10,Kelantan,10,4,6,2008
2008-12-11,Kelantan,32,12,20,2008
2008-12-12,Kelantan,34,28,6,2008
2008-12-13,Kelantan,105,92,13,2008
2008-12-14,Kelantan,15,3,12,2008
2008-12-15,Kelantan,18,8,10,2008
2008-12-16,Kelantan,52,26,26,2008
2008-12-17,Kelantan,6,1,5,2008
2008-12-18,Kelantan,17,7,10,2008
2008-12-19,Kelantan,42,28,14,2008
2008-12-20,Kelantan,97,54,43,2008
2008-12-21,Kelantan,3,3,0,2008
2008-12-22,Kelantan,12,7,5,2008
2008-12-23,Kelantan,10,1,9,2008
2008-12-24,Kelantan,17,11,6,2008
2008-12-25,Kelantan,116,44,72,2008
2008-12-26,Kelantan,4,3,1,2008
2008-12-27,Kelantan,0,0,0,2008
2008-12-28,Kelantan,1,1,0,2008
2008-12-29,Kelantan,0,0,0,2008
2008-12-30,Kelantan,0,0,0,2008
2008-12-31,Kelantan,0,0,0,2008
2009-01-01,Kelantan,7,3,4,2009
2009-01-02,Kelantan,16,10,6,2009
2009-01-03,Kelantan,20,14,6,2009
2009-01-04,Kelantan,10,3,7,2009
2009-01-05,Kelantan,8,2,6,2009
2009-01-06,Kelantan,25,9,16,2009
2009-01-07,Kelantan,34,30,4,2009
2009-01-08,Kelantan,58,49,9,2009
2009-01-09,Kelantan,0,0,0,2009
2009-01-10,Kelantan,0,0,0,2009
2009-01-11,Kelantan,25,15,10,2009
2009-01-12,Kelantan,0,0,0,2009
2009-01-13,Kelantan,25,15,10,2009
2009-01-14,Kelantan,53,49,4,2009
2009-01-15,Kelantan,80,61,19,2009
2009-01-16,Kelantan,0,0,0,2009
2009-01-17,Kelantan,156,117,39,2009
2009-01-18,Kelantan,13,5,8,2009
2009-01-19,Kelantan,80,62,18,2009
2009-01-20,Kelantan,67,47,20,2009
2009-01-21,Kelantan,5,0,5,2009
2009-01-22,Kelantan,117,99,18,2009
2009-01-23,Kelantan,0,0,0,2009
2009-01-24,Kelantan,0,0,0,2009
2009-01-25,Kelantan,13,5,8,2009
2009-01-26,Kelantan,39,16,23,2009
2009-01-27,Kelantan,42,28,14,2009
2009-01-28,Kelantan,9,1,8,2009
2009-01-29,Kelantan,38,33,5,2009
2009-01-30,Kelantan,0,0,0,2009
2009-01-31,Kelantan,14,12,2,2009
2009-02-01,Kelantan,9,3,6,2009
2009-02-02,Kelantan,15,11,4,2009
2009-02-03,Kelantan,52,39,13,2009
2009-02-04,Kelantan,8,4,4,2009
2009-02-05,Kelantan,62,46,16,2009
2009-02-06,Kelantan,51,29,22,2009
2009-02-07,Kelantan,9,7,2,2009
2009-02-08,Kelantan,51,41,10,2009
2009-02-09,Kelantan,49,31,18,2009
2009-02-10,Kelantan,76,41,35,2009
2009-02-11,Kelantan,133,56,77,2009
2009-02-12,Kelantan,12,6,6,2009
2009-02-13,Kelantan,57,30,27,2009
2009-02-14,Kelantan,142,89,53,2009
2009-02-15,Kelantan,7,2,5,2009
2009-02-16,Kelantan,135,104,31,2009
2009-02-17,Kelantan,5,3,2,2009
2009-02-18,Kelantan,43,30,13,2009
2009-02-19,Kelantan,10,1,9,2009
2009-02-20,Kelantan,1,0,1,2009
2009-02-21,Kelantan,122,119,3,2009
2009-02-22,Kelantan,61,47,14,2009
2009-02-23,Kelantan,7,3,4,2009
2009-02-24,Kelantan,63,51,12,2009
2009-02-25,Kelantan,91,78,13,2009
2009-02-26,Kelantan,3,0,3,2009
2009-02-27,Kelantan,48,24,24,2009
2009-02-28,Kelantan,10,5,5,2009
2009-03-01,Kelantan,5,1,4,2009
2009-03-02,Kelantan,48,31,17,2009
2009-03-03,Kelantan,123,60,63,2009
2009-03-04,Kelantan,2,0,2,2009
2009-03-05,Kelantan,6,1,5,2009
2009-03-06,Kelantan,0,0,0,2009
2009-03-07,Kelantan,52,36,16,2009
2009-03-08,Kelantan,7,0,7,2009
2009-03-09,Kelantan,47,26,21,2009
2009-03-10,Kelantan,6,5,1,2009
2009-03-11,Kelantan,5,1,4,2009
2009-03-12,Kelantan,18,6,12,2009
2009-03-13,Kelantan,9,4,5,2009
2009-03-14,Kelantan,3,1,2,2009
2009-03-15,Kelantan,8,1,7,2009
2009-03-16,Kelantan,10,2,8,2009
2009-03-17,Kelantan,9,1,8,2009
2009-03-18,Kelantan,18,3,15,2009
2009-03-19,Kelantan,8,0,8,2009
2009-03-20,Kelantan,7,1,6,2009
2009-03-21,Kelantan,61,31,30,2009
2009-03-22,Kelantan,54,32,22,2009
2009-03-23,Kelantan,129,81,48,2009
2009-03-24,Kelantan,6,3,3,2009
2009-03-25,Kelantan,68,31,37,2009
2009-03-26,Kelantan,322,160,162,2009
2009-03-27,Kelantan,0,0,0,2009
2009-03-28,Kelantan,17,7,10,2009
2009-03-29,Kelantan,13,8,5,2009
2009-03-30,Kelantan,24,12,12,2009
2009-03-31,Kelantan,30,22,8,2009
2009-04-01,Kelantan,9,1,8,2009
2009-04-02,Kelantan,5,1,4,2009
2009-04-03,Kelantan,15,13,2,2009
2009-04-04,Kelantan,82,44,38,2009
2009-04-05,Kelantan,5,2,3,2009
2009-04-06,Kelantan,13,3,10,2009
2009-04-07,Kelantan,5,1,4,2009
2009-04-08,Kelantan,8,1,7,2009
2009-04-09,Kelantan,47,28,19,2009
2009-04-10,Kelantan,2,0,2,2009
2009-04-11,Kelantan,34,22,12,2009
2009-04-12,Kelantan,6,1,5,2009
2009-04-13,Kelantan,66,45,21,2009
2009-04-14,Kelantan,51,43,8,2009
2009-04-15,Kelantan,4,0,4,2009
2009-04-16,Kelantan,71,49,22,2009
2009-04-17,Kelantan,4,0,4,2009
2009-04-18,Kelantan,2,0,2,2009
2009-04-19,Kelantan,40,29,11,2009
2009-04-20,Kelantan,5,2,3,2009
2009-04-21,Kelantan,4,1,3,2009
2009-04-22,Kelantan,11,3,8,2009
2009-04-23,Kelantan,33,24,9,2009
2009-04-24,Kelantan,17,12,5,2009
2009-04-25,Kelantan,37,30,7,2009
2009-04-26,Kelantan,7,2,5,2009
2009-04-27,Kelantan,8,0,8,2009
2009-04-28,Kelantan,20,4,16,2009
2009-04-29,Kelantan,2,0,2,2009
2009-04-30,Kelantan,52,44,8,2009
2009-05-01,Kelantan,78,24,54,2009
2009-05-02,Kelantan,68,33,35,2009
2009-05-03,Kelantan,5,1,4,2009
2009-05-04,Kelantan,32,22,10,2009
2009-05-05,Kelantan,7,2,5,2009
2009-05-06,Kelantan,58,50,8,2009
2009-05-07,Kelantan,71,25,46,2009
2009-05-08,Kelantan,3,0,3,2009
2009-05-09,Kelantan,18,11,7,2009
2009-05-10,Kelantan,8,1,7,2009
2009-05-11,Kelantan,18,12,6,2009
2009-05-12,Kelantan,75,64,11,2009
2009-05-13,Kelantan,3,0,3,2009
2009-05-14,Kelantan,46,36,10,2009
2009-05-15,Kelantan,3,0,3,2009
2009-05-16,Kelantan,18,12,6,2009
2009-05-17,Kelantan,11,0,11,2009
2009-05-18,Kelantan,31,27,4,2009
2009-05-19,Kelantan,8,1,7,2009
2009-05-20,Kelantan,8,2,6,2009
2009-05-21,Kelantan,131,111,20,2009
2009-05-22,Kelantan,11,6,5,2009
2009-05-23,Kelantan,81,77,4,2009
2009-05-24,Kelantan,6,1,5,2009
2009-05-25,Kelantan,7,0,7,2009
2009-05-26,Kelantan,9,5,4,2009
2009-05-27,Kelantan,8,1,7,2009
2009-05-28,Kelantan,10,2,8,2009
2009-05-29,Kelantan,0,0,0,2009
2009-05-30,Kelantan,0,0,0,2009
2009-05-31,Kelantan,8,1,7,2009
2009-06-01,Kelantan,5,1,4,2009
2009-06-02,Kelantan,3,1,2,2009
2009-06-03,Kelantan,4,2,2,2009
2009-06-04,Kelantan,38,26,12,2009
2009-06-05,Kelantan,20,9,11,2009
2009-06-06,Kelantan,23,15,8,2009
2009-06-07,Kelantan,40,23,17,2009
2009-06-08,Kelantan,4,1,3,2009
2009-06-09,Kelantan,0,0,0,2009
2009-06-10,Kelantan,85,31,54,2009
2009-06-11,Kelantan,0,0,0,2009
2009-06-12,Kelantan,2,0,2,2009
2009-06-13,Kelantan,27,12,15,2009
2009-06-14,Kelantan,41,11,30,2009
2009-06-15,Kelantan,134,69,65,2009
2009-06-16,Kelantan,78,43,35,2009
2009-06-17,Kelantan,12,7,5,2009
2009-06-18,Kelantan,72,49,23,2009
2009-06-19,Kelantan,49,27,22,2009
2009-06-20,Kelantan,14,7,7,2009
2009-06-21,Kelantan,35,21,14,2009
2009-06-22,Kelantan,5,1,4,2009
2009-06-23,Kelantan,7,1,6,2009
2009-06-24,Kelantan,7,2,5,2009
2009-06-25,Kelantan,40,34,6,2009
2009-06-26,Kelantan,7,4,3,2009
2009-06-27,Kelantan,28,22,6,2009
2009-06-28,Kelantan,11,1,10,2009
2009-06-29,Kelantan,51,34,17,2009
2009-06-30,Kelantan,10,1,9,2009
2009-07-01,Kelantan,34,30,4,2009
2009-07-02,Kelantan,28,15,13,2009
2009-07-03,Kelantan,26,24,2,2009
2009-07-04,Kelantan,0,0,0,2009
2009-07-05,Kelantan,10,3,7,2009
2009-07-06,Kelantan,68,51,17,2009
2009-07-07,Kelantan,98,68,30,2009
2009-07-08,Kelantan,4,2,2,2009
2009-07-09,Kelantan,7,2,5,2009
2009-07-10,Kelantan,11,5,6,2009
2009-07-11,Kelantan,4,3,1,2009
2009-07-12,Kelantan,4,0,4,2009
2009-07-13,Kelantan,16,13,3,2009
2009-07-14,Kelantan,0,0,0,2009
2009-07-15,Kelantan,60,34,26,2009
2009-07-16,Kelantan,39,26,13,2009
2009-07-17,Kelantan,0,0,0,2009
2009-07-18,Kelantan,2,0,2,2009
2009-07-19,Kelantan,55,47,8,2009
2009-07-20,Kelantan,10,3,7,2009
2009-07-21,Kelantan,0,0,0,2009
2009-07-22,Kelantan,42,39,3,2009
2009-07-23,Kelantan,17,3,14,2009
2009-07-24,Kelantan,80,28,52,2009
2009-07-25,Kelantan,28,14,14,2009
2009-07-26,Kelantan,51,38,13,2009
2009-07-27,Kelantan,66,56,10,2009
2009-07-28,Kelantan,225,141,84,2009
2009-07-29,Kelantan,4,3,1,2009
2009-07-30,Kelantan,42,12,30,2009
2009-07-31,Kelantan,1,0,1,2009
2009-08-01,Kelantan,0,0,0,2009
2009-08-02,Kelantan,74,60,14,2009
2009-08-03,Kelantan,1,0,1,2009
2009-08-04,Kelantan,2,0,2,2009
2009-08-05,Kelantan,9,3,6,2009
2009-08-06,Kelantan,135,57,78,2009
2009-08-07,Kelantan,13,4,9,2009
2009-08-08,Kelantan,74,49,25,2009
2009-08-09,Kelantan,7,1,6,2009
2009-08-10,Kelantan,122,60,62,2009
2009-08-11,Kelantan,3,1,2,2009
2009-08-12,Kelantan,2,0,2,2009
2009-08-13,Kelantan,32,18,14,2009
2009-08-14,Kelantan,3,1,2,2009
2009-08-15,Kelantan,1,0,1,2009
2009-08-16,Kelantan,0,0,0,2009
2009-08-17,Kelantan,5,0,5,2009
2009-08-18,Kelantan,4,1,3,2009
2009-08-19,Kelantan,12,2,10,2009
2009-08-20,Kelantan,4,0,4,2009
2009-08-21,Kelantan,0,0,0,2009
2009-08-22,Kelantan,0,0,0,2009
2009-08-23,Kelantan,8,0,8,2009
2009-08-24,Kelantan,9,2,7,2009
2009-08-25,Kelantan,3,1,2,2009
2009-08-26,Kelantan,7,4,3,2009
2009-08-27,Kelantan,16,5,11,2009
2009-08-28,Kelantan,0,0,0,2009
2009-08-29,Kelantan,1,0,1,2009
2009-08-30,Kelantan,14,2,12,2009
2009-08-31,Kelantan,0,0,0,2009
2009-09-01,Kelantan,17,7,10,2009
2009-09-02,Kelantan,11,1,10,2009
2009-09-03,Kelantan,53,33,20,2009
2009-09-04,Kelantan,0,0,0,2009
2009-09-05,Kelantan,0,0,0,2009
2009-09-06,Kelantan,15,3,12,2009
2009-09-07,Kelantan,48,14,34,2009
2009-09-08,Kelantan,40,17,23,2009
2009-09-09,Kelantan,54,20,34,2009
2009-09-10,Kelantan,32,23,9,2009
2009-09-11,Kelantan,198,79,119,2009
2009-09-12,Kelantan,102,94,8,2009
2009-09-13,Kelantan,43,32,11,2009
2009-09-14,Kelantan,30,18,12,2009
2009-09-15,Kelantan,7,3,4,2009
2009-09-16,Kelantan,8,1,7,2009
2009-09-17,Kelantan,24,8,16,2009
2009-09-18,Kelantan,0,0,0,2009
2009-09-19,Kelantan,0,0,0,2009
2009-09-20,Kelantan,0,0,0,2009
2009-09-21,Kelantan,0,0,0,2009
2009-09-22,Kelantan,26,4,22,2009
2009-09-23,Kelantan,36,12,24,2009
2009-09-24,Kelantan,16,4,12,2009
2009-09-25,Kelantan,8,6,2,2009
2009-09-26,Kelantan,3,0,3,2009
2009-09-27,Kelantan,6,1,5,2009
2009-09-28,Kelantan,37,9,28,2009
2009-09-29,Kelantan,73,46,27,2009
2009-09-30,Kelantan,9,2,7,2009
2009-10-01,Kelantan,18,6,12,2009
2009-10-02,Kelantan,26,14,12,2009
2009-10-03,Kelantan,0,0,0,2009
2009-10-04,Kelantan,14,2,12,2009
2009-10-05,Kelantan,3,2,1,2009
2009-10-06,Kelantan,23,17,6,2009
2009-10-07,Kelantan,6,2,4,2009
2009-10-08,Kelantan,12,6,6,2009
2009-10-09,Kelantan,67,41,26,2009
2009-10-10,Kelantan,5,2,3,2009
2009-10-11,Kelantan,26,16,10,2009
2009-10-12,Kelantan,11,4,7,2009
2009-10-13,Kelantan,789,623,166,2009
2009-10-14,Kelantan,9,4,5,2009
2009-10-15,Kelantan,49,18,31,2009
2009-10-16,Kelantan,0,0,0,2009
2009-10-17,Kelantan,57,47,10,2009
2009-10-18,Kelantan,3,0,3,2009
2009-10-19,Kelantan,15,6,9,2009
2009-10-20,Kelantan,7,1,6,2009
2009-10-21,Kelantan,10,1,9,2009
2009-10-22,Kelantan,9,2,7,2009
2009-10-23,Kelantan,33,21,12,2009
2009-10-24,Kelantan,4,1,3,2009
2009-10-25,Kelantan,33,14,19,2009
2009-10-26,Kelantan,52,21,31,2009
2009-10-27,Kelantan,24,7,17,2009
2009-10-28,Kelantan,70,45,25,2009
2009-10-29,Kelantan,1,0,1,2009
2009-10-30,Kelantan,2,0,2,2009
2009-10-31,Kelantan,41,34,7,2009
2009-11-01,Kelantan,11,4,7,2009
2009-11-02,Kelantan,12,2,10,2009
2009-11-03,Kelantan,8,1,7,2009
2009-11-04,Kelantan,0,0,0,2009
2009-11-05,Kelantan,23,11,12,2009
2009-11-06,Kelantan,23,16,7,2009
2009-11-07,Kelantan,9,3,6,2009
2009-11-08,Kelantan,0,0,0,2009
2009-11-09,Kelantan,36,16,20,2009
2009-11-10,Kelantan,11,3,8,2009
2009-11-11,Kelantan,16,5,11,2009
2009-11-12,Kelantan,45,25,20,2009
2009-11-13,Kelantan,65,32,33,2009
2009-11-14,Kelantan,42,29,13,2009
2009-11-15,Kelantan,61,44,17,2009
2009-11-16,Kelantan,10,0,10,2009
2009-11-17,Kelantan,28,16,12,2009
2009-11-18,Kelantan,19,12,7,2009
2009-11-19,Kelantan,3,1,2,2009
2009-11-20,Kelantan,1,0,1,2009
2009-11-21,Kelantan,15,8,7,2009
2009-11-22,Kelantan,26,9,17,2009
2009-11-23,Kelantan,40,22,18,2009
2009-11-24,Kelantan,3,0,3,2009
2009-11-25,Kelantan,32,20,12,2009
2009-11-26,Kelantan,26,9,17,2009
2009-11-27,Kelantan,0,0,0,2009
2009-11-28,Kelantan,0,0,0,2009
2009-11-29,Kelantan,17,14,3,2009
2009-11-30,Kelantan,26,14,12,2009
2009-12-01,Kelantan,73,41,32,2009
2009-12-02,Kelantan,24,11,13,2009
2009-12-03,Kelantan,89,54,35,2009
2009-12-04,Kelantan,55,27,28,2009
2009-12-05,Kelantan,36,24,12,2009
2009-12-06,Kelantan,22,11,11,2009
2009-12-07,Kelantan,10,3,7,2009
2009-12-08,Kelantan,42,25,17,2009
2009-12-09,Kelantan,45,22,23,2009
2009-12-10,Kelantan,31,15,16,2009
2009-12-11,Kelantan,40,17,23,2009
2009-12-12,Kelantan,133,79,54,2009
2009-12-13,Kelantan,45,29,16,2009
2009-12-14,Kelantan,17,14,3,2009
2009-12-15,Kelantan,30,17,13,2009
2009-12-16,Kelantan,58,31,27,2009
2009-12-17,Kelantan,44,19,25,2009
2009-12-18,Kelantan,12,5,7,2009
2009-12-19,Kelantan,23,6,17,2009
2009-12-20,Kelantan,21,9,12,2009
2009-12-21,Kelantan,19,3,16,2009
2009-12-22,Kelantan,20,8,12,2009
2009-12-23,Kelantan,7,3,4,2009
2009-12-24,Kelantan,49,28,21,2009
2009-12-25,Kelantan,10,4,6,2009
2009-12-26,Kelantan,82,58,24,2009
2009-12-27,Kelantan,46,22,24,2009
2009-12-28,Kelantan,39,22,17,2009
2009-12-29,Kelantan,78,46,32,2009
2009-12-30,Kelantan,22,14,8,2009
2009-12-31,Kelantan,24,8,16,2009
2010-01-01,Kelantan,4,0,4,2010
2010-01-02,Kelantan,8,5,3,2010
2010-01-03,Kelantan,7,2,5,2010
2010-01-04,Kelantan,23,8,15,2010
2010-01-05,Kelantan,14,6,8,2010
2010-01-06,Kelantan,34,25,9,2010
2010-01-07,Kelantan,47,39,8,2010
2010-01-08,Kelantan,3,1,2,2010
2010-01-09,Kelantan,19,10,9,2010
2010-01-10,Kelantan,13,2,11,2010
2010-01-11,Kelantan,97,46,51,2010
2010-01-12,Kelantan,91,50,41,2010
2010-01-13,Kelantan,144,43,101,2010
2010-01-14,Kelantan,58,52,6,2010
2010-01-15,Kelantan,54,38,16,2010
2010-01-16,Kelantan,32,9,23,2010
2010-01-17,Kelantan,30,15,15,2010
2010-01-18,Kelantan,6,0,6,2010
2010-01-19,Kelantan,3,2,1,2010
2010-01-20,Kelantan,62,46,16,2010
2010-01-21,Kelantan,143,95,48,2010
2010-01-22,Kelantan,5,1,4,2010
2010-01-23,Kelantan,44,25,19,2010
2010-01-24,Kelantan,33,18,15,2010
2010-01-25,Kelantan,106,46,60,2010
2010-01-26,Kelantan,138,110,28,2010
2010-01-27,Kelantan,39,34,5,2010
2010-01-28,Kelantan,114,68,46,2010
2010-01-29,Kelantan,0,0,0,2010
2010-01-30,Kelantan,19,9,10,2010
2010-01-31,Kelantan,7,3,4,2010
2010-02-01,Kelantan,68,37,31,2010
2010-02-02,Kelantan,130,113,17,2010
2010-02-03,Kelantan,74,61,13,2010
2010-02-04,Kelantan,192,123,69,2010
2010-02-05,Kelantan,23,12,11,2010
2010-02-06,Kelantan,55,40,15,2010
2010-02-07,Kelantan,132,70,62,2010
2010-02-08,Kelantan,140,82,58,2010
2010-02-09,Kelantan,69,60,9,2010
2010-02-10,Kelantan,6,4,2,2010
2010-02-11,Kelantan,157,142,15,2010
2010-02-12,Kelantan,5,3,2,2010
2010-02-13,Kelantan,49,14,35,2010
2010-02-14,Kelantan,6,3,3,2010
2010-02-15,Kelantan,11,8,3,2010
2010-02-16,Kelantan,4,0,4,2010
2010-02-17,Kelantan,41,24,17,2010
2010-02-18,Kelantan,38,10,28,2010
2010-02-19,Kelantan,4,0,4,2010
2010-02-20,Kelantan,0,0,0,2010
2010-02-21,Kelantan,7,4,3,2010
2010-02-22,Kelantan,13,0,13,2010
2010-02-23,Kelantan,85,55,30,2010
2010-02-24,Kelantan,93,66,27,2010
2010-02-25,Kelantan,58,44,14,2010
2010-02-26,Kelantan,0,0,0,2010
2010-02-27,Kelantan,132,127,5,2010
2010-02-28,Kelantan,80,66,14,2010
2010-03-01,Kelantan,10,3,7,2010
2010-03-02,Kelantan,6,1,5,2010
2010-03-03,Kelantan,53,33,20,2010
2010-03-04,Kelantan,6,3,3,2010
2010-03-05,Kelantan,11,7,4,2010
2010-03-06,Kelantan,5,1,4,2010
2010-03-07,Kelantan,19,13,6,2010
2010-03-08,Kelantan,10,2,8,2010
2010-03-09,Kelantan,19,16,3,2010
2010-03-10,Kelantan,23,14,9,2010
2010-03-11,Kelantan,10,5,5,2010
2010-03-12,Kelantan,3,0,3,2010
2010-03-13,Kelantan,2,0,2,2010
2010-03-14,Kelantan,11,4,7,2010
2010-03-15,Kelantan,47,35,12,2010
2010-03-16,Kelantan,18,4,14,2010
2010-03-17,Kelantan,13,4,9,2010
2010-03-18,Kelantan,10,4,6,2010
2010-03-19,Kelantan,0,0,0,2010
2010-03-20,Kelantan,14,9,5,2010
2010-03-21,Kelantan,27,16,11,2010
2010-03-22,Kelantan,19,5,14,2010
2010-03-23,Kelantan,86,61,25,2010
2010-03-24,Kelantan,10,4,6,2010
2010-03-25,Kelantan,80,46,34,2010
2010-03-26,Kelantan,70,40,30,2010
2010-03-27,Kelantan,96,84,12,2010
2010-03-28,Kelantan,34,19,15,2010
2010-03-29,Kelantan,11,2,9,2010
2010-03-30,Kelantan,0,0,0,2010
2010-03-31,Kelantan,0,0,0,2010
2010-04-01,Kelantan,9,3,6,2010
2010-04-02,Kelantan,94,61,33,2010
2010-04-03,Kelantan,104,73,31,2010
2010-04-04,Kelantan,60,22,38,2010
2010-04-05,Kelantan,32,20,12,2010
2010-04-06,Kelantan,60,38,22,2010
2010-04-07,Kelantan,79,31,48,2010
2010-04-08,Kelantan,74,36,38,2010
2010-04-09,Kelantan,8,3,5,2010
2010-04-10,Kelantan,0,0,0,2010
2010-04-11,Kelantan,37,27,10,2010
2010-04-12,Kelantan,40,24,16,2010
2010-04-13,Kelantan,37,4,33,2010
2010-04-14,Kelantan,28,7,21,2010
2010-04-15,Kelantan,64,34,30,2010
2010-04-16,Kelantan,6,1,5,2010
2010-04-17,Kelantan,87,51,36,2010
2010-04-18,Kelantan,34,19,15,2010
2010-04-19,Kelantan,13,4,9,2010
2010-04-20,Kelantan,18,13,5,2010
2010-04-21,Kelantan,5,1,4,2010
2010-04-22,Kelantan,100,78,22,2010
2010-04-23,Kelantan,0,0,0,2010
2010-04-24,Kelantan,0,0,0,2010
2010-04-25,Kelantan,6,1,5,2010
2010-04-26,Kelantan,5,1,4,2010
2010-04-27,Kelantan,27,27,0,2010
2010-04-28,Kelantan,18,7,11,2010
2010-04-29,Kelantan,23,12,11,2010
2010-04-30,Kelantan,0,0,0,2010
2010-05-01,Kelantan,34,20,14,2010
2010-05-02,Kelantan,15,7,8,2010
2010-05-03,Kelantan,11,2,9,2010
2010-05-04,Kelantan,27,16,11,2010
2010-05-05,Kelantan,15,7,8,2010
2010-05-06,Kelantan,4,2,2,2010
2010-05-07,Kelantan,0,0,0,2010
2010-05-08,Kelantan,0,0,0,2010
2010-05-09,Kelantan,9,1,8,2010
2010-05-10,Kelantan,26,10,16,2010
2010-05-11,Kelantan,2,1,1,2010
2010-05-12,Kelantan,7,0,7,2010
2010-05-13,Kelantan,64,48,16,2010
2010-05-14,Kelantan,47,42,5,2010
2010-05-15,Kelantan,38,21,17,2010
2010-05-16,Kelantan,23,9,14,2010
2010-05-17,Kelantan,28,8,20,2010
2010-05-18,Kelantan,13,4,9,2010
2010-05-19,Kelantan,15,6,9,2010
2010-05-20,Kelantan,39,22,17,2010
2010-05-21,Kelantan,0,0,0,2010
2010-05-22,Kelantan,16,8,8,2010
2010-05-23,Kelantan,7,1,6,2010
2010-05-24,Kelantan,174,165,9,2010
2010-05-25,Kelantan,6,3,3,2010
2010-05-26,Kelantan,85,59,26,2010
2010-05-27,Kelantan,3,1,2,2010
2010-05-28,Kelantan,4,3,1,2010
2010-05-29,Kelantan,17,13,4,2010
2010-05-30,Kelantan,66,33,33,2010
2010-05-31,Kelantan,62,25,37,2010
2010-06-01,Kelantan,8,1,7,2010
2010-06-02,Kelantan,3,0,3,2010
2010-06-03,Kelantan,4,1,3,2010
2010-06-04,Kelantan,0,0,0,2010
2010-06-05,Kelantan,29,7,22,2010
2010-06-06,Kelantan,19,12,7,2010
2010-06-07,Kelantan,30,11,19,2010
2010-06-08,Kelantan,25,12,13,2010
2010-06-09,Kelantan,3,0,3,2010
2010-06-10,Kelantan,11,5,6,2010
2010-06-11,Kelantan,13,4,9,2010
2010-06-12,Kelantan,53,16,37,2010
2010-06-13,Kelantan,14,9,5,2010
2010-06-14,Kelantan,10,5,5,2010
2010-06-15,Kelantan,5,0,5,2010
2010-06-16,Kelantan,4,1,3,2010
2010-06-17,Kelantan,4,1,3,2010
2010-06-18,Kelantan,21,8,13,2010
2010-06-19,Kelantan,23,10,13,2010
2010-06-20,Kelantan,6,0,6,2010
2010-06-21,Kelantan,16,9,7,2010
2010-06-22,Kelantan,4,0,4,2010
2010-06-23,Kelantan,43,37,6,2010
2010-06-24,Kelantan,50,48,2,2010
2010-06-25,Kelantan,1,0,1,2010
2010-06-26,Kelantan,59,35,24,2010
2010-06-27,Kelantan,34,22,12,2010
2010-06-28,Kelantan,41,35,6,2010
2010-06-29,Kelantan,104,46,58,2010
2010-06-30,Kelantan,106,34,72,2010
2010-07-01,Kelantan,7,5,2,2010
2010-07-02,Kelantan,0,0,0,2010
2010-07-03,Kelantan,19,8,11,2010
2010-07-04,Kelantan,57,48,9,2010
2010-07-05,Kelantan,51,41,10,2010
2010-07-06,Kelantan,19,9,10,2010
2010-07-07,Kelantan,58,49,9,2010
2010-07-08,Kelantan,120,85,35,2010
2010-07-09,Kelantan,79,69,10,2010
2010-07-10,Kelantan,97,80,17,2010
2010-07-11,Kelantan,5,0,5,2010
2010-07-12,Kelantan,6,1,5,2010
2010-07-13,Kelantan,125,93,32,2010
2010-07-14,Kelantan,134,77,57,2010
2010-07-15,Kelantan,53,31,22,2010
2010-07-16,Kelantan,7,5,2,2010
2010-07-17,Kelantan,7,3,4,2010
2010-07-18,Kelantan,15,0,15,2010
2010-07-19,Kelantan,22,16,6,2010
2010-07-20,Kelantan,4,0,4,2010
2010-07-21,Kelantan,5,0,5,2010
2010-07-22,Kelantan,27,17,10,2010
2010-07-23,Kelantan,0,0,0,2010
2010-07-24,Kelantan,0,0,0,2010
2010-07-25,Kelantan,15,6,9,2010
2010-07-26,Kelantan,7,1,6,2010
2010-07-27,Kelantan,8,6,2,2010
2010-07-28,Kelantan,6,2,4,2010
2010-07-29,Kelantan,172,66,106,2010
2010-07-30,Kelantan,6,4,2,2010
2010-07-31,Kelantan,133,95,38,2010
2010-08-01,Kelantan,28,9,19,2010
2010-08-02,Kelantan,35,20,15,2010
2010-08-03,Kelantan,886,702,184,2010
2010-08-04,Kelantan,2,0,2,2010
2010-08-05,Kelantan,214,160,54,2010
2010-08-06,Kelantan,1,1,0,2010
2010-08-07,Kelantan,10,5,5,2010
2010-08-08,Kelantan,29,9,20,2010
2010-08-09,Kelantan,6,3,3,2010
2010-08-10,Kelantan,11,3,8,2010
2010-08-11,Kelantan,5,0,5,2010
2010-08-12,Kelantan,4,1,3,2010
2010-08-13,Kelantan,138,43,95,2010
2010-08-14,Kelantan,0,0,0,2010
2010-08-15,Kelantan,4,1,3,2010
2010-08-16,Kelantan,1,0,1,2010
2010-08-17,Kelantan,7,2,5,2010
2010-08-18,Kelantan,21,3,18,2010
2010-08-19,Kelantan,4,1,3,2010
2010-08-20,Kelantan,13,5,8,2010
2010-08-21,Kelantan,0,0,0,2010
2010-08-22,Kelantan,3,0,3,2010
2010-08-23,Kelantan,40,27,13,2010
2010-08-24,Kelantan,10,7,3,2010
2010-08-25,Kelantan,21,8,13,2010
2010-08-26,Kelantan,12,3,9,2010
2010-08-27,Kelantan,0,0,0,2010
2010-08-28,Kelantan,0,0,0,2010
2010-08-29,Kelantan,47,31,16,2010
2010-08-30,Kelantan,39,22,17,2010
2010-08-31,Kelantan,1,0,1,2010
2010-09-01,Kelantan,8,2,6,2010
2010-09-02,Kelantan,9,1,8,2010
2010-09-03,Kelantan,13,13,0,2010
2010-09-04,Kelantan,0,0,0,2010
2010-09-05,Kelantan,28,2,26,2010
2010-09-06,Kelantan,34,11,23,2010
2010-09-07,Kelantan,13,6,7,2010
2010-09-08,Kelantan,37,16,21,2010
2010-09-09,Kelantan,2,1,1,2010
2010-09-10,Kelantan,0,0,0,2010
2010-09-11,Kelantan,0,0,0,2010
2010-09-12,Kelantan,4,1,3,2010
2010-09-13,Kelantan,10,2,8,2010
2010-09-14,Kelantan,21,7,14,2010
2010-09-15,Kelantan,15,5,10,2010
2010-09-16,Kelantan,13,6,7,2010
2010-09-17,Kelantan,30,11,19,2010
2010-09-18,Kelantan,23,10,13,2010
2010-09-19,Kelantan,23,13,10,2010
2010-09-20,Kelantan,5,1,4,2010
2010-09-21,Kelantan,10,1,9,2010
2010-09-22,Kelantan,107,53,54,2010
2010-09-23,Kelantan,129,110,19,2010
2010-09-24,Kelantan,1,0,1,2010
2010-09-25,Kelantan,13,8,5,2010
2010-09-26,Kelantan,13,6,7,2010
2010-09-27,Kelantan,72,51,21,2010
2010-09-28,Kelantan,66,42,24,2010
2010-09-29,Kelantan,47,30,17,2010
2010-09-30,Kelantan,14,6,8,2010
2010-10-01,Kelantan,0,0,0,2010
2010-10-02,Kelantan,65,38,27,2010
2010-10-03,Kelantan,10,4,6,2010
2010-10-04,Kelantan,4,2,2,2010
2010-10-05,Kelantan,11,0,11,2010
2010-10-06,Kelantan,41,18,23,2010
2010-10-07,Kelantan,30,14,16,2010
2010-10-08,Kelantan,0,0,0,2010
2010-10-09,Kelantan,46,33,13,2010
2010-10-10,Kelantan,73,7,66,2010
2010-10-11,Kelantan,18,4,14,2010
2010-10-12,Kelantan,5,0,5,2010
2010-10-13,Kelantan,7,1,6,2010
2010-10-14,Kelantan,64,27,37,2010
2010-10-15,Kelantan,21,17,4,2010
2010-10-16,Kelantan,70,40,30,2010
2010-10-17,Kelantan,14,6,8,2010
2010-10-18,Kelantan,67,33,34,2010
2010-10-19,Kelantan,84,47,37,2010
2010-10-20,Kelantan,50,28,22,2010
2010-10-21,Kelantan,13,11,2,2010
2010-10-22,Kelantan,19,8,11,2010
2010-10-23,Kelantan,23,10,13,2010
2010-10-24,Kelantan,12,4,8,2010
2010-10-25,Kelantan,26,13,13,2010
2010-10-26,Kelantan,13,4,9,2010
2010-10-27,Kelantan,10,4,6,2010
2010-10-28,Kelantan,15,7,8,2010
2010-10-29,Kelantan,54,17,37,2010
2010-10-30,Kelantan,12,7,5,2010
2010-10-31,Kelantan,8,3,5,2010
2010-11-01,Kelantan,6,1,5,2010
2010-11-02,Kelantan,13,5,8,2010
2010-11-03,Kelantan,10,3,7,2010
2010-11-04,Kelantan,0,0,0,2010
2010-11-05,Kelantan,3,0,3,2010
2010-11-06,Kelantan,42,22,20,2010
2010-11-07,Kelantan,8,3,5,2010
2010-11-08,Kelantan,40,28,12,2010
2010-11-09,Kelantan,6,2,4,2010
2010-11-10,Kelantan,28,6,22,2010
2010-11-11,Kelantan,17,3,14,2010
2010-11-12,Kelantan,0,0,0,2010
2010-11-13,Kelantan,16,11,5,2010
2010-11-14,Kelantan,12,7,5,2010
2010-11-15,Kelantan,6,3,3,2010
2010-11-16,Kelantan,64,43,21,2010
2010-11-17,Kelantan,1,0,1,2010
2010-11-18,Kelantan,0,0,0,2010
2010-11-19,Kelantan,0,0,0,2010
2010-11-20,Kelantan,33,16,17,2010
2010-11-21,Kelantan,15,6,9,2010
2010-11-22,Kelantan,11,4,7,2010
2010-11-23,Kelantan,76,49,27,2010
2010-11-24,Kelantan,59,30,29,2010
2010-11-25,Kelantan,128,32,96,2010
2010-11-26,Kelantan,40,22,18,2010
2010-11-27,Kelantan,0,0,0,2010
2010-11-28,Kelantan,10,6,4,2010
2010-11-29,Kelantan,53,32,21,2010
2010-11-30,Kelantan,6,4,2,2010
2010-12-01,Kelantan,7,1,6,2010
2010-12-02,Kelantan,16,6,10,2010
2010-12-03,Kelantan,18,9,9,2010
2010-12-04,Kelantan,12,7,5,2010
2010-12-05,Kelantan,92,40,52,2010
2010-12-06,Kelantan,105,44,61,2010
2010-12-07,Kelantan,0,0,0,2010
2010-12-08,Kelantan,21,10,11,2010
2010-12-09,Kelantan,12,2,10,2010
2010-12-10,Kelantan,83,65,18,2010
2010-12-11,Kelantan,19,11,8,2010
2010-12-12,Kelantan,10,6,4,2010
2010-12-13,Kelantan,17,8,9,2010
2010-12-14,Kelantan,10,2,8,2010
2010-12-15,Kelantan,41,25,16,2010
2010-12-16,Kelantan,35,28,7,2010
2010-12-17,Kelantan,84,46,38,2010
2010-12-18,Kelantan,2,0,2,2010
2010-12-19,Kelantan,11,7,4,2010
2010-12-20,Kelantan,13,4,9,2010
2010-12-21,Kelantan,19,10,9,2010
2010-12-22,Kelantan,22,6,16,2010
2010-12-23,Kelantan,21,12,9,2010
2010-12-24,Kelantan,6,2,4,2010
2010-12-25,Kelantan,16,12,4,2010
2010-12-26,Kelantan,89,19,70,2010
2010-12-27,Kelantan,93,43,50,2010
2010-12-28,Kelantan,28,12,16,2010
2010-12-29,Kelantan,15,6,9,2010
2010-12-30,Kelantan,10,2,8,2010
2010-12-31,Kelantan,16,13,3,2010
2011-01-01,Kelantan,38,21,17,2011
2011-01-02,Kelantan,0,0,0,2011
2011-01-03,Kelantan,12,4,8,2011
2011-01-04,Kelantan,28,22,6,2011
2011-01-05,Kelantan,9,3,6,2011
2011-01-06,Kelantan,48,42,6,2011
2011-01-07,Kelantan,0,0,0,2011
2011-01-08,Kelantan,5,1,4,2011
2011-01-09,Kelantan,9,3,6,2011
2011-01-10,Kelantan,44,23,21,2011
2011-01-11,Kelantan,40,14,26,2011
2011-01-12,Kelantan,17,4,13,2011
2011-01-13,Kelantan,36,26,10,2011
2011-01-14,Kelantan,3,2,1,2011
2011-01-15,Kelantan,10,8,2,2011
2011-01-16,Kelantan,115,36,79,2011
2011-01-17,Kelantan,95,35,60,2011
2011-01-18,Kelantan,11,6,5,2011
2011-01-19,Kelantan,11,1,10,2011
2011-01-20,Kelantan,6,5,1,2011
2011-01-21,Kelantan,52,16,36,2011
2011-01-22,Kelantan,6,3,3,2011
2011-01-23,Kelantan,135,61,74,2011
2011-01-24,Kelantan,141,62,79,2011
2011-01-25,Kelantan,119,50,69,2011
2011-01-26,Kelantan,16,6,10,2011
2011-01-27,Kelantan,51,34,17,2011
2011-01-28,Kelantan,0,0,0,2011
2011-01-29,Kelantan,12,4,8,2011
2011-01-30,Kelantan,39,31,8,2011
2011-01-31,Kelantan,12,4,8,2011
2011-02-01,Kelantan,5,1,4,2011
2011-02-02,Kelantan,121,68,53,2011
2011-02-03,Kelantan,0,0,0,2011
2011-02-04,Kelantan,0,0,0,2011
2011-02-05,Kelantan,9,3,6,2011
2011-02-06,Kelantan,32,19,13,2011
2011-02-07,Kelantan,47,33,14,2011
2011-02-08,Kelantan,9,2,7,2011
2011-02-09,Kelantan,5,3,2,2011
2011-02-10,Kelantan,200,107,93,2011
2011-02-11,Kelantan,0,0,0,2011
2011-02-12,Kelantan,19,5,14,2011
2011-02-13,Kelantan,9,0,9,2011
2011-02-14,Kelantan,42,28,14,2011
2011-02-15,Kelantan,1,0,1,2011
2011-02-16,Kelantan,61,38,23,2011
2011-02-17,Kelantan,52,34,18,2011
2011-02-18,Kelantan,0,0,0,2011
2011-02-19,Kelantan,11,6,5,2011
2011-02-20,Kelantan,10,2,8,2011
2011-02-21,Kelantan,40,27,13,2011
2011-02-22,Kelantan,72,53,19,2011
2011-02-23,Kelantan,65,54,11,2011
2011-02-24,Kelantan,47,31,16,2011
2011-02-25,Kelantan,19,15,4,2011
2011-02-26,Kelantan,43,23,20,2011
2011-02-27,Kelantan,60,39,21,2011
2011-02-28,Kelantan,3,1,2,2011
2011-03-01,Kelantan,79,40,39,2011
2011-03-02,Kelantan,11,4,7,2011
2011-03-03,Kelantan,15,9,6,2011
2011-03-04,Kelantan,0,0,0,2011
2011-03-05,Kelantan,4,1,3,2011
2011-03-06,Kelantan,2,1,1,2011
2011-03-07,Kelantan,31,18,13,2011
2011-03-08,Kelantan,76,24,52,2011
2011-03-09,Kelantan,3,0,3,2011
2011-03-10,Kelantan,27,14,13,2011
2011-03-11,Kelantan,12,10,2,2011
2011-03-12,Kelantan,21,9,12,2011
2011-03-13,Kelantan,6,0,6,2011
2011-03-14,Kelantan,95,32,63,2011
2011-03-15,Kelantan,102,48,54,2011
2011-03-16,Kelantan,6,1,5,2011
2011-03-17,Kelantan,7,0,7,2011
2011-03-18,Kelantan,0,0,0,2011
2011-03-19,Kelantan,35,22,13,2011
2011-03-20,Kelantan,6,1,5,2011
2011-03-21,Kelantan,71,34,37,2011
2011-03-22,Kelantan,8,2,6,2011
2011-03-23,Kelantan,7,3,4,2011
2011-03-24,Kelantan,15,7,8,2011
2011-03-25,Kelantan,157,90,67,2011
2011-03-26,Kelantan,69,30,39,2011
2011-03-27,Kelantan,70,44,26,2011
2011-03-28,Kelantan,27,18,9,2011
2011-03-29,Kelantan,84,78,6,2011
2011-03-30,Kelantan,2,0,2,2011
2011-03-31,Kelantan,4,0,4,2011
2011-04-01,Kelantan,0,0,0,2011
2011-04-02,Kelantan,40,25,15,2011
2011-04-03,Kelantan,10,3,7,2011
2011-04-04,Kelantan,28,16,12,2011
2011-04-05,Kelantan,10,3,7,2011
2011-04-06,Kelantan,15,3,12,2011
2011-04-07,Kelantan,62,34,28,2011
2011-04-08,Kelantan,0,0,0,2011
2011-04-09,Kelantan,7,0,7,2011
2011-04-10,Kelantan,23,17,6,2011
2011-04-11,Kelantan,1,0,1,2011
2011-04-12,Kelantan,21,7,14,2011
2011-04-13,Kelantan,5,1,4,2011
2011-04-14,Kelantan,62,54,8,2011
2011-04-15,Kelantan,0,0,0,2011
2011-04-16,Kelantan,78,34,44,2011
2011-04-17,Kelantan,9,6,3,2011
2011-04-18,Kelantan,22,7,15,2011
2011-04-19,Kelantan,55,36,19,2011
2011-04-20,Kelantan,11,3,8,2011
2011-04-21,Kelantan,40,30,10,2011
2011-04-22,Kelantan,14,9,5,2011
2011-04-23,Kelantan,15,8,7,2011
2011-04-24,Kelantan,18,5,13,2011
2011-04-25,Kelantan,7,1,6,2011
2011-04-26,Kelantan,10,2,8,2011
2011-04-27,Kelantan,8,1,7,2011
2011-04-28,Kelantan,14,6,8,2011
2011-04-29,Kelantan,12,8,4,2011
2011-04-30,Kelantan,149,82,67,2011
2011-05-01,Kelantan,38,10,28,2011
2011-05-02,Kelantan,20,11,9,2011
2011-05-03,Kelantan,3,0,3,2011
2011-05-04,Kelantan,13,5,8,2011
2011-05-05,Kelantan,132,112,20,2011
2011-05-06,Kelantan,46,27,19,2011
2011-05-07,Kelantan,31,16,15,2011
2011-05-08,Kelantan,0,0,0,2011
2011-05-09,Kelantan,93,62,31,2011
2011-05-10,Kelantan,65,41,24,2011
2011-05-11,Kelantan,89,71,18,2011
2011-05-12,Kelantan,34,25,9,2011
2011-05-13,Kelantan,1,1,0,2011
2011-05-14,Kelantan,15,10,5,2011
2011-05-15,Kelantan,6,2,4,2011
2011-05-16,Kelantan,8,2,6,2011
2011-05-17,Kelantan,0,0,0,2011
2011-05-18,Kelantan,51,19,32,2011
2011-05-19,Kelantan,6,2,4,2011
2011-05-20,Kelantan,0,0,0,2011
2011-05-21,Kelantan,13,10,3,2011
2011-05-22,Kelantan,18,10,8,2011
2011-05-23,Kelantan,11,2,9,2011
2011-05-24,Kelantan,11,2,9,2011
2011-05-25,Kelantan,2,2,0,2011
2011-05-26,Kelantan,3,0,3,2011
2011-05-27,Kelantan,4,0,4,2011
2011-05-28,Kelantan,14,2,12,2011
2011-05-29,Kelantan,16,5,11,2011
2011-05-30,Kelantan,10,5,5,2011
2011-05-31,Kelantan,8,3,5,2011
2011-06-01,Kelantan,30,24,6,2011
2011-06-02,Kelantan,47,18,29,2011
2011-06-03,Kelantan,7,3,4,2011
2011-06-04,Kelantan,35,19,16,2011
2011-06-05,Kelantan,14,7,7,2011
2011-06-06,Kelantan,11,1,10,2011
2011-06-07,Kelantan,5,0,5,2011
2011-06-08,Kelantan,8,1,7,2011
2011-06-09,Kelantan,29,12,17,2011
2011-06-10,Kelantan,0,0,0,2011
2011-06-11,Kelantan,0,0,0,2011
2011-06-12,Kelantan,0,0,0,2011
2011-06-13,Kelantan,21,8,13,2011
2011-06-14,Kelantan,23,3,20,2011
2011-06-15,Kelantan,13,5,8,2011
2011-06-16,Kelantan,36,22,14,2011
2011-06-17,Kelantan,0,0,0,2011
2011-06-18,Kelantan,33,13,20,2011
2011-06-19,Kelantan,17,6,11,2011
2011-06-20,Kelantan,12,1,11,2011
2011-06-21,Kelantan,85,41,44,2011
2011-06-22,Kelantan,11,3,8,2011
2011-06-23,Kelantan,12,4,8,2011
2011-06-24,Kelantan,40,22,18,2011
2011-06-25,Kelantan,62,31,31,2011
2011-06-26,Kelantan,21,13,8,2011
2011-06-27,Kelantan,10,2,8,2011
2011-06-28,Kelantan,14,7,7,2011
2011-06-29,Kelantan,86,39,47,2011
2011-06-30,Kelantan,11,4,7,2011
2011-07-01,Kelantan,7,5,2,2011
2011-07-02,Kelantan,27,14,13,2011
2011-07-03,Kelantan,5,1,4,2011
2011-07-04,Kelantan,77,69,8,2011
2011-07-05,Kelantan,25,17,8,2011
2011-07-06,Kelantan,50,31,19,2011
2011-07-07,Kelantan,25,14,11,2011
2011-07-08,Kelantan,0,0,0,2011
2011-07-09,Kelantan,28,15,13,2011
2011-07-10,Kelantan,4,2,2,2011
2011-07-11,Kelantan,68,28,40,2011
2011-07-12,Kelantan,68,44,24,2011
2011-07-13,Kelantan,63,14,49,2011
2011-07-14,Kelantan,53,24,29,2011
2011-07-15,Kelantan,1,0,1,2011
2011-07-16,Kelantan,77,27,50,2011
2011-07-17,Kelantan,13,5,8,2011
2011-07-18,Kelantan,19,5,14,2011
2011-07-19,Kelantan,13,3,10,2011
2011-07-20,Kelantan,3,0,3,2011
2011-07-21,Kelantan,21,11,10,2011
2011-07-22,Kelantan,0,0,0,2011
2011-07-23,Kelantan,33,19,14,2011
2011-07-24,Kelantan,7,1,6,2011
2011-07-25,Kelantan,30,18,12,2011
2011-07-26,Kelantan,13,2,11,2011
2011-07-27,Kelantan,7,2,5,2011
2011-07-28,Kelantan,46,17,29,2011
2011-07-29,Kelantan,14,9,5,2011
2011-07-30,Kelantan,11,6,5,2011
2011-07-31,Kelantan,16,5,11,2011
2011-08-01,Kelantan,4,2,2,2011
2011-08-02,Kelantan,3,0,3,2011
2011-08-03,Kelantan,0,0,0,2011
2011-08-04,Kelantan,14,9,5,2011
2011-08-05,Kelantan,0,0,0,2011
2011-08-06,Kelantan,0,0,0,2011
2011-08-07,Kelantan,11,1,10,2011
2011-08-08,Kelantan,42,15,27,2011
2011-08-09,Kelantan,20,7,13,2011
2011-08-10,Kelantan,61,47,14,2011
2011-08-11,Kelantan,8,5,3,2011
2011-08-12,Kelantan,0,0,0,2011
2011-08-13,Kelantan,0,0,0,2011
2011-08-14,Kelantan,7,4,3,2011
2011-08-15,Kelantan,70,59,11,2011
2011-08-16,Kelantan,32,20,12,2011
2011-08-17,Kelantan,0,0,0,2011
2011-08-18,Kelantan,22,16,6,2011
2011-08-19,Kelantan,0,0,0,2011
2011-08-20,Kelantan,0,0,0,2011
2011-08-21,Kelantan,6,3,3,2011
2011-08-22,Kelantan,24,7,17,2011
2011-08-23,Kelantan,41,25,16,2011
2011-08-24,Kelantan,11,5,6,2011
2011-08-25,Kelantan,6,2,4,2011
2011-08-26,Kelantan,0,0,0,2011
2011-08-27,Kelantan,0,0,0,2011
2011-08-28,Kelantan,21,8,13,2011
2011-08-29,Kelantan,10,3,7,2011
2011-08-30,Kelantan,0,0,0,2011
2011-08-31,Kelantan,0,0,0,2011
2011-09-01,Kelantan,26,18,8,2011
2011-09-02,Kelantan,9,6,3,2011
2011-09-03,Kelantan,29,6,23,2011
2011-09-04,Kelantan,21,7,14,2011
2011-09-05,Kelantan,32,16,16,2011
2011-09-06,Kelantan,131,86,45,2011
2011-09-07,Kelantan,56,18,38,2011
2011-09-08,Kelantan,60,35,25,2011
2011-09-09,Kelantan,0,0,0,2011
2011-09-10,Kelantan,0,0,0,2011
2011-09-11,Kelantan,17,8,9,2011
2011-09-12,Kelantan,7,1,6,2011
2011-09-13,Kelantan,864,688,176,2011
2011-09-14,Kelantan,14,5,9,2011
2011-09-15,Kelantan,6,2,4,2011
2011-09-16,Kelantan,35,24,11,2011
2011-09-17,Kelantan,24,7,17,2011
2011-09-18,Kelantan,21,8,13,2011
2011-09-19,Kelantan,74,25,49,2011
2011-09-20,Kelantan,1,0,1,2011
2011-09-21,Kelantan,35,12,23,2011
2011-09-22,Kelantan,4,0,4,2011
2011-09-23,Kelantan,32,16,16,2011
2011-09-24,Kelantan,0,0,0,2011
2011-09-25,Kelantan,55,35,20,2011
2011-09-26,Kelantan,35,22,13,2011
2011-09-27,Kelantan,6,1,5,2011
2011-09-28,Kelantan,11,6,5,2011
2011-09-29,Kelantan,71,59,12,2011
2011-09-30,Kelantan,0,0,0,2011
2011-10-01,Kelantan,8,5,3,2011
2011-10-02,Kelantan,13,4,9,2011
2011-10-03,Kelantan,74,20,54,2011
2011-10-04,Kelantan,49,16,33,2011
2011-10-05,Kelantan,14,7,7,2011
2011-10-06,Kelantan,131,86,45,2011
2011-10-07,Kelantan,0,0,0,2011
2011-10-08,Kelantan,21,14,7,2011
2011-10-09,Kelantan,6,1,5,2011
2011-10-10,Kelantan,15,6,9,2011
2011-10-11,Kelantan,9,2,7,2011
2011-10-12,Kelantan,59,21,38,2011
2011-10-13,Kelantan,151,60,91,2011
2011-10-14,Kelantan,0,0,0,2011
2011-10-15,Kelantan,12,6,6,2011
2011-10-16,Kelantan,36,8,28,2011
2011-10-17,Kelantan,16,12,4,2011
2011-10-18,Kelantan,87,16,71,2011
2011-10-19,Kelantan,50,8,42,2011
2011-10-20,Kelantan,148,53,95,2011
2011-10-21,Kelantan,59,20,39,2011
2011-10-22,Kelantan,0,0,0,2011
2011-10-23,Kelantan,6,0,6,2011
2011-10-24,Kelantan,7,4,3,2011
2011-10-25,Kelantan,10,5,5,2011
2011-10-26,Kelantan,15,11,4,2011
2011-10-27,Kelantan,21,12,9,2011
2011-10-28,Kelantan,20,10,10,2011
2011-10-29,Kelantan,22,9,13,2011
2011-10-30,Kelantan,5,1,4,2011
2011-10-31,Kelantan,6,2,4,2011
2011-11-01,Kelantan,38,11,27,2011
2011-11-02,Kelantan,24,15,9,2011
2011-11-03,Kelantan,10,1,9,2011
2011-11-04,Kelantan,8,4,4,2011
2011-11-05,Kelantan,17,10,7,2011
2011-11-06,Kelantan,0,0,0,2011
2011-11-07,Kelantan,0,0,0,2011
2011-11-08,Kelantan,26,14,12,2011
2011-11-09,Kelantan,26,16,10,2011
2011-11-10,Kelantan,53,26,27,2011
2011-11-11,Kelantan,64,55,9,2011
2011-11-12,Kelantan,55,34,21,2011
2011-11-13,Kelantan,25,12,13,2011
2011-11-14,Kelantan,23,12,11,2011
2011-11-15,Kelantan,72,52,20,2011
2011-11-16,Kelantan,32,17,15,2011
2011-11-17,Kelantan,67,32,35,2011
2011-11-18,Kelantan,0,0,0,2011
2011-11-19,Kelantan,73,35,38,2011
2011-11-20,Kelantan,6,3,3,2011
2011-11-21,Kelantan,32,5,27,2011
2011-11-22,Kelantan,39,19,20,2011
2011-11-23,Kelantan,27,20,7,2011
2011-11-24,Kelantan,5,2,3,2011
2011-11-25,Kelantan,0,0,0,2011
2011-11-26,Kelantan,29,16,13,2011
2011-11-27,Kelantan,0,0,0,2011
2011-11-28,Kelantan,59,25,34,2011
2011-11-29,Kelantan,3,1,2,2011
2011-11-30,Kelantan,57,30,27,2011
2011-12-01,Kelantan,26,13,13,2011
2011-12-02,Kelantan,4,1,3,2011
2011-12-03,Kelantan,1,1,0,2011
2011-12-04,Kelantan,95,60,35,2011
2011-12-05,Kelantan,70,51,19,2011
2011-12-06,Kelantan,10,2,8,2011
2011-12-07,Kelantan,13,6,7,2011
2011-12-08,Kelantan,8,4,4,2011
2011-12-09,Kelantan,0,0,0,2011
2011-12-10,Kelantan,57,39,18,2011
2011-12-11,Kelantan,14,7,7,2011
2011-12-12,Kelantan,11,6,5,2011
2011-12-13,Kelantan,31,21,10,2011
2011-12-14,Kelantan,36,14,22,2011
2011-12-15,Kelantan,20,8,12,2011
2011-12-16,Kelantan,27,20,7,2011
2011-12-17,Kelantan,14,10,4,2011
2011-12-18,Kelantan,25,16,9,2011
2011-12-19,Kelantan,3,0,3,2011
2011-12-20,Kelantan,13,2,11,2011
2011-12-21,Kelantan,10,6,4,2011
2011-12-22,Kelantan,9,1,8,2011
2011-12-23,Kelantan,0,0,0,2011
2011-12-24,Kelantan,48,27,21,2011
2011-12-25,Kelantan,35,19,16,2011
2011-12-26,Kelantan,15,6,9,2011
2011-12-27,Kelantan,24,6,18,2011
2011-12-28,Kelantan,49,18,31,2011
2011-12-29,Kelantan,15,9,6,2011
2011-12-30,Kelantan,7,3,4,2011
2011-12-31,Kelantan,19,10,9,2011
2012-01-01,Kelantan,74,33,41,2012
2012-01-02,Kelantan,8,3,5,2012
2012-01-03,Kelantan,7,2,5,2012
2012-01-04,Kelantan,7,3,4,2012
2012-01-05,Kelantan,38,29,9,2012
2012-01-06,Kelantan,0,0,0,2012
2012-01-07,Kelantan,30,11,19,2012
2012-01-08,Kelantan,35,27,8,2012
2012-01-09,Kelantan,6,1,5,2012
2012-01-10,Kelantan,88,42,46,2012
2012-01-11,Kelantan,149,61,88,2012
2012-01-12,Kelantan,98,41,57,2012
2012-01-13,Kelantan,0,0,0,2012
2012-01-14,Kelantan,18,11,7,2012
2012-01-15,Kelantan,16,5,11,2012
2012-01-16,Kelantan,8,2,6,2012
2012-01-17,Kelantan,13,2,11,2012
2012-01-18,Kelantan,11,1,10,2012
2012-01-19,Kelantan,67,42,25,2012
2012-01-20,Kelantan,31,15,16,2012
2012-01-21,Kelantan,0,0,0,2012
2012-01-22,Kelantan,12,0,12,2012
2012-01-23,Kelantan,0,0,0,2012
2012-01-24,Kelantan,0,0,0,2012
2012-01-25,Kelantan,15,4,11,2012
2012-01-26,Kelantan,19,7,12,2012
2012-01-27,Kelantan,0,0,0,2012
2012-01-28,Kelantan,77,36,41,2012
2012-01-29,Kelantan,57,30,27,2012
2012-01-30,Kelantan,41,17,24,2012
2012-01-31,Kelantan,24,14,10,2012
2012-02-01,Kelantan,87,76,11,2012
2012-02-02,Kelantan,124,108,16,2012
2012-02-03,Kelantan,17,8,9,2012
2012-02-04,Kelantan,18,8,10,2012
2012-02-05,Kelantan,0,0,0,2012
2012-02-06,Kelantan,15,8,7,2012
2012-02-07,Kelantan,12,7,5,2012
2012-02-08,Kelantan,13,7,6,2012
2012-02-09,Kelantan,7,3,4,2012
2012-02-10,Kelantan,39,20,19,2012
2012-02-11,Kelantan,0,0,0,2012
2012-02-12,Kelantan,36,13,23,2012
2012-02-13,Kelantan,9,2,7,2012
2012-02-14,Kelantan,8,1,7,2012
2012-02-15,Kelantan,21,11,10,2012
2012-02-16,Kelantan,14,11,3,2012
2012-02-17,Kelantan,0,0,0,2012
2012-02-18,Kelantan,59,30,29,2012
2012-02-19,Kelantan,32,19,13,2012
2012-02-20,Kelantan,3,1,2,2012
2012-02-21,Kelantan,48,36,12,2012
2012-02-22,Kelantan,15,7,8,2012
2012-02-23,Kelantan,189,73,116,2012
2012-02-24,Kelantan,22,4,18,2012
2012-02-25,Kelantan,0,0,0,2012
2012-02-26,Kelantan,10,2,8,2012
2012-02-27,Kelantan,3,0,3,2012
2012-02-28,Kelantan,118,44,74,2012
2012-02-29,Kelantan,3,0,3,2012
2012-03-01,Kelantan,3,0,3,2012
2012-03-02,Kelantan,26,10,16,2012
2012-03-03,Kelantan,5,1,4,2012
2012-03-04,Kelantan,9,5,4,2012
2012-03-05,Kelantan,8,1,7,2012
2012-03-06,Kelantan,7,1,6,2012
2012-03-07,Kelantan,10,2,8,2012
2012-03-08,Kelantan,7,3,4,2012
2012-03-09,Kelantan,1,0,1,2012
2012-03-10,Kelantan,130,60,70,2012
2012-03-11,Kelantan,13,2,11,2012
2012-03-12,Kelantan,6,0,6,2012
2012-03-13,Kelantan,58,33,25,2012
2012-03-14,Kelantan,38,25,13,2012
2012-03-15,Kelantan,28,9,19,2012
2012-03-16,Kelantan,0,0,0,2012
2012-03-17,Kelantan,0,0,0,2012
2012-03-18,Kelantan,10,1,9,2012
2012-03-19,Kelantan,40,12,28,2012
2012-03-20,Kelantan,19,5,14,2012
2012-03-21,Kelantan,4,1,3,2012
2012-03-22,Kelantan,5,0,5,2012
2012-03-23,Kelantan,11,4,7,2012
2012-03-24,Kelantan,20,7,13,2012
2012-03-25,Kelantan,39,23,16,2012
2012-03-26,Kelantan,6,0,6,2012
2012-03-27,Kelantan,29,14,15,2012
2012-03-28,Kelantan,106,75,31,2012
2012-03-29,Kelantan,52,33,19,2012
2012-03-30,Kelantan,36,25,11,2012
2012-03-31,Kelantan,18,9,9,2012
2012-04-01,Kelantan,15,1,14,2012
2012-04-02,Kelantan,18,12,6,2012
2012-04-03,Kelantan,24,16,8,2012
2012-04-04,Kelantan,26,15,11,2012
2012-04-05,Kelantan,14,2,12,2012
2012-04-06,Kelantan,16,9,7,2012
2012-04-07,Kelantan,6,3,3,2012
2012-04-08,Kelantan,6,1,5,2012
2012-04-09,Kelantan,118,68,50,2012
2012-04-10,Kelantan,11,4,7,2012
2012-04-11,Kelantan,0,0,0,2012
2012-04-12,Kelantan,11,2,9,2012
2012-04-13,Kelantan,48,27,21,2012
2012-04-14,Kelantan,13,7,6,2012
2012-04-15,Kelantan,59,29,30,2012
2012-04-16,Kelantan,6,1,5,2012
2012-04-17,Kelantan,12,2,10,2012
2012-04-18,Kelantan,43,22,21,2012
2012-04-19,Kelantan,32,26,6,2012
2012-04-20,Kelantan,0,0,0,2012
2012-04-21,Kelantan,37,18,19,2012
2012-04-22,Kelantan,14,5,9,2012
2012-04-23,Kelantan,9,2,7,2012
2012-04-24,Kelantan,8,2,6,2012
2012-04-25,Kelantan,6,4,2,2012
2012-04-26,Kelantan,3,1,2,2012
2012-04-27,Kelantan,0,0,0,2012
2012-04-28,Kelantan,55,23,32,2012
2012-04-29,Kelantan,20,8,12,2012
2012-04-30,Kelantan,9,0,9,2012
2012-05-01,Kelantan,10,7,3,2012
2012-05-02,Kelantan,70,48,22,2012
2012-05-03,Kelantan,5,2,3,2012
2012-05-04,Kelantan,14,5,9,2012
2012-05-05,Kelantan,27,15,12,2012
2012-05-06,Kelantan,0,0,0,2012
2012-05-07,Kelantan,17,7,10,2012
2012-05-08,Kelantan,103,77,26,2012
2012-05-09,Kelantan,99,80,19,2012
2012-05-10,Kelantan,4,0,4,2012
2012-05-11,Kelantan,22,10,12,2012
2012-05-12,Kelantan,54,20,34,2012
2012-05-13,Kelantan,149,99,50,2012
2012-05-14,Kelantan,7,1,6,2012
2012-05-15,Kelantan,13,3,10,2012
2012-05-16,Kelantan,5,1,4,2012
2012-05-17,Kelantan,34,18,16,2012
2012-05-18,Kelantan,0,0,0,2012
2012-05-19,Kelantan,14,12,2,2012
2012-05-20,Kelantan,0,0,0,2012
2012-05-21,Kelantan,7,1,6,2012
2012-05-22,Kelantan,17,2,15,2012
2012-05-23,Kelantan,12,6,6,2012
2012-05-24,Kelantan,4,0,4,2012
2012-05-25,Kelantan,12,4,8,2012
2012-05-26,Kelantan,9,4,5,2012
2012-05-27,Kelantan,54,29,25,2012
2012-05-28,Kelantan,9,4,5,2012
2012-05-29,Kelantan,6,4,2,2012
2012-05-30,Kelantan,7,1,6,2012
2012-05-31,Kelantan,5,3,2,2012
2012-06-01,Kelantan,0,0,0,2012
2012-06-02,Kelantan,9,4,5,2012
2012-06-03,Kelantan,0,0,0,2012
2012-06-04,Kelantan,12,6,6,2012
2012-06-05,Kelantan,3,0,3,2012
2012-06-06,Kelantan,4,0,4,2012
2012-06-07,Kelantan,3,1,2,2012
2012-06-08,Kelantan,24,9,15,2012
2012-06-09,Kelantan,0,0,0,2012
2012-06-10,Kelantan,3,1,2,2012
2012-06-11,Kelantan,42,26,16,2012
2012-06-12,Kelantan,98,57,41,2012
2012-06-13,Kelantan,94,46,48,2012
2012-06-14,Kelantan,66,22,44,2012
2012-06-15,Kelantan,0,0,0,2012
2012-06-16,Kelantan,29,19,10,2012
2012-06-17,Kelantan,7,0,7,2012
2012-06-18,Kelantan,32,21,11,2012
2012-06-19,Kelantan,13,3,10,2012
2012-06-20,Kelantan,2,0,2,2012
2012-06-21,Kelantan,4,0,4,2012
2012-06-22,Kelantan,19,8,11,2012
2012-06-23,Kelantan,50,25,25,2012
2012-06-24,Kelantan,31,13,18,2012
2012-06-25,Kelantan,11,1,10,2012
2012-06-26,Kelantan,9,1,8,2012
2012-06-27,Kelantan,5,1,4,2012
2012-06-28,Kelantan,112,40,72,2012
2012-06-29,Kelantan,0,0,0,2012
2012-06-30,Kelantan,0,0,0,2012
2012-07-01,Kelantan,12,2,10,2012
2012-07-02,Kelantan,55,25,30,2012
2012-07-03,Kelantan,38,16,22,2012
2012-07-04,Kelantan,5,0,5,2012
2012-07-05,Kelantan,29,22,7,2012
2012-07-06,Kelantan,7,6,1,2012
2012-07-07,Kelantan,42,32,10,2012
2012-07-08,Kelantan,14,5,9,2012
2012-07-09,Kelantan,36,14,22,2012
2012-07-10,Kelantan,41,29,12,2012
2012-07-11,Kelantan,17,8,9,2012
2012-07-12,Kelantan,61,28,33,2012
2012-07-13,Kelantan,0,0,0,2012
2012-07-14,Kelantan,47,14,33,2012
2012-07-15,Kelantan,83,60,23,2012
2012-07-16,Kelantan,22,13,9,2012
2012-07-17,Kelantan,12,0,12,2012
2012-07-18,Kelantan,39,14,25,2012
2012-07-19,Kelantan,133,58,75,2012
2012-07-20,Kelantan,0,0,0,2012
2012-07-21,Kelantan,0,0,0,2012
2012-07-22,Kelantan,0,0,0,2012
2012-07-23,Kelantan,3,0,3,2012
2012-07-24,Kelantan,1,0,1,2012
2012-07-25,Kelantan,0,0,0,2012
2012-07-26,Kelantan,1,0,1,2012
2012-07-27,Kelantan,155,56,99,2012
2012-07-28,Kelantan,0,0,0,2012
2012-07-29,Kelantan,0,0,0,2012
2012-07-30,Kelantan,0,0,0,2012
2012-07-31,Kelantan,39,23,16,2012
2012-08-01,Kelantan,7,3,4,2012
2012-08-02,Kelantan,10,4,6,2012
2012-08-03,Kelantan,0,0,0,2012
2012-08-04,Kelantan,0,0,0,2012
2012-08-05,Kelantan,7,4,3,2012
2012-08-06,Kelantan,0,0,0,2012
2012-08-07,Kelantan,34,16,18,2012
2012-08-08,Kelantan,27,13,14,2012
2012-08-09,Kelantan,21,16,5,2012
2012-08-10,Kelantan,0,0,0,2012
2012-08-11,Kelantan,0,0,0,2012
2012-08-12,Kelantan,21,7,14,2012
2012-08-13,Kelantan,8,0,8,2012
2012-08-14,Kelantan,12,5,7,2012
2012-08-15,Kelantan,18,6,12,2012
2012-08-16,Kelantan,20,3,17,2012
2012-08-17,Kelantan,3,0,3,2012
2012-08-18,Kelantan,1,1,0,2012
2012-08-19,Kelantan,0,0,0,2012
2012-08-20,Kelantan,0,0,0,2012
2012-08-21,Kelantan,12,3,9,2012
2012-08-22,Kelantan,8,1,7,2012
2012-08-23,Kelantan,26,6,20,2012
2012-08-24,Kelantan,0,0,0,2012
2012-08-25,Kelantan,0,0,0,2012
2012-08-26,Kelantan,9,2,7,2012
2012-08-27,Kelantan,14,6,8,2012
2012-08-28,Kelantan,20,3,17,2012
2012-08-29,Kelantan,20,5,15,2012
2012-08-30,Kelantan,44,23,21,2012
2012-08-31,Kelantan,0,0,0,2012
2012-09-01,Kelantan,0,0,0,2012
2012-09-02,Kelantan,22,9,13,2012
2012-09-03,Kelantan,51,31,20,2012
2012-09-04,Kelantan,16,4,12,2012
2012-09-05,Kelantan,5,2,3,2012
2012-09-06,Kelantan,56,28,28,2012
2012-09-07,Kelantan,7,1,6,2012
2012-09-08,Kelantan,3,3,0,2012
2012-09-09,Kelantan,12,4,8,2012
2012-09-10,Kelantan,9,3,6,2012
2012-09-11,Kelantan,473,162,311,2012
2012-09-12,Kelantan,5,2,3,2012
2012-09-13,Kelantan,23,15,8,2012
2012-09-14,Kelantan,0,0,0,2012
2012-09-15,Kelantan,28,14,14,2012
2012-09-16,Kelantan,0,0,0,2012
2012-09-17,Kelantan,5,0,5,2012
2012-09-18,Kelantan,9,1,8,2012
2012-09-19,Kelantan,41,18,23,2012
2012-09-20,Kelantan,37,17,20,2012
2012-09-21,Kelantan,0,0,0,2012
2012-09-22,Kelantan,7,1,6,2012
2012-09-23,Kelantan,7,3,4,2012
2012-09-24,Kelantan,32,14,18,2012
2012-09-25,Kelantan,15,9,6,2012
2012-09-26,Kelantan,8,0,8,2012
2012-09-27,Kelantan,8,2,6,2012
2012-09-28,Kelantan,0,0,0,2012
2012-09-29,Kelantan,0,0,0,2012
2012-09-30,Kelantan,10,1,9,2012
2012-10-01,Kelantan,9,0,9,2012
2012-10-02,Kelantan,8,3,5,2012
2012-10-03,Kelantan,5,0,5,2012
2012-10-04,Kelantan,2,0,2,2012
2012-10-05,Kelantan,62,19,43,2012
2012-10-06,Kelantan,26,9,17,2012
2012-10-07,Kelantan,8,1,7,2012
2012-10-08,Kelantan,23,3,20,2012
2012-10-09,Kelantan,3,0,3,2012
2012-10-10,Kelantan,7,2,5,2012
2012-10-11,Kelantan,13,4,9,2012
2012-10-12,Kelantan,17,4,13,2012
2012-10-13,Kelantan,0,0,0,2012
2012-10-14,Kelantan,51,24,27,2012
2012-10-15,Kelantan,6,0,6,2012
2012-10-16,Kelantan,8,0,8,2012
2012-10-17,Kelantan,29,15,14,2012
2012-10-18,Kelantan,81,35,46,2012
2012-10-19,Kelantan,30,20,10,2012
2012-10-20,Kelantan,2,1,1,2012
2012-10-21,Kelantan,0,0,0,2012
2012-10-22,Kelantan,5,0,5,2012
2012-10-23,Kelantan,14,5,9,2012
2012-10-24,Kelantan,17,10,7,2012
2012-10-25,Kelantan,17,5,12,2012
2012-10-26,Kelantan,0,0,0,2012
2012-10-27,Kelantan,0,0,0,2012
2012-10-28,Kelantan,45,29,16,2012
2012-10-29,Kelantan,45,17,28,2012
2012-10-30,Kelantan,25,11,14,2012
2012-10-31,Kelantan,48,16,32,2012
2012-11-01,Kelantan,14,2,12,2012
2012-11-02,Kelantan,0,0,0,2012
2012-11-03,Kelantan,87,56,31,2012
2012-11-04,Kelantan,19,7,12,2012
2012-11-05,Kelantan,14,7,7,2012
2012-11-06,Kelantan,4,0,4,2012
2012-11-07,Kelantan,8,0,8,2012
2012-11-08,Kelantan,10,4,6,2012
2012-11-09,Kelantan,0,0,0,2012
2012-11-10,Kelantan,43,21,22,2012
2012-11-11,Kelantan,19,7,12,2012
2012-11-12,Kelantan,23,13,10,2012
2012-11-13,Kelantan,0,0,0,2012
2012-11-14,Kelantan,16,4,12,2012
2012-11-15,Kelantan,0,0,0,2012
2012-11-16,Kelantan,18,6,12,2012
2012-11-17,Kelantan,21,10,11,2012
2012-11-18,Kelantan,10,6,4,2012
2012-11-19,Kelantan,46,21,25,2012
2012-11-20,Kelantan,50,23,27,2012
2012-11-21,Kelantan,14,3,11,2012
2012-11-22,Kelantan,7,3,4,2012
2012-11-23,Kelantan,0,0,0,2012
2012-11-24,Kelantan,51,21,30,2012
2012-11-25,Kelantan,21,13,8,2012
2012-11-26,Kelantan,82,33,49,2012
2012-11-27,Kelantan,34,10,24,2012
2012-11-28,Kelantan,38,19,19,2012
2012-11-29,Kelantan,28,11,17,2012
2012-11-30,Kelantan,29,16,13,2012
2012-12-01,Kelantan,31,11,20,2012
2012-12-02,Kelantan,27,8,19,2012
2012-12-03,Kelantan,33,19,14,2012
2012-12-04,Kelantan,19,9,10,2012
2012-12-05,Kelantan,33,7,26,2012
2012-12-06,Kelantan,44,18,26,2012
2012-12-07,Kelantan,32,15,17,2012
2012-12-08,Kelantan,22,13,9,2012
2012-12-09,Kelantan,30,13,17,2012
2012-12-10,Kelantan,32,19,13,2012
2012-12-11,Kelantan,46,22,24,2012
2012-12-12,Kelantan,46,24,22,2012
2012-12-13,Kelantan,58,27,31,2012
2012-12-14,Kelantan,63,39,24,2012
2012-12-15,Kelantan,0,0,0,2012
2012-12-16,Kelantan,20,4,16,2012
2012-12-17,Kelantan,19,8,11,2012
2012-12-18,Kelantan,25,10,15,2012
2012-12-19,Kelantan,21,8,13,2012
2012-12-20,Kelantan,3,0,3,2012
2012-12-21,Kelantan,28,15,13,2012
2012-12-22,Kelantan,19,7,12,2012
2012-12-23,Kelantan,5,1,4,2012
2012-12-24,Kelantan,29,14,15,2012
2012-12-25,Kelantan,57,23,34,2012
2012-12-26,Kelantan,25,14,11,2012
2012-12-27,Kelantan,27,10,17,2012
2012-12-28,Kelantan,25,8,17,2012
2012-12-29,Kelantan,50,13,37,2012
2012-12-30,Kelantan,15,3,12,2012
2012-12-31,Kelantan,8,1,7,2012
2013-01-01,Kelantan,73,18,55,2013
2013-01-02,Kelantan,12,3,9,2013
2013-01-03,Kelantan,8,2,6,2013
2013-01-04,Kelantan,34,19,15,2013
2013-01-05,Kelantan,0,0,0,2013
2013-01-06,Kelantan,46,34,12,2013
2013-01-07,Kelantan,5,0,5,2013
2013-01-08,Kelantan,6,0,6,2013
2013-01-09,Kelantan,7,2,5,2013
2013-01-10,Kelantan,49,33,16,2013
2013-01-11,Kelantan,0,0,0,2013
2013-01-12,Kelantan,0,0,0,2013
2013-01-13,Kelantan,31,12,19,2013
2013-01-14,Kelantan,44,17,27,2013
2013-01-15,Kelantan,102,65,37,2013
2013-01-16,Kelantan,116,74,42,2013
2013-01-17,Kelantan,11,4,7,2013
2013-01-18,Kelantan,0,0,0,2013
2013-01-19,Kelantan,0,0,0,2013
2013-01-20,Kelantan,4,2,2,2013
2013-01-21,Kelantan,33,19,14,2013
2013-01-22,Kelantan,53,30,23,2013
2013-01-23,Kelantan,10,1,9,2013
2013-01-24,Kelantan,8,3,5,2013
2013-01-25,Kelantan,0,0,0,2013
2013-01-26,Kelantan,0,0,0,2013
2013-01-27,Kelantan,36,17,19,2013
2013-01-28,Kelantan,5,0,5,2013
2013-01-29,Kelantan,37,22,15,2013
2013-01-30,Kelantan,36,24,12,2013
2013-01-31,Kelantan,62,42,20,2013
2013-02-01,Kelantan,0,0,0,2013
2013-02-02,Kelantan,0,0,0,2013
2013-02-03,Kelantan,8,1,7,2013
2013-02-04,Kelantan,49,15,34,2013
2013-02-05,Kelantan,31,17,14,2013
2013-02-06,Kelantan,13,11,2,2013
2013-02-07,Kelantan,51,47,4,2013
2013-02-08,Kelantan,11,6,5,2013
2013-02-09,Kelantan,29,18,11,2013
2013-02-10,Kelantan,16,5,11,2013
2013-02-11,Kelantan,10,1,9,2013
2013-02-12,Kelantan,17,1,16,2013
2013-02-13,Kelantan,43,32,11,2013
2013-02-14,Kelantan,3,1,2,2013
2013-02-15,Kelantan,0,0,0,2013
2013-02-16,Kelantan,0,0,0,2013
2013-02-17,Kelantan,38,28,10,2013
2013-02-18,Kelantan,31,21,10,2013
2013-02-19,Kelantan,41,25,16,2013
2013-02-20,Kelantan,53,50,3,2013
2013-02-21,Kelantan,145,75,70,2013
2013-02-22,Kelantan,0,0,0,2013
2013-02-23,Kelantan,39,25,14,2013
2013-02-24,Kelantan,8,4,4,2013
2013-02-25,Kelantan,91,42,49,2013
2013-02-26,Kelantan,55,21,34,2013
2013-02-27,Kelantan,9,3,6,2013
2013-02-28,Kelantan,4,2,2,2013
2013-03-01,Kelantan,0,0,0,2013
2013-03-02,Kelantan,0,0,0,2013
2013-03-03,Kelantan,26,20,6,2013
2013-03-04,Kelantan,10,3,7,2013
2013-03-05,Kelantan,8,1,7,2013
2013-03-06,Kelantan,10,1,9,2013
2013-03-07,Kelantan,9,2,7,2013
2013-03-08,Kelantan,7,6,1,2013
2013-03-09,Kelantan,79,72,7,2013
2013-03-10,Kelantan,58,31,27,2013
2013-03-11,Kelantan,8,1,7,2013
2013-03-12,Kelantan,29,14,15,2013
2013-03-13,Kelantan,7,2,5,2013
2013-03-14,Kelantan,9,0,9,2013
2013-03-15,Kelantan,33,9,24,2013
2013-03-16,Kelantan,59,26,33,2013
2013-03-17,Kelantan,11,0,11,2013
2013-03-18,Kelantan,6,3,3,2013
2013-03-19,Kelantan,4,1,3,2013
2013-03-20,Kelantan,31,12,19,2013
2013-03-21,Kelantan,8,1,7,2013
2013-03-22,Kelantan,48,18,30,2013
2013-03-23,Kelantan,90,44,46,2013
2013-03-24,Kelantan,33,10,23,2013
2013-03-25,Kelantan,33,11,22,2013
2013-03-26,Kelantan,57,17,40,2013
2013-03-27,Kelantan,51,20,31,2013
2013-03-28,Kelantan,3,0,3,2013
2013-03-29,Kelantan,51,22,29,2013
2013-03-30,Kelantan,0,0,0,2013
2013-03-31,Kelantan,6,3,3,2013
2013-04-01,Kelantan,9,3,6,2013
2013-04-02,Kelantan,37,27,10,2013
2013-04-03,Kelantan,27,20,7,2013
2013-04-04,Kelantan,12,1,11,2013
2013-04-05,Kelantan,41,12,29,2013
2013-04-06,Kelantan,53,27,26,2013
2013-04-07,Kelantan,53,24,29,2013
2013-04-08,Kelantan,30,13,17,2013
2013-04-09,Kelantan,27,12,15,2013
2013-04-10,Kelantan,5,0,5,2013
2013-04-11,Kelantan,24,4,20,2013
2013-04-12,Kelantan,0,0,0,2013
2013-04-13,Kelantan,16,10,6,2013
2013-04-14,Kelantan,9,3,6,2013
2013-04-15,Kelantan,9,2,7,2013
2013-04-16,Kelantan,43,10,33,2013
2013-04-17,Kelantan,32,13,19,2013
2013-04-18,Kelantan,21,9,12,2013
2013-04-19,Kelantan,4,1,3,2013
2013-04-20,Kelantan,12,4,8,2013
2013-04-21,Kelantan,16,4,12,2013
2013-04-22,Kelantan,11,3,8,2013
2013-04-23,Kelantan,38,29,9,2013
2013-04-24,Kelantan,111,49,62,2013
2013-04-25,Kelantan,45,16,29,2013
2013-04-26,Kelantan,20,7,13,2013
2013-04-27,Kelantan,0,0,0,2013
2013-04-28,Kelantan,6,1,5,2013
2013-04-29,Kelantan,23,13,10,2013
2013-04-30,Kelantan,8,0,8,2013
2013-05-01,Kelantan,20,9,11,2013
2013-05-02,Kelantan,9,3,6,2013
2013-05-03,Kelantan,8,4,4,2013
2013-05-04,Kelantan,15,9,6,2013
2013-05-05,Kelantan,0,0,0,2013
2013-05-06,Kelantan,8,4,4,2013
2013-05-07,Kelantan,13,4,9,2013
2013-05-08,Kelantan,10,4,6,2013
2013-05-09,Kelantan,53,20,33,2013
2013-05-10,Kelantan,30,14,16,2013
2013-05-11,Kelantan,29,13,16,2013
2013-05-12,Kelantan,25,9,16,2013
2013-05-13,Kelantan,73,39,34,2013
2013-05-14,Kelantan,134,102,32,2013
2013-05-15,Kelantan,87,63,24,2013
2013-05-16,Kelantan,6,1,5,2013
2013-05-17,Kelantan,19,13,6,2013
2013-05-18,Kelantan,37,14,23,2013
2013-05-19,Kelantan,11,3,8,2013
2013-05-20,Kelantan,2,0,2,2013
2013-05-21,Kelantan,16,8,8,2013
2013-05-22,Kelantan,10,7,3,2013
2013-05-23,Kelantan,64,36,28,2013
2013-05-24,Kelantan,22,11,11,2013
2013-05-25,Kelantan,19,9,10,2013
2013-05-26,Kelantan,1,0,1,2013
2013-05-27,Kelantan,37,14,23,2013
2013-05-28,Kelantan,8,3,5,2013
2013-05-29,Kelantan,6,1,5,2013
2013-05-30,Kelantan,5,2,3,2013
2013-05-31,Kelantan,26,8,18,2013
2013-06-01,Kelantan,31,17,14,2013
2013-06-02,Kelantan,0,0,0,2013
2013-06-03,Kelantan,14,6,8,2013
2013-06-04,Kelantan,13,4,9,2013
2013-06-05,Kelantan,15,2,13,2013
2013-06-06,Kelantan,34,14,20,2013
2013-06-07,Kelantan,21,13,8,2013
2013-06-08,Kelantan,4,3,1,2013
2013-06-09,Kelantan,10,3,7,2013
2013-06-10,Kelantan,4,1,3,2013
2013-06-11,Kelantan,3,0,3,2013
2013-06-12,Kelantan,15,1,14,2013
2013-06-13,Kelantan,10,0,10,2013
2013-06-14,Kelantan,16,5,11,2013
2013-06-15,Kelantan,13,7,6,2013
2013-06-16,Kelantan,10,3,7,2013
2013-06-17,Kelantan,9,4,5,2013
2013-06-18,Kelantan,9,1,8,2013
2013-06-19,Kelantan,4,0,4,2013
2013-06-20,Kelantan,100,32,68,2013
2013-06-21,Kelantan,25,9,16,2013
2013-06-22,Kelantan,69,34,35,2013
2013-06-23,Kelantan,3,0,3,2013
2013-06-24,Kelantan,11,3,8,2013
2013-06-25,Kelantan,42,31,11,2013
2013-06-26,Kelantan,3,1,2,2013
2013-06-27,Kelantan,25,13,12,2013
2013-06-28,Kelantan,10,4,6,2013
2013-06-29,Kelantan,39,15,24,2013
2013-06-30,Kelantan,0,0,0,2013
2013-07-01,Kelantan,50,17,33,2013
2013-07-02,Kelantan,52,19,33,2013
2013-07-03,Kelantan,21,9,12,2013
2013-07-04,Kelantan,17,7,10,2013
2013-07-05,Kelantan,40,19,21,2013
2013-07-06,Kelantan,81,38,43,2013
2013-07-07,Kelantan,14,6,8,2013
2013-07-08,Kelantan,32,5,27,2013
2013-07-09,Kelantan,24,5,19,2013
2013-07-10,Kelantan,0,0,0,2013
2013-07-11,Kelantan,23,12,11,2013
2013-07-12,Kelantan,140,29,111,2013
2013-07-13,Kelantan,0,0,0,2013
2013-07-14,Kelantan,5,2,3,2013
2013-07-15,Kelantan,26,9,17,2013
2013-07-16,Kelantan,5,1,4,2013
2013-07-17,Kelantan,24,18,6,2013
2013-07-18,Kelantan,10,2,8,2013
2013-07-19,Kelantan,35,16,19,2013
2013-07-20,Kelantan,0,0,0,2013
2013-07-21,Kelantan,26,12,14,2013
2013-07-22,Kelantan,50,38,12,2013
2013-07-23,Kelantan,76,50,26,2013
2013-07-24,Kelantan,46,31,15,2013
2013-07-25,Kelantan,54,16,38,2013
2013-07-26,Kelantan,0,0,0,2013
2013-07-27,Kelantan,0,0,0,2013
2013-07-28,Kelantan,7,0,7,2013
2013-07-29,Kelantan,25,19,6,2013
2013-07-30,Kelantan,0,0,0,2013
2013-07-31,Kelantan,121,74,47,2013
2013-08-01,Kelantan,61,34,27,2013
2013-08-02,Kelantan,1,0,1,2013
2013-08-03,Kelantan,0,0,0,2013
2013-08-04,Kelantan,1,1,0,2013
2013-08-05,Kelantan,9,4,5,2013
2013-08-06,Kelantan,25,7,18,2013
2013-08-07,Kelantan,0,0,0,2013
2013-08-08,Kelantan,0,0,0,2013
2013-08-09,Kelantan,0,0,0,2013
2013-08-10,Kelantan,2,0,2,2013
2013-08-11,Kelantan,0,0,0,2013
2013-08-12,Kelantan,25,11,14,2013
2013-08-13,Kelantan,58,24,34,2013
2013-08-14,Kelantan,150,88,62,2013
2013-08-15,Kelantan,26,9,17,2013
2013-08-16,Kelantan,53,19,34,2013
2013-08-17,Kelantan,68,36,32,2013
2013-08-18,Kelantan,14,4,10,2013
2013-08-19,Kelantan,62,22,40,2013
2013-08-20,Kelantan,97,35,62,2013
2013-08-21,Kelantan,20,9,11,2013
2013-08-22,Kelantan,158,126,32,2013
2013-08-23,Kelantan,11,5,6,2013
2013-08-24,Kelantan,17,8,9,2013
2013-08-25,Kelantan,30,12,18,2013
2013-08-26,Kelantan,77,54,23,2013
2013-08-27,Kelantan,113,68,45,2013
2013-08-28,Kelantan,87,59,28,2013
2013-08-29,Kelantan,36,21,15,2013
2013-08-30,Kelantan,21,10,11,2013
2013-08-31,Kelantan,29,10,19,2013
2013-09-01,Kelantan,0,0,0,2013
2013-09-02,Kelantan,30,10,20,2013
2013-09-03,Kelantan,10,2,8,2013
2013-09-04,Kelantan,83,45,38,2013
2013-09-05,Kelantan,14,8,6,2013
2013-09-06,Kelantan,18,6,12,2013
2013-09-07,Kelantan,97,67,30,2013
2013-09-08,Kelantan,29,19,10,2013
2013-09-09,Kelantan,43,25,18,2013
2013-09-10,Kelantan,12,1,11,2013
2013-09-11,Kelantan,14,7,7,2013
2013-09-12,Kelantan,1,0,1,2013
2013-09-13,Kelantan,0,0,0,2013
2013-09-14,Kelantan,45,37,8,2013
2013-09-15,Kelantan,78,39,39,2013
2013-09-16,Kelantan,11,4,7,2013
2013-09-17,Kelantan,10,2,8,2013
2013-09-18,Kelantan,70,56,14,2013
2013-09-19,Kelantan,58,18,40,2013
2013-09-20,Kelantan,14,6,8,2013
2013-09-21,Kelantan,43,24,19,2013
2013-09-22,Kelantan,20,10,10,2013
2013-09-23,Kelantan,10,4,6,2013
2013-09-24,Kelantan,49,23,26,2013
2013-09-25,Kelantan,34,23,11,2013
2013-09-26,Kelantan,8,0,8,2013
2013-09-27,Kelantan,36,27,9,2013
2013-09-28,Kelantan,25,10,15,2013
2013-09-29,Kelantan,9,2,7,2013
2013-09-30,Kelantan,10,2,8,2013
2013-10-01,Kelantan,21,7,14,2013
2013-10-02,Kelantan,5,0,5,2013
2013-10-03,Kelantan,14,2,12,2013
2013-10-04,Kelantan,55,26,29,2013
2013-10-05,Kelantan,34,13,21,2013
2013-10-06,Kelantan,30,20,10,2013
2013-10-07,Kelantan,30,10,20,2013
2013-10-08,Kelantan,105,41,64,2013
2013-10-09,Kelantan,5,1,4,2013
2013-10-10,Kelantan,16,5,11,2013
2013-10-11,Kelantan,37,13,24,2013
2013-10-12,Kelantan,31,16,15,2013
2013-10-13,Kelantan,8,1,7,2013
2013-10-14,Kelantan,11,2,9,2013
2013-10-15,Kelantan,0,0,0,2013
2013-10-16,Kelantan,0,0,0,2013
2013-10-17,Kelantan,49,26,23,2013
2013-10-18,Kelantan,4,4,0,2013
2013-10-19,Kelantan,9,4,5,2013
2013-10-20,Kelantan,18,10,8,2013
2013-10-21,Kelantan,10,5,5,2013
2013-10-22,Kelantan,24,4,20,2013
2013-10-23,Kelantan,18,11,7,2013
2013-10-24,Kelantan,7,2,5,2013
2013-10-25,Kelantan,80,31,49,2013
2013-10-26,Kelantan,142,72,70,2013
2013-10-27,Kelantan,24,7,17,2013
2013-10-28,Kelantan,36,16,20,2013
2013-10-29,Kelantan,3,0,3,2013
2013-10-30,Kelantan,106,48,58,2013
2013-10-31,Kelantan,6,1,5,2013
2013-11-01,Kelantan,19,5,14,2013
2013-11-02,Kelantan,27,12,15,2013
2013-11-03,Kelantan,19,7,12,2013
2013-11-04,Kelantan,27,12,15,2013
2013-11-05,Kelantan,89,54,35,2013
2013-11-06,Kelantan,27,6,21,2013
2013-11-07,Kelantan,45,23,22,2013
2013-11-08,Kelantan,63,40,23,2013
2013-11-09,Kelantan,18,6,12,2013
2013-11-10,Kelantan,13,6,7,2013
2013-11-11,Kelantan,40,19,21,2013
2013-11-12,Kelantan,21,11,10,2013
2013-11-13,Kelantan,12,4,8,2013
2013-11-14,Kelantan,70,35,35,2013
2013-11-15,Kelantan,0,0,0,2013
2013-11-16,Kelantan,125,48,77,2013
2013-11-17,Kelantan,63,21,42,2013
2013-11-18,Kelantan,30,10,20,2013
2013-11-19,Kelantan,35,18,17,2013
2013-11-20,Kelantan,18,6,12,2013
2013-11-21,Kelantan,14,3,11,2013
2013-11-22,Kelantan,2,1,1,2013
2013-11-23,Kelantan,5,1,4,2013
2013-11-24,Kelantan,6,0,6,2013
2013-11-25,Kelantan,6,0,6,2013
2013-11-26,Kelantan,9,3,6,2013
2013-11-27,Kelantan,30,7,23,2013
2013-11-28,Kelantan,8,1,7,2013
2013-11-29,Kelantan,49,15,34,2013
2013-11-30,Kelantan,0,0,0,2013
2013-12-01,Kelantan,13,3,10,2013
2013-12-02,Kelantan,55,43,12,2013
2013-12-03,Kelantan,49,21,28,2013
2013-12-04,Kelantan,71,26,45,2013
2013-12-05,Kelantan,8,1,7,2013
2013-12-06,Kelantan,0,0,0,2013
2013-12-07,Kelantan,0,0,0,2013
2013-12-08,Kelantan,24,10,14,2013
2013-12-09,Kelantan,27,8,19,2013
2013-12-10,Kelantan,18,11,7,2013
2013-12-11,Kelantan,46,18,28,2013
2013-12-12,Kelantan,31,24,7,2013
2013-12-13,Kelantan,13,2,11,2013
2013-12-14,Kelantan,13,1,12,2013
2013-12-15,Kelantan,12,2,10,2013
2013-12-16,Kelantan,45,22,23,2013
2013-12-17,Kelantan,22,4,18,2013
2013-12-18,Kelantan,38,24,14,2013
2013-12-19,Kelantan,10,5,5,2013
2013-12-20,Kelantan,26,8,18,2013
2013-12-21,Kelantan,14,4,10,2013
2013-12-22,Kelantan,9,1,8,2013
2013-12-23,Kelantan,14,5,9,2013
2013-12-24,Kelantan,22,4,18,2013
2013-12-25,Kelantan,81,32,49,2013
2013-12-26,Kelantan,17,8,9,2013
2013-12-27,Kelantan,76,39,37,2013
2013-12-28,Kelantan,54,24,30,2013
2013-12-29,Kelantan,12,3,9,2013
2013-12-30,Kelantan,31,12,19,2013
2013-12-31,Kelantan,22,10,12,2013
2014-01-01,Kelantan,64,21,43,2014
2014-01-02,Kelantan,50,42,8,2014
2014-01-03,Kelantan,0,0,0,2014
2014-01-04,Kelantan,26,0,26,2014
2014-01-05,Kelantan,45,20,25,2014
2014-01-06,Kelantan,34,11,23,2014
2014-01-07,Kelantan,56,34,22,2014
2014-01-08,Kelantan,92,66,26,2014
2014-01-09,Kelantan,36,21,15,2014
2014-01-10,Kelantan,6,0,6,2014
2014-01-11,Kelantan,17,5,12,2014
2014-01-12,Kelantan,70,26,44,2014
2014-01-13,Kelantan,55,20,35,2014
2014-01-14,Kelantan,1,0,1,2014
2014-01-15,Kelantan,11,3,8,2014
2014-01-16,Kelantan,57,41,16,2014
2014-01-17,Kelantan,17,11,6,2014
2014-01-18,Kelantan,48,30,18,2014
2014-01-19,Kelantan,15,4,11,2014
2014-01-20,Kelantan,6,0,6,2014
2014-01-21,Kelantan,34,13,21,2014
2014-01-22,Kelantan,85,54,31,2014
2014-01-23,Kelantan,91,46,45,2014
2014-01-24,Kelantan,36,14,22,2014
2014-01-25,Kelantan,83,49,34,2014
2014-01-26,Kelantan,10,5,5,2014
2014-01-27,Kelantan,18,10,8,2014
2014-01-28,Kelantan,9,3,6,2014
2014-01-29,Kelantan,9,2,7,2014
2014-01-30,Kelantan,177,109,68,2014
2014-01-31,Kelantan,5,2,3,2014
2014-02-01,Kelantan,19,6,13,2014
2014-02-02,Kelantan,6,0,6,2014
2014-02-03,Kelantan,28,10,18,2014
2014-02-04,Kelantan,24,12,12,2014
2014-02-05,Kelantan,25,13,12,2014
2014-02-06,Kelantan,6,0,6,2014
2014-02-07,Kelantan,10,4,6,2014
2014-02-08,Kelantan,11,7,4,2014
2014-02-09,Kelantan,12,2,10,2014
2014-02-10,Kelantan,11,2,9,2014
2014-02-11,Kelantan,47,15,32,2014
2014-02-12,Kelantan,45,25,20,2014
2014-02-13,Kelantan,92,66,26,2014
2014-02-14,Kelantan,7,4,3,2014
2014-02-15,Kelantan,22,13,9,2014
2014-02-16,Kelantan,9,1,8,2014
2014-02-17,Kelantan,35,13,22,2014
2014-02-18,Kelantan,32,10,22,2014
2014-02-19,Kelantan,4,0,4,2014
2014-02-20,Kelantan,25,10,15,2014
2014-02-21,Kelantan,113,43,70,2014
2014-02-22,Kelantan,55,32,23,2014
2014-02-23,Kelantan,53,29,24,2014
2014-02-24,Kelantan,11,2,9,2014
2014-02-25,Kelantan,60,25,35,2014
2014-02-26,Kelantan,34,19,15,2014
2014-02-27,Kelantan,18,12,6,2014
2014-02-28,Kelantan,22,9,13,2014
2014-03-01,Kelantan,25,7,18,2014
2014-03-02,Kelantan,11,5,6,2014
2014-03-03,Kelantan,62,55,7,2014
2014-03-04,Kelantan,42,30,12,2014
2014-03-05,Kelantan,0,0,0,2014
2014-03-06,Kelantan,1,0,1,2014
2014-03-07,Kelantan,23,4,19,2014
2014-03-08,Kelantan,18,8,10,2014
2014-03-09,Kelantan,20,7,13,2014
2014-03-10,Kelantan,83,52,31,2014
2014-03-11,Kelantan,69,41,28,2014
2014-03-12,Kelantan,16,7,9,2014
2014-03-13,Kelantan,34,12,22,2014
2014-03-14,Kelantan,17,11,6,2014
2014-03-15,Kelantan,61,20,41,2014
2014-03-16,Kelantan,25,2,23,2014
2014-03-17,Kelantan,20,4,16,2014
2014-03-18,Kelantan,6,0,6,2014
2014-03-19,Kelantan,154,93,61,2014
2014-03-20,Kelantan,2,0,2,2014
2014-03-21,Kelantan,14,6,8,2014
2014-03-22,Kelantan,17,8,9,2014
2014-03-23,Kelantan,16,7,9,2014
2014-03-24,Kelantan,14,6,8,2014
2014-03-25,Kelantan,28,11,17,2014
2014-03-26,Kelantan,22,7,15,2014
2014-03-27,Kelantan,56,17,39,2014
2014-03-28,Kelantan,14,5,9,2014
2014-03-29,Kelantan,15,8,7,2014
2014-03-30,Kelantan,6,1,5,2014
2014-03-31,Kelantan,5,2,3,2014
2014-04-01,Kelantan,112,63,49,2014
2014-04-02,Kelantan,27,15,12,2014
2014-04-03,Kelantan,31,12,19,2014
2014-04-04,Kelantan,20,7,13,2014
2014-04-05,Kelantan,9,4,5,2014
2014-04-06,Kelantan,9,2,7,2014
2014-04-07,Kelantan,17,6,11,2014
2014-04-08,Kelantan,14,6,8,2014
2014-04-09,Kelantan,8,1,7,2014
2014-04-10,Kelantan,19,7,12,2014
2014-04-11,Kelantan,10,4,6,2014
2014-04-12,Kelantan,35,16,19,2014
2014-04-13,Kelantan,54,45,9,2014
2014-04-14,Kelantan,5,1,4,2014
2014-04-15,Kelantan,2,1,1,2014
2014-04-16,Kelantan,32,10,22,2014
2014-04-17,Kelantan,13,3,10,2014
2014-04-18,Kelantan,9,3,6,2014
2014-04-19,Kelantan,11,7,4,2014
2014-04-20,Kelantan,6,1,5,2014
2014-04-21,Kelantan,58,52,6,2014
2014-04-22,Kelantan,15,6,9,2014
2014-04-23,Kelantan,3,0,3,2014
2014-04-24,Kelantan,176,52,124,2014
2014-04-25,Kelantan,40,14,26,2014
2014-04-26,Kelantan,13,6,7,2014
2014-04-27,Kelantan,8,1,7,2014
2014-04-28,Kelantan,15,9,6,2014
2014-04-29,Kelantan,10,3,7,2014
2014-04-30,Kelantan,28,14,14,2014
2014-05-01,Kelantan,27,10,17,2014
2014-05-02,Kelantan,37,16,21,2014
2014-05-03,Kelantan,14,7,7,2014
2014-05-04,Kelantan,26,7,19,2014
2014-05-05,Kelantan,6,2,4,2014
2014-05-06,Kelantan,55,33,22,2014
2014-05-07,Kelantan,31,17,14,2014
2014-05-08,Kelantan,10,7,3,2014
2014-05-09,Kelantan,11,4,7,2014
2014-05-10,Kelantan,0,0,0,2014
2014-05-11,Kelantan,42,29,13,2014
2014-05-12,Kelantan,58,45,13,2014
2014-05-13,Kelantan,0,0,0,2014
2014-05-14,Kelantan,52,34,18,2014
2014-05-15,Kelantan,90,63,27,2014
2014-05-16,Kelantan,10,7,3,2014
2014-05-17,Kelantan,13,7,6,2014
2014-05-18,Kelantan,16,3,13,2014
2014-05-19,Kelantan,62,26,36,2014
2014-05-20,Kelantan,20,9,11,2014
2014-05-21,Kelantan,12,4,8,2014
2014-05-22,Kelantan,28,7,21,2014
2014-05-23,Kelantan,55,24,31,2014
2014-05-24,Kelantan,23,15,8,2014
2014-05-25,Kelantan,8,4,4,2014
2014-05-26,Kelantan,11,7,4,2014
2014-05-27,Kelantan,7,0,7,2014
2014-05-28,Kelantan,3,0,3,2014
2014-05-29,Kelantan,8,1,7,2014
2014-05-30,Kelantan,25,10,15,2014
2014-05-31,Kelantan,9,7,2,2014
2014-06-01,Kelantan,29,17,12,2014
2014-06-02,Kelantan,24,7,17,2014
2014-06-03,Kelantan,28,16,12,2014
2014-06-04,Kelantan,38,18,20,2014
2014-06-05,Kelantan,29,11,18,2014
2014-06-06,Kelantan,17,7,10,2014
2014-06-07,Kelantan,34,10,24,2014
2014-06-08,Kelantan,0,0,0,2014
2014-06-09,Kelantan,15,4,11,2014
2014-06-10,Kelantan,11,5,6,2014
2014-06-11,Kelantan,24,11,13,2014
2014-06-12,Kelantan,12,4,8,2014
2014-06-13,Kelantan,6,2,4,2014
2014-06-14,Kelantan,50,19,31,2014
2014-06-15,Kelantan,15,3,12,2014
2014-06-16,Kelantan,53,41,12,2014
2014-06-17,Kelantan,6,0,6,2014
2014-06-18,Kelantan,86,37,49,2014
2014-06-19,Kelantan,65,24,41,2014
2014-06-20,Kelantan,0,0,0,2014
2014-06-21,Kelantan,0,0,0,2014
2014-06-22,Kelantan,68,41,27,2014
2014-06-23,Kelantan,2,0,2,2014
2014-06-24,Kelantan,1,0,1,2014
2014-06-25,Kelantan,0,0,0,2014
2014-06-26,Kelantan,1,0,1,2014
2014-06-27,Kelantan,29,11,18,2014
2014-06-28,Kelantan,0,0,0,2014
2014-06-29,Kelantan,0,0,0,2014
2014-06-30,Kelantan,0,0,0,2014
2014-07-01,Kelantan,1,0,1,2014
2014-07-02,Kelantan,0,0,0,2014
2014-07-03,Kelantan,0,0,0,2014
2014-07-04,Kelantan,0,0,0,2014
2014-07-05,Kelantan,0,0,0,2014
2014-07-06,Kelantan,0,0,0,2014
2014-07-07,Kelantan,0,0,0,2014
2014-07-08,Kelantan,0,0,0,2014
2014-07-09,Kelantan,2,0,2,2014
2014-07-10,Kelantan,0,0,0,2014
2014-07-11,Kelantan,0,0,0,2014
2014-07-12,Kelantan,0,0,0,2014
2014-07-13,Kelantan,0,0,0,2014
2014-07-14,Kelantan,1,0,1,2014
2014-07-15,Kelantan,0,0,0,2014
2014-07-16,Kelantan,1,0,1,2014
2014-07-17,Kelantan,49,40,9,2014
2014-07-18,Kelantan,0,0,0,2014
2014-07-19,Kelantan,0,0,0,2014
2014-07-20,Kelantan,33,19,14,2014
2014-07-21,Kelantan,10,6,4,2014
2014-07-22,Kelantan,0,0,0,2014
2014-07-23,Kelantan,0,0,0,2014
2014-07-24,Kelantan,5,1,4,2014
2014-07-25,Kelantan,4,0,4,2014
2014-07-26,Kelantan,24,9,15,2014
2014-07-27,Kelantan,0,0,0,2014
2014-07-28,Kelantan,0,0,0,2014
2014-07-29,Kelantan,0,0,0,2014
2014-07-30,Kelantan,21,2,19,2014
2014-07-31,Kelantan,11,4,7,2014
2014-08-01,Kelantan,15,5,10,2014
2014-08-02,Kelantan,34,18,16,2014
2014-08-03,Kelantan,32,5,27,2014
2014-08-04,Kelantan,50,18,32,2014
2014-08-05,Kelantan,80,45,35,2014
2014-08-06,Kelantan,96,57,39,2014
2014-08-07,Kelantan,6,1,5,2014
2014-08-08,Kelantan,29,13,16,2014
2014-08-09,Kelantan,59,19,40,2014
2014-08-10,Kelantan,35,11,24,2014
2014-08-11,Kelantan,62,24,38,2014
2014-08-12,Kelantan,36,8,28,2014
2014-08-13,Kelantan,41,22,19,2014
2014-08-14,Kelantan,46,29,17,2014
2014-08-15,Kelantan,66,30,36,2014
2014-08-16,Kelantan,78,37,41,2014
2014-08-17,Kelantan,3,0,3,2014
2014-08-18,Kelantan,39,16,23,2014
2014-08-19,Kelantan,60,17,43,2014
2014-08-20,Kelantan,11,4,7,2014
2014-08-21,Kelantan,5,2,3,2014
2014-08-22,Kelantan,0,0,0,2014
2014-08-23,Kelantan,46,26,20,2014
2014-08-24,Kelantan,37,19,18,2014
2014-08-25,Kelantan,25,15,10,2014
2014-08-26,Kelantan,27,8,19,2014
2014-08-27,Kelantan,10,1,9,2014
2014-08-28,Kelantan,10,5,5,2014
2014-08-29,Kelantan,21,8,13,2014
2014-08-30,Kelantan,39,17,22,2014
2014-08-31,Kelantan,22,9,13,2014
2014-09-01,Kelantan,96,35,61,2014
2014-09-02,Kelantan,51,14,37,2014
2014-09-03,Kelantan,5,1,4,2014
2014-09-04,Kelantan,13,2,11,2014
2014-09-05,Kelantan,67,27,40,2014
2014-09-06,Kelantan,0,0,0,2014
2014-09-07,Kelantan,42,23,19,2014
2014-09-08,Kelantan,6,2,4,2014
2014-09-09,Kelantan,93,64,29,2014
2014-09-10,Kelantan,151,51,100,2014
2014-09-11,Kelantan,42,24,18,2014
2014-09-12,Kelantan,29,12,17,2014
2014-09-13,Kelantan,26,11,15,2014
2014-09-14,Kelantan,34,14,20,2014
2014-09-15,Kelantan,27,12,15,2014
2014-09-16,Kelantan,26,24,2,2014
2014-09-17,Kelantan,25,11,14,2014
2014-09-18,Kelantan,24,8,16,2014
2014-09-19,Kelantan,84,59,25,2014
2014-09-20,Kelantan,42,21,21,2014
2014-09-21,Kelantan,10,1,9,2014
2014-09-22,Kelantan,23,2,21,2014
2014-09-23,Kelantan,8,2,6,2014
2014-09-24,Kelantan,119,54,65,2014
2014-09-25,Kelantan,0,0,0,2014
2014-09-26,Kelantan,0,0,0,2014
2014-09-27,Kelantan,134,63,71,2014
2014-09-28,Kelantan,7,1,6,2014
2014-09-29,Kelantan,11,2,9,2014
2014-09-30,Kelantan,122,62,60,2014
2014-10-01,Kelantan,4,1,3,2014
2014-10-02,Kelantan,66,26,40,2014
2014-10-03,Kelantan,14,6,8,2014
2014-10-04,Kelantan,0,0,0,2014
2014-10-05,Kelantan,0,0,0,2014
2014-10-06,Kelantan,0,0,0,2014
2014-10-07,Kelantan,11,0,11,2014
2014-10-08,Kelantan,2,0,2,2014
2014-10-09,Kelantan,9,3,6,2014
2014-10-10,Kelantan,15,4,11,2014
2014-10-11,Kelantan,18,8,10,2014
2014-10-12,Kelantan,26,8,18,2014
2014-10-13,Kelantan,28,11,17,2014
2014-10-14,Kelantan,44,18,26,2014
2014-10-15,Kelantan,36,15,21,2014
2014-10-16,Kelantan,5,4,1,2014
2014-10-17,Kelantan,0,0,0,2014
2014-10-18,Kelantan,109,55,54,2014
2014-10-19,Kelantan,16,8,8,2014
2014-10-20,Kelantan,62,38,24,2014
2014-10-21,Kelantan,59,21,38,2014
2014-10-22,Kelantan,41,20,21,2014
2014-10-23,Kelantan,43,22,21,2014
2014-10-24,Kelantan,32,18,14,2014
2014-10-25,Kelantan,16,8,8,2014
2014-10-26,Kelantan,19,9,10,2014
2014-10-27,Kelantan,9,2,7,2014
2014-10-28,Kelantan,23,11,12,2014
2014-10-29,Kelantan,24,10,14,2014
2014-10-30,Kelantan,5,0,5,2014
2014-10-31,Kelantan,93,37,56,2014
2014-11-01,Kelantan,11,7,4,2014
2014-11-02,Kelantan,36,10,26,2014
2014-11-03,Kelantan,15,5,10,2014
2014-11-04,Kelantan,14,5,9,2014
2014-11-05,Kelantan,22,4,18,2014
2014-11-06,Kelantan,49,21,28,2014
2014-11-07,Kelantan,38,22,16,2014
2014-11-08,Kelantan,41,14,27,2014
2014-11-09,Kelantan,29,14,15,2014
2014-11-10,Kelantan,43,18,25,2014
2014-11-11,Kelantan,35,18,17,2014
2014-11-12,Kelantan,20,9,11,2014
2014-11-13,Kelantan,9,3,6,2014
2014-11-14,Kelantan,13,9,4,2014
2014-11-15,Kelantan,23,18,5,2014
2014-11-16,Kelantan,25,7,18,2014
2014-11-17,Kelantan,71,29,42,2014
2014-11-18,Kelantan,13,2,11,2014
2014-11-19,Kelantan,27,11,16,2014
2014-11-20,Kelantan,28,12,16,2014
2014-11-21,Kelantan,17,9,8,2014
2014-11-22,Kelantan,54,25,29,2014
2014-11-23,Kelantan,66,25,41,2014
2014-11-24,Kelantan,44,24,20,2014
2014-11-25,Kelantan,79,57,22,2014
2014-11-26,Kelantan,33,14,19,2014
2014-11-27,Kelantan,35,10,25,2014
2014-11-28,Kelantan,68,33,35,2014
2014-11-29,Kelantan,98,49,49,2014
2014-11-30,Kelantan,58,25,33,2014
2014-12-01,Kelantan,7,0,7,2014
2014-12-02,Kelantan,3,0,3,2014
2014-12-03,Kelantan,16,8,8,2014
2014-12-04,Kelantan,81,18,63,2014
2014-12-05,Kelantan,67,25,42,2014
2014-12-06,Kelantan,0,0,0,2014
2014-12-07,Kelantan,15,5,10,2014
2014-12-08,Kelantan,12,2,10,2014
2014-12-09,Kelantan,15,4,11,2014
2014-12-10,Kelantan,14,6,8,2014
2014-12-11,Kelantan,104,64,40,2014
2014-12-12,Kelantan,101,56,45,2014
2014-12-13,Kelantan,27,16,11,2014
2014-12-14,Kelantan,11,3,8,2014
2014-12-15,Kelantan,15,8,7,2014
2014-12-16,Kelantan,20,6,14,2014
2014-12-17,Kelantan,11,2,9,2014
2014-12-18,Kelantan,10,10,0,2014
2014-12-19,Kelantan,0,0,0,2014
2014-12-20,Kelantan,106,44,62,2014
2014-12-21,Kelantan,13,4,9,2014
2014-12-22,Kelantan,11,5,6,2014
2014-12-23,Kelantan,4,2,2,2014
2014-12-24,Kelantan,7,1,6,2014
2014-12-25,Kelantan,6,1,5,2014
2014-12-26,Kelantan,0,0,0,2014
2014-12-27,Kelantan,0,0,0,2014
2014-12-28,Kelantan,12,6,6,2014
2014-12-29,Kelantan,24,12,12,2014
2014-12-30,Kelantan,20,10,10,2014
2014-12-31,Kelantan,14,4,10,2014
2015-01-01,Kelantan,92,39,53,2015
2015-01-02,Kelantan,52,26,26,2015
2015-01-03,Kelantan,29,16,13,2015
2015-01-04,Kelantan,67,29,38,2015
2015-01-05,Kelantan,52,19,33,2015
2015-01-06,Kelantan,101,53,48,2015
2015-01-07,Kelantan,85,39,46,2015
2015-01-08,Kelantan,18,8,10,2015
2015-01-09,Kelantan,63,36,27,2015
2015-01-10,Kelantan,32,17,15,2015
2015-01-11,Kelantan,2,1,1,2015
2015-01-12,Kelantan,18,10,8,2015
2015-01-13,Kelantan,88,29,59,2015
2015-01-14,Kelantan,50,41,9,2015
2015-01-15,Kelantan,68,44,24,2015
2015-01-16,Kelantan,75,61,14,2015
2015-01-17,Kelantan,84,41,43,2015
2015-01-18,Kelantan,16,8,8,2015
2015-01-19,Kelantan,246,166,80,2015
2015-01-20,Kelantan,255,196,59,2015
2015-01-21,Kelantan,293,208,85,2015
2015-01-22,Kelantan,7,2,5,2015
2015-01-23,Kelantan,68,36,32,2015
2015-01-24,Kelantan,0,0,0,2015
2015-01-25,Kelantan,17,7,10,2015
2015-01-26,Kelantan,11,1,10,2015
2015-01-27,Kelantan,16,8,8,2015
2015-01-28,Kelantan,70,27,43,2015
2015-01-29,Kelantan,45,18,27,2015
2015-01-30,Kelantan,18,11,7,2015
2015-01-31,Kelantan,0,0,0,2015
2015-02-01,Kelantan,16,0,16,2015
2015-02-02,Kelantan,47,29,18,2015
2015-02-03,Kelantan,24,18,6,2015
2015-02-04,Kelantan,22,10,12,2015
2015-02-05,Kelantan,28,14,14,2015
2015-02-06,Kelantan,80,37,43,2015
2015-02-07,Kelantan,30,16,14,2015
2015-02-08,Kelantan,37,17,20,2015
2015-02-09,Kelantan,34,17,17,2015
2015-02-10,Kelantan,42,26,16,2015
2015-02-11,Kelantan,36,16,20,2015
2015-02-12,Kelantan,68,42,26,2015
2015-02-13,Kelantan,7,5,2,2015
2015-02-14,Kelantan,0,0,0,2015
2015-02-15,Kelantan,26,14,12,2015
2015-02-16,Kelantan,36,13,23,2015
2015-02-17,Kelantan,4,0,4,2015
2015-02-18,Kelantan,224,128,96,2015
2015-02-19,Kelantan,0,0,0,2015
2015-02-20,Kelantan,0,0,0,2015
2015-02-21,Kelantan,29,17,12,2015
2015-02-22,Kelantan,19,10,9,2015
2015-02-23,Kelantan,77,65,12,2015
2015-02-24,Kelantan,7,0,7,2015
2015-02-25,Kelantan,5,1,4,2015
2015-02-26,Kelantan,24,11,13,2015
2015-02-27,Kelantan,38,19,19,2015
2015-02-28,Kelantan,47,23,24,2015
2015-03-01,Kelantan,9,0,9,2015
2015-03-02,Kelantan,72,59,13,2015
2015-03-03,Kelantan,10,1,9,2015
2015-03-04,Kelantan,127,39,88,2015
2015-03-05,Kelantan,124,64,60,2015
2015-03-06,Kelantan,30,20,10,2015
2015-03-07,Kelantan,27,10,17,2015
2015-03-08,Kelantan,50,38,12,2015
2015-03-09,Kelantan,18,1,17,2015
2015-03-10,Kelantan,8,1,7,2015
2015-03-11,Kelantan,18,6,12,2015
2015-03-12,Kelantan,11,3,8,2015
2015-03-13,Kelantan,0,0,0,2015
2015-03-14,Kelantan,21,14,7,2015
2015-03-15,Kelantan,50,17,33,2015
2015-03-16,Kelantan,10,3,7,2015
2015-03-17,Kelantan,34,13,21,2015
2015-03-18,Kelantan,34,8,26,2015
2015-03-19,Kelantan,62,14,48,2015
2015-03-20,Kelantan,30,16,14,2015
2015-03-21,Kelantan,16,7,9,2015
2015-03-22,Kelantan,0,0,0,2015
2015-03-23,Kelantan,32,25,7,2015
2015-03-24,Kelantan,10,1,9,2015
2015-03-25,Kelantan,45,27,18,2015
2015-03-26,Kelantan,33,18,15,2015
2015-03-27,Kelantan,28,13,15,2015
2015-03-28,Kelantan,79,39,40,2015
2015-03-29,Kelantan,50,27,23,2015
2015-03-30,Kelantan,12,3,9,2015
2015-03-31,Kelantan,8,0,8,2015
2015-04-01,Kelantan,8,3,5,2015
2015-04-02,Kelantan,47,32,15,2015
2015-04-03,Kelantan,20,10,10,2015
2015-04-04,Kelantan,10,4,6,2015
2015-04-05,Kelantan,8,0,8,2015
2015-04-06,Kelantan,9,2,7,2015
2015-04-07,Kelantan,24,4,20,2015
2015-04-08,Kelantan,17,5,12,2015
2015-04-09,Kelantan,39,16,23,2015
2015-04-10,Kelantan,22,11,11,2015
2015-04-11,Kelantan,16,5,11,2015
2015-04-12,Kelantan,52,25,27,2015
2015-04-13,Kelantan,32,24,8,2015
2015-04-14,Kelantan,13,2,11,2015
2015-04-15,Kelantan,14,5,9,2015
2015-04-16,Kelantan,60,41,19,2015
2015-04-17,Kelantan,7,4,3,2015
2015-04-18,Kelantan,10,6,4,2015
2015-04-19,Kelantan,32,11,21,2015
2015-04-20,Kelantan,5,1,4,2015
2015-04-21,Kelantan,117,44,73,2015
2015-04-22,Kelantan,16,4,12,2015
2015-04-23,Kelantan,14,6,8,2015
2015-04-24,Kelantan,11,5,6,2015
2015-04-25,Kelantan,82,43,39,2015
2015-04-26,Kelantan,4,1,3,2015
2015-04-27,Kelantan,22,11,11,2015
2015-04-28,Kelantan,19,9,10,2015
2015-04-29,Kelantan,27,15,12,2015
2015-04-30,Kelantan,12,4,8,2015
2015-05-01,Kelantan,13,7,6,2015
2015-05-02,Kelantan,51,30,21,2015
2015-05-03,Kelantan,27,8,19,2015
2015-05-04,Kelantan,17,9,8,2015
2015-05-05,Kelantan,27,10,17,2015
2015-05-06,Kelantan,24,7,17,2015
2015-05-07,Kelantan,16,6,10,2015
2015-05-08,Kelantan,28,7,21,2015
2015-05-09,Kelantan,49,30,19,2015
2015-05-10,Kelantan,124,106,18,2015
2015-05-11,Kelantan,65,60,5,2015
2015-05-12,Kelantan,46,18,28,2015
2015-05-13,Kelantan,4,1,3,2015
2015-05-14,Kelantan,105,91,14,2015
2015-05-15,Kelantan,11,5,6,2015
2015-05-16,Kelantan,19,11,8,2015
2015-05-17,Kelantan,70,54,16,2015
2015-05-18,Kelantan,37,27,10,2015
2015-05-19,Kelantan,36,18,18,2015
2015-05-20,Kelantan,4,1,3,2015
2015-05-21,Kelantan,340,230,110,2015
2015-05-22,Kelantan,0,0,0,2015
2015-05-23,Kelantan,18,8,10,2015
2015-05-24,Kelantan,0,0,0,2015
2015-05-25,Kelantan,128,40,88,2015
2015-05-26,Kelantan,50,47,3,2015
2015-05-27,Kelantan,10,4,6,2015
2015-05-28,Kelantan,3,1,2,2015
2015-05-29,Kelantan,0,0,0,2015
2015-05-30,Kelantan,1,0,1,2015
2015-05-31,Kelantan,45,16,29,2015
2015-06-01,Kelantan,73,27,46,2015
2015-06-02,Kelantan,25,11,14,2015
2015-06-03,Kelantan,8,3,5,2015
2015-06-04,Kelantan,11,1,10,2015
2015-06-05,Kelantan,70,22,48,2015
2015-06-06,Kelantan,69,44,25,2015
2015-06-07,Kelantan,0,0,0,2015
2015-06-08,Kelantan,18,9,9,2015
2015-06-09,Kelantan,32,12,20,2015
2015-06-10,Kelantan,15,2,13,2015
2015-06-11,Kelantan,12,3,9,2015
2015-06-12,Kelantan,0,0,0,2015
2015-06-13,Kelantan,58,11,47,2015
2015-06-14,Kelantan,80,17,63,2015
2015-06-15,Kelantan,34,9,25,2015
2015-06-16,Kelantan,26,8,18,2015
2015-06-17,Kelantan,14,3,11,2015
2015-06-18,Kelantan,1,0,1,2015
2015-06-19,Kelantan,5,2,3,2015
2015-06-20,Kelantan,0,0,0,2015
2015-06-21,Kelantan,5,0,5,2015
2015-06-22,Kelantan,4,0,4,2015
2015-06-23,Kelantan,33,18,15,2015
2015-06-24,Kelantan,13,7,6,2015
2015-06-25,Kelantan,9,3,6,2015
2015-06-26,Kelantan,5,1,4,2015
2015-06-27,Kelantan,13,2,11,2015
2015-06-28,Kelantan,24,6,18,2015
2015-06-29,Kelantan,49,28,21,2015
2015-06-30,Kelantan,22,14,8,2015
2015-07-01,Kelantan,34,24,10,2015
2015-07-02,Kelantan,54,14,40,2015
2015-07-03,Kelantan,57,26,31,2015
2015-07-04,Kelantan,23,16,7,2015
2015-07-05,Kelantan,28,11,17,2015
2015-07-06,Kelantan,79,44,35,2015
2015-07-07,Kelantan,70,30,40,2015
2015-07-08,Kelantan,115,67,48,2015
2015-07-09,Kelantan,212,137,75,2015
2015-07-10,Kelantan,46,28,18,2015
2015-07-11,Kelantan,13,5,8,2015
2015-07-12,Kelantan,31,9,22,2015
2015-07-13,Kelantan,122,72,50,2015
2015-07-14,Kelantan,22,10,12,2015
2015-07-15,Kelantan,18,5,13,2015
2015-07-16,Kelantan,9,6,3,2015
2015-07-17,Kelantan,0,0,0,2015
2015-07-18,Kelantan,0,0,0,2015
2015-07-19,Kelantan,27,13,14,2015
2015-07-20,Kelantan,22,11,11,2015
2015-07-21,Kelantan,20,5,15,2015
2015-07-22,Kelantan,62,18,44,2015
2015-07-23,Kelantan,19,6,13,2015
2015-07-24,Kelantan,30,11,19,2015
2015-07-25,Kelantan,9,5,4,2015
2015-07-26,Kelantan,12,1,11,2015
2015-07-27,Kelantan,35,25,10,2015
2015-07-28,Kelantan,102,49,53,2015
2015-07-29,Kelantan,74,45,29,2015
2015-07-30,Kelantan,107,68,39,2015
2015-07-31,Kelantan,54,22,32,2015
2015-08-01,Kelantan,3,2,1,2015
2015-08-02,Kelantan,21,12,9,2015
2015-08-03,Kelantan,158,66,92,2015
2015-08-04,Kelantan,12,1,11,2015
2015-08-05,Kelantan,15,6,9,2015
2015-08-06,Kelantan,89,70,19,2015
2015-08-07,Kelantan,15,7,8,2015
2015-08-08,Kelantan,107,50,57,2015
2015-08-09,Kelantan,55,38,17,2015
2015-08-10,Kelantan,30,13,17,2015
2015-08-11,Kelantan,22,4,18,2015
2015-08-12,Kelantan,318,233,85,2015
2015-08-13,Kelantan,88,58,30,2015
2015-08-14,Kelantan,1,1,0,2015
2015-08-15,Kelantan,14,7,7,2015
2015-08-16,Kelantan,15,1,14,2015
2015-08-17,Kelantan,60,28,32,2015
2015-08-18,Kelantan,46,16,30,2015
2015-08-19,Kelantan,11,1,10,2015
2015-08-20,Kelantan,8,3,5,2015
2015-08-21,Kelantan,22,6,16,2015
2015-08-22,Kelantan,39,17,22,2015
2015-08-23,Kelantan,16,4,12,2015
2015-08-24,Kelantan,12,1,11,2015
2015-08-25,Kelantan,80,65,15,2015
2015-08-26,Kelantan,110,98,12,2015
2015-08-27,Kelantan,114,72,42,2015
2015-08-28,Kelantan,55,19,36,2015
2015-08-29,Kelantan,32,20,12,2015
2015-08-30,Kelantan,72,28,44,2015
2015-08-31,Kelantan,67,37,30,2015
2015-09-01,Kelantan,24,6,18,2015
2015-09-02,Kelantan,164,128,36,2015
2015-09-03,Kelantan,14,1,13,2015
2015-09-04,Kelantan,70,21,49,2015
2015-09-05,Kelantan,105,38,67,2015
2015-09-06,Kelantan,43,20,23,2015
2015-09-07,Kelantan,80,72,8,2015
2015-09-08,Kelantan,54,26,28,2015
2015-09-09,Kelantan,11,1,10,2015
2015-09-10,Kelantan,1,0,1,2015
2015-09-11,Kelantan,19,7,12,2015
2015-09-12,Kelantan,0,0,0,2015
2015-09-13,Kelantan,61,31,30,2015
2015-09-14,Kelantan,46,28,18,2015
2015-09-15,Kelantan,38,30,8,2015
2015-09-16,Kelantan,45,27,18,2015
2015-09-17,Kelantan,30,8,22,2015
2015-09-18,Kelantan,58,32,26,2015
2015-09-19,Kelantan,98,45,53,2015
2015-09-20,Kelantan,120,99,21,2015
2015-09-21,Kelantan,153,133,20,2015
2015-09-22,Kelantan,16,8,8,2015
2015-09-23,Kelantan,8,1,7,2015
2015-09-24,Kelantan,0,0,0,2015
2015-09-25,Kelantan,0,0,0,2015
2015-09-26,Kelantan,0,0,0,2015
2015-09-27,Kelantan,6,1,5,2015
2015-09-28,Kelantan,16,0,16,2015
2015-09-29,Kelantan,87,32,55,2015
2015-09-30,Kelantan,49,23,26,2015
2015-10-01,Kelantan,7,1,6,2015
2015-10-02,Kelantan,36,11,25,2015
2015-10-03,Kelantan,59,23,36,2015
2015-10-04,Kelantan,10,4,6,2015
2015-10-05,Kelantan,50,42,8,2015
2015-10-06,Kelantan,147,68,79,2015
2015-10-07,Kelantan,71,35,36,2015
2015-10-08,Kelantan,7,1,6,2015
2015-10-09,Kelantan,20,11,9,2015
2015-10-10,Kelantan,31,15,16,2015
2015-10-11,Kelantan,22,8,14,2015
2015-10-12,Kelantan,103,89,14,2015
2015-10-13,Kelantan,6,0,6,2015
2015-10-14,Kelantan,70,44,26,2015
2015-10-15,Kelantan,52,25,27,2015
2015-10-16,Kelantan,33,12,21,2015
2015-10-17,Kelantan,12,4,8,2015
2015-10-18,Kelantan,79,38,41,2015
2015-10-19,Kelantan,3,0,3,2015
2015-10-20,Kelantan,34,18,16,2015
2015-10-21,Kelantan,47,26,21,2015
2015-10-22,Kelantan,17,4,13,2015
2015-10-23,Kelantan,9,5,4,2015
2015-10-24,Kelantan,75,45,30,2015
2015-10-25,Kelantan,4,0,4,2015
2015-10-26,Kelantan,49,30,19,2015
2015-10-27,Kelantan,17,9,8,2015
2015-10-28,Kelantan,45,38,7,2015
2015-10-29,Kelantan,24,17,7,2015
2015-10-30,Kelantan,41,14,27,2015
2015-10-31,Kelantan,56,29,27,2015
2015-11-01,Kelantan,12,2,10,2015
2015-11-02,Kelantan,54,19,35,2015
2015-11-03,Kelantan,55,32,23,2015
2015-11-04,Kelantan,59,40,19,2015
2015-11-05,Kelantan,50,39,11,2015
2015-11-06,Kelantan,56,23,33,2015
2015-11-07,Kelantan,22,15,7,2015
2015-11-08,Kelantan,29,14,15,2015
2015-11-09,Kelantan,36,15,21,2015
2015-11-10,Kelantan,26,13,13,2015
2015-11-11,Kelantan,11,1,10,2015
2015-11-12,Kelantan,24,13,11,2015
2015-11-13,Kelantan,0,0,0,2015
2015-11-14,Kelantan,22,7,15,2015
2015-11-15,Kelantan,29,9,20,2015
2015-11-16,Kelantan,47,16,31,2015
2015-11-17,Kelantan,71,45,26,2015
2015-11-18,Kelantan,41,28,13,2015
2015-11-19,Kelantan,37,24,13,2015
2015-11-20,Kelantan,60,27,33,2015
2015-11-21,Kelantan,28,14,14,2015
2015-11-22,Kelantan,19,7,12,2015
2015-11-23,Kelantan,28,20,8,2015
2015-11-24,Kelantan,169,89,80,2015
2015-11-25,Kelantan,16,1,15,2015
2015-11-26,Kelantan,110,71,39,2015
2015-11-27,Kelantan,13,8,5,2015
2015-11-28,Kelantan,0,0,0,2015
2015-11-29,Kelantan,107,59,48,2015
2015-11-30,Kelantan,94,56,38,2015
2015-12-01,Kelantan,52,31,21,2015
2015-12-02,Kelantan,13,1,12,2015
2015-12-03,Kelantan,174,114,60,2015
2015-12-04,Kelantan,63,23,40,2015
2015-12-05,Kelantan,82,41,41,2015
2015-12-06,Kelantan,73,34,39,2015
2015-12-07,Kelantan,63,35,28,2015
2015-12-08,Kelantan,43,21,22,2015
2015-12-09,Kelantan,13,2,11,2015
2015-12-10,Kelantan,11,1,10,2015
2015-12-11,Kelantan,5,2,3,2015
2015-12-12,Kelantan,13,6,7,2015
2015-12-13,Kelantan,20,4,16,2015
2015-12-14,Kelantan,15,5,10,2015
2015-12-15,Kelantan,16,3,13,2015
2015-12-16,Kelantan,42,20,22,2015
2015-12-17,Kelantan,41,16,25,2015
2015-12-18,Kelantan,0,0,0,2015
2015-12-19,Kelantan,43,19,24,2015
2015-12-20,Kelantan,13,4,9,2015
2015-12-21,Kelantan,11,3,8,2015
2015-12-22,Kelantan,23,4,19,2015
2015-12-23,Kelantan,139,102,37,2015
2015-12-24,Kelantan,0,0,0,2015
2015-12-25,Kelantan,50,21,29,2015
2015-12-26,Kelantan,133,49,84,2015
2015-12-27,Kelantan,41,16,25,2015
2015-12-28,Kelantan,52,26,26,2015
2015-12-29,Kelantan,11,3,8,2015
2015-12-30,Kelantan,55,29,26,2015
2015-12-31,Kelantan,0,0,0,2015
2016-01-01,Kelantan,41,7,34,2016
2016-01-02,Kelantan,44,12,32,2016
2016-01-03,Kelantan,40,9,31,2016
2016-01-04,Kelantan,43,11,32,2016
2016-01-05,Kelantan,48,12,36,2016
2016-01-06,Kelantan,58,12,46,2016
2016-01-07,Kelantan,27,15,12,2016
2016-01-08,Kelantan,6,3,3,2016
2016-01-09,Kelantan,55,22,33,2016
2016-01-10,Kelantan,14,5,9,2016
2016-01-11,Kelantan,25,9,16,2016
2016-01-12,Kelantan,83,40,43,2016
2016-01-13,Kelantan,58,33,25,2016
2016-01-14,Kelantan,42,30,12,2016
2016-01-15,Kelantan,17,8,9,2016
2016-01-16,Kelantan,16,7,9,2016
2016-01-17,Kelantan,28,18,10,2016
2016-01-18,Kelantan,29,9,20,2016
2016-01-19,Kelantan,10,2,8,2016
2016-01-20,Kelantan,39,17,22,2016
2016-01-21,Kelantan,10,7,3,2016
2016-01-22,Kelantan,10,3,7,2016
2016-01-23,Kelantan,26,13,13,2016
2016-01-24,Kelantan,18,6,12,2016
2016-01-25,Kelantan,40,20,20,2016
2016-01-26,Kelantan,66,36,30,2016
2016-01-27,Kelantan,71,45,26,2016
2016-01-28,Kelantan,64,33,31,2016
2016-01-29,Kelantan,26,11,15,2016
2016-01-30,Kelantan,17,8,9,2016
2016-01-31,Kelantan,25,13,12,2016
2016-02-01,Kelantan,5,2,3,2016
2016-02-02,Kelantan,56,50,6,2016
2016-02-03,Kelantan,48,35,13,2016
2016-02-04,Kelantan,73,35,38,2016
2016-02-05,Kelantan,18,10,8,2016
2016-02-06,Kelantan,33,19,14,2016
2016-02-07,Kelantan,13,3,10,2016
2016-02-08,Kelantan,20,12,8,2016
2016-02-09,Kelantan,15,6,9,2016
2016-02-10,Kelantan,26,13,13,2016
2016-02-11,Kelantan,21,8,13,2016
2016-02-12,Kelantan,0,0,0,2016
2016-02-13,Kelantan,34,11,23,2016
2016-02-14,Kelantan,20,7,13,2016
2016-02-15,Kelantan,35,12,23,2016
2016-02-16,Kelantan,64,39,25,2016
2016-02-17,Kelantan,102,47,55,2016
2016-02-18,Kelantan,41,29,12,2016
2016-02-19,Kelantan,43,21,22,2016
2016-02-20,Kelantan,71,26,45,2016
2016-02-21,Kelantan,10,2,8,2016
2016-02-22,Kelantan,20,5,15,2016
2016-02-23,Kelantan,31,12,19,2016
2016-02-24,Kelantan,129,86,43,2016
2016-02-25,Kelantan,24,13,11,2016
2016-02-26,Kelantan,50,18,32,2016
2016-02-27,Kelantan,29,9,20,2016
2016-02-28,Kelantan,65,42,23,2016
2016-02-29,Kelantan,66,41,25,2016
2016-03-01,Kelantan,29,7,22,2016
2016-03-02,Kelantan,30,16,14,2016
2016-03-03,Kelantan,25,11,14,2016
2016-03-04,Kelantan,111,38,73,2016
2016-03-05,Kelantan,14,2,12,2016
2016-03-06,Kelantan,26,8,18,2016
2016-03-07,Kelantan,20,7,13,2016
2016-03-08,Kelantan,37,20,17,2016
2016-03-09,Kelantan,38,15,23,2016
2016-03-10,Kelantan,76,41,35,2016
2016-03-11,Kelantan,61,32,29,2016
2016-03-12,Kelantan,57,18,39,2016
2016-03-13,Kelantan,52,25,27,2016
2016-03-14,Kelantan,77,28,49,2016
2016-03-15,Kelantan,30,15,15,2016
2016-03-16,Kelantan,93,33,60,2016
2016-03-17,Kelantan,52,18,34,2016
2016-03-18,Kelantan,49,23,26,2016
2016-03-19,Kelantan,40,19,21,2016
2016-03-20,Kelantan,36,12,24,2016
2016-03-21,Kelantan,41,31,10,2016
2016-03-22,Kelantan,40,21,19,2016
2016-03-23,Kelantan,20,5,15,2016
2016-03-24,Kelantan,65,38,27,2016
2016-03-25,Kelantan,36,15,21,2016
2016-03-26,Kelantan,97,38,59,2016
2016-03-27,Kelantan,32,13,19,2016
2016-03-28,Kelantan,50,17,33,2016
2016-03-29,Kelantan,64,34,30,2016
2016-03-30,Kelantan,85,56,29,2016
2016-03-31,Kelantan,14,3,11,2016
2016-04-01,Kelantan,21,8,13,2016
2016-04-02,Kelantan,10,2,8,2016
2016-04-03,Kelantan,20,2,18,2016
2016-04-04,Kelantan,10,0,10,2016
2016-04-05,Kelantan,107,47,60,2016
2016-04-06,Kelantan,217,93,124,2016
2016-04-07,Kelantan,39,17,22,2016
2016-04-08,Kelantan,41,21,20,2016
2016-04-09,Kelantan,32,10,22,2016
2016-04-10,Kelantan,28,16,12,2016
2016-04-11,Kelantan,29,13,16,2016
2016-04-12,Kelantan,39,25,14,2016
2016-04-13,Kelantan,22,9,13,2016
2016-04-14,Kelantan,65,19,46,2016
2016-04-15,Kelantan,13,3,10,2016
2016-04-16,Kelantan,132,63,69,2016
2016-04-17,Kelantan,10,4,6,2016
2016-04-18,Kelantan,41,8,33,2016
2016-04-19,Kelantan,43,8,35,2016
2016-04-20,Kelantan,29,10,19,2016
2016-04-21,Kelantan,37,21,16,2016
2016-04-22,Kelantan,38,9,29,2016
2016-04-23,Kelantan,92,45,47,2016
2016-04-24,Kelantan,13,4,9,2016
2016-04-25,Kelantan,9,3,6,2016
2016-04-26,Kelantan,70,31,39,2016
2016-04-27,Kelantan,75,34,41,2016
2016-04-28,Kelantan,42,24,18,2016
2016-04-29,Kelantan,23,14,9,2016
2016-04-30,Kelantan,9,3,6,2016
2016-05-01,Kelantan,34,23,11,2016
2016-05-02,Kelantan,36,17,19,2016
2016-05-03,Kelantan,76,50,26,2016
2016-05-04,Kelantan,89,58,31,2016
2016-05-05,Kelantan,163,73,90,2016
2016-05-06,Kelantan,33,2,31,2016
2016-05-07,Kelantan,49,19,30,2016
2016-05-08,Kelantan,89,34,55,2016
2016-05-09,Kelantan,94,81,13,2016
2016-05-10,Kelantan,113,97,16,2016
2016-05-11,Kelantan,41,29,12,2016
2016-05-12,Kelantan,76,61,15,2016
2016-05-13,Kelantan,72,50,22,2016
2016-05-14,Kelantan,18,15,3,2016
2016-05-15,Kelantan,46,32,14,2016
2016-05-16,Kelantan,78,46,32,2016
2016-05-17,Kelantan,65,31,34,2016
2016-05-18,Kelantan,48,20,28,2016
2016-05-19,Kelantan,63,45,18,2016
2016-05-20,Kelantan,16,15,1,2016
2016-05-21,Kelantan,20,9,11,2016
2016-05-22,Kelantan,9,5,4,2016
2016-05-23,Kelantan,93,39,54,2016
2016-05-24,Kelantan,3,1,2,2016
2016-05-25,Kelantan,39,12,27,2016
2016-05-26,Kelantan,29,11,18,2016
2016-05-27,Kelantan,67,25,42,2016
2016-05-28,Kelantan,52,30,22,2016
2016-05-29,Kelantan,6,1,5,2016
2016-05-30,Kelantan,83,57,26,2016
2016-05-31,Kelantan,125,47,78,2016
2016-06-01,Kelantan,8,0,8,2016
2016-06-02,Kelantan,35,10,25,2016
2016-06-03,Kelantan,84,30,54,2016
2016-06-04,Kelantan,64,18,46,2016
2016-06-05,Kelantan,33,14,19,2016
2016-06-06,Kelantan,2,1,1,2016
2016-06-07,Kelantan,16,7,9,2016
2016-06-08,Kelantan,40,32,8,2016
2016-06-09,Kelantan,22,7,15,2016
2016-06-10,Kelantan,0,0,0,2016
2016-06-11,Kelantan,13,6,7,2016
2016-06-12,Kelantan,22,6,16,2016
2016-06-13,Kelantan,19,9,10,2016
2016-06-14,Kelantan,29,8,21,2016
2016-06-15,Kelantan,19,8,11,2016
2016-06-16,Kelantan,27,11,16,2016
2016-06-17,Kelantan,126,30,96,2016
2016-06-18,Kelantan,0,0,0,2016
2016-06-19,Kelantan,24,6,18,2016
2016-06-20,Kelantan,39,16,23,2016
2016-06-21,Kelantan,30,20,10,2016
2016-06-22,Kelantan,41,14,27,2016
2016-06-23,Kelantan,32,8,24,2016
2016-06-24,Kelantan,64,17,47,2016
2016-06-25,Kelantan,35,19,16,2016
2016-06-26,Kelantan,37,15,22,2016
2016-06-27,Kelantan,28,14,14,2016
2016-06-28,Kelantan,22,10,12,2016
2016-06-29,Kelantan,39,24,15,2016
2016-06-30,Kelantan,21,6,15,2016
2016-07-01,Kelantan,24,8,16,2016
2016-07-02,Kelantan,0,0,0,2016
2016-07-03,Kelantan,32,15,17,2016
2016-07-04,Kelantan,34,14,20,2016
2016-07-05,Kelantan,0,0,0,2016
2016-07-06,Kelantan,0,0,0,2016
2016-07-07,Kelantan,0,0,0,2016
2016-07-08,Kelantan,22,6,16,2016
2016-07-09,Kelantan,21,9,12,2016
2016-07-10,Kelantan,20,1,19,2016
2016-07-11,Kelantan,27,4,23,2016
2016-07-12,Kelantan,40,9,31,2016
2016-07-13,Kelantan,44,11,33,2016
2016-07-14,Kelantan,77,36,41,2016
2016-07-15,Kelantan,60,21,39,2016
2016-07-16,Kelantan,35,14,21,2016
2016-07-17,Kelantan,41,11,30,2016
2016-07-18,Kelantan,28,3,25,2016
2016-07-19,Kelantan,41,14,27,2016
2016-07-20,Kelantan,51,26,25,2016
2016-07-21,Kelantan,95,70,25,2016
2016-07-22,Kelantan,16,9,7,2016
2016-07-23,Kelantan,42,23,19,2016
2016-07-24,Kelantan,41,23,18,2016
2016-07-25,Kelantan,95,65,30,2016
2016-07-26,Kelantan,18,5,13,2016
2016-07-27,Kelantan,66,44,22,2016
2016-07-28,Kelantan,76,35,41,2016
2016-07-29,Kelantan,53,15,38,2016
2016-07-30,Kelantan,15,5,10,2016
2016-07-31,Kelantan,30,13,17,2016
2016-08-01,Kelantan,60,34,26,2016
2016-08-02,Kelantan,94,77,17,2016
2016-08-03,Kelantan,71,36,35,2016
2016-08-04,Kelantan,33,13,20,2016
2016-08-05,Kelantan,57,26,31,2016
2016-08-06,Kelantan,47,20,27,2016
2016-08-07,Kelantan,49,29,20,2016
2016-08-08,Kelantan,42,31,11,2016
2016-08-09,Kelantan,46,27,19,2016
2016-08-10,Kelantan,109,87,22,2016
2016-08-11,Kelantan,45,28,17,2016
2016-08-12,Kelantan,12,8,4,2016
2016-08-13,Kelantan,21,11,10,2016
2016-08-14,Kelantan,79,25,54,2016
2016-08-15,Kelantan,86,24,62,2016
2016-08-16,Kelantan,47,31,16,2016
2016-08-17,Kelantan,17,10,7,2016
2016-08-18,Kelantan,42,18,24,2016
2016-08-19,Kelantan,0,0,0,2016
2016-08-20,Kelantan,101,45,56,2016
2016-08-21,Kelantan,43,16,27,2016
2016-08-22,Kelantan,19,8,11,2016
2016-08-23,Kelantan,117,49,68,2016
2016-08-24,Kelantan,71,38,33,2016
2016-08-25,Kelantan,5,1,4,2016
2016-08-26,Kelantan,35,20,15,2016
2016-08-27,Kelantan,24,20,4,2016
2016-08-28,Kelantan,21,11,10,2016
2016-08-29,Kelantan,39,25,14,2016
2016-08-30,Kelantan,13,7,6,2016
2016-08-31,Kelantan,30,12,18,2016
2016-09-01,Kelantan,36,5,31,2016
2016-09-02,Kelantan,0,0,0,2016
2016-09-03,Kelantan,26,13,13,2016
2016-09-04,Kelantan,32,15,17,2016
2016-09-05,Kelantan,86,28,58,2016
2016-09-06,Kelantan,63,29,34,2016
2016-09-07,Kelantan,103,40,63,2016
2016-09-08,Kelantan,57,25,32,2016
2016-09-09,Kelantan,2,0,2,2016
2016-09-10,Kelantan,0,0,0,2016
2016-09-11,Kelantan,36,14,22,2016
2016-09-12,Kelantan,0,0,0,2016
2016-09-13,Kelantan,15,11,4,2016
2016-09-14,Kelantan,19,7,12,2016
2016-09-15,Kelantan,69,22,47,2016
2016-09-16,Kelantan,8,4,4,2016
2016-09-17,Kelantan,42,21,21,2016
2016-09-18,Kelantan,3,1,2,2016
2016-09-19,Kelantan,86,45,41,2016
2016-09-20,Kelantan,89,38,51,2016
2016-09-21,Kelantan,43,24,19,2016
2016-09-22,Kelantan,15,10,5,2016
2016-09-23,Kelantan,16,1,15,2016
2016-09-24,Kelantan,96,37,59,2016
2016-09-25,Kelantan,125,55,70,2016
2016-09-26,Kelantan,103,40,63,2016
2016-09-27,Kelantan,80,34,46,2016
2016-09-28,Kelantan,37,22,15,2016
2016-09-29,Kelantan,16,8,8,2016
2016-09-30,Kelantan,0,0,0,2016
2016-10-01,Kelantan,84,34,50,2016
2016-10-02,Kelantan,30,9,21,2016
2016-10-03,Kelantan,43,13,30,2016
2016-10-04,Kelantan,38,12,26,2016
2016-10-05,Kelantan,46,23,23,2016
2016-10-06,Kelantan,21,8,13,2016
2016-10-07,Kelantan,48,23,25,2016
2016-10-08,Kelantan,39,18,21,2016
2016-10-09,Kelantan,16,3,13,2016
2016-10-10,Kelantan,14,3,11,2016
2016-10-11,Kelantan,83,32,51,2016
2016-10-12,Kelantan,89,50,39,2016
2016-10-13,Kelantan,14,5,9,2016
2016-10-14,Kelantan,57,25,32,2016
2016-10-15,Kelantan,19,5,14,2016
2016-10-16,Kelantan,48,21,27,2016
2016-10-17,Kelantan,13,3,10,2016
2016-10-18,Kelantan,26,7,19,2016
2016-10-19,Kelantan,5,0,5,2016
2016-10-20,Kelantan,117,57,60,2016
2016-10-21,Kelantan,31,13,18,2016
2016-10-22,Kelantan,41,25,16,2016
2016-10-23,Kelantan,15,4,11,2016
2016-10-24,Kelantan,54,24,30,2016
2016-10-25,Kelantan,17,6,11,2016
2016-10-26,Kelantan,8,2,6,2016
2016-10-27,Kelantan,20,5,15,2016
2016-10-28,Kelantan,5,3,2,2016
2016-10-29,Kelantan,13,4,9,2016
2016-10-30,Kelantan,14,5,9,2016
2016-10-31,Kelantan,4,0,4,2016
2016-11-01,Kelantan,26,19,7,2016
2016-11-02,Kelantan,27,12,15,2016
2016-11-03,Kelantan,40,14,26,2016
2016-11-04,Kelantan,53,16,37,2016
2016-11-05,Kelantan,125,56,69,2016
2016-11-06,Kelantan,29,10,19,2016
2016-11-07,Kelantan,53,25,28,2016
2016-11-08,Kelantan,51,33,18,2016
2016-11-09,Kelantan,62,35,27,2016
2016-11-10,Kelantan,15,9,6,2016
2016-11-11,Kelantan,12,3,9,2016
2016-11-12,Kelantan,41,20,21,2016
2016-11-13,Kelantan,38,17,21,2016
2016-11-14,Kelantan,33,8,25,2016
2016-11-15,Kelantan,26,9,17,2016
2016-11-16,Kelantan,21,9,12,2016
2016-11-17,Kelantan,28,12,16,2016
2016-11-18,Kelantan,18,8,10,2016
2016-11-19,Kelantan,33,15,18,2016
2016-11-20,Kelantan,103,35,68,2016
2016-11-21,Kelantan,38,13,25,2016
2016-11-22,Kelantan,25,8,17,2016
2016-11-23,Kelantan,29,15,14,2016
2016-11-24,Kelantan,30,10,20,2016
2016-11-25,Kelantan,24,10,14,2016
2016-11-26,Kelantan,47,15,32,2016
2016-11-27,Kelantan,53,18,35,2016
2016-11-28,Kelantan,21,12,9,2016
2016-11-29,Kelantan,21,8,13,2016
2016-11-30,Kelantan,36,10,26,2016
2016-12-01,Kelantan,20,9,11,2016
2016-12-02,Kelantan,23,14,9,2016
2016-12-03,Kelantan,42,18,24,2016
2016-12-04,Kelantan,68,19,49,2016
2016-12-05,Kelantan,35,14,21,2016
2016-12-06,Kelantan,105,54,51,2016
2016-12-07,Kelantan,113,71,42,2016
2016-12-08,Kelantan,17,1,16,2016
2016-12-09,Kelantan,12,4,8,2016
2016-12-10,Kelantan,29,9,20,2016
2016-12-11,Kelantan,38,12,26,2016
2016-12-12,Kelantan,30,19,11,2016
2016-12-13,Kelantan,9,6,3,2016
2016-12-14,Kelantan,23,9,14,2016
2016-12-15,Kelantan,17,4,13,2016
2016-12-16,Kelantan,21,3,18,2016
2016-12-17,Kelantan,12,7,5,2016
2016-12-18,Kelantan,30,2,28,2016
2016-12-19,Kelantan,10,0,10,2016
2016-12-20,Kelantan,30,16,14,2016
2016-12-21,Kelantan,39,19,20,2016
2016-12-22,Kelantan,58,41,17,2016
2016-12-23,Kelantan,24,9,15,2016
2016-12-24,Kelantan,49,15,34,2016
2016-12-25,Kelantan,45,16,29,2016
2016-12-26,Kelantan,34,18,16,2016
2016-12-27,Kelantan,28,18,10,2016
2016-12-28,Kelantan,36,14,22,2016
2016-12-29,Kelantan,22,8,14,2016
2016-12-30,Kelantan,23,11,12,2016
2016-12-31,Kelantan,10,4,6,2016
2017-01-01,Kelantan,28,4,24,2017
2017-01-02,Kelantan,0,0,0,2017
2017-01-03,Kelantan,1,1,0,2017
2017-01-04,Kelantan,0,0,0,2017
2017-01-05,Kelantan,0,0,0,2017
2017-01-06,Kelantan,0,0,0,2017
2017-01-07,Kelantan,0,0,0,2017
2017-01-08,Kelantan,0,0,0,2017
2017-01-09,Kelantan,0,0,0,2017
2017-01-10,Kelantan,0,0,0,2017
2017-01-11,Kelantan,0,0,0,2017
2017-01-12,Kelantan,0,0,0,2017
2017-01-13,Kelantan,0,0,0,2017
2017-01-14,Kelantan,0,0,0,2017
2017-01-15,Kelantan,1,0,1,2017
2017-01-16,Kelantan,0,0,0,2017
2017-01-17,Kelantan,0,0,0,2017
2017-01-18,Kelantan,0,0,0,2017
2017-01-19,Kelantan,0,0,0,2017
2017-01-20,Kelantan,0,0,0,2017
2017-01-21,Kelantan,0,0,0,2017
2017-01-22,Kelantan,0,0,0,2017
2017-01-23,Kelantan,0,0,0,2017
2017-01-24,Kelantan,0,0,0,2017
2017-01-25,Kelantan,0,0,0,2017
2017-01-26,Kelantan,0,0,0,2017
2017-01-27,Kelantan,0,0,0,2017
2017-01-28,Kelantan,0,0,0,2017
2017-01-29,Kelantan,0,0,0,2017
2017-01-30,Kelantan,0,0,0,2017
2017-01-31,Kelantan,0,0,0,2017
2017-02-01,Kelantan,0,0,0,2017
2017-02-02,Kelantan,0,0,0,2017
2017-02-03,Kelantan,0,0,0,2017
2017-02-04,Kelantan,0,0,0,2017
2017-02-05,Kelantan,0,0,0,2017
2017-02-06,Kelantan,0,0,0,2017
2017-02-07,Kelantan,0,0,0,2017
2017-02-08,Kelantan,0,0,0,2017
2017-02-09,Kelantan,1,0,1,2017
2017-02-10,Kelantan,0,0,0,2017
2017-02-11,Kelantan,0,0,0,2017
2017-02-12,Kelantan,0,0,0,2017
2017-02-13,Kelantan,0,0,0,2017
2017-02-14,Kelantan,0,0,0,2017
2017-02-15,Kelantan,0,0,0,2017
2017-02-16,Kelantan,0,0,0,2017
2017-02-17,Kelantan,0,0,0,2017
2017-02-18,Kelantan,0,0,0,2017
2017-02-19,Kelantan,0,0,0,2017
2017-02-20,Kelantan,0,0,0,2017
2017-02-21,Kelantan,0,0,0,2017
2017-02-22,Kelantan,0,0,0,2017
2017-02-23,Kelantan,0,0,0,2017
2017-02-24,Kelantan,0,0,0,2017
2017-02-25,Kelantan,0,0,0,2017
2017-02-26,Kelantan,0,0,0,2017
2017-02-27,Kelantan,0,0,0,2017
2017-02-28,Kelantan,0,0,0,2017
2017-03-01,Kelantan,0,0,0,2017
2017-03-02,Kelantan,0,0,0,2017
2017-03-03,Kelantan,0,0,0,2017
2017-03-04,Kelantan,0,0,0,2017
2017-03-05,Kelantan,0,0,0,2017
2017-03-06,Kelantan,0,0,0,2017
2017-03-07,Kelantan,0,0,0,2017
2017-03-08,Kelantan,0,0,0,2017
2017-03-09,Kelantan,0,0,0,2017
2017-03-10,Kelantan,0,0,0,2017
2017-03-11,Kelantan,0,0,0,2017
2017-03-12,Kelantan,0,0,0,2017
2017-03-13,Kelantan,0,0,0,2017
2017-03-14,Kelantan,0,0,0,2017
2017-03-15,Kelantan,0,0,0,2017
2017-03-16,Kelantan,0,0,0,2017
2017-03-17,Kelantan,0,0,0,2017
2017-03-18,Kelantan,0,0,0,2017
2017-03-19,Kelantan,0,0,0,2017
2017-03-20,Kelantan,0,0,0,2017
2017-03-21,Kelantan,0,0,0,2017
2017-03-22,Kelantan,0,0,0,2017
2017-03-23,Kelantan,0,0,0,2017
2017-03-24,Kelantan,0,0,0,2017
2017-03-25,Kelantan,0,0,0,2017
2017-03-26,Kelantan,0,0,0,2017
2017-03-27,Kelantan,0,0,0,2017
2017-03-28,Kelantan,0,0,0,2017
2017-03-29,Kelantan,0,0,0,2017
2017-03-30,Kelantan,0,0,0,2017
2017-03-31,Kelantan,0,0,0,2017
2017-04-01,Kelantan,0,0,0,2017
2017-04-02,Kelantan,0,0,0,2017
2017-04-03,Kelantan,0,0,0,2017
2017-04-04,Kelantan,0,0,0,2017
2017-04-05,Kelantan,0,0,0,2017
2017-04-06,Kelantan,0,0,0,2017
2017-04-07,Kelantan,0,0,0,2017
2017-04-08,Kelantan,0,0,0,2017
2017-04-09,Kelantan,0,0,0,2017
2017-04-10,Kelantan,0,0,0,2017
2017-04-11,Kelantan,0,0,0,2017
2017-04-12,Kelantan,0,0,0,2017
2017-04-13,Kelantan,0,0,0,2017
2017-04-14,Kelantan,0,0,0,2017
2017-04-15,Kelantan,0,0,0,2017
2017-04-16,Kelantan,0,0,0,2017
2017-04-17,Kelantan,0,0,0,2017
2017-04-18,Kelantan,0,0,0,2017
2017-04-19,Kelantan,0,0,0,2017
2017-04-20,Kelantan,0,0,0,2017
2017-04-21,Kelantan,0,0,0,2017
2017-04-22,Kelantan,0,0,0,2017
2017-04-23,Kelantan,0,0,0,2017
2017-04-24,Kelantan,0,0,0,2017
2017-04-25,Kelantan,0,0,0,2017
2017-04-26,Kelantan,0,0,0,2017
2017-04-27,Kelantan,0,0,0,2017
2017-04-28,Kelantan,0,0,0,2017
2017-04-29,Kelantan,0,0,0,2017
2017-04-30,Kelantan,0,0,0,2017
2017-05-01,Kelantan,0,0,0,2017
2017-05-02,Kelantan,0,0,0,2017
2017-05-03,Kelantan,0,0,0,2017
2017-05-04,Kelantan,0,0,0,2017
2017-05-05,Kelantan,0,0,0,2017
2017-05-06,Kelantan,0,0,0,2017
2017-05-07,Kelantan,0,0,0,2017
2017-05-08,Kelantan,0,0,0,2017
2017-05-09,Kelantan,0,0,0,2017
2017-05-10,Kelantan,0,0,0,2017
2017-05-11,Kelantan,0,0,0,2017
2017-05-12,Kelantan,0,0,0,2017
2017-05-13,Kelantan,0,0,0,2017
2017-05-14,Kelantan,0,0,0,2017
2017-05-15,Kelantan,0,0,0,2017
2017-05-16,Kelantan,0,0,0,2017
2017-05-17,Kelantan,0,0,0,2017
2017-05-18,Kelantan,0,0,0,2017
2017-05-19,Kelantan,0,0,0,2017
2017-05-20,Kelantan,0,0,0,2017
2017-05-21,Kelantan,0,0,0,2017
2017-05-22,Kelantan,0,0,0,2017
2017-05-23,Kelantan,0,0,0,2017
2017-05-24,Kelantan,0,0,0,2017
2017-05-25,Kelantan,0,0,0,2017
2017-05-26,Kelantan,0,0,0,2017
2017-05-27,Kelantan,0,0,0,2017
2017-05-28,Kelantan,0,0,0,2017
2017-05-29,Kelantan,0,0,0,2017
2017-05-30,Kelantan,0,0,0,2017
2017-05-31,Kelantan,0,0,0,2017
2017-06-01,Kelantan,0,0,0,2017
2017-06-02,Kelantan,0,0,0,2017
2017-06-03,Kelantan,0,0,0,2017
2017-06-04,Kelantan,0,0,0,2017
2017-06-05,Kelantan,0,0,0,2017
2017-06-06,Kelantan,0,0,0,2017
2017-06-07,Kelantan,0,0,0,2017
2017-06-08,Kelantan,0,0,0,2017
2017-06-09,Kelantan,0,0,0,2017
2017-06-10,Kelantan,0,0,0,2017
2017-06-11,Kelantan,0,0,0,2017
2017-06-12,Kelantan,0,0,0,2017
2017-06-13,Kelantan,0,0,0,2017
2017-06-14,Kelantan,0,0,0,2017
2017-06-15,Kelantan,0,0,0,2017
2017-06-16,Kelantan,0,0,0,2017
2017-06-17,Kelantan,0,0,0,2017
2017-06-18,Kelantan,0,0,0,2017
2017-06-19,Kelantan,0,0,0,2017
2017-06-20,Kelantan,0,0,0,2017
2017-06-21,Kelantan,1,1,0,2017
2017-06-22,Kelantan,0,0,0,2017
2017-06-23,Kelantan,0,0,0,2017
2017-06-24,Kelantan,0,0,0,2017
2017-06-25,Kelantan,0,0,0,2017
2017-06-26,Kelantan,0,0,0,2017
2017-06-27,Kelantan,0,0,0,2017
2017-06-28,Kelantan,0,0,0,2017
2017-06-29,Kelantan,0,0,0,2017
2017-06-30,Kelantan,0,0,0,2017
2017-07-01,Kelantan,0,0,0,2017
2017-07-02,Kelantan,0,0,0,2017
2017-07-03,Kelantan,0,0,0,2017
2017-07-04,Kelantan,0,0,0,2017
2017-07-05,Kelantan,0,0,0,2017
2017-07-06,Kelantan,0,0,0,2017
2017-07-07,Kelantan,0,0,0,2017
2017-07-08,Kelantan,0,0,0,2017
2017-07-09,Kelantan,0,0,0,2017
2017-07-10,Kelantan,0,0,0,2017
2017-07-11,Kelantan,0,0,0,2017
2017-07-12,Kelantan,1,0,1,2017
2017-07-13,Kelantan,0,0,0,2017
2017-07-14,Kelantan,0,0,0,2017
2017-07-15,Kelantan,0,0,0,2017
2017-07-16,Kelantan,0,0,0,2017
2017-07-17,Kelantan,0,0,0,2017
2017-07-18,Kelantan,0,0,0,2017
2017-07-19,Kelantan,0,0,0,2017
2017-07-20,Kelantan,0,0,0,2017
2017-07-21,Kelantan,0,0,0,2017
2017-07-22,Kelantan,0,0,0,2017
2017-07-23,Kelantan,0,0,0,2017
2017-07-24,Kelantan,0,0,0,2017
2017-07-25,Kelantan,0,0,0,2017
2017-07-26,Kelantan,0,0,0,2017
2017-07-27,Kelantan,0,0,0,2017
2017-07-28,Kelantan,0,0,0,2017
2017-07-29,Kelantan,0,0,0,2017
2017-07-30,Kelantan,0,0,0,2017
2017-07-31,Kelantan,0,0,0,2017
2017-08-01,Kelantan,0,0,0,2017
2017-08-02,Kelantan,0,0,0,2017
2017-08-03,Kelantan,0,0,0,2017
2017-08-04,Kelantan,0,0,0,2017
2017-08-05,Kelantan,0,0,0,2017
2017-08-06,Kelantan,0,0,0,2017
2017-08-07,Kelantan,0,0,0,2017
2017-08-08,Kelantan,0,0,0,2017
2017-08-09,Kelantan,0,0,0,2017
2017-08-10,Kelantan,0,0,0,2017
2017-08-11,Kelantan,0,0,0,2017
2017-08-12,Kelantan,0,0,0,2017
2017-08-13,Kelantan,0,0,0,2017
2017-08-14,Kelantan,0,0,0,2017
2017-08-15,Kelantan,0,0,0,2017
2017-08-16,Kelantan,0,0,0,2017
2017-08-17,Kelantan,0,0,0,2017
2017-08-18,Kelantan,0,0,0,2017
2017-08-19,Kelantan,0,0,0,2017
2017-08-20,Kelantan,0,0,0,2017
2017-08-21,Kelantan,0,0,0,2017
2017-08-22,Kelantan,0,0,0,2017
2017-08-23,Kelantan,0,0,0,2017
2017-08-24,Kelantan,0,0,0,2017
2017-08-25,Kelantan,0,0,0,2017
2017-08-26,Kelantan,0,0,0,2017
2017-08-27,Kelantan,0,0,0,2017
2017-08-28,Kelantan,0,0,0,2017
2017-08-29,Kelantan,0,0,0,2017
2017-08-30,Kelantan,0,0,0,2017
2017-08-31,Kelantan,0,0,0,2017
2017-09-01,Kelantan,0,0,0,2017
2017-09-02,Kelantan,0,0,0,2017
2017-09-03,Kelantan,0,0,0,2017
2017-09-04,Kelantan,0,0,0,2017
2017-09-05,Kelantan,0,0,0,2017
2017-09-06,Kelantan,0,0,0,2017
2017-09-07,Kelantan,0,0,0,2017
2017-09-08,Kelantan,0,0,0,2017
2017-09-09,Kelantan,0,0,0,2017
2017-09-10,Kelantan,0,0,0,2017
2017-09-11,Kelantan,0,0,0,2017
2017-09-12,Kelantan,0,0,0,2017
2017-09-13,Kelantan,0,0,0,2017
2017-09-14,Kelantan,0,0,0,2017
2017-09-15,Kelantan,0,0,0,2017
2017-09-16,Kelantan,0,0,0,2017
2017-09-17,Kelantan,0,0,0,2017
2017-09-18,Kelantan,0,0,0,2017
2017-09-19,Kelantan,0,0,0,2017
2017-09-20,Kelantan,0,0,0,2017
2017-09-21,Kelantan,0,0,0,2017
2017-09-22,Kelantan,0,0,0,2017
2017-09-23,Kelantan,0,0,0,2017
2017-09-24,Kelantan,1,0,1,2017
2017-09-25,Kelantan,0,0,0,2017
2017-09-26,Kelantan,0,0,0,2017
2017-09-27,Kelantan,0,0,0,2017
2017-09-28,Kelantan,0,0,0,2017
2017-09-29,Kelantan,0,0,0,2017
2017-09-30,Kelantan,0,0,0,2017
2017-10-01,Kelantan,0,0,0,2017
2017-10-02,Kelantan,0,0,0,2017
2017-10-03,Kelantan,0,0,0,2017
2017-10-04,Kelantan,0,0,0,2017
2017-10-05,Kelantan,0,0,0,2017
2017-10-06,Kelantan,0,0,0,2017
2017-10-07,Kelantan,0,0,0,2017
2017-10-08,Kelantan,0,0,0,2017
2017-10-09,Kelantan,0,0,0,2017
2017-10-10,Kelantan,0,0,0,2017
2017-10-11,Kelantan,1,1,0,2017
2017-10-12,Kelantan,0,0,0,2017
2017-10-13,Kelantan,0,0,0,2017
2017-10-14,Kelantan,0,0,0,2017
2017-10-15,Kelantan,0,0,0,2017
2017-10-16,Kelantan,0,0,0,2017
2017-10-17,Kelantan,0,0,0,2017
2017-10-18,Kelantan,0,0,0,2017
2017-10-19,Kelantan,0,0,0,2017
2017-10-20,Kelantan,0,0,0,2017
2017-10-21,Kelantan,0,0,0,2017
2017-10-22,Kelantan,0,0,0,2017
2017-10-23,Kelantan,0,0,0,2017
2017-10-24,Kelantan,0,0,0,2017
2017-10-25,Kelantan,0,0,0,2017
2017-10-26,Kelantan,0,0,0,2017
2017-10-27,Kelantan,0,0,0,2017
2017-10-28,Kelantan,0,0,0,2017
2017-10-29,Kelantan,0,0,0,2017
2017-10-30,Kelantan,0,0,0,2017
2017-10-31,Kelantan,0,0,0,2017
2017-11-01,Kelantan,0,0,0,2017
2017-11-02,Kelantan,0,0,0,2017
2017-11-03,Kelantan,0,0,0,2017
2017-11-04,Kelantan,0,0,0,2017
2017-11-05,Kelantan,0,0,0,2017
2017-11-06,Kelantan,0,0,0,2017
2017-11-07,Kelantan,0,0,0,2017
2017-11-08,Kelantan,0,0,0,2017
2017-11-09,Kelantan,0,0,0,2017
2017-11-10,Kelantan,0,0,0,2017
2017-11-11,Kelantan,0,0,0,2017
2017-11-12,Kelantan,0,0,0,2017
2017-11-13,Kelantan,0,0,0,2017
2017-11-14,Kelantan,0,0,0,2017
2017-11-15,Kelantan,0,0,0,2017
2017-11-16,Kelantan,0,0,0,2017
2017-11-17,Kelantan,0,0,0,2017
2017-11-18,Kelantan,0,0,0,2017
2017-11-19,Kelantan,0,0,0,2017
2017-11-20,Kelantan,0,0,0,2017
2017-11-21,Kelantan,0,0,0,2017
2017-11-22,Kelantan,0,0,0,2017
2017-11-23,Kelantan,0,0,0,2017
2017-11-24,Kelantan,0,0,0,2017
2017-11-25,Kelantan,0,0,0,2017
2017-11-26,Kelantan,0,0,0,2017
2017-11-27,Kelantan,0,0,0,2017
2017-11-28,Kelantan,0,0,0,2017
2017-11-29,Kelantan,0,0,0,2017
2017-11-30,Kelantan,0,0,0,2017
2017-12-01,Kelantan,0,0,0,2017
2017-12-02,Kelantan,0,0,0,2017
2017-12-03,Kelantan,0,0,0,2017
2017-12-04,Kelantan,0,0,0,2017
2017-12-05,Kelantan,0,0,0,2017
2017-12-06,Kelantan,0,0,0,2017
2017-12-07,Kelantan,0,0,0,2017
2017-12-08,Kelantan,0,0,0,2017
2017-12-09,Kelantan,0,0,0,2017
2017-12-10,Kelantan,0,0,0,2017
2017-12-11,Kelantan,0,0,0,2017
2017-12-12,Kelantan,0,0,0,2017
2017-12-13,Kelantan,0,0,0,2017
2017-12-14,Kelantan,0,0,0,2017
2017-12-15,Kelantan,0,0,0,2017
2017-12-16,Kelantan,0,0,0,2017
2017-12-17,Kelantan,0,0,0,2017
2017-12-18,Kelantan,0,0,0,2017
2017-12-19,Kelantan,0,0,0,2017
2017-12-20,Kelantan,0,0,0,2017
2017-12-21,Kelantan,0,0,0,2017
2017-12-22,Kelantan,0,0,0,2017
2017-12-23,Kelantan,0,0,0,2017
2017-12-24,Kelantan,0,0,0,2017
2017-12-25,Kelantan,0,0,0,2017
2017-12-26,Kelantan,0,0,0,2017
2017-12-27,Kelantan,0,0,0,2017
2017-12-28,Kelantan,0,0,0,2017
2017-12-29,Kelantan,0,0,0,2017
2017-12-30,Kelantan,0,0,0,2017
2017-12-31,Kelantan,0,0,0,2017
2018-01-01,Kelantan,83,31,52,2018
2018-01-02,Kelantan,21,9,12,2018
2018-01-03,Kelantan,20,5,15,2018
2018-01-04,Kelantan,43,35,8,2018
2018-01-05,Kelantan,21,6,15,2018
2018-01-06,Kelantan,46,19,27,2018
2018-01-07,Kelantan,74,50,24,2018
2018-01-08,Kelantan,35,12,23,2018
2018-01-09,Kelantan,22,7,15,2018
2018-01-10,Kelantan,18,6,12,2018
2018-01-11,Kelantan,59,41,18,2018
2018-01-12,Kelantan,44,17,27,2018
2018-01-13,Kelantan,77,42,35,2018
2018-01-14,Kelantan,11,4,7,2018
2018-01-15,Kelantan,84,66,18,2018
2018-01-16,Kelantan,64,58,6,2018
2018-01-17,Kelantan,60,49,11,2018
2018-01-18,Kelantan,131,108,23,2018
2018-01-19,Kelantan,131,84,47,2018
2018-01-20,Kelantan,24,7,17,2018
2018-01-21,Kelantan,53,52,1,2018
2018-01-22,Kelantan,57,53,4,2018
2018-01-23,Kelantan,93,84,9,2018
2018-01-24,Kelantan,5,1,4,2018
2018-01-25,Kelantan,46,38,8,2018
2018-01-26,Kelantan,121,50,71,2018
2018-01-27,Kelantan,0,0,0,2018
2018-01-28,Kelantan,57,19,38,2018
2018-01-29,Kelantan,84,52,32,2018
2018-01-30,Kelantan,14,2,12,2018
2018-01-31,Kelantan,32,24,8,2018
2018-02-01,Kelantan,52,42,10,2018
2018-02-02,Kelantan,18,5,13,2018
2018-02-03,Kelantan,41,11,30,2018
2018-02-04,Kelantan,12,5,7,2018
2018-02-05,Kelantan,65,59,6,2018
2018-02-06,Kelantan,39,33,6,2018
2018-02-07,Kelantan,125,90,35,2018
2018-02-08,Kelantan,52,38,14,2018
2018-02-09,Kelantan,10,4,6,2018
2018-02-10,Kelantan,35,15,20,2018
2018-02-11,Kelantan,56,47,9,2018
2018-02-12,Kelantan,72,53,19,2018
2018-02-13,Kelantan,62,54,8,2018
2018-02-14,Kelantan,74,69,5,2018
2018-02-15,Kelantan,27,8,19,2018
2018-02-16,Kelantan,29,9,20,2018
2018-02-17,Kelantan,45,19,26,2018
2018-02-18,Kelantan,25,11,14,2018
2018-02-19,Kelantan,37,15,22,2018
2018-02-20,Kelantan,26,16,10,2018
2018-02-21,Kelantan,12,3,9,2018
2018-02-22,Kelantan,163,101,62,2018
2018-02-23,Kelantan,0,0,0,2018
2018-02-24,Kelantan,55,15,40,2018
2018-02-25,Kelantan,12,0,12,2018
2018-02-26,Kelantan,21,9,12,2018
2018-02-27,Kelantan,22,8,14,2018
2018-02-28,Kelantan,14,6,8,2018
2018-03-01,Kelantan,59,39,20,2018
2018-03-02,Kelantan,0,0,0,2018
2018-03-03,Kelantan,33,13,20,2018
2018-03-04,Kelantan,69,54,15,2018
2018-03-05,Kelantan,40,34,6,2018
2018-03-06,Kelantan,126,96,30,2018
2018-03-07,Kelantan,54,24,30,2018
2018-03-08,Kelantan,12,2,10,2018
2018-03-09,Kelantan,0,0,0,2018
2018-03-10,Kelantan,88,35,53,2018
2018-03-11,Kelantan,18,8,10,2018
2018-03-12,Kelantan,28,22,6,2018
2018-03-13,Kelantan,4,0,4,2018
2018-03-14,Kelantan,24,2,22,2018
2018-03-15,Kelantan,22,12,10,2018
2018-03-16,Kelantan,34,12,22,2018
2018-03-17,Kelantan,35,17,18,2018
2018-03-18,Kelantan,52,19,33,2018
2018-03-19,Kelantan,72,37,35,2018
2018-03-20,Kelantan,81,37,44,2018
2018-03-21,Kelantan,48,34,14,2018
2018-03-22,Kelantan,49,18,31,2018
2018-03-23,Kelantan,16,4,12,2018
2018-03-24,Kelantan,68,27,41,2018
2018-03-25,Kelantan,52,43,9,2018
2018-03-26,Kelantan,74,57,17,2018
2018-03-27,Kelantan,80,64,16,2018
2018-03-28,Kelantan,69,46,23,2018
2018-03-29,Kelantan,67,60,7,2018
2018-03-30,Kelantan,0,0,0,2018
2018-03-31,Kelantan,43,17,26,2018
2018-04-01,Kelantan,7,0,7,2018
2018-04-02,Kelantan,30,7,23,2018
2018-04-03,Kelantan,18,2,16,2018
2018-04-04,Kelantan,86,26,60,2018
2018-04-05,Kelantan,19,2,17,2018
2018-04-06,Kelantan,71,35,36,2018
2018-04-07,Kelantan,43,18,25,2018
2018-04-08,Kelantan,21,7,14,2018
2018-04-09,Kelantan,8,2,6,2018
2018-04-10,Kelantan,50,32,18,2018
2018-04-11,Kelantan,69,36,33,2018
2018-04-12,Kelantan,4,0,4,2018
2018-04-13,Kelantan,38,22,16,2018
2018-04-14,Kelantan,84,24,60,2018
2018-04-15,Kelantan,39,35,4,2018
2018-04-16,Kelantan,30,15,15,2018
2018-04-17,Kelantan,25,14,11,2018
2018-04-18,Kelantan,16,6,10,2018
2018-04-19,Kelantan,29,13,16,2018
2018-04-20,Kelantan,33,10,23,2018
2018-04-21,Kelantan,49,17,32,2018
2018-04-22,Kelantan,24,14,10,2018
2018-04-23,Kelantan,8,3,5,2018
2018-04-24,Kelantan,58,25,33,2018
2018-04-25,Kelantan,46,12,34,2018
2018-04-26,Kelantan,6,0,6,2018
2018-04-27,Kelantan,16,4,12,2018
2018-04-28,Kelantan,4,2,2,2018
2018-04-29,Kelantan,29,12,17,2018
2018-04-30,Kelantan,16,8,8,2018
2018-05-01,Kelantan,31,9,22,2018
2018-05-02,Kelantan,0,0,0,2018
2018-05-03,Kelantan,61,40,21,2018
2018-05-04,Kelantan,0,0,0,2018
2018-05-05,Kelantan,3,3,0,2018
2018-05-06,Kelantan,96,58,38,2018
2018-05-07,Kelantan,90,57,33,2018
2018-05-08,Kelantan,24,15,9,2018
2018-05-09,Kelantan,0,0,0,2018
2018-05-10,Kelantan,18,3,15,2018
2018-05-11,Kelantan,40,17,23,2018
2018-05-12,Kelantan,54,17,37,2018
2018-05-13,Kelantan,12,5,7,2018
2018-05-14,Kelantan,10,2,8,2018
2018-05-15,Kelantan,33,14,19,2018
2018-05-16,Kelantan,53,18,35,2018
2018-05-17,Kelantan,18,7,11,2018
2018-05-18,Kelantan,120,19,101,2018
2018-05-19,Kelantan,38,18,20,2018
2018-05-20,Kelantan,36,16,20,2018
2018-05-21,Kelantan,31,19,12,2018
2018-05-22,Kelantan,0,0,0,2018
2018-05-23,Kelantan,33,12,21,2018
2018-05-24,Kelantan,28,18,10,2018
2018-05-25,Kelantan,30,13,17,2018
2018-05-26,Kelantan,28,10,18,2018
2018-05-27,Kelantan,33,13,20,2018
2018-05-28,Kelantan,0,0,0,2018
2018-05-29,Kelantan,26,13,13,2018
2018-05-30,Kelantan,22,10,12,2018
2018-05-31,Kelantan,1,0,1,2018
2018-06-01,Kelantan,31,10,21,2018
2018-06-02,Kelantan,11,3,8,2018
2018-06-03,Kelantan,42,22,20,2018
2018-06-04,Kelantan,30,20,10,2018
2018-06-05,Kelantan,21,8,13,2018
2018-06-06,Kelantan,36,12,24,2018
2018-06-07,Kelantan,26,12,14,2018
2018-06-08,Kelantan,23,8,15,2018
2018-06-09,Kelantan,24,8,16,2018
2018-06-10,Kelantan,27,6,21,2018
2018-06-11,Kelantan,33,12,21,2018
2018-06-12,Kelantan,40,11,29,2018
2018-06-13,Kelantan,19,6,13,2018
2018-06-14,Kelantan,0,0,0,2018
2018-06-15,Kelantan,0,0,0,2018
2018-06-16,Kelantan,0,0,0,2018
2018-06-17,Kelantan,63,19,44,2018
2018-06-18,Kelantan,57,24,33,2018
2018-06-19,Kelantan,59,20,39,2018
2018-06-20,Kelantan,28,8,20,2018
2018-06-21,Kelantan,38,15,23,2018
2018-06-22,Kelantan,66,23,43,2018
2018-06-23,Kelantan,65,27,38,2018
2018-06-24,Kelantan,53,17,36,2018
2018-06-25,Kelantan,53,26,27,2018
2018-06-26,Kelantan,21,7,14,2018
2018-06-27,Kelantan,75,42,33,2018
2018-06-28,Kelantan,4,0,4,2018
2018-06-29,Kelantan,22,8,14,2018
2018-06-30,Kelantan,68,25,43,2018
2018-07-01,Kelantan,61,27,34,2018
2018-07-02,Kelantan,14,4,10,2018
2018-07-03,Kelantan,22,10,12,2018
2018-07-04,Kelantan,43,12,31,2018
2018-07-05,Kelantan,62,31,31,2018
2018-07-06,Kelantan,13,10,3,2018
2018-07-07,Kelantan,48,11,37,2018
2018-07-08,Kelantan,7,1,6,2018
2018-07-09,Kelantan,87,59,28,2018
2018-07-10,Kelantan,86,76,10,2018
2018-07-11,Kelantan,133,121,12,2018
2018-07-12,Kelantan,101,89,12,2018
2018-07-13,Kelantan,13,4,9,2018
2018-07-14,Kelantan,56,18,38,2018
2018-07-15,Kelantan,58,37,21,2018
2018-07-16,Kelantan,46,30,16,2018
2018-07-17,Kelantan,84,32,52,2018
2018-07-18,Kelantan,138,56,82,2018
2018-07-19,Kelantan,7,0,7,2018
2018-07-20,Kelantan,6,1,5,2018
2018-07-21,Kelantan,33,13,20,2018
2018-07-22,Kelantan,6,0,6,2018
2018-07-23,Kelantan,40,28,12,2018
2018-07-24,Kelantan,26,19,7,2018
2018-07-25,Kelantan,86,36,50,2018
2018-07-26,Kelantan,147,109,38,2018
2018-07-27,Kelantan,29,16,13,2018
2018-07-28,Kelantan,29,10,19,2018
2018-07-29,Kelantan,25,9,16,2018
2018-07-30,Kelantan,15,10,5,2018
2018-07-31,Kelantan,36,9,27,2018
2018-08-01,Kelantan,44,29,15,2018
2018-08-02,Kelantan,32,16,16,2018
2018-08-03,Kelantan,0,0,0,2018
2018-08-04,Kelantan,189,61,128,2018
2018-08-05,Kelantan,10,1,9,2018
2018-08-06,Kelantan,36,30,6,2018
2018-08-07,Kelantan,44,36,8,2018
2018-08-08,Kelantan,42,26,16,2018
2018-08-09,Kelantan,89,46,43,2018
2018-08-10,Kelantan,0,0,0,2018
2018-08-11,Kelantan,34,10,24,2018
2018-08-12,Kelantan,28,10,18,2018
2018-08-13,Kelantan,15,7,8,2018
2018-08-14,Kelantan,20,12,8,2018
2018-08-15,Kelantan,23,8,15,2018
2018-08-16,Kelantan,49,15,34,2018
2018-08-17,Kelantan,1,1,0,2018
2018-08-18,Kelantan,73,28,45,2018
2018-08-19,Kelantan,38,16,22,2018
2018-08-20,Kelantan,41,13,28,2018
2018-08-21,Kelantan,19,6,13,2018
2018-08-22,Kelantan,0,0,0,2018
2018-08-23,Kelantan,0,0,0,2018
2018-08-24,Kelantan,24,9,15,2018
2018-08-25,Kelantan,25,7,18,2018
2018-08-26,Kelantan,39,17,22,2018
2018-08-27,Kelantan,23,8,15,2018
2018-08-28,Kelantan,16,5,11,2018
2018-08-29,Kelantan,28,5,23,2018
2018-08-30,Kelantan,28,14,14,2018
2018-08-31,Kelantan,27,10,17,2018
2018-09-01,Kelantan,18,6,12,2018
2018-09-02,Kelantan,9,0,9,2018
2018-09-03,Kelantan,25,15,10,2018
2018-09-04,Kelantan,53,36,17,2018
2018-09-05,Kelantan,54,31,23,2018
2018-09-06,Kelantan,58,39,19,2018
2018-09-07,Kelantan,0,0,0,2018
2018-09-08,Kelantan,38,17,21,2018
2018-09-09,Kelantan,49,17,32,2018
2018-09-10,Kelantan,30,7,23,2018
2018-09-11,Kelantan,22,11,11,2018
2018-09-12,Kelantan,31,18,13,2018
2018-09-13,Kelantan,62,27,35,2018
2018-09-14,Kelantan,8,1,7,2018
2018-09-15,Kelantan,35,13,22,2018
2018-09-16,Kelantan,25,12,13,2018
2018-09-17,Kelantan,61,27,34,2018
2018-09-18,Kelantan,83,41,42,2018
2018-09-19,Kelantan,55,34,21,2018
2018-09-20,Kelantan,15,6,9,2018
2018-09-21,Kelantan,124,58,66,2018
2018-09-22,Kelantan,32,5,27,2018
2018-09-23,Kelantan,64,39,25,2018
2018-09-24,Kelantan,84,64,20,2018
2018-09-25,Kelantan,6,1,5,2018
2018-09-26,Kelantan,67,30,37,2018
2018-09-27,Kelantan,84,28,56,2018
2018-09-28,Kelantan,0,0,0,2018
2018-09-29,Kelantan,83,28,55,2018
2018-09-30,Kelantan,27,9,18,2018
2018-10-01,Kelantan,31,14,17,2018
2018-10-02,Kelantan,16,4,12,2018
2018-10-03,Kelantan,31,7,24,2018
2018-10-04,Kelantan,38,15,23,2018
2018-10-05,Kelantan,35,11,24,2018
2018-10-06,Kelantan,31,16,15,2018
2018-10-07,Kelantan,21,2,19,2018
2018-10-08,Kelantan,53,31,22,2018
2018-10-09,Kelantan,46,23,23,2018
2018-10-10,Kelantan,36,19,17,2018
2018-10-11,Kelantan,96,68,28,2018
2018-10-12,Kelantan,0,0,0,2018
2018-10-13,Kelantan,61,33,28,2018
2018-10-14,Kelantan,81,50,31,2018
2018-10-15,Kelantan,62,31,31,2018
2018-10-16,Kelantan,53,23,30,2018
2018-10-17,Kelantan,102,62,40,2018
2018-10-18,Kelantan,4,0,4,2018
2018-10-19,Kelantan,0,0,0,2018
2018-10-20,Kelantan,32,11,21,2018
2018-10-21,Kelantan,5,0,5,2018
2018-10-22,Kelantan,23,6,17,2018
2018-10-23,Kelantan,20,5,15,2018
2018-10-24,Kelantan,19,6,13,2018
2018-10-25,Kelantan,22,5,17,2018
2018-10-26,Kelantan,0,0,0,2018
2018-10-27,Kelantan,17,9,8,2018
2018-10-28,Kelantan,36,10,26,2018
2018-10-29,Kelantan,37,11,26,2018
2018-10-30,Kelantan,23,12,11,2018
2018-10-31,Kelantan,51,22,29,2018
2018-11-01,Kelantan,27,8,19,2018
2018-11-02,Kelantan,28,18,10,2018
2018-11-03,Kelantan,34,16,18,2018
2018-11-04,Kelantan,24,8,16,2018
2018-11-05,Kelantan,16,3,13,2018
2018-11-06,Kelantan,50,12,38,2018
2018-11-07,Kelantan,11,4,7,2018
2018-11-08,Kelantan,47,18,29,2018
2018-11-09,Kelantan,0,0,0,2018
2018-11-10,Kelantan,51,17,34,2018
2018-11-11,Kelantan,38,15,23,2018
2018-11-12,Kelantan,26,12,14,2018
2018-11-13,Kelantan,33,15,18,2018
2018-11-14,Kelantan,44,12,32,2018
2018-11-15,Kelantan,71,34,37,2018
2018-11-16,Kelantan,0,0,0,2018
2018-11-17,Kelantan,52,14,38,2018
2018-11-18,Kelantan,51,17,34,2018
2018-11-19,Kelantan,37,13,24,2018
2018-11-20,Kelantan,58,22,36,2018
2018-11-21,Kelantan,130,71,59,2018
2018-11-22,Kelantan,57,26,31,2018
2018-11-23,Kelantan,0,0,0,2018
2018-11-24,Kelantan,100,24,76,2018
2018-11-25,Kelantan,57,25,32,2018
2018-11-26,Kelantan,86,37,49,2018
2018-11-27,Kelantan,52,30,22,2018
2018-11-28,Kelantan,30,12,18,2018
2018-11-29,Kelantan,6,2,4,2018
2018-11-30,Kelantan,46,21,25,2018
2018-12-01,Kelantan,47,14,33,2018
2018-12-02,Kelantan,31,12,19,2018
2018-12-03,Kelantan,26,6,20,2018
2018-12-04,Kelantan,44,16,28,2018
2018-12-05,Kelantan,46,20,26,2018
2018-12-06,Kelantan,21,8,13,2018
2018-12-07,Kelantan,25,10,15,2018
2018-12-08,Kelantan,6,1,5,2018
2018-12-09,Kelantan,0,0,0,2018
2018-12-10,Kelantan,34,9,25,2018
2018-12-11,Kelantan,18,6,12,2018
2018-12-12,Kelantan,36,16,20,2018
2018-12-13,Kelantan,55,33,22,2018
2018-12-14,Kelantan,73,27,46,2018
2018-12-15,Kelantan,18,7,11,2018
2018-12-16,Kelantan,43,12,31,2018
2018-12-17,Kelantan,47,22,25,2018
2018-12-18,Kelantan,63,20,43,2018
2018-12-19,Kelantan,12,4,8,2018
2018-12-20,Kelantan,16,2,14,2018
2018-12-21,Kelantan,59,23,36,2018
2018-12-22,Kelantan,12,4,8,2018
2018-12-23,Kelantan,43,23,20,2018
2018-12-24,Kelantan,23,2,21,2018
2018-12-25,Kelantan,42,17,25,2018
2018-12-26,Kelantan,35,9,26,2018
2018-12-27,Kelantan,49,17,32,2018
2018-12-28,Kelantan,0,0,0,2018
2018-12-29,Kelantan,74,37,37,2018
2018-12-30,Kelantan,21,5,16,2018
2018-12-31,Kelantan,21,5,16,2018
2019-01-01,Kelantan,53,16,37,2019
2019-01-02,Kelantan,40,9,31,2019
2019-01-03,Kelantan,27,14,13,2019
2019-01-04,Kelantan,0,0,0,2019
2019-01-05,Kelantan,78,23,55,2019
2019-01-06,Kelantan,45,18,27,2019
2019-01-07,Kelantan,28,3,25,2019
2019-01-08,Kelantan,37,18,19,2019
2019-01-09,Kelantan,36,16,20,2019
2019-01-10,Kelantan,29,16,13,2019
2019-01-11,Kelantan,0,0,0,2019
2019-01-12,Kelantan,71,35,36,2019
2019-01-13,Kelantan,40,16,24,2019
2019-01-14,Kelantan,36,15,21,2019
2019-01-15,Kelantan,22,5,17,2019
2019-01-16,Kelantan,24,5,19,2019
2019-01-17,Kelantan,31,20,11,2019
2019-01-18,Kelantan,2,1,1,2019
2019-01-19,Kelantan,8,3,5,2019
2019-01-20,Kelantan,40,21,19,2019
2019-01-21,Kelantan,64,37,27,2019
2019-01-22,Kelantan,84,63,21,2019
2019-01-23,Kelantan,51,40,11,2019
2019-01-24,Kelantan,86,51,35,2019
2019-01-25,Kelantan,0,0,0,2019
2019-01-26,Kelantan,36,18,18,2019
2019-01-27,Kelantan,68,28,40,2019
2019-01-28,Kelantan,45,32,13,2019
2019-01-29,Kelantan,51,34,17,2019
2019-01-30,Kelantan,9,1,8,2019
2019-01-31,Kelantan,70,20,50,2019
2019-02-01,Kelantan,0,0,0,2019
2019-02-02,Kelantan,15,7,8,2019
2019-02-03,Kelantan,68,21,47,2019
2019-02-04,Kelantan,52,16,36,2019
2019-02-05,Kelantan,12,3,9,2019
2019-02-06,Kelantan,24,5,19,2019
2019-02-07,Kelantan,23,7,16,2019
2019-02-08,Kelantan,0,0,0,2019
2019-02-09,Kelantan,59,28,31,2019
2019-02-10,Kelantan,6,0,6,2019
2019-02-11,Kelantan,55,47,8,2019
2019-02-12,Kelantan,76,31,45,2019
2019-02-13,Kelantan,9,0,9,2019
2019-02-14,Kelantan,34,24,10,2019
2019-02-15,Kelantan,0,0,0,2019
2019-02-16,Kelantan,34,17,17,2019
2019-02-17,Kelantan,26,8,18,2019
2019-02-18,Kelantan,33,10,23,2019
2019-02-19,Kelantan,56,50,6,2019
2019-02-20,Kelantan,12,1,11,2019
2019-02-21,Kelantan,7,2,5,2019
2019-02-22,Kelantan,0,0,0,2019
2019-02-23,Kelantan,42,14,28,2019
2019-02-24,Kelantan,9,1,8,2019
2019-02-25,Kelantan,21,6,15,2019
2019-02-26,Kelantan,38,29,9,2019
2019-02-27,Kelantan,42,14,28,2019
2019-02-28,Kelantan,26,9,17,2019
2019-03-01,Kelantan,0,0,0,2019
2019-03-02,Kelantan,20,6,14,2019
2019-03-03,Kelantan,7,1,6,2019
2019-03-04,Kelantan,63,44,19,2019
2019-03-05,Kelantan,95,47,48,2019
2019-03-06,Kelantan,43,21,22,2019
2019-03-07,Kelantan,77,51,26,2019
2019-03-08,Kelantan,80,15,65,2019
2019-03-09,Kelantan,37,14,23,2019
2019-03-10,Kelantan,30,15,15,2019
2019-03-11,Kelantan,29,18,11,2019
2019-03-12,Kelantan,26,10,16,2019
2019-03-13,Kelantan,67,39,28,2019
2019-03-14,Kelantan,4,2,2,2019
2019-03-15,Kelantan,0,0,0,2019
2019-03-16,Kelantan,14,1,13,2019
2019-03-17,Kelantan,40,11,29,2019
2019-03-18,Kelantan,37,14,23,2019
2019-03-19,Kelantan,75,35,40,2019
2019-03-20,Kelantan,34,10,24,2019
2019-03-21,Kelantan,42,17,25,2019
2019-03-22,Kelantan,30,8,22,2019
2019-03-23,Kelantan,7,3,4,2019
2019-03-24,Kelantan,44,10,34,2019
2019-03-25,Kelantan,21,7,14,2019
2019-03-26,Kelantan,59,13,46,2019
2019-03-27,Kelantan,79,27,52,2019
2019-03-28,Kelantan,19,3,16,2019
2019-03-29,Kelantan,0,0,0,2019
2019-03-30,Kelantan,13,2,11,2019
2019-03-31,Kelantan,11,2,9,2019
2019-04-01,Kelantan,7,1,6,2019
2019-04-02,Kelantan,50,18,32,2019
2019-04-03,Kelantan,43,15,28,2019
2019-04-04,Kelantan,15,7,8,2019
2019-04-05,Kelantan,0,0,0,2019
2019-04-06,Kelantan,47,28,19,2019
2019-04-07,Kelantan,11,0,11,2019
2019-04-08,Kelantan,9,1,8,2019
2019-04-09,Kelantan,41,22,19,2019
2019-04-10,Kelantan,10,2,8,2019
2019-04-11,Kelantan,52,20,32,2019
2019-04-12,Kelantan,0,0,0,2019
2019-04-13,Kelantan,114,43,71,2019
2019-04-14,Kelantan,7,2,5,2019
2019-04-15,Kelantan,50,32,18,2019
2019-04-16,Kelantan,6,0,6,2019
2019-04-17,Kelantan,16,6,10,2019
2019-04-18,Kelantan,34,15,19,2019
2019-04-19,Kelantan,0,0,0,2019
2019-04-20,Kelantan,58,22,36,2019
2019-04-21,Kelantan,25,7,18,2019
2019-04-22,Kelantan,42,11,31,2019
2019-04-23,Kelantan,31,10,21,2019
2019-04-24,Kelantan,15,7,8,2019
2019-04-25,Kelantan,5,1,4,2019
2019-04-26,Kelantan,55,15,40,2019
2019-04-27,Kelantan,54,19,35,2019
2019-04-28,Kelantan,27,5,22,2019
2019-04-29,Kelantan,48,13,35,2019
2019-04-30,Kelantan,112,79,33,2019
2019-05-01,Kelantan,72,21,51,2019
2019-05-02,Kelantan,24,9,15,2019
2019-05-03,Kelantan,26,8,18,2019
2019-05-04,Kelantan,20,4,16,2019
2019-05-05,Kelantan,30,8,22,2019
2019-05-06,Kelantan,0,0,0,2019
2019-05-07,Kelantan,17,4,13,2019
2019-05-08,Kelantan,1,0,1,2019
2019-05-09,Kelantan,22,8,14,2019
2019-05-10,Kelantan,0,0,0,2019
2019-05-11,Kelantan,15,5,10,2019
2019-05-12,Kelantan,6,2,4,2019
2019-05-13,Kelantan,10,2,8,2019
2019-05-14,Kelantan,31,15,16,2019
2019-05-15,Kelantan,1,0,1,2019
2019-05-16,Kelantan,20,10,10,2019
2019-05-17,Kelantan,0,0,0,2019
2019-05-18,Kelantan,16,7,9,2019
2019-05-19,Kelantan,0,0,0,2019
2019-05-20,Kelantan,26,7,19,2019
2019-05-21,Kelantan,2,0,2,2019
2019-05-22,Kelantan,15,3,12,2019
2019-05-23,Kelantan,0,0,0,2019
2019-05-24,Kelantan,25,10,15,2019
2019-05-25,Kelantan,26,9,17,2019
2019-05-26,Kelantan,20,6,14,2019
2019-05-27,Kelantan,25,20,5,2019
2019-05-28,Kelantan,31,8,23,2019
2019-05-29,Kelantan,35,32,3,2019
2019-05-30,Kelantan,13,3,10,2019
2019-05-31,Kelantan,10,6,4,2019
2019-06-01,Kelantan,9,3,6,2019
2019-06-02,Kelantan,41,9,32,2019
2019-06-03,Kelantan,45,12,33,2019
2019-06-04,Kelantan,0,0,0,2019
2019-06-05,Kelantan,0,0,0,2019
2019-06-06,Kelantan,0,0,0,2019
2019-06-07,Kelantan,22,5,17,2019
2019-06-08,Kelantan,23,7,16,2019
2019-06-09,Kelantan,97,27,70,2019
2019-06-10,Kelantan,64,17,47,2019
2019-06-11,Kelantan,37,5,32,2019
2019-06-12,Kelantan,25,7,18,2019
2019-06-13,Kelantan,55,13,42,2019
2019-06-14,Kelantan,0,0,0,2019
2019-06-15,Kelantan,51,23,28,2019
2019-06-16,Kelantan,31,13,18,2019
2019-06-17,Kelantan,96,31,65,2019
2019-06-18,Kelantan,117,35,82,2019
2019-06-19,Kelantan,228,93,135,2019
2019-06-20,Kelantan,109,37,72,2019
2019-06-21,Kelantan,0,0,0,2019
2019-06-22,Kelantan,81,26,55,2019
2019-06-23,Kelantan,130,54,76,2019
2019-06-24,Kelantan,37,15,22,2019
2019-06-25,Kelantan,13,5,8,2019
2019-06-26,Kelantan,57,33,24,2019
2019-06-27,Kelantan,11,3,8,2019
2019-06-28,Kelantan,0,0,0,2019
2019-06-29,Kelantan,8,7,1,2019
2019-06-30,Kelantan,19,7,12,2019
2019-07-01,Kelantan,43,18,25,2019
2019-07-02,Kelantan,23,6,17,2019
2019-07-03,Kelantan,56,29,27,2019
2019-07-04,Kelantan,24,10,14,2019
2019-07-05,Kelantan,0,0,0,2019
2019-07-06,Kelantan,90,28,62,2019
2019-07-07,Kelantan,109,40,69,2019
2019-07-08,Kelantan,8,1,7,2019
2019-07-09,Kelantan,6,1,5,2019
2019-07-10,Kelantan,2,2,0,2019
2019-07-11,Kelantan,40,30,10,2019
2019-07-12,Kelantan,0,0,0,2019
2019-07-13,Kelantan,254,68,186,2019
2019-07-14,Kelantan,10,0,10,2019
2019-07-15,Kelantan,12,3,9,2019
2019-07-16,Kelantan,10,2,8,2019
2019-07-17,Kelantan,31,26,5,2019
2019-07-18,Kelantan,7,1,6,2019
2019-07-19,Kelantan,0,0,0,2019
2019-07-20,Kelantan,54,26,28,2019
2019-07-21,Kelantan,5,1,4,2019
2019-07-22,Kelantan,85,47,38,2019
2019-07-23,Kelantan,29,20,9,2019
2019-07-24,Kelantan,16,10,6,2019
2019-07-25,Kelantan,24,11,13,2019
2019-07-26,Kelantan,0,0,0,2019
2019-07-27,Kelantan,17,8,9,2019
2019-07-28,Kelantan,6,1,5,2019
2019-07-29,Kelantan,6,1,5,2019
2019-07-30,Kelantan,27,8,19,2019
2019-07-31,Kelantan,11,2,9,2019
2019-08-01,Kelantan,23,4,19,2019
2019-08-02,Kelantan,0,0,0,2019
2019-08-03,Kelantan,21,8,13,2019
2019-08-04,Kelantan,34,20,14,2019
2019-08-05,Kelantan,3,1,2,2019
2019-08-06,Kelantan,21,7,14,2019
2019-08-07,Kelantan,22,12,10,2019
2019-08-08,Kelantan,22,8,14,2019
2019-08-09,Kelantan,28,7,21,2019
2019-08-10,Kelantan,14,1,13,2019
2019-08-11,Kelantan,0,0,0,2019
2019-08-12,Kelantan,0,0,0,2019
2019-08-13,Kelantan,29,8,21,2019
2019-08-14,Kelantan,29,6,23,2019
2019-08-15,Kelantan,60,20,40,2019
2019-08-16,Kelantan,0,0,0,2019
2019-08-17,Kelantan,6,3,3,2019
2019-08-18,Kelantan,44,12,32,2019
2019-08-19,Kelantan,28,12,16,2019
2019-08-20,Kelantan,29,18,11,2019
2019-08-21,Kelantan,22,7,15,2019
2019-08-22,Kelantan,24,6,18,2019
2019-08-23,Kelantan,0,0,0,2019
2019-08-24,Kelantan,73,27,46,2019
2019-08-25,Kelantan,8,1,7,2019
2019-08-26,Kelantan,15,5,10,2019
2019-08-27,Kelantan,8,4,4,2019
2019-08-28,Kelantan,37,27,10,2019
2019-08-29,Kelantan,34,4,30,2019
2019-08-30,Kelantan,7,4,3,2019
2019-08-31,Kelantan,22,5,17,2019
2019-09-01,Kelantan,19,5,14,2019
2019-09-02,Kelantan,22,8,14,2019
2019-09-03,Kelantan,14,4,10,2019
2019-09-04,Kelantan,18,5,13,2019
2019-09-05,Kelantan,19,3,16,2019
2019-09-06,Kelantan,0,0,0,2019
2019-09-07,Kelantan,23,10,13,2019
2019-09-08,Kelantan,9,1,8,2019
2019-09-09,Kelantan,17,7,10,2019
2019-09-10,Kelantan,15,7,8,2019
2019-09-11,Kelantan,13,4,9,2019
2019-09-12,Kelantan,56,26,30,2019
2019-09-13,Kelantan,0,0,0,2019
2019-09-14,Kelantan,0,0,0,2019
2019-09-15,Kelantan,24,3,21,2019
2019-09-16,Kelantan,73,36,37,2019
2019-09-17,Kelantan,32,7,25,2019
2019-09-18,Kelantan,50,17,33,2019
2019-09-19,Kelantan,42,8,34,2019
2019-09-20,Kelantan,0,0,0,2019
2019-09-21,Kelantan,68,23,45,2019
2019-09-22,Kelantan,32,9,23,2019
2019-09-23,Kelantan,36,9,27,2019
2019-09-24,Kelantan,44,8,36,2019
2019-09-25,Kelantan,9,2,7,2019
2019-09-26,Kelantan,54,16,38,2019
2019-09-27,Kelantan,21,9,12,2019
2019-09-28,Kelantan,33,18,15,2019
2019-09-29,Kelantan,25,12,13,2019
2019-09-30,Kelantan,51,43,8,2019
2019-10-01,Kelantan,102,61,41,2019
2019-10-02,Kelantan,7,1,6,2019
2019-10-03,Kelantan,8,1,7,2019
2019-10-04,Kelantan,0,0,0,2019
2019-10-05,Kelantan,20,6,14,2019
2019-10-06,Kelantan,14,3,11,2019
2019-10-07,Kelantan,33,12,21,2019
2019-10-08,Kelantan,25,5,20,2019
2019-10-09,Kelantan,9,2,7,2019
2019-10-10,Kelantan,76,21,55,2019
2019-10-11,Kelantan,29,19,10,2019
2019-10-12,Kelantan,36,8,28,2019
2019-10-13,Kelantan,11,2,9,2019
2019-10-14,Kelantan,15,4,11,2019
2019-10-15,Kelantan,19,6,13,2019
2019-10-16,Kelantan,16,6,10,2019
2019-10-17,Kelantan,47,16,31,2019
2019-10-18,Kelantan,33,6,27,2019
2019-10-19,Kelantan,62,34,28,2019
2019-10-20,Kelantan,8,1,7,2019
2019-10-21,Kelantan,84,34,50,2019
2019-10-22,Kelantan,98,38,60,2019
2019-10-23,Kelantan,20,6,14,2019
2019-10-24,Kelantan,9,3,6,2019
2019-10-25,Kelantan,0,0,0,2019
2019-10-26,Kelantan,30,8,22,2019
2019-10-27,Kelantan,17,5,12,2019
2019-10-28,Kelantan,89,23,66,2019
2019-10-29,Kelantan,36,16,20,2019
2019-10-30,Kelantan,14,3,11,2019
2019-10-31,Kelantan,46,18,28,2019
2019-11-01,Kelantan,0,0,0,2019
2019-11-02,Kelantan,33,9,24,2019
2019-11-03,Kelantan,12,2,10,2019
2019-11-04,Kelantan,25,4,21,2019
2019-11-05,Kelantan,24,7,17,2019
2019-11-06,Kelantan,27,5,22,2019
2019-11-07,Kelantan,25,13,12,2019
2019-11-08,Kelantan,40,12,28,2019
2019-11-09,Kelantan,47,13,34,2019
2019-11-10,Kelantan,49,15,34,2019
2019-11-11,Kelantan,32,11,21,2019
2019-11-12,Kelantan,21,6,15,2019
2019-11-13,Kelantan,73,48,25,2019
2019-11-14,Kelantan,78,53,25,2019
2019-11-15,Kelantan,0,0,0,2019
2019-11-16,Kelantan,31,13,18,2019
2019-11-17,Kelantan,5,1,4,2019
2019-11-18,Kelantan,32,6,26,2019
2019-11-19,Kelantan,23,10,13,2019
2019-11-20,Kelantan,14,3,11,2019
2019-11-21,Kelantan,15,3,12,2019
2019-11-22,Kelantan,0,0,0,2019
2019-11-23,Kelantan,102,82,20,2019
2019-11-24,Kelantan,20,5,15,2019
2019-11-25,Kelantan,41,12,29,2019
2019-11-26,Kelantan,57,18,39,2019
2019-11-27,Kelantan,18,6,12,2019
2019-11-28,Kelantan,11,4,7,2019
2019-11-29,Kelantan,0,0,0,2019
2019-11-30,Kelantan,29,16,13,2019
2019-12-01,Kelantan,21,5,16,2019
2019-12-02,Kelantan,36,13,23,2019
2019-12-03,Kelantan,37,10,27,2019
2019-12-04,Kelantan,48,15,33,2019
2019-12-05,Kelantan,35,6,29,2019
2019-12-06,Kelantan,0,0,0,2019
2019-12-07,Kelantan,31,10,21,2019
2019-12-08,Kelantan,18,1,17,2019
2019-12-09,Kelantan,46,15,31,2019
2019-12-10,Kelantan,32,10,22,2019
2019-12-11,Kelantan,28,7,21,2019
2019-12-12,Kelantan,181,50,131,2019
2019-12-13,Kelantan,0,0,0,2019
2019-12-14,Kelantan,46,6,40,2019
2019-12-15,Kelantan,41,16,25,2019
2019-12-16,Kelantan,56,24,32,2019
2019-12-17,Kelantan,46,24,22,2019
2019-12-18,Kelantan,54,10,44,2019
2019-12-19,Kelantan,21,3,18,2019
2019-12-20,Kelantan,0,0,0,2019
2019-12-21,Kelantan,22,8,14,2019
2019-12-22,Kelantan,23,2,21,2019
2019-12-23,Kelantan,20,5,15,2019
2019-12-24,Kelantan,53,15,38,2019
2019-12-25,Kelantan,29,10,19,2019
2019-12-26,Kelantan,69,16,53,2019
2019-12-27,Kelantan,22,5,17,2019
2019-12-28,Kelantan,41,12,29,2019
2019-12-29,Kelantan,45,16,29,2019
2019-12-30,Kelantan,26,8,18,2019
2019-12-31,Kelantan,50,11,39,2019
2020-01-01,Kelantan,15,2,13,2020
2020-01-02,Kelantan,13,3,10,2020
2020-01-03,Kelantan,18,3,15,2020
2020-01-04,Kelantan,73,16,57,2020
2020-01-05,Kelantan,6,1,5,2020
2020-01-06,Kelantan,28,5,23,2020
2020-01-07,Kelantan,26,5,21,2020
2020-01-08,Kelantan,29,10,19,2020
2020-01-09,Kelantan,47,20,27,2020
2020-01-10,Kelantan,36,15,21,2020
2020-01-11,Kelantan,118,48,70,2020
2020-01-12,Kelantan,50,10,40,2020
2020-01-13,Kelantan,51,25,26,2020
2020-01-14,Kelantan,13,3,10,2020
2020-01-15,Kelantan,20,10,10,2020
2020-01-16,Kelantan,17,2,15,2020
2020-01-17,Kelantan,34,12,22,2020
2020-01-18,Kelantan,48,23,25,2020
2020-01-19,Kelantan,34,25,9,2020
2020-01-20,Kelantan,34,9,25,2020
2020-01-21,Kelantan,57,15,42,2020
2020-01-22,Kelantan,38,16,22,2020
2020-01-23,Kelantan,108,85,23,2020
2020-01-24,Kelantan,45,16,29,2020
2020-01-25,Kelantan,28,6,22,2020
2020-01-26,Kelantan,26,10,16,2020
2020-01-27,Kelantan,37,19,18,2020
2020-01-28,Kelantan,28,9,19,2020
2020-01-29,Kelantan,71,14,57,2020
2020-01-30,Kelantan,29,17,12,2020
2020-01-31,Kelantan,49,16,33,2020
2020-02-01,Kelantan,56,14,42,2020
2020-02-02,Kelantan,30,6,24,2020
2020-02-03,Kelantan,9,1,8,2020
2020-02-04,Kelantan,25,7,18,2020
2020-02-05,Kelantan,40,33,7,2020
2020-02-06,Kelantan,2,0,2,2020
2020-02-07,Kelantan,0,0,0,2020
2020-02-08,Kelantan,51,10,41,2020
2020-02-09,Kelantan,12,2,10,2020
2020-02-10,Kelantan,38,24,14,2020
2020-02-11,Kelantan,49,33,16,2020
2020-02-12,Kelantan,57,40,17,2020
2020-02-13,Kelantan,29,4,25,2020
2020-02-14,Kelantan,0,0,0,2020
2020-02-15,Kelantan,19,4,15,2020
2020-02-16,Kelantan,10,3,7,2020
2020-02-17,Kelantan,47,30,17,2020
2020-02-18,Kelantan,14,2,12,2020
2020-02-19,Kelantan,57,23,34,2020
2020-02-20,Kelantan,19,5,14,2020
2020-02-21,Kelantan,15,7,8,2020
2020-02-22,Kelantan,42,18,24,2020
2020-02-23,Kelantan,38,12,26,2020
2020-02-24,Kelantan,30,14,16,2020
2020-02-25,Kelantan,33,23,10,2020
2020-02-26,Kelantan,23,5,18,2020
2020-02-27,Kelantan,34,13,21,2020
2020-02-28,Kelantan,0,0,0,2020
2020-02-29,Kelantan,50,18,32,2020
2020-03-01,Kelantan,57,16,41,2020
2020-03-02,Kelantan,53,17,36,2020
2020-03-03,Kelantan,43,23,20,2020
2020-03-04,Kelantan,86,48,38,2020
2020-03-05,Kelantan,6,2,4,2020
2020-03-06,Kelantan,70,33,37,2020
2020-03-07,Kelantan,77,18,59,2020
2020-03-08,Kelantan,9,3,6,2020
2020-03-09,Kelantan,12,4,8,2020
2020-03-10,Kelantan,15,0,15,2020
2020-03-11,Kelantan,21,7,14,2020
2020-03-12,Kelantan,60,18,42,2020
2020-03-13,Kelantan,21,6,15,2020
2020-03-14,Kelantan,24,12,12,2020
2020-03-15,Kelantan,20,5,15,2020
2020-03-16,Kelantan,20,4,16,2020
2020-03-17,Kelantan,24,5,19,2020
2020-03-18,Kelantan,17,6,11,2020
2020-03-19,Kelantan,9,2,7,2020
2020-03-20,Kelantan,0,0,0,2020
2020-03-21,Kelantan,0,0,0,2020
2020-03-22,Kelantan,9,1,8,2020
2020-03-23,Kelantan,43,14,29,2020
2020-03-24,Kelantan,65,26,39,2020
2020-03-25,Kelantan,42,17,25,2020
2020-03-26,Kelantan,42,11,31,2020
2020-03-27,Kelantan,0,0,0,2020
2020-03-28,Kelantan,42,12,30,2020
2020-03-29,Kelantan,9,0,9,2020
2020-03-30,Kelantan,23,8,15,2020
2020-03-31,Kelantan,33,11,22,2020
2020-04-01,Kelantan,24,4,20,2020
2020-04-02,Kelantan,16,5,11,2020
2020-04-03,Kelantan,0,0,0,2020
2020-04-04,Kelantan,21,5,16,2020
2020-04-05,Kelantan,24,9,15,2020
2020-04-06,Kelantan,23,4,19,2020
2020-04-07,Kelantan,25,3,22,2020
2020-04-08,Kelantan,23,4,19,2020
2020-04-09,Kelantan,28,8,20,2020
2020-04-10,Kelantan,0,0,0,2020
2020-04-11,Kelantan,78,29,49,2020
2020-04-12,Kelantan,37,6,31,2020
2020-04-13,Kelantan,28,2,26,2020
2020-04-14,Kelantan,27,4,23,2020
2020-04-15,Kelantan,27,7,20,2020
2020-04-16,Kelantan,50,13,37,2020
2020-04-17,Kelantan,0,0,0,2020
2020-04-18,Kelantan,94,35,59,2020
2020-04-19,Kelantan,34,5,29,2020
2020-04-20,Kelantan,28,1,27,2020
2020-04-21,Kelantan,58,24,34,2020
2020-04-22,Kelantan,64,22,42,2020
2020-04-23,Kelantan,39,4,35,2020
2020-04-24,Kelantan,0,0,0,2020
2020-04-25,Kelantan,0,0,0,2020
2020-04-26,Kelantan,6,0,6,2020
2020-04-27,Kelantan,12,2,10,2020
2020-04-28,Kelantan,4,2,2,2020
2020-04-29,Kelantan,7,1,6,2020
2020-04-30,Kelantan,37,9,28,2020
2020-05-01,Kelantan,0,0,0,2020
2020-05-02,Kelantan,30,10,20,2020
2020-05-03,Kelantan,37,8,29,2020
2020-05-04,Kelantan,5,0,5,2020
2020-05-05,Kelantan,55,19,36,2020
2020-05-06,Kelantan,2,2,0,2020
2020-05-07,Kelantan,35,8,27,2020
2020-05-08,Kelantan,0,0,0,2020
2020-05-09,Kelantan,0,0,0,2020
2020-05-10,Kelantan,18,3,15,2020
2020-05-11,Kelantan,8,1,7,2020
2020-05-12,Kelantan,29,7,22,2020
2020-05-13,Kelantan,2,0,2,2020
2020-05-14,Kelantan,34,6,28,2020
2020-05-15,Kelantan,30,11,19,2020
2020-05-16,Kelantan,0,0,0,2020
2020-05-17,Kelantan,25,10,15,2020
2020-05-18,Kelantan,22,5,17,2020
2020-05-19,Kelantan,31,3,28,2020
2020-05-20,Kelantan,23,4,19,2020
2020-05-21,Kelantan,24,6,18,2020
2020-05-22,Kelantan,42,7,35,2020
2020-05-23,Kelantan,0,0,0,2020
2020-05-24,Kelantan,0,0,0,2020
2020-05-25,Kelantan,0,0,0,2020
2020-05-26,Kelantan,17,2,15,2020
2020-05-27,Kelantan,76,21,55,2020
2020-05-28,Kelantan,107,32,75,2020
2020-05-29,Kelantan,0,0,0,2020
2020-05-30,Kelantan,118,40,78,2020
2020-05-31,Kelantan,73,18,55,2020
2020-06-01,Kelantan,74,26,48,2020
2020-06-02,Kelantan,75,22,53,2020
2020-06-03,Kelantan,59,22,37,2020
2020-06-04,Kelantan,64,14,50,2020
2020-06-05,Kelantan,153,67,86,2020
2020-06-06,Kelantan,31,9,22,2020
2020-06-07,Kelantan,46,13,33,2020
2020-06-08,Kelantan,53,20,33,2020
2020-06-09,Kelantan,226,149,77,2020
2020-06-10,Kelantan,80,25,55,2020
2020-06-11,Kelantan,47,9,38,2020
2020-06-12,Kelantan,47,11,36,2020
2020-06-13,Kelantan,42,13,29,2020
2020-06-14,Kelantan,48,16,32,2020
2020-06-15,Kelantan,44,13,31,2020
2020-06-16,Kelantan,53,11,42,2020
2020-06-17,Kelantan,39,8,31,2020
2020-06-18,Kelantan,46,14,32,2020
2020-06-19,Kelantan,210,78,132,2020
2020-06-20,Kelantan,0,0,0,2020
2020-06-21,Kelantan,43,15,28,2020
2020-06-22,Kelantan,35,13,22,2020
2020-06-23,Kelantan,49,16,33,2020
2020-06-24,Kelantan,34,17,17,2020
2020-06-25,Kelantan,38,10,28,2020
2020-06-26,Kelantan,0,0,0,2020
2020-06-27,Kelantan,38,11,27,2020
2020-06-28,Kelantan,32,8,24,2020
2020-06-29,Kelantan,37,11,26,2020
2020-06-30,Kelantan,45,8,37,2020
2020-07-01,Kelantan,24,7,17,2020
2020-07-02,Kelantan,25,10,15,2020
2020-07-03,Kelantan,0,0,0,2020
2020-07-04,Kelantan,42,14,28,2020
2020-07-05,Kelantan,44,8,36,2020
2020-07-06,Kelantan,27,7,20,2020
2020-07-07,Kelantan,23,4,19,2020
2020-07-08,Kelantan,24,6,18,2020
2020-07-09,Kelantan,39,10,29,2020
2020-07-10,Kelantan,0,0,0,2020
2020-07-11,Kelantan,48,15,33,2020
2020-07-12,Kelantan,41,10,31,2020
2020-07-13,Kelantan,23,3,20,2020
2020-07-14,Kelantan,40,8,32,2020
2020-07-15,Kelantan,26,5,21,2020
2020-07-16,Kelantan,22,5,17,2020
2020-07-17,Kelantan,0,0,0,2020
2020-07-18,Kelantan,33,10,23,2020
2020-07-19,Kelantan,19,6,13,2020
2020-07-20,Kelantan,11,3,8,2020
2020-07-21,Kelantan,21,3,18,2020
2020-07-22,Kelantan,21,1,20,2020
2020-07-23,Kelantan,129,55,74,2020
2020-07-24,Kelantan,0,0,0,2020
2020-07-25,Kelantan,38,5,33,2020
2020-07-26,Kelantan,24,6,18,2020
2020-07-27,Kelantan,19,4,15,2020
2020-07-28,Kelantan,25,9,16,2020
2020-07-29,Kelantan,22,6,16,2020
2020-07-30,Kelantan,28,7,21,2020
2020-07-31,Kelantan,0,0,0,2020
2020-08-01,Kelantan,0,0,0,2020
2020-08-02,Kelantan,23,5,18,2020
2020-08-03,Kelantan,44,5,39,2020
2020-08-04,Kelantan,19,7,12,2020
2020-08-05,Kelantan,21,7,14,2020
2020-08-06,Kelantan,30,5,25,2020
2020-08-07,Kelantan,0,0,0,2020
2020-08-08,Kelantan,50,18,32,2020
2020-08-09,Kelantan,18,0,18,2020
2020-08-10,Kelantan,71,42,29,2020
2020-08-11,Kelantan,40,21,19,2020
2020-08-12,Kelantan,35,9,26,2020
2020-08-13,Kelantan,47,11,36,2020
2020-08-14,Kelantan,0,0,0,2020
2020-08-15,Kelantan,33,14,19,2020
2020-08-16,Kelantan,19,8,11,2020
2020-08-17,Kelantan,47,8,39,2020
2020-08-18,Kelantan,64,19,45,2020
2020-08-19,Kelantan,68,25,43,2020
2020-08-20,Kelantan,71,24,47,2020
2020-08-21,Kelantan,0,0,0,2020
2020-08-22,Kelantan,69,18,51,2020
2020-08-23,Kelantan,43,7,36,2020
2020-08-24,Kelantan,53,17,36,2020
2020-08-25,Kelantan,56,16,40,2020
2020-08-26,Kelantan,118,30,88,2020
2020-08-27,Kelantan,41,14,27,2020
2020-08-28,Kelantan,0,0,0,2020
2020-08-29,Kelantan,25,5,20,2020
2020-08-30,Kelantan,41,7,34,2020
2020-08-31,Kelantan,40,5,35,2020
2020-09-01,Kelantan,118,65,53,2020
2020-09-02,Kelantan,30,6,24,2020
2020-09-03,Kelantan,25,5,20,2020
2020-09-04,Kelantan,0,0,0,2020
2020-09-05,Kelantan,31,14,17,2020
2020-09-06,Kelantan,60,40,20,2020
2020-09-07,Kelantan,100,67,33,2020
2020-09-08,Kelantan,76,54,22,2020
2020-09-09,Kelantan,25,2,23,2020
2020-09-10,Kelantan,27,6,21,2020
2020-09-11,Kelantan,101,29,72,2020
2020-09-12,Kelantan,0,0,0,2020
2020-09-13,Kelantan,14,4,10,2020
2020-09-14,Kelantan,28,2,26,2020
2020-09-15,Kelantan,23,8,15,2020
2020-09-16,Kelantan,54,11,43,2020
2020-09-17,Kelantan,26,8,18,2020
2020-09-18,Kelantan,0,0,0,2020
2020-09-19,Kelantan,22,5,17,2020
2020-09-20,Kelantan,32,7,25,2020
2020-09-21,Kelantan,19,4,15,2020
2020-09-22,Kelantan,25,5,20,2020
2020-09-23,Kelantan,28,4,24,2020
2020-09-24,Kelantan,7,1,6,2020
2020-09-25,Kelantan,60,9,51,2020
2020-09-26,Kelantan,37,9,28,2020
2020-09-27,Kelantan,28,4,24,2020
2020-09-28,Kelantan,41,8,33,2020
2020-09-29,Kelantan,66,19,47,2020
2020-09-30,Kelantan,44,16,28,2020
2020-10-01,Kelantan,38,4,34,2020
2020-10-02,Kelantan,0,0,0,2020
2020-10-03,Kelantan,17,4,13,2020
2020-10-04,Kelantan,9,0,9,2020
2020-10-05,Kelantan,12,2,10,2020
2020-10-06,Kelantan,19,2,17,2020
2020-10-07,Kelantan,28,9,19,2020
2020-10-08,Kelantan,30,6,24,2020
2020-10-09,Kelantan,0,0,0,2020
2020-10-10,Kelantan,50,14,36,2020
2020-10-11,Kelantan,32,5,27,2020
2020-10-12,Kelantan,10,0,10,2020
2020-10-13,Kelantan,63,15,48,2020
2020-10-14,Kelantan,30,6,24,2020
2020-10-15,Kelantan,18,1,17,2020
2020-10-16,Kelantan,344,94,250,2020
2020-10-17,Kelantan,0,0,0,2020
2020-10-18,Kelantan,43,17,26,2020
2020-10-19,Kelantan,47,11,36,2020
2020-10-20,Kelantan,23,6,17,2020
2020-10-21,Kelantan,3,0,3,2020
2020-10-22,Kelantan,5,0,5,2020
2020-10-23,Kelantan,0,0,0,2020
2020-10-24,Kelantan,0,0,0,2020
2020-10-25,Kelantan,50,6,44,2020
2020-10-26,Kelantan,54,10,44,2020
2020-10-27,Kelantan,41,10,31,2020
2020-10-28,Kelantan,51,11,40,2020
2020-10-29,Kelantan,57,25,32,2020
2020-10-30,Kelantan,0,0,0,2020
2020-10-31,Kelantan,50,15,35,2020
2020-11-01,Kelantan,38,17,21,2020
2020-11-02,Kelantan,26,7,19,2020
2020-11-03,Kelantan,33,10,23,2020
2020-11-04,Kelantan,34,10,24,2020
2020-11-05,Kelantan,48,11,37,2020
2020-11-06,Kelantan,0,0,0,2020
2020-11-07,Kelantan,47,16,31,2020
2020-11-08,Kelantan,17,5,12,2020
2020-11-09,Kelantan,57,22,35,2020
2020-11-10,Kelantan,44,11,33,2020
2020-11-11,Kelantan,83,12,71,2020
2020-11-12,Kelantan,33,6,27,2020
2020-11-13,Kelantan,0,0,0,2020
2020-11-14,Kelantan,24,6,18,2020
2020-11-15,Kelantan,33,7,26,2020
2020-11-16,Kelantan,21,4,17,2020
2020-11-17,Kelantan,24,3,21,2020
2020-11-18,Kelantan,12,1,11,2020
2020-11-19,Kelantan,18,5,13,2020
2020-11-20,Kelantan,0,0,0,2020
2020-11-21,Kelantan,72,21,51,2020
2020-11-22,Kelantan,28,6,22,2020
2020-11-23,Kelantan,7,0,7,2020
2020-11-24,Kelantan,17,4,13,2020
2020-11-25,Kelantan,25,8,17,2020
2020-11-26,Kelantan,77,29,48,2020
2020-11-27,Kelantan,0,0,0,2020
2020-11-28,Kelantan,23,5,18,2020
2020-11-29,Kelantan,20,10,10,2020
2020-11-30,Kelantan,103,34,69,2020
2020-12-01,Kelantan,17,1,16,2020
2020-12-02,Kelantan,20,2,18,2020
2020-12-03,Kelantan,15,1,14,2020
2020-12-04,Kelantan,0,0,0,2020
2020-12-05,Kelantan,25,8,17,2020
2020-12-06,Kelantan,20,6,14,2020
2020-12-07,Kelantan,21,3,18,2020
2020-12-08,Kelantan,80,28,52,2020
2020-12-09,Kelantan,24,3,21,2020
2020-12-10,Kelantan,18,2,16,2020
2020-12-11,Kelantan,0,0,0,2020
2020-12-12,Kelantan,88,19,69,2020
2020-12-13,Kelantan,28,4,24,2020
2020-12-14,Kelantan,42,12,30,2020
2020-12-15,Kelantan,31,6,25,2020
2020-12-16,Kelantan,19,5,14,2020
2020-12-17,Kelantan,73,14,59,2020
2020-12-18,Kelantan,39,7,32,2020
2020-12-19,Kelantan,34,7,27,2020
2020-12-20,Kelantan,30,4,26,2020
2020-12-21,Kelantan,28,5,23,2020
2020-12-22,Kelantan,37,7,30,2020
2020-12-23,Kelantan,125,51,74,2020
2020-12-24,Kelantan,27,3,24,2020
2020-12-25,Kelantan,0,0,0,2020
2020-12-26,Kelantan,83,21,62,2020
2020-12-27,Kelantan,32,5,27,2020
2020-12-28,Kelantan,20,4,16,2020
2020-12-29,Kelantan,18,4,14,2020
2020-12-30,Kelantan,31,5,26,2020
2020-12-31,Kelantan,21,2,19,2020
2021-01-01,Kelantan,0,0,0,2021
2021-01-02,Kelantan,21,3,18,2021
2021-01-03,Kelantan,26,3,23,2021
2021-01-04,Kelantan,24,4,20,2021
2021-01-05,Kelantan,23,3,20,2021
2021-01-06,Kelantan,28,5,23,2021
2021-01-07,Kelantan,27,4,23,2021
2021-01-08,Kelantan,0,0,0,2021
2021-01-09,Kelantan,22,5,17,2021
2021-01-10,Kelantan,32,3,29,2021
2021-01-11,Kelantan,32,4,28,2021
2021-01-12,Kelantan,89,23,66,2021
2021-01-13,Kelantan,44,12,32,2021
2021-01-14,Kelantan,41,11,30,2021
2021-01-15,Kelantan,37,9,28,2021
2021-01-16,Kelantan,40,6,34,2021
2021-01-17,Kelantan,76,31,45,2021
2021-01-18,Kelantan,58,7,51,2021
2021-01-19,Kelantan,44,14,30,2021
2021-01-20,Kelantan,186,94,92,2021
2021-01-21,Kelantan,97,34,63,2021
2021-01-22,Kelantan,0,0,0,2021
2021-01-23,Kelantan,0,0,0,2021
2021-01-24,Kelantan,48,10,38,2021
2021-01-25,Kelantan,21,5,16,2021
2021-01-26,Kelantan,43,13,30,2021
2021-01-27,Kelantan,34,3,31,2021
2021-01-28,Kelantan,35,10,25,2021
2021-01-29,Kelantan,0,0,0,2021
2021-01-30,Kelantan,28,6,22,2021
2021-01-31,Kelantan,46,21,25,2021
2021-02-01,Kelantan,33,8,25,2021
2021-02-02,Kelantan,25,10,15,2021
2021-02-03,Kelantan,34,11,23,2021
2021-02-04,Kelantan,58,32,26,2021
2021-02-05,Kelantan,0,0,0,2021
2021-02-06,Kelantan,11,0,11,2021
2021-02-07,Kelantan,27,6,21,2021
2021-02-08,Kelantan,32,6,26,2021
2021-02-09,Kelantan,37,10,27,2021
2021-02-10,Kelantan,40,11,29,2021
2021-02-11,Kelantan,42,15,27,2021
2021-02-12,Kelantan,0,0,0,2021
2021-02-13,Kelantan,32,8,24,2021
2021-02-14,Kelantan,32,4,28,2021
2021-02-15,Kelantan,28,15,13,2021
2021-02-16,Kelantan,25,6,19,2021
2021-02-17,Kelantan,24,2,22,2021
2021-02-18,Kelantan,19,6,13,2021
2021-02-19,Kelantan,0,0,0,2021
2021-02-20,Kelantan,32,6,26,2021
2021-02-21,Kelantan,18,5,13,2021
2021-02-22,Kelantan,45,8,37,2021
2021-02-23,Kelantan,46,8,38,2021
2021-02-24,Kelantan,33,8,25,2021
2021-02-25,Kelantan,19,4,15,2021
2021-02-26,Kelantan,0,0,0,2021
2021-02-27,Kelantan,50,9,41,2021
2021-02-28,Kelantan,35,8,27,2021
2021-03-01,Kelantan,30,6,24,2021
2021-03-02,Kelantan,30,5,25,2021
2021-03-03,Kelantan,36,5,31,2021
2021-03-04,Kelantan,22,4,18,2021
2021-03-05,Kelantan,0,0,0,2021
2021-03-06,Kelantan,9,2,7,2021
2021-03-07,Kelantan,47,16,31,2021
2021-03-08,Kelantan,19,2,17,2021
2021-03-09,Kelantan,29,9,20,2021
2021-03-10,Kelantan,34,7,27,2021
2021-03-11,Kelantan,30,3,27,2021
2021-03-12,Kelantan,0,0,0,2021
2021-03-13,Kelantan,65,16,49,2021
2021-03-14,Kelantan,52,14,38,2021
2021-03-15,Kelantan,30,4,26,2021
2021-03-16,Kelantan,29,3,26,2021
2021-03-17,Kelantan,33,3,30,2021
2021-03-18,Kelantan,35,2,33,2021
2021-03-19,Kelantan,57,15,42,2021
2021-03-20,Kelantan,57,21,36,2021
2021-03-21,Kelantan,71,24,47,2021
2021-03-22,Kelantan,22,6,16,2021
2021-03-23,Kelantan,69,13,56,2021
2021-03-24,Kelantan,13,2,11,2021
2021-03-25,Kelantan,28,7,21,2021
2021-03-26,Kelantan,7,4,3,2021
2021-03-27,Kelantan,55,12,43,2021
2021-03-28,Kelantan,34,6,28,2021
2021-03-29,Kelantan,19,4,15,2021
2021-03-30,Kelantan,23,3,20,2021
2021-03-31,Kelantan,28,11,17,2021
2021-04-01,Kelantan,51,21,30,2021
2021-04-02,Kelantan,0,0,0,2021
2021-04-03,Kelantan,20,3,17,2021
2021-04-04,Kelantan,34,5,29,2021
2021-04-05,Kelantan,57,25,32,2021
2021-04-06,Kelantan,72,38,34,2021
2021-04-07,Kelantan,47,14,33,2021
2021-04-08,Kelantan,34,8,26,2021
2021-04-09,Kelantan,95,20,75,2021
2021-04-10,Kelantan,108,28,80,2021
2021-04-11,Kelantan,63,14,49,2021
2021-04-12,Kelantan,100,21,79,2021
2021-04-13,Kelantan,0,0,0,2021
2021-04-14,Kelantan,10,2,8,2021
2021-04-15,Kelantan,1,0,1,2021
2021-04-16,Kelantan,59,4,55,2021
2021-04-17,Kelantan,0,0,0,2021
2021-04-18,Kelantan,11,1,10,2021
2021-04-19,Kelantan,1,0,1,2021
2021-04-20,Kelantan,29,17,12,2021
2021-04-21,Kelantan,36,30,6,2021
2021-04-22,Kelantan,2,0,2,2021
2021-04-23,Kelantan,21,3,18,2021
2021-04-24,Kelantan,0,0,0,2021
2021-04-25,Kelantan,32,13,19,2021
2021-04-26,Kelantan,31,5,26,2021
2021-04-27,Kelantan,21,1,20,2021
2021-04-28,Kelantan,20,4,16,2021
2021-04-29,Kelantan,12,3,9,2021
2021-04-30,Kelantan,25,9,16,2021
2021-05-01,Kelantan,16,3,13,2021
2021-05-02,Kelantan,35,7,28,2021
2021-05-03,Kelantan,24,2,22,2021
2021-05-04,Kelantan,38,31,7,2021
2021-05-05,Kelantan,20,3,17,2021
2021-05-06,Kelantan,28,6,22,2021
2021-05-07,Kelantan,17,1,16,2021
2021-05-08,Kelantan,6,1,5,2021
2021-05-09,Kelantan,13,4,9,2021
2021-05-10,Kelantan,14,0,14,2021
2021-05-11,Kelantan,11,0,11,2021
2021-05-12,Kelantan,3,0,3,2021
2021-05-13,Kelantan,0,0,0,2021
2021-05-14,Kelantan,0,0,0,2021
2021-05-15,Kelantan,41,11,30,2021
2021-05-16,Kelantan,50,5,45,2021
2021-05-17,Kelantan,27,6,21,2021
2021-05-18,Kelantan,42,8,34,2021
2021-05-19,Kelantan,39,5,34,2021
2021-05-20,Kelantan,25,5,20,2021
2021-05-21,Kelantan,0,0,0,2021
2021-05-22,Kelantan,17,1,16,2021
2021-05-23,Kelantan,32,3,29,2021
2021-05-24,Kelantan,31,5,26,2021
2021-05-25,Kelantan,24,6,18,2021
2021-05-26,Kelantan,25,8,17,2021
2021-05-27,Kelantan,41,3,38,2021
2021-05-28,Kelantan,0,0,0,2021
2021-05-29,Kelantan,33,7,26,2021
2021-05-30,Kelantan,49,7,42,2021
2021-05-31,Kelantan,67,14,53,2021
2021-06-01,Kelantan,45,8,37,2021
2021-06-02,Kelantan,54,13,41,2021
2021-06-03,Kelantan,54,4,50,2021
2021-06-04,Kelantan,0,0,0,2021
2021-06-05,Kelantan,21,6,15,2021
2021-06-06,Kelantan,40,7,33,2021
2021-06-07,Kelantan,20,5,15,2021
2021-06-08,Kelantan,38,5,33,2021
2021-06-09,Kelantan,31,4,27,2021
2021-06-10,Kelantan,52,13,39,2021
2021-06-11,Kelantan,0,0,0,2021
2021-06-12,Kelantan,20,3,17,2021
2021-06-13,Kelantan,35,8,27,2021
2021-06-14,Kelantan,58,4,54,2021
2021-06-15,Kelantan,41,6,35,2021
2021-06-16,Kelantan,22,3,19,2021
2021-06-17,Kelantan,26,9,17,2021
2021-06-18,Kelantan,0,0,0,2021
2021-06-19,Kelantan,33,4,29,2021
2021-06-20,Kelantan,28,3,25,2021
2021-06-21,Kelantan,21,2,19,2021
2021-06-22,Kelantan,20,4,16,2021
2021-06-23,Kelantan,25,5,20,2021
2021-06-24,Kelantan,29,8,21,2021
2021-06-25,Kelantan,0,0,0,2021
2021-06-26,Kelantan,69,13,56,2021
2021-06-27,Kelantan,36,10,26,2021
2021-06-28,Kelantan,41,14,27,2021
2021-06-29,Kelantan,40,8,32,2021
2021-06-30,Kelantan,27,6,21,2021
2021-07-01,Kelantan,25,7,18,2021
2021-07-02,Kelantan,0,0,0,2021
2021-07-03,Kelantan,34,10,24,2021
2021-07-04,Kelantan,25,4,21,2021
2021-07-05,Kelantan,33,1,32,2021
2021-07-06,Kelantan,41,9,32,2021
2021-07-07,Kelantan,22,4,18,2021
2021-07-08,Kelantan,23,2,21,2021
2021-07-09,Kelantan,61,42,19,2021
2021-07-10,Kelantan,31,5,26,2021
2021-07-11,Kelantan,37,4,33,2021
2021-07-12,Kelantan,20,8,12,2021
2021-07-13,Kelantan,22,2,20,2021
2021-07-14,Kelantan,23,7,16,2021
2021-07-15,Kelantan,31,7,24,2021
2021-07-16,Kelantan,0,0,0,2021
2021-07-17,Kelantan,31,3,28,2021
2021-07-18,Kelantan,35,5,30,2021
2021-07-19,Kelantan,8,0,8,2021
2021-07-20,Kelantan,0,0,0,2021
2021-07-21,Kelantan,16,5,11,2021
2021-07-22,Kelantan,33,4,29,2021
2021-07-23,Kelantan,0,0,0,2021
2021-07-24,Kelantan,65,20,45,2021
2021-07-25,Kelantan,48,7,41,2021
2021-07-26,Kelantan,74,13,61,2021
2021-07-27,Kelantan,77,22,55,2021
2021-07-28,Kelantan,76,20,56,2021
2021-07-29,Kelantan,61,13,48,2021
2021-07-30,Kelantan,0,0,0,2021
2021-07-31,Kelantan,38,6,32,2021
2021-08-01,Kelantan,43,8,35,2021
2021-08-02,Kelantan,44,7,37,2021
2021-08-03,Kelantan,36,7,29,2021
2021-08-04,Kelantan,77,34,43,2021
2021-08-05,Kelantan,22,8,14,2021
2021-08-06,Kelantan,32,6,26,2021
2021-08-07,Kelantan,45,11,34,2021
2021-08-08,Kelantan,22,6,16,2021
2021-08-09,Kelantan,27,1,26,2021
2021-08-10,Kelantan,23,1,22,2021
2021-08-11,Kelantan,17,1,16,2021
2021-08-12,Kelantan,26,3,23,2021
2021-08-13,Kelantan,0,0,0,2021
2021-08-14,Kelantan,73,18,55,2021
2021-08-15,Kelantan,23,4,19,2021
2021-08-16,Kelantan,24,5,19,2021
2021-08-17,Kelantan,22,3,19,2021
2021-08-18,Kelantan,26,3,23,2021
2021-08-19,Kelantan,9,0,9,2021
2021-08-20,Kelantan,6,0,6,2021
2021-08-21,Kelantan,73,11,62,2021
2021-08-22,Kelantan,40,11,29,2021
2021-08-23,Kelantan,21,2,19,2021
2021-08-24,Kelantan,20,7,13,2021
2021-08-25,Kelantan,26,4,22,2021
2021-08-26,Kelantan,38,9,29,2021
2021-08-27,Kelantan,0,0,0,2021
2021-08-28,Kelantan,16,7,9,2021
2021-08-29,Kelantan,54,10,44,2021
2021-08-30,Kelantan,48,9,39,2021
2021-08-31,Kelantan,0,0,0,2021
2021-09-01,Kelantan,24,1,23,2021
2021-09-02,Kelantan,27,3,24,2021
2021-09-03,Kelantan,0,0,0,2021
2021-09-04,Kelantan,147,61,86,2021
2021-09-05,Kelantan,22,6,16,2021
2021-09-06,Kelantan,31,4,27,2021
2021-09-07,Kelantan,37,7,30,2021
2021-09-08,Kelantan,28,8,20,2021
2021-09-09,Kelantan,27,1,26,2021
2021-09-10,Kelantan,0,0,0,2021
2021-09-11,Kelantan,154,71,83,2021
2021-09-12,Kelantan,33,8,25,2021
2021-09-13,Kelantan,62,31,31,2021
2021-09-14,Kelantan,29,7,22,2021
2021-09-15,Kelantan,34,6,28,2021
2021-09-16,Kelantan,0,0,0,2021
2021-09-17,Kelantan,0,0,0,2021
2021-09-18,Kelantan,33,8,25,2021
2021-09-19,Kelantan,37,1,36,2021
2021-09-20,Kelantan,26,1,25,2021
2021-09-21,Kelantan,30,5,25,2021
2021-09-22,Kelantan,21,2,19,2021
2021-09-23,Kelantan,9,0,9,2021
2021-09-24,Kelantan,0,0,0,2021
2021-09-25,Kelantan,73,23,50,2021
2021-09-26,Kelantan,27,4,23,2021
2021-09-27,Kelantan,31,11,20,2021
2021-09-28,Kelantan,23,4,19,2021
2021-09-29,Kelantan,38,7,31,2021
2021-09-30,Kelantan,44,6,38,2021
2021-10-01,Kelantan,0,0,0,2021
2021-10-02,Kelantan,36,7,29,2021
2021-10-03,Kelantan,48,8,40,2021
2021-10-04,Kelantan,29,3,26,2021
2021-10-05,Kelantan,26,2,24,2021
2021-10-06,Kelantan,49,9,40,2021
2021-10-07,Kelantan,23,2,21,2021
2021-10-08,Kelantan,0,0,0,2021
2021-10-09,Kelantan,23,6,17,2021
2021-10-10,Kelantan,33,3,30,2021
2021-10-11,Kelantan,33,6,27,2021
2021-10-12,Kelantan,34,6,28,2021
2021-10-13,Kelantan,37,6,31,2021
2021-10-14,Kelantan,34,7,27,2021
2021-10-15,Kelantan,0,0,0,2021
2021-10-16,Kelantan,42,13,29,2021
2021-10-17,Kelantan,41,6,35,2021
2021-10-18,Kelantan,29,5,24,2021
2021-10-19,Kelantan,32,8,24,2021
2021-10-20,Kelantan,32,5,27,2021
2021-10-21,Kelantan,28,5,23,2021
2021-10-22,Kelantan,0,0,0,2021
2021-10-23,Kelantan,35,6,29,2021
2021-10-24,Kelantan,31,7,24,2021
2021-10-25,Kelantan,31,7,24,2021
2021-10-26,Kelantan,30,3,27,2021
2021-10-27,Kelantan,60,5,55,2021
2021-10-28,Kelantan,62,6,56,2021
2021-10-29,Kelantan,80,27,53,2021
2021-10-30,Kelantan,87,25,62,2021
2021-10-31,Kelantan,54,10,44,2021
2021-11-01,Kelantan,30,6,24,2021
2021-11-02,Kelantan,30,6,24,2021
2021-11-03,Kelantan,57,8,49,2021
2021-11-04,Kelantan,58,9,49,2021
2021-11-05,Kelantan,0,0,0,2021
2021-11-06,Kelantan,38,8,30,2021
2021-11-07,Kelantan,35,6,29,2021
2021-11-08,Kelantan,26,3,23,2021
2021-11-09,Kelantan,30,1,29,2021
2021-11-10,Kelantan,67,25,42,2021
2021-11-11,Kelantan,82,28,54,2021
2021-11-12,Kelantan,0,0,0,2021
2021-11-13,Kelantan,37,7,30,2021
2021-11-14,Kelantan,35,7,28,2021
2021-11-15,Kelantan,21,1,20,2021
2021-11-16,Kelantan,35,4,31,2021
2021-11-17,Kelantan,30,10,20,2021
2021-11-18,Kelantan,31,6,25,2021
2021-11-19,Kelantan,35,4,31,2021
2021-11-20,Kelantan,16,2,14,2021
2021-11-21,Kelantan,40,10,30,2021
2021-11-22,Kelantan,29,7,22,2021
2021-11-23,Kelantan,35,16,19,2021
2021-11-24,Kelantan,34,7,27,2021
2021-11-25,Kelantan,52,23,29,2021
2021-11-26,Kelantan,27,9,18,2021
2021-11-27,Kelantan,26,7,19,2021
2021-11-28,Kelantan,42,6,36,2021
2021-11-29,Kelantan,19,4,15,2021
2021-11-30,Kelantan,30,6,24,2021
2021-12-01,Kelantan,69,24,45,2021
2021-12-02,Kelantan,73,31,42,2021
2021-12-03,Kelantan,0,0,0,2021
2021-12-04,Kelantan,69,21,48,2021
2021-12-05,Kelantan,32,5,27,2021
2021-12-06,Kelantan,31,10,21,2021
2021-12-07,Kelantan,30,5,25,2021
2021-12-08,Kelantan,81,28,53,2021
2021-12-09,Kelantan,67,27,40,2021
2021-12-10,Kelantan,21,6,15,2021
2021-12-11,Kelantan,90,20,70,2021
2021-12-12,Kelantan,33,4,29,2021
2021-12-13,Kelantan,38,12,26,2021
2021-12-14,Kelantan,33,4,29,2021
2021-12-15,Kelantan,30,3,27,2021
2021-12-16,Kelantan,25,5,20,2021
2021-12-17,Kelantan,85,13,72,2021
2021-12-18,Kelantan,22,6,16,2021
2021-12-19,Kelantan,24,3,21,2021
2021-12-20,Kelantan,36,12,24,2021
2021-12-21,Kelantan,87,13,74,2021
2021-12-22,Kelantan,19,2,17,2021
2021-12-23,Kelantan,6,0,6,2021
2021-12-24,Kelantan,32,9,23,2021
2021-12-25,Kelantan,61,12,49,2021
2021-12-26,Kelantan,26,5,21,2021
2021-12-27,Kelantan,69,10,59,2021
2021-12-28,Kelantan,73,6,67,2021
2021-12-29,Kelantan,40,10,30,2021
2021-12-30,Kelantan,39,7,32,2021
2021-12-31,Kelantan,0,0,0,2021
2022-01-01,Kelantan,21,7,14,2022
2022-01-02,Kelantan,63,15,48,2022
2022-01-03,Kelantan,42,8,34,2022
2022-01-04,Kelantan,43,12,31,2022
2022-01-05,Kelantan,31,2,29,2022
2022-01-06,Kelantan,24,5,19,2022
2022-01-07,Kelantan,41,17,24,2022
2022-01-08,Kelantan,0,0,0,2022
2022-01-09,Kelantan,31,6,25,2022
2022-01-10,Kelantan,44,7,37,2022
2022-01-11,Kelantan,24,4,20,2022
2022-01-12,Kelantan,30,7,23,2022
2022-01-13,Kelantan,29,4,25,2022
2022-01-14,Kelantan,34,9,25,2022
2022-01-15,Kelantan,27,11,16,2022
2022-01-16,Kelantan,35,2,33,2022
2022-01-17,Kelantan,17,2,15,2022
2022-01-18,Kelantan,36,4,32,2022
2022-01-19,Kelantan,27,6,21,2022
2022-01-20,Kelantan,38,4,34,2022
2022-01-21,Kelantan,53,20,33,2022
2022-01-22,Kelantan,49,17,32,2022
2022-01-23,Kelantan,26,1,25,2022
2022-01-24,Kelantan,12,3,9,2022
2022-01-25,Kelantan,19,6,13,2022
2022-01-26,Kelantan,42,5,37,2022
2022-01-27,Kelantan,19,1,18,2022
2022-01-28,Kelantan,0,0,0,2022
2022-01-29,Kelantan,54,16,38,2022
2022-01-30,Kelantan,61,11,50,2022
2022-01-31,Kelantan,12,0,12,2022
2022-02-01,Kelantan,0,0,0,2022
2022-02-02,Kelantan,26,5,21,2022
2022-02-03,Kelantan,39,3,36,2022
2022-02-04,Kelantan,0,0,0,2022
2022-02-05,Kelantan,11,2,9,2022
2022-02-06,Kelantan,23,3,20,2022
2022-02-07,Kelantan,23,2,21,2022
2022-02-08,Kelantan,28,4,24,2022
2022-02-09,Kelantan,31,3,28,2022
2022-02-10,Kelantan,31,2,29,2022
2022-02-11,Kelantan,0,0,0,2022
2022-02-12,Kelantan,32,7,25,2022
2022-02-13,Kelantan,39,2,37,2022
2022-02-14,Kelantan,35,8,27,2022
2022-02-15,Kelantan,33,3,30,2022
2022-02-16,Kelantan,47,4,43,2022
2022-02-17,Kelantan,90,29,61,2022
2022-02-18,Kelantan,0,0,0,2022
2022-02-19,Kelantan,13,5,8,2022
2022-02-20,Kelantan,32,5,27,2022
2022-02-21,Kelantan,23,0,23,2022
2022-02-22,Kelantan,93,6,87,2022
2022-02-23,Kelantan,20,6,14,2022
2022-02-24,Kelantan,80,16,64,2022
2022-02-25,Kelantan,0,0,0,2022
2022-02-26,Kelantan,7,3,4,2022
2022-02-27,Kelantan,14,2,12,2022
2022-02-28,Kelantan,27,6,21,2022
2022-03-01,Kelantan,26,3,23,2022
2022-03-02,Kelantan,37,7,30,2022
2022-03-03,Kelantan,27,4,23,2022
2022-03-04,Kelantan,52,14,38,2022
2022-03-05,Kelantan,38,18,20,2022
2022-03-06,Kelantan,25,5,20,2022
2022-03-07,Kelantan,29,15,14,2022
2022-03-08,Kelantan,27,15,12,2022
2022-03-09,Kelantan,34,6,28,2022
2022-03-10,Kelantan,16,3,13,2022
2022-03-11,Kelantan,51,14,37,2022
2022-03-12,Kelantan,43,15,28,2022
2022-03-13,Kelantan,28,4,24,2022
2022-03-14,Kelantan,42,8,34,2022
2022-03-15,Kelantan,58,12,46,2022
2022-03-16,Kelantan,35,5,30,2022
2022-03-17,Kelantan,32,6,26,2022
2022-03-18,Kelantan,0,0,0,2022
2022-03-19,Kelantan,18,11,7,2022
2022-03-20,Kelantan,80,15,65,2022
2022-03-21,Kelantan,19,2,17,2022
2022-03-22,Kelantan,26,3,23,2022
2022-03-23,Kelantan,19,5,14,2022
2022-03-24,Kelantan,40,7,33,2022
2022-03-25,Kelantan,27,16,11,2022
2022-03-26,Kelantan,67,20,47,2022
2022-03-27,Kelantan,82,25,57,2022
2022-03-28,Kelantan,104,30,74,2022
2022-03-29,Kelantan,74,11,63,2022
2022-03-30,Kelantan,77,27,50,2022
2022-03-31,Kelantan,83,14,69,2022
2022-04-01,Kelantan,51,13,38,2022
2022-04-02,Kelantan,71,17,54,2022
2022-04-03,Kelantan,2,0,2,2022
2022-04-04,Kelantan,18,1,17,2022
2022-04-05,Kelantan,10,0,10,2022
2022-04-06,Kelantan,31,5,26,2022
2022-04-07,Kelantan,20,7,13,2022
2022-04-08,Kelantan,66,16,50,2022
2022-04-09,Kelantan,18,7,11,2022
2022-04-10,Kelantan,32,21,11,2022
2022-04-11,Kelantan,32,25,7,2022
2022-04-12,Kelantan,47,11,36,2022
2022-04-13,Kelantan,33,9,24,2022
2022-04-14,Kelantan,16,5,11,2022
2022-04-15,Kelantan,66,21,45,2022
2022-04-16,Kelantan,12,3,9,2022
2022-04-17,Kelantan,20,7,13,2022
2022-04-18,Kelantan,37,3,34,2022
2022-04-19,Kelantan,22,6,16,2022
2022-04-20,Kelantan,30,5,25,2022
2022-04-21,Kelantan,28,5,23,2022
2022-04-22,Kelantan,33,8,25,2022
2022-04-23,Kelantan,5,0,5,2022
2022-04-24,Kelantan,38,16,22,2022
2022-04-25,Kelantan,33,3,30,2022
2022-04-26,Kelantan,42,8,34,2022
2022-04-27,Kelantan,31,5,26,2022
2022-04-28,Kelantan,40,6,34,2022
2022-04-29,Kelantan,49,18,31,2022
2022-04-30,Kelantan,35,11,24,2022
2022-05-01,Kelantan,26,5,21,2022
2022-05-02,Kelantan,0,0,0,2022
2022-05-03,Kelantan,0,0,0,2022
2022-05-04,Kelantan,42,15,27,2022
2022-05-05,Kelantan,60,11,49,2022
2022-05-06,Kelantan,54,9,45,2022
2022-05-07,Kelantan,54,15,39,2022
2022-05-08,Kelantan,42,8,34,2022
2022-05-09,Kelantan,21,5,16,2022
2022-05-10,Kelantan,38,10,28,2022
2022-05-11,Kelantan,40,9,31,2022
2022-05-12,Kelantan,66,15,51,2022
2022-05-13,Kelantan,42,10,32,2022
2022-05-14,Kelantan,37,9,28,2022
2022-05-15,Kelantan,54,9,45,2022
2022-05-16,Kelantan,52,6,46,2022
2022-05-17,Kelantan,58,3,55,2022
2022-05-18,Kelantan,166,58,108,2022
2022-05-19,Kelantan,16,4,12,2022
2022-05-20,Kelantan,68,14,54,2022
2022-05-21,Kelantan,107,26,81,2022
2022-05-22,Kelantan,41,8,33,2022
2022-05-23,Kelantan,15,2,13,2022
2022-05-24,Kelantan,31,4,27,2022
2022-05-25,Kelantan,30,1,29,2022
2022-05-26,Kelantan,74,24,50,2022
2022-05-27,Kelantan,46,18,28,2022
2022-05-28,Kelantan,0,0,0,2022
2022-05-29,Kelantan,36,2,34,2022
2022-05-30,Kelantan,76,55,21,2022
2022-05-31,Kelantan,18,1,17,2022
2022-06-01,Kelantan,38,6,32,2022
2022-06-02,Kelantan,48,8,40,2022
2022-06-03,Kelantan,0,0,0,2022
2022-06-04,Kelantan,33,5,28,2022
2022-06-05,Kelantan,48,4,44,2022
2022-06-06,Kelantan,18,5,13,2022
2022-06-07,Kelantan,56,11,45,2022
2022-06-08,Kelantan,78,34,44,2022
2022-06-09,Kelantan,66,10,56,2022
2022-06-10,Kelantan,0,0,0,2022
2022-06-11,Kelantan,52,11,41,2022
2022-06-12,Kelantan,35,10,25,2022
2022-06-13,Kelantan,33,8,25,2022
2022-06-14,Kelantan,195,31,164,2022
2022-06-15,Kelantan,51,9,42,2022
2022-06-16,Kelantan,72,18,54,2022
2022-06-17,Kelantan,0,0,0,2022
2022-06-18,Kelantan,35,12,23,2022
2022-06-19,Kelantan,38,9,29,2022
2022-06-20,Kelantan,48,10,38,2022
2022-06-21,Kelantan,38,5,33,2022
2022-06-22,Kelantan,33,0,33,2022
2022-06-23,Kelantan,55,38,17,2022
2022-06-24,Kelantan,25,10,15,2022
2022-06-25,Kelantan,85,22,63,2022
2022-06-26,Kelantan,32,7,25,2022
2022-06-27,Kelantan,29,9,20,2022
2022-06-28,Kelantan,29,4,25,2022
2022-06-29,Kelantan,51,13,38,2022
2022-06-30,Kelantan,21,4,17,2022
2022-07-01,Kelantan,0,0,0,2022
2022-07-02,Kelantan,32,11,21,2022
2022-07-03,Kelantan,29,7,22,2022
2022-07-04,Kelantan,30,2,28,2022
2022-07-05,Kelantan,35,16,19,2022
2022-07-06,Kelantan,32,5,27,2022
2022-07-07,Kelantan,101,50,51,2022
2022-07-08,Kelantan,0,0,0,2022
2022-07-09,Kelantan,23,6,17,2022
2022-07-10,Kelantan,0,0,0,2022
2022-07-11,Kelantan,0,0,0,2022
2022-07-12,Kelantan,36,7,29,2022
2022-07-13,Kelantan,45,11,34,2022
2022-07-14,Kelantan,36,6,30,2022
2022-07-15,Kelantan,0,0,0,2022
2022-07-16,Kelantan,21,2,19,2022
2022-07-17,Kelantan,45,23,22,2022
2022-07-18,Kelantan,76,47,29,2022
2022-07-19,Kelantan,40,12,28,2022
2022-07-20,Kelantan,93,21,72,2022
2022-07-21,Kelantan,67,17,50,2022
2022-07-22,Kelantan,9,1,8,2022
2022-07-23,Kelantan,27,5,22,2022
2022-07-24,Kelantan,28,5,23,2022
2022-07-25,Kelantan,41,12,29,2022
2022-07-26,Kelantan,54,32,22,2022
2022-07-27,Kelantan,26,9,17,2022
2022-07-28,Kelantan,19,2,17,2022
2022-07-29,Kelantan,539,129,410,2022
2022-07-30,Kelantan,0,0,0,2022
2022-07-31,Kelantan,0,0,0,2022
2022-08-01,Kelantan,37,7,30,2022
2022-08-02,Kelantan,32,9,23,2022
2022-08-03,Kelantan,40,12,28,2022
2022-08-04,Kelantan,50,8,42,2022
2022-08-05,Kelantan,85,17,68,2022
2022-08-06,Kelantan,19,3,16,2022
2022-08-07,Kelantan,37,2,35,2022
2022-08-08,Kelantan,22,2,20,2022
2022-08-09,Kelantan,65,56,9,2022
2022-08-10,Kelantan,65,42,23,2022
2022-08-11,Kelantan,34,6,28,2022
2022-08-12,Kelantan,37,28,9,2022
2022-08-13,Kelantan,19,2,17,2022
2022-08-14,Kelantan,29,6,23,2022
2022-08-15,Kelantan,27,5,22,2022
2022-08-16,Kelantan,38,9,29,2022
2022-08-17,Kelantan,44,10,34,2022
2022-08-18,Kelantan,30,5,25,2022
2022-08-19,Kelantan,75,30,45,2022
2022-08-20,Kelantan,0,0,0,2022
2022-08-21,Kelantan,43,11,32,2022
2022-08-22,Kelantan,57,24,33,2022
2022-08-23,Kelantan,25,4,21,2022
2022-08-24,Kelantan,35,7,28,2022
2022-08-25,Kelantan,56,17,39,2022
2022-08-26,Kelantan,16,8,8,2022
2022-08-27,Kelantan,50,18,32,2022
2022-08-28,Kelantan,20,2,18,2022
2022-08-29,Kelantan,18,2,16,2022
2022-08-30,Kelantan,73,17,56,2022
2022-08-31,Kelantan,66,20,46,2022
2022-09-01,Kelantan,23,4,19,2022
2022-09-02,Kelantan,0,0,0,2022
2022-09-03,Kelantan,32,12,20,2022
2022-09-04,Kelantan,18,1,17,2022
2022-09-05,Kelantan,34,9,25,2022
2022-09-06,Kelantan,44,8,36,2022
2022-09-07,Kelantan,36,5,31,2022
2022-09-08,Kelantan,54,11,43,2022
2022-09-09,Kelantan,0,0,0,2022
2022-09-10,Kelantan,33,9,24,2022
2022-09-11,Kelantan,32,7,25,2022
2022-09-12,Kelantan,20,4,16,2022
2022-09-13,Kelantan,14,0,14,2022
2022-09-14,Kelantan,248,208,40,2022
2022-09-15,Kelantan,34,23,11,2022
2022-09-16,Kelantan,91,9,82,2022
2022-09-17,Kelantan,70,26,44,2022
2022-09-18,Kelantan,21,0,21,2022
2022-09-19,Kelantan,18,2,16,2022
2022-09-20,Kelantan,35,4,31,2022
2022-09-21,Kelantan,25,2,23,2022
2022-09-22,Kelantan,41,11,30,2022
2022-09-23,Kelantan,0,0,0,2022
2022-09-24,Kelantan,63,17,46,2022
2022-09-25,Kelantan,40,4,36,2022
2022-09-26,Kelantan,45,5,40,2022
2022-09-27,Kelantan,34,12,22,2022
2022-09-28,Kelantan,49,13,36,2022
2022-09-29,Kelantan,32,5,27,2022
2022-09-30,Kelantan,23,18,5,2022
2022-10-01,Kelantan,21,7,14,2022
2022-10-02,Kelantan,43,12,31,2022
2022-10-03,Kelantan,37,4,33,2022
2022-10-04,Kelantan,56,20,36,2022
2022-10-05,Kelantan,32,9,23,2022
2022-10-06,Kelantan,21,1,20,2022
2022-10-07,Kelantan,57,15,42,2022
2022-10-08,Kelantan,153,42,111,2022
2022-10-09,Kelantan,0,0,0,2022
2022-10-10,Kelantan,24,1,23,2022
2022-10-11,Kelantan,34,7,27,2022
2022-10-12,Kelantan,44,9,35,2022
2022-10-13,Kelantan,37,9,28,2022
2022-10-14,Kelantan,0,0,0,2022
2022-10-15,Kelantan,110,34,76,2022
2022-10-16,Kelantan,31,5,26,2022
2022-10-17,Kelantan,65,22,43,2022
2022-10-18,Kelantan,43,7,36,2022
2022-10-19,Kelantan,74,35,39,2022
2022-10-20,Kelantan,26,6,20,2022
2022-10-21,Kelantan,25,7,18,2022
2022-10-22,Kelantan,35,21,14,2022
2022-10-23,Kelantan,18,1,17,2022
2022-10-24,Kelantan,45,10,35,2022
2022-10-25,Kelantan,46,34,12,2022
2022-10-26,Kelantan,115,58,57,2022
2022-10-27,Kelantan,94,72,22,2022
2022-10-28,Kelantan,78,23,55,2022
2022-10-29,Kelantan,45,5,40,2022
2022-10-30,Kelantan,28,4,24,2022
2022-10-31,Kelantan,39,5,34,2022
2022-11-01,Kelantan,93,44,49,2022
2022-11-02,Kelantan,105,52,53,2022
2022-11-03,Kelantan,33,17,16,2022
2022-11-04,Kelantan,60,14,46,2022
2022-11-05,Kelantan,0,0,0,2022
2022-11-06,Kelantan,61,15,46,2022
2022-11-07,Kelantan,39,5,34,2022
2022-11-08,Kelantan,50,13,37,2022
2022-11-09,Kelantan,26,4,22,2022
2022-11-10,Kelantan,154,131,23,2022
2022-11-11,Kelantan,44,11,33,2022
2022-11-12,Kelantan,38,11,27,2022
2022-11-13,Kelantan,19,1,18,2022
2022-11-14,Kelantan,32,3,29,2022
2022-11-15,Kelantan,30,3,27,2022
2022-11-16,Kelantan,25,5,20,2022
2022-11-17,Kelantan,48,4,44,2022
2022-11-18,Kelantan,0,0,0,2022
2022-11-19,Kelantan,0,0,0,2022
2022-11-20,Kelantan,36,3,33,2022
2022-11-21,Kelantan,38,10,28,2022
2022-11-22,Kelantan,143,53,90,2022
2022-11-23,Kelantan,43,14,29,2022
2022-11-24,Kelantan,43,17,26,2022
2022-11-25,Kelantan,72,22,50,2022
2022-11-26,Kelantan,73,43,30,2022
2022-11-27,Kelantan,49,13,36,2022
2022-11-28,Kelantan,28,5,23,2022
2022-11-29,Kelantan,65,51,14,2022
2022-11-30,Kelantan,64,22,42,2022
2022-12-01,Kelantan,39,8,31,2022
2022-12-02,Kelantan,50,17,33,2022
2022-12-03,Kelantan,49,13,36,2022
2022-12-04,Kelantan,34,4,30,2022
2022-12-05,Kelantan,32,1,31,2022
2022-12-06,Kelantan,79,26,53,2022
2022-12-07,Kelantan,65,11,54,2022
2022-12-08,Kelantan,22,3,19,2022
2022-12-09,Kelantan,0,0,0,2022
2022-12-10,Kelantan,52,14,38,2022
2022-12-11,Kelantan,15,1,14,2022
2022-12-12,Kelantan,43,4,39,2022
2022-12-13,Kelantan,58,4,54,2022
2022-12-14,Kelantan,112,19,93,2022
2022-12-15,Kelantan,57,12,45,2022
2022-12-16,Kelantan,51,42,9,2022
2022-12-17,Kelantan,69,25,44,2022
2022-12-18,Kelantan,24,6,18,2022
2022-12-19,Kelantan,6,0,6,2022
2022-12-20,Kelantan,13,0,13,2022
2022-12-21,Kelantan,50,15,35,2022
2022-12-22,Kelantan,36,4,32,2022
2022-12-23,Kelantan,14,4,10,2022
2022-12-24,Kelantan,42,9,33,2022
2022-12-25,Kelantan,37,11,26,2022
2022-12-26,Kelantan,59,12,47,2022
2022-12-27,Kelantan,49,6,43,2022
2022-12-28,Kelantan,38,5,33,2022
2022-12-29,Kelantan,61,13,48,2022
2022-12-30,Kelantan,63,13,50,2022
2022-12-31,Kelantan,0,0,0,2022
2023-01-01,Kelantan,83,10,73,2023
2023-01-02,Kelantan,58,22,36,2023
2023-01-03,Kelantan,34,9,25,2023
2023-01-04,Kelantan,46,11,35,2023
2023-01-05,Kelantan,66,34,32,2023
2023-01-06,Kelantan,51,24,27,2023
2023-01-07,Kelantan,25,8,17,2023
2023-01-08,Kelantan,33,10,23,2023
2023-01-09,Kelantan,29,1,28,2023
2023-01-10,Kelantan,56,16,40,2023
2023-01-11,Kelantan,26,3,23,2023
2023-01-12,Kelantan,34,8,26,2023
2023-01-13,Kelantan,36,9,27,2023
2023-01-14,Kelantan,31,13,18,2023
2023-01-15,Kelantan,36,3,33,2023
2023-01-16,Kelantan,69,28,41,2023
2023-01-17,Kelantan,81,36,45,2023
2023-01-18,Kelantan,34,6,28,2023
2023-01-19,Kelantan,117,29,88,2023
2023-01-20,Kelantan,0,0,0,2023
2023-01-21,Kelantan,27,6,21,2023
2023-01-22,Kelantan,44,12,32,2023
2023-01-23,Kelantan,61,19,42,2023
2023-01-24,Kelantan,40,10,30,2023
2023-01-25,Kelantan,20,5,15,2023
2023-01-26,Kelantan,34,19,15,2023
2023-01-27,Kelantan,35,6,29,2023
2023-01-28,Kelantan,24,5,19,2023
2023-01-29,Kelantan,24,1,23,2023
2023-01-30,Kelantan,26,0,26,2023
2023-01-31,Kelantan,28,5,23,2023
2023-02-01,Kelantan,35,3,32,2023
2023-02-02,Kelantan,38,17,21,2023
2023-02-03,Kelantan,0,0,0,2023
2023-02-04,Kelantan,65,19,46,2023
2023-02-05,Kelantan,40,11,29,2023
2023-02-06,Kelantan,111,55,56,2023
2023-02-07,Kelantan,33,4,29,2023
2023-02-08,Kelantan,32,2,30,2023
2023-02-09,Kelantan,200,111,89,2023
2023-02-10,Kelantan,53,50,3,2023
2023-02-11,Kelantan,18,3,15,2023
2023-02-12,Kelantan,36,3,33,2023
2023-02-13,Kelantan,52,16,36,2023
2023-02-14,Kelantan,53,19,34,2023
2023-02-15,Kelantan,58,16,42,2023
2023-02-16,Kelantan,34,8,26,2023
2023-02-17,Kelantan,0,0,0,2023
2023-02-18,Kelantan,49,9,40,2023
2023-02-19,Kelantan,51,18,33,2023
2023-02-20,Kelantan,62,34,28,2023
2023-02-21,Kelantan,44,7,37,2023
2023-02-22,Kelantan,57,19,38,2023
2023-02-23,Kelantan,42,11,31,2023
2023-02-24,Kelantan,19,2,17,2023
2023-02-25,Kelantan,69,29,40,2023
2023-02-26,Kelantan,90,23,67,2023
2023-02-27,Kelantan,54,8,46,2023
2023-02-28,Kelantan,44,29,15,2023
2023-03-01,Kelantan,48,10,38,2023
2023-03-02,Kelantan,53,15,38,2023
2023-03-03,Kelantan,0,0,0,2023
2023-03-04,Kelantan,70,21,49,2023
2023-03-05,Kelantan,59,18,41,2023
2023-03-06,Kelantan,65,9,56,2023
2023-03-07,Kelantan,54,11,43,2023
2023-03-08,Kelantan,43,6,37,2023
2023-03-09,Kelantan,41,3,38,2023
2023-03-10,Kelantan,167,46,121,2023
2023-03-11,Kelantan,76,18,58,2023
2023-03-12,Kelantan,104,37,67,2023
2023-03-13,Kelantan,54,10,44,2023
2023-03-14,Kelantan,48,8,40,2023
2023-03-15,Kelantan,48,9,39,2023
2023-03-16,Kelantan,184,31,153,2023
2023-03-17,Kelantan,116,32,84,2023
2023-03-18,Kelantan,84,17,67,2023
2023-03-19,Kelantan,76,16,60,2023
2023-03-20,Kelantan,39,9,30,2023
2023-03-21,Kelantan,46,7,39,2023
2023-03-22,Kelantan,85,36,49,2023
2023-03-23,Kelantan,2,0,2,2023
2023-03-24,Kelantan,88,9,79,2023
2023-03-25,Kelantan,33,7,26,2023
2023-03-26,Kelantan,26,3,23,2023
2023-03-27,Kelantan,22,4,18,2023
2023-03-28,Kelantan,74,21,53,2023
2023-03-29,Kelantan,82,41,41,2023
2023-03-30,Kelantan,36,4,32,2023
2023-03-31,Kelantan,36,10,26,2023
2023-04-01,Kelantan,0,0,0,2023
2023-04-02,Kelantan,63,6,57,2023
2023-04-03,Kelantan,41,12,29,2023
2023-04-04,Kelantan,27,10,17,2023
2023-04-05,Kelantan,29,4,25,2023
2023-04-06,Kelantan,22,3,19,2023
2023-04-07,Kelantan,29,8,21,2023
2023-04-08,Kelantan,21,9,12,2023
2023-04-09,Kelantan,14,9,5,2023
2023-04-10,Kelantan,31,19,12,2023
2023-04-11,Kelantan,11,2,9,2023
2023-04-12,Kelantan,29,7,22,2023
2023-04-13,Kelantan,15,4,11,2023
2023-04-14,Kelantan,38,10,28,2023
2023-04-15,Kelantan,33,13,20,2023
2023-04-16,Kelantan,61,11,50,2023
2023-04-17,Kelantan,21,7,14,2023
2023-04-18,Kelantan,80,10,70,2023
2023-04-19,Kelantan,65,7,58,2023
2023-04-20,Kelantan,6,0,6,2023
2023-04-21,Kelantan,0,0,0,2023
2023-04-22,Kelantan,0,0,0,2023
2023-04-23,Kelantan,0,0,0,2023
2023-04-24,Kelantan,71,22,49,2023
2023-04-25,Kelantan,42,9,33,2023
2023-04-26,Kelantan,59,13,46,2023
2023-04-27,Kelantan,41,8,33,2023
2023-04-28,Kelantan,30,7,23,2023
2023-04-29,Kelantan,85,24,61,2023
2023-04-30,Kelantan,64,12,52,2023
2023-05-01,Kelantan,70,16,54,2023
2023-05-02,Kelantan,25,2,23,2023
2023-05-03,Kelantan,55,3,52,2023
2023-05-04,Kelantan,19,4,15,2023
2023-05-05,Kelantan,0,0,0,2023
2023-05-06,Kelantan,49,8,41,2023
2023-05-07,Kelantan,45,10,35,2023
2023-05-08,Kelantan,29,3,26,2023
2023-05-09,Kelantan,130,63,67,2023
2023-05-10,Kelantan,43,9,34,2023
2023-05-11,Kelantan,17,3,14,2023
2023-05-12,Kelantan,20,7,13,2023
2023-05-13,Kelantan,14,9,5,2023
2023-05-14,Kelantan,24,0,24,2023
2023-05-15,Kelantan,33,11,22,2023
2023-05-16,Kelantan,37,19,18,2023
2023-05-17,Kelantan,20,4,16,2023
2023-05-18,Kelantan,46,23,23,2023
2023-05-19,Kelantan,220,60,160,2023
2023-05-20,Kelantan,0,0,0,2023
2023-05-21,Kelantan,43,12,31,2023
2023-05-22,Kelantan,43,3,40,2023
2023-05-23,Kelantan,76,25,51,2023
2023-05-24,Kelantan,20,1,19,2023
2023-05-25,Kelantan,22,4,18,2023
2023-05-26,Kelantan,21,6,15,2023
2023-05-27,Kelantan,35,18,17,2023
2023-05-28,Kelantan,79,11,68,2023
2023-05-29,Kelantan,42,5,37,2023
2023-05-30,Kelantan,76,23,53,2023
2023-05-31,Kelantan,55,16,39,2023
2023-06-01,Kelantan,36,12,24,2023
2023-06-02,Kelantan,22,9,13,2023
2023-06-03,Kelantan,36,12,24,2023
2023-06-04,Kelantan,10,0,10,2023
2023-06-05,Kelantan,46,12,34,2023
2023-06-06,Kelantan,64,13,51,2023
2023-06-07,Kelantan,89,26,63,2023
2023-06-08,Kelantan,15,0,15,2023
2023-06-09,Kelantan,19,2,17,2023
2023-06-10,Kelantan,58,19,39,2023
2023-06-11,Kelantan,28,6,22,2023
2023-06-12,Kelantan,24,1,23,2023
2023-06-13,Kelantan,64,15,49,2023
2023-06-14,Kelantan,108,21,87,2023
2023-06-15,Kelantan,19,0,19,2023
2023-06-16,Kelantan,636,169,467,2023
2023-06-17,Kelantan,0,0,0,2023
2023-06-18,Kelantan,25,1,24,2023
2023-06-19,Kelantan,20,2,18,2023
2023-06-20,Kelantan,57,30,27,2023
2023-06-21,Kelantan,50,28,22,2023
2023-06-22,Kelantan,81,54,27,2023
2023-06-23,Kelantan,0,0,0,2023
2023-06-24,Kelantan,83,16,67,2023
2023-06-25,Kelantan,39,3,36,2023
2023-06-26,Kelantan,49,13,36,2023
2023-06-27,Kelantan,35,4,31,2023
2023-06-28,Kelantan,31,12,19,2023
2023-06-29,Kelantan,0,0,0,2023
2023-06-30,Kelantan,0,0,0,2023
2023-07-01,Kelantan,37,14,23,2023
2023-07-02,Kelantan,24,1,23,2023
2023-07-03,Kelantan,44,11,33,2023
2023-07-04,Kelantan,48,7,41,2023
2023-07-05,Kelantan,45,7,38,2023
2023-07-06,Kelantan,14,0,14,2023
2023-07-07,Kelantan,38,12,26,2023
2023-07-08,Kelantan,35,2,33,2023
2023-07-09,Kelantan,32,4,28,2023
2023-07-10,Kelantan,73,20,53,2023
2023-07-11,Kelantan,72,35,37,2023
2023-07-12,Kelantan,33,9,24,2023
2023-07-13,Kelantan,41,11,30,2023
2023-07-14,Kelantan,65,16,49,2023
2023-07-15,Kelantan,49,21,28,2023
2023-07-16,Kelantan,52,16,36,2023
2023-07-17,Kelantan,31,7,24,2023
2023-07-18,Kelantan,39,5,34,2023
2023-07-19,Kelantan,24,4,20,2023
2023-07-20,Kelantan,54,38,16,2023
2023-07-21,Kelantan,0,0,0,2023
2023-07-22,Kelantan,25,6,19,2023
2023-07-23,Kelantan,103,46,57,2023
2023-07-24,Kelantan,14,1,13,2023
2023-07-25,Kelantan,68,45,23,2023
2023-07-26,Kelantan,54,36,18,2023
2023-07-27,Kelantan,34,11,23,2023
2023-07-28,Kelantan,35,9,26,2023
2023-07-29,Kelantan,0,0,0,2023
2023-07-30,Kelantan,30,4,26,2023
2023-07-31,Kelantan,40,9,31,2023
2023-08-01,Kelantan,28,2,26,2023
2023-08-02,Kelantan,37,9,28,2023
2023-08-03,Kelantan,24,1,23,2023
2023-08-04,Kelantan,0,0,0,2023
2023-08-05,Kelantan,43,14,29,2023
2023-08-06,Kelantan,37,5,32,2023
2023-08-07,Kelantan,24,4,20,2023
2023-08-08,Kelantan,37,6,31,2023
2023-08-09,Kelantan,68,48,20,2023
2023-08-10,Kelantan,41,17,24,2023
2023-08-11,Kelantan,24,7,17,2023
2023-08-12,Kelantan,0,0,0,2023
2023-08-13,Kelantan,26,6,20,2023
2023-08-14,Kelantan,52,7,45,2023
2023-08-15,Kelantan,95,71,24,2023
2023-08-16,Kelantan,106,83,23,2023
2023-08-17,Kelantan,18,0,18,2023
2023-08-18,Kelantan,37,12,25,2023
2023-08-19,Kelantan,44,10,34,2023
2023-08-20,Kelantan,48,9,39,2023
2023-08-21,Kelantan,67,47,20,2023
2023-08-22,Kelantan,62,41,21,2023
2023-08-23,Kelantan,45,7,38,2023
2023-08-24,Kelantan,48,24,24,2023
2023-08-25,Kelantan,0,0,0,2023
2023-08-26,Kelantan,10,5,5,2023
2023-08-27,Kelantan,68,6,62,2023
2023-08-28,Kelantan,30,8,22,2023
2023-08-29,Kelantan,16,1,15,2023
2023-08-30,Kelantan,171,17,154,2023
2023-08-31,Kelantan,75,21,54,2023
2023-09-01,Kelantan,0,0,0,2023
2023-09-02,Kelantan,45,10,35,2023
2023-09-03,Kelantan,27,7,20,2023
2023-09-04,Kelantan,18,0,18,2023
2023-09-05,Kelantan,14,0,14,2023
2023-09-06,Kelantan,44,8,36,2023
2023-09-07,Kelantan,51,1,50,2023
2023-09-08,Kelantan,28,3,25,2023
2023-09-09,Kelantan,31,11,20,2023
2023-09-10,Kelantan,42,10,32,2023
2023-09-11,Kelantan,65,18,47,2023
2023-09-12,Kelantan,75,35,40,2023
2023-09-13,Kelantan,64,26,38,2023
2023-09-14,Kelantan,98,57,41,2023
2023-09-15,Kelantan,40,13,27,2023
2023-09-16,Kelantan,0,0,0,2023
2023-09-17,Kelantan,32,7,25,2023
2023-09-18,Kelantan,65,38,27,2023
2023-09-19,Kelantan,48,8,40,2023
2023-09-20,Kelantan,30,1,29,2023
2023-09-21,Kelantan,138,81,57,2023
2023-09-22,Kelantan,29,2,27,2023
2023-09-23,Kelantan,55,14,41,2023
2023-09-24,Kelantan,54,8,46,2023
2023-09-25,Kelantan,13,1,12,2023
2023-09-26,Kelantan,38,15,23,2023
2023-09-27,Kelantan,20,4,16,2023
2023-09-28,Kelantan,20,4,16,2023
2023-09-29,Kelantan,0,0,0,2023
2023-09-30,Kelantan,47,12,35,2023
2023-10-01,Kelantan,29,8,21,2023
2023-10-02,Kelantan,26,2,24,2023
2023-10-03,Kelantan,15,1,14,2023
2023-10-04,Kelantan,51,26,25,2023
2023-10-05,Kelantan,35,1,34,2023
2023-10-06,Kelantan,47,17,30,2023
2023-10-07,Kelantan,34,10,24,2023
2023-10-08,Kelantan,42,7,35,2023
2023-10-09,Kelantan,22,2,20,2023
2023-10-10,Kelantan,83,63,20,2023
2023-10-11,Kelantan,33,17,16,2023
2023-10-12,Kelantan,56,28,28,2023
2023-10-13,Kelantan,11,3,8,2023
2023-10-14,Kelantan,83,24,59,2023
2023-10-15,Kelantan,25,1,24,2023
2023-10-16,Kelantan,37,5,32,2023
2023-10-17,Kelantan,26,4,22,2023
2023-10-18,Kelantan,77,58,19,2023
2023-10-19,Kelantan,50,17,33,2023
2023-10-20,Kelantan,19,4,15,2023
2023-10-21,Kelantan,23,12,11,2023
2023-10-22,Kelantan,25,1,24,2023
2023-10-23,Kelantan,39,7,32,2023
2023-10-24,Kelantan,52,18,34,2023
2023-10-25,Kelantan,42,6,36,2023
2023-10-26,Kelantan,14,1,13,2023
2023-10-27,Kelantan,0,0,0,2023
2023-10-28,Kelantan,41,5,36,2023
2023-10-29,Kelantan,32,8,24,2023
2023-10-30,Kelantan,16,3,13,2023
2023-10-31,Kelantan,77,39,38,2023
2023-11-01,Kelantan,24,2,22,2023
2023-11-02,Kelantan,52,14,38,2023
2023-11-03,Kelantan,46,26,20,2023
2023-11-04,Kelantan,29,12,17,2023
2023-11-05,Kelantan,61,4,57,2023
2023-11-06,Kelantan,60,14,46,2023
2023-11-07,Kelantan,92,43,49,2023
2023-11-08,Kelantan,22,5,17,2023
2023-11-09,Kelantan,26,3,23,2023
2023-11-10,Kelantan,0,0,0,2023
2023-11-11,Kelantan,8,0,8,2023
2023-11-12,Kelantan,57,29,28,2023
2023-11-13,Kelantan,12,4,8,2023
2023-11-14,Kelantan,43,4,39,2023
2023-11-15,Kelantan,187,58,129,2023
2023-11-16,Kelantan,26,9,17,2023
2023-11-17,Kelantan,0,0,0,2023
2023-11-18,Kelantan,34,6,28,2023
2023-11-19,Kelantan,17,1,16,2023
2023-11-20,Kelantan,55,30,25,2023
2023-11-21,Kelantan,66,43,23,2023
2023-11-22,Kelantan,82,35,47,2023
2023-11-23,Kelantan,56,16,40,2023
2023-11-24,Kelantan,5,3,2,2023
2023-11-25,Kelantan,61,12,49,2023
2023-11-26,Kelantan,31,4,27,2023
2023-11-27,Kelantan,45,9,36,2023
2023-11-28,Kelantan,78,36,42,2023
2023-11-29,Kelantan,99,18,81,2023
2023-11-30,Kelantan,24,7,17,2023
2023-12-01,Kelantan,0,0,0,2023
2023-12-02,Kelantan,31,4,27,2023
2023-12-03,Kelantan,91,13,78,2023
2023-12-04,Kelantan,26,6,20,2023
2023-12-05,Kelantan,33,5,28,2023
2023-12-06,Kelantan,30,3,27,2023
2023-12-07,Kelantan,36,4,32,2023
2023-12-08,Kelantan,92,18,74,2023
2023-12-09,Kelantan,40,8,32,2023
2023-12-10,Kelantan,52,2,50,2023
2023-12-11,Kelantan,39,4,35,2023
2023-12-12,Kelantan,137,49,88,2023
2023-12-13,Kelantan,27,5,22,2023
2023-12-14,Kelantan,35,5,30,2023
2023-12-15,Kelantan,22,3,19,2023
2023-12-16,Kelantan,0,0,0,2023
2023-12-17,Kelantan,36,3,33,2023
2023-12-18,Kelantan,23,2,21,2023
2023-12-19,Kelantan,43,10,33,2023
2023-12-20,Kelantan,45,11,34,2023
2023-12-21,Kelantan,34,5,29,2023
2023-12-22,Kelantan,31,10,21,2023
2023-12-23,Kelantan,82,18,64,2023
2023-12-24,Kelantan,91,19,72,2023
2023-12-25,Kelantan,30,3,27,2023
2023-12-26,Kelantan,59,11,48,2023
2023-12-27,Kelantan,70,15,55,2023
2023-12-28,Kelantan,41,7,34,2023
2023-12-29,Kelantan,0,0,0,2023
2023-12-30,Kelantan,55,10,45,2023
2023-12-31,Kelantan,74,8,66,2023
2024-01-01,Kelantan,57,7,50,2024
2024-01-02,Kelantan,39,3,36,2024
2024-01-03,Kelantan,46,4,42,2024
2024-01-04,Kelantan,51,9,42,2024
2024-01-05,Kelantan,13,7,6,2024
2024-01-06,Kelantan,56,13,43,2024
2024-01-07,Kelantan,41,5,36,2024
2024-01-08,Kelantan,89,42,47,2024
2024-01-09,Kelantan,95,45,50,2024
2024-01-10,Kelantan,37,3,34,2024
2024-01-11,Kelantan,92,23,69,2024
2024-01-12,Kelantan,0,0,0,2024
2024-01-13,Kelantan,53,7,46,2024
2024-01-14,Kelantan,39,4,35,2024
2024-01-15,Kelantan,77,19,58,2024
2024-01-16,Kelantan,67,28,39,2024
2024-01-17,Kelantan,94,16,78,2024
2024-01-18,Kelantan,76,35,41,2024
2024-01-19,Kelantan,19,9,10,2024
2024-01-20,Kelantan,88,29,59,2024
2024-01-21,Kelantan,49,10,39,2024
2024-01-22,Kelantan,45,3,42,2024
2024-01-23,Kelantan,64,27,37,2024
2024-01-24,Kelantan,39,23,16,2024
2024-01-25,Kelantan,48,21,27,2024
2024-01-26,Kelantan,41,3,38,2024
2024-01-27,Kelantan,68,11,57,2024
2024-01-28,Kelantan,36,4,32,2024
2024-01-29,Kelantan,27,5,22,2024
2024-01-30,Kelantan,75,27,48,2024
2024-01-31,Kelantan,25,2,23,2024
2024-02-01,Kelantan,14,3,11,2024
2024-02-02,Kelantan,0,0,0,2024
2006-01-01,Melaka,1,0,1,2006
2006-01-02,Melaka,0,0,0,2006
2006-01-03,Melaka,1,0,1,2006
2006-01-04,Melaka,1,1,0,2006
2006-01-05,Melaka,9,9,0,2006
2006-01-06,Melaka,1,0,1,2006
2006-01-07,Melaka,1,1,0,2006
2006-01-08,Melaka,2,2,0,2006
2006-01-09,Melaka,0,0,0,2006
2006-01-10,Melaka,0,0,0,2006
2006-01-11,Melaka,2,1,1,2006
2006-01-12,Melaka,2,2,0,2006
2006-01-13,Melaka,0,0,0,2006
2006-01-14,Melaka,1,1,0,2006
2006-01-15,Melaka,1,1,0,2006
2006-01-16,Melaka,0,0,0,2006
2006-01-17,Melaka,0,0,0,2006
2006-01-18,Melaka,1,1,0,2006
2006-01-19,Melaka,2,1,1,2006
2006-01-20,Melaka,2,1,1,2006
2006-01-21,Melaka,0,0,0,2006
2006-01-22,Melaka,2,2,0,2006
2006-01-23,Melaka,1,1,0,2006
2006-01-24,Melaka,4,4,0,2006
2006-01-25,Melaka,2,2,0,2006
2006-01-26,Melaka,3,2,1,2006
2006-01-27,Melaka,1,0,1,2006
2006-01-28,Melaka,0,0,0,2006
2006-01-29,Melaka,0,0,0,2006
2006-01-30,Melaka,0,0,0,2006
2006-01-31,Melaka,0,0,0,2006
2006-02-01,Melaka,38,37,1,2006
2006-02-02,Melaka,91,89,2,2006
2006-02-03,Melaka,2,1,1,2006
2006-02-04,Melaka,99,97,2,2006
2006-02-05,Melaka,80,77,3,2006
2006-02-06,Melaka,38,35,3,2006
2006-02-07,Melaka,18,18,0,2006
2006-02-08,Melaka,10,2,8,2006
2006-02-09,Melaka,142,132,10,2006
2006-02-10,Melaka,136,124,12,2006
2006-02-11,Melaka,75,75,0,2006
2006-02-12,Melaka,240,192,48,2006
2006-02-13,Melaka,47,44,3,2006
2006-02-14,Melaka,3,1,2,2006
2006-02-15,Melaka,93,92,1,2006
2006-02-16,Melaka,26,3,23,2006
2006-02-17,Melaka,0,0,0,2006
2006-02-18,Melaka,34,31,3,2006
2006-02-19,Melaka,65,63,2,2006
2006-02-20,Melaka,0,0,0,2006
2006-02-21,Melaka,43,20,23,2006
2006-02-22,Melaka,40,40,0,2006
2006-02-23,Melaka,0,0,0,2006
2006-02-24,Melaka,1,0,1,2006
2006-02-25,Melaka,73,61,12,2006
2006-02-26,Melaka,218,215,3,2006
2006-02-27,Melaka,0,0,0,2006
2006-02-28,Melaka,1,0,1,2006
2006-03-01,Melaka,24,18,6,2006
2006-03-02,Melaka,3,1,2,2006
2006-03-03,Melaka,1,1,0,2006
2006-03-04,Melaka,18,15,3,2006
2006-03-05,Melaka,89,84,5,2006
2006-03-06,Melaka,223,218,5,2006
2006-03-07,Melaka,2,2,0,2006
2006-03-08,Melaka,69,68,1,2006
2006-03-09,Melaka,23,21,2,2006
2006-03-10,Melaka,2,2,0,2006
2006-03-11,Melaka,59,55,4,2006
2006-03-12,Melaka,132,105,27,2006
2006-03-13,Melaka,133,100,33,2006
2006-03-14,Melaka,53,50,3,2006
2006-03-15,Melaka,39,34,5,2006
2006-03-16,Melaka,34,33,1,2006
2006-03-17,Melaka,3,3,0,2006
2006-03-18,Melaka,73,66,7,2006
2006-03-19,Melaka,53,46,7,2006
2006-03-20,Melaka,16,15,1,2006
2006-03-21,Melaka,130,126,4,2006
2006-03-22,Melaka,45,41,4,2006
2006-03-23,Melaka,85,84,1,2006
2006-03-24,Melaka,14,14,0,2006
2006-03-25,Melaka,15,15,0,2006
2006-03-26,Melaka,62,47,15,2006
2006-03-27,Melaka,4,0,4,2006
2006-03-28,Melaka,2,1,1,2006
2006-03-29,Melaka,30,27,3,2006
2006-03-30,Melaka,104,82,22,2006
2006-03-31,Melaka,134,121,13,2006
2006-04-01,Melaka,229,199,30,2006
2006-04-02,Melaka,41,36,5,2006
2006-04-03,Melaka,1,1,0,2006
2006-04-04,Melaka,31,31,0,2006
2006-04-05,Melaka,14,12,2,2006
2006-04-06,Melaka,0,0,0,2006
2006-04-07,Melaka,0,0,0,2006
2006-04-08,Melaka,176,151,25,2006
2006-04-09,Melaka,380,318,62,2006
2006-04-10,Melaka,106,89,17,2006
2006-04-11,Melaka,0,0,0,2006
2006-04-12,Melaka,0,0,0,2006
2006-04-13,Melaka,41,40,1,2006
2006-04-14,Melaka,0,0,0,2006
2006-04-15,Melaka,17,16,1,2006
2006-04-16,Melaka,388,289,99,2006
2006-04-17,Melaka,48,47,1,2006
2006-04-18,Melaka,92,88,4,2006
2006-04-19,Melaka,32,32,0,2006
2006-04-20,Melaka,29,28,1,2006
2006-04-21,Melaka,80,77,3,2006
2006-04-22,Melaka,117,106,11,2006
2006-04-23,Melaka,97,84,13,2006
2006-04-24,Melaka,10,9,1,2006
2006-04-25,Melaka,33,32,1,2006
2006-04-26,Melaka,88,85,3,2006
2006-04-27,Melaka,33,26,7,2006
2006-04-28,Melaka,2,1,1,2006
2006-04-29,Melaka,6,6,0,2006
2006-04-30,Melaka,133,123,10,2006
2006-05-01,Melaka,0,0,0,2006
2006-05-02,Melaka,1,0,1,2006
2006-05-03,Melaka,6,5,1,2006
2006-05-04,Melaka,5,1,4,2006
2006-05-05,Melaka,1,0,1,2006
2006-05-06,Melaka,2,2,0,2006
2006-05-07,Melaka,2,2,0,2006
2006-05-08,Melaka,0,0,0,2006
2006-05-09,Melaka,1,0,1,2006
2006-05-10,Melaka,6,5,1,2006
2006-05-11,Melaka,2,1,1,2006
2006-05-12,Melaka,1,0,1,2006
2006-05-13,Melaka,0,0,0,2006
2006-05-14,Melaka,2,1,1,2006
2006-05-15,Melaka,31,31,0,2006
2006-05-16,Melaka,3,2,1,2006
2006-05-17,Melaka,2,2,0,2006
2006-05-18,Melaka,1,0,1,2006
2006-05-19,Melaka,1,0,1,2006
2006-05-20,Melaka,1,1,0,2006
2006-05-21,Melaka,1,1,0,2006
2006-05-22,Melaka,1,1,0,2006
2006-05-23,Melaka,0,0,0,2006
2006-05-24,Melaka,4,2,2,2006
2006-05-25,Melaka,2,1,1,2006
2006-05-26,Melaka,1,1,0,2006
2006-05-27,Melaka,2,2,0,2006
2006-05-28,Melaka,4,4,0,2006
2006-05-29,Melaka,1,0,1,2006
2006-05-30,Melaka,1,0,1,2006
2006-05-31,Melaka,73,54,19,2006
2006-06-01,Melaka,3,2,1,2006
2006-06-02,Melaka,2,1,1,2006
2006-06-03,Melaka,3,2,1,2006
2006-06-04,Melaka,2,1,1,2006
2006-06-05,Melaka,1,0,1,2006
2006-06-06,Melaka,7,2,5,2006
2006-06-07,Melaka,4,1,3,2006
2006-06-08,Melaka,1,0,1,2006
2006-06-09,Melaka,1,0,1,2006
2006-06-10,Melaka,1,0,1,2006
2006-06-11,Melaka,3,0,3,2006
2006-06-12,Melaka,0,0,0,2006
2006-06-13,Melaka,1,0,1,2006
2006-06-14,Melaka,1,1,0,2006
2006-06-15,Melaka,1,0,1,2006
2006-06-16,Melaka,3,3,0,2006
2006-06-17,Melaka,4,2,2,2006
2006-06-18,Melaka,1,0,1,2006
2006-06-19,Melaka,1,1,0,2006
2006-06-20,Melaka,2,1,1,2006
2006-06-21,Melaka,1,1,0,2006
2006-06-22,Melaka,1,1,0,2006
2006-06-23,Melaka,3,3,0,2006
2006-06-24,Melaka,1,1,0,2006
2006-06-25,Melaka,1,0,1,2006
2006-06-26,Melaka,0,0,0,2006
2006-06-27,Melaka,4,2,2,2006
2006-06-28,Melaka,4,3,1,2006
2006-06-29,Melaka,0,0,0,2006
2006-06-30,Melaka,1,0,1,2006
2006-07-01,Melaka,0,0,0,2006
2006-07-02,Melaka,46,29,17,2006
2006-07-03,Melaka,4,0,4,2006
2006-07-04,Melaka,1,1,0,2006
2006-07-05,Melaka,0,0,0,2006
2006-07-06,Melaka,0,0,0,2006
2006-07-07,Melaka,1,1,0,2006
2006-07-08,Melaka,1,0,1,2006
2006-07-09,Melaka,1,1,0,2006
2006-07-10,Melaka,1,1,0,2006
2006-07-11,Melaka,0,0,0,2006
2006-07-12,Melaka,1,0,1,2006
2006-07-13,Melaka,0,0,0,2006
2006-07-14,Melaka,0,0,0,2006
2006-07-15,Melaka,1,1,0,2006
2006-07-16,Melaka,2,1,1,2006
2006-07-17,Melaka,1,1,0,2006
2006-07-18,Melaka,1,0,1,2006
2006-07-19,Melaka,1,0,1,2006
2006-07-20,Melaka,0,0,0,2006
2006-07-21,Melaka,0,0,0,2006
2006-07-22,Melaka,1,1,0,2006
2006-07-23,Melaka,4,3,1,2006
2006-07-24,Melaka,13,9,4,2006
2006-07-25,Melaka,0,0,0,2006
2006-07-26,Melaka,0,0,0,2006
2006-07-27,Melaka,3,2,1,2006
2006-07-28,Melaka,1,0,1,2006
2006-07-29,Melaka,0,0,0,2006
2006-07-30,Melaka,0,0,0,2006
2006-07-31,Melaka,4,1,3,2006
2006-08-01,Melaka,0,0,0,2006
2006-08-02,Melaka,4,4,0,2006
2006-08-03,Melaka,1,0,1,2006
2006-08-04,Melaka,1,0,1,2006
2006-08-05,Melaka,6,4,2,2006
2006-08-06,Melaka,0,0,0,2006
2006-08-07,Melaka,2,2,0,2006
2006-08-08,Melaka,1,0,1,2006
2006-08-09,Melaka,2,1,1,2006
2006-08-10,Melaka,1,0,1,2006
2006-08-11,Melaka,0,0,0,2006
2006-08-12,Melaka,0,0,0,2006
2006-08-13,Melaka,2,0,2,2006
2006-08-14,Melaka,2,2,0,2006
2006-08-15,Melaka,0,0,0,2006
2006-08-16,Melaka,2,1,1,2006
2006-08-17,Melaka,5,4,1,2006
2006-08-18,Melaka,0,0,0,2006
2006-08-19,Melaka,0,0,0,2006
2006-08-20,Melaka,5,3,2,2006
2006-08-21,Melaka,2,0,2,2006
2006-08-22,Melaka,1,0,1,2006
2006-08-23,Melaka,0,0,0,2006
2006-08-24,Melaka,1,0,1,2006
2006-08-25,Melaka,0,0,0,2006
2006-08-26,Melaka,4,3,1,2006
2006-08-27,Melaka,5,3,2,2006
2006-08-28,Melaka,1,0,1,2006
2006-08-29,Melaka,2,1,1,2006
2006-08-30,Melaka,0,0,0,2006
2006-08-31,Melaka,0,0,0,2006
2006-09-01,Melaka,5,5,0,2006
2006-09-02,Melaka,1,1,0,2006
2006-09-03,Melaka,9,5,4,2006
2006-09-04,Melaka,3,1,2,2006
2006-09-05,Melaka,1,1,0,2006
2006-09-06,Melaka,2,0,2,2006
2006-09-07,Melaka,0,0,0,2006
2006-09-08,Melaka,0,0,0,2006
2006-09-09,Melaka,1,1,0,2006
2006-09-10,Melaka,10,5,5,2006
2006-09-11,Melaka,0,0,0,2006
2006-09-12,Melaka,1,0,1,2006
2006-09-13,Melaka,3,3,0,2006
2006-09-14,Melaka,2,2,0,2006
2006-09-15,Melaka,2,1,1,2006
2006-09-16,Melaka,1,1,0,2006
2006-09-17,Melaka,5,3,2,2006
2006-09-18,Melaka,2,1,1,2006
2006-09-19,Melaka,4,0,4,2006
2006-09-20,Melaka,1,1,0,2006
2006-09-21,Melaka,7,2,5,2006
2006-09-22,Melaka,0,0,0,2006
2006-09-23,Melaka,4,3,1,2006
2006-09-24,Melaka,5,2,3,2006
2006-09-25,Melaka,0,0,0,2006
2006-09-26,Melaka,1,0,1,2006
2006-09-27,Melaka,2,1,1,2006
2006-09-28,Melaka,0,0,0,2006
2006-09-29,Melaka,1,0,1,2006
2006-09-30,Melaka,0,0,0,2006
2006-10-01,Melaka,1,0,1,2006
2006-10-02,Melaka,0,0,0,2006
2006-10-03,Melaka,1,1,0,2006
2006-10-04,Melaka,27,17,10,2006
2006-10-05,Melaka,9,9,0,2006
2006-10-06,Melaka,17,6,11,2006
2006-10-07,Melaka,2,1,1,2006
2006-10-08,Melaka,16,6,10,2006
2006-10-09,Melaka,17,13,4,2006
2006-10-10,Melaka,12,2,10,2006
2006-10-11,Melaka,12,3,9,2006
2006-10-12,Melaka,24,11,13,2006
2006-10-13,Melaka,7,2,5,2006
2006-10-14,Melaka,1,1,0,2006
2006-10-15,Melaka,1,0,1,2006
2006-10-16,Melaka,4,2,2,2006
2006-10-17,Melaka,2,1,1,2006
2006-10-18,Melaka,6,0,6,2006
2006-10-19,Melaka,2,2,0,2006
2006-10-20,Melaka,0,0,0,2006
2006-10-21,Melaka,1,0,1,2006
2006-10-22,Melaka,25,11,14,2006
2006-10-23,Melaka,0,0,0,2006
2006-10-24,Melaka,1,0,1,2006
2006-10-25,Melaka,2,1,1,2006
2006-10-26,Melaka,2,1,1,2006
2006-10-27,Melaka,2,1,1,2006
2006-10-28,Melaka,3,2,1,2006
2006-10-29,Melaka,2,1,1,2006
2006-10-30,Melaka,3,1,2,2006
2006-10-31,Melaka,4,0,4,2006
2006-11-01,Melaka,2,1,1,2006
2006-11-02,Melaka,17,9,8,2006
2006-11-03,Melaka,8,3,5,2006
2006-11-04,Melaka,1,0,1,2006
2006-11-05,Melaka,2,0,2,2006
2006-11-06,Melaka,10,3,7,2006
2006-11-07,Melaka,3,2,1,2006
2006-11-08,Melaka,5,1,4,2006
2006-11-09,Melaka,10,4,6,2006
2006-11-10,Melaka,5,2,3,2006
2006-11-11,Melaka,2,2,0,2006
2006-11-12,Melaka,4,3,1,2006
2006-11-13,Melaka,30,8,22,2006
2006-11-14,Melaka,0,0,0,2006
2006-11-15,Melaka,6,4,2,2006
2006-11-16,Melaka,29,27,2,2006
2006-11-17,Melaka,11,9,2,2006
2006-11-18,Melaka,0,0,0,2006
2006-11-19,Melaka,5,2,3,2006
2006-11-20,Melaka,49,40,9,2006
2006-11-21,Melaka,34,22,12,2006
2006-11-22,Melaka,18,6,12,2006
2006-11-23,Melaka,173,141,32,2006
2006-11-24,Melaka,3,3,0,2006
2006-11-25,Melaka,0,0,0,2006
2006-11-26,Melaka,3,2,1,2006
2006-11-27,Melaka,16,8,8,2006
2006-11-28,Melaka,14,4,10,2006
2006-11-29,Melaka,2,0,2,2006
2006-11-30,Melaka,0,0,0,2006
2006-12-01,Melaka,0,0,0,2006
2006-12-02,Melaka,2,2,0,2006
2006-12-03,Melaka,14,9,5,2006
2006-12-04,Melaka,33,20,13,2006
2006-12-05,Melaka,26,19,7,2006
2006-12-06,Melaka,7,3,4,2006
2006-12-07,Melaka,10,2,8,2006
2006-12-08,Melaka,7,0,7,2006
2006-12-09,Melaka,2,2,0,2006
2006-12-10,Melaka,5,2,3,2006
2006-12-11,Melaka,12,5,7,2006
2006-12-12,Melaka,12,8,4,2006
2006-12-13,Melaka,52,41,11,2006
2006-12-14,Melaka,9,3,6,2006
2006-12-15,Melaka,9,3,6,2006
2006-12-16,Melaka,2,2,0,2006
2006-12-17,Melaka,2,2,0,2006
2006-12-18,Melaka,17,7,10,2006
2006-12-19,Melaka,6,4,2,2006
2006-12-20,Melaka,12,4,8,2006
2006-12-21,Melaka,9,4,5,2006
2006-12-22,Melaka,6,1,5,2006
2006-12-23,Melaka,1,0,1,2006
2006-12-24,Melaka,1,0,1,2006
2006-12-25,Melaka,0,0,0,2006
2006-12-26,Melaka,19,7,12,2006
2006-12-27,Melaka,21,7,14,2006
2006-12-28,Melaka,10,3,7,2006
2006-12-29,Melaka,23,11,12,2006
2006-12-30,Melaka,0,0,0,2006
2006-12-31,Melaka,1,0,1,2006
2007-01-01,Melaka,80,70,10,2007
2007-01-02,Melaka,14,12,2,2007
2007-01-03,Melaka,34,24,10,2007
2007-01-04,Melaka,71,53,18,2007
2007-01-05,Melaka,18,13,5,2007
2007-01-06,Melaka,20,17,3,2007
2007-01-07,Melaka,28,18,10,2007
2007-01-08,Melaka,69,56,13,2007
2007-01-09,Melaka,67,51,16,2007
2007-01-10,Melaka,19,10,9,2007
2007-01-11,Melaka,129,103,26,2007
2007-01-12,Melaka,13,6,7,2007
2007-01-13,Melaka,53,47,6,2007
2007-01-14,Melaka,150,90,60,2007
2007-01-15,Melaka,101,87,14,2007
2007-01-16,Melaka,175,166,9,2007
2007-01-17,Melaka,21,13,8,2007
2007-01-18,Melaka,27,13,14,2007
2007-01-19,Melaka,11,1,10,2007
2007-01-20,Melaka,102,76,26,2007
2007-01-21,Melaka,180,128,52,2007
2007-01-22,Melaka,11,7,4,2007
2007-01-23,Melaka,127,92,35,2007
2007-01-24,Melaka,139,99,40,2007
2007-01-25,Melaka,63,45,18,2007
2007-01-26,Melaka,45,26,19,2007
2007-01-27,Melaka,138,100,38,2007
2007-01-28,Melaka,103,80,23,2007
2007-01-29,Melaka,13,12,1,2007
2007-01-30,Melaka,90,77,13,2007
2007-01-31,Melaka,186,176,10,2007
2007-02-01,Melaka,53,34,19,2007
2007-02-02,Melaka,6,3,3,2007
2007-02-03,Melaka,241,231,10,2007
2007-02-04,Melaka,139,89,50,2007
2007-02-05,Melaka,22,8,14,2007
2007-02-06,Melaka,12,3,9,2007
2007-02-07,Melaka,173,140,33,2007
2007-02-08,Melaka,14,4,10,2007
2007-02-09,Melaka,72,54,18,2007
2007-02-10,Melaka,49,45,4,2007
2007-02-11,Melaka,74,73,1,2007
2007-02-12,Melaka,29,13,16,2007
2007-02-13,Melaka,51,42,9,2007
2007-02-14,Melaka,89,71,18,2007
2007-02-15,Melaka,52,44,8,2007
2007-02-16,Melaka,38,24,14,2007
2007-02-17,Melaka,30,26,4,2007
2007-02-18,Melaka,5,4,1,2007
2007-02-19,Melaka,20,16,4,2007
2007-02-20,Melaka,0,0,0,2007
2007-02-21,Melaka,100,58,42,2007
2007-02-22,Melaka,119,89,30,2007
2007-02-23,Melaka,24,14,10,2007
2007-02-24,Melaka,112,108,4,2007
2007-02-25,Melaka,0,0,0,2007
2007-02-26,Melaka,36,20,16,2007
2007-02-27,Melaka,52,36,16,2007
2007-02-28,Melaka,64,49,15,2007
2007-03-01,Melaka,69,53,16,2007
2007-03-02,Melaka,5,0,5,2007
2007-03-03,Melaka,0,0,0,2007
2007-03-04,Melaka,49,39,10,2007
2007-03-05,Melaka,46,35,11,2007
2007-03-06,Melaka,67,33,34,2007
2007-03-07,Melaka,55,32,23,2007
2007-03-08,Melaka,40,32,8,2007
2007-03-09,Melaka,33,22,11,2007
2007-03-10,Melaka,106,77,29,2007
2007-03-11,Melaka,193,91,102,2007
2007-03-12,Melaka,14,5,9,2007
2007-03-13,Melaka,150,123,27,2007
2007-03-14,Melaka,89,57,32,2007
2007-03-15,Melaka,84,57,27,2007
2007-03-16,Melaka,66,37,29,2007
2007-03-17,Melaka,117,76,41,2007
2007-03-18,Melaka,60,28,32,2007
2007-03-19,Melaka,75,44,31,2007
2007-03-20,Melaka,153,120,33,2007
2007-03-21,Melaka,99,65,34,2007
2007-03-22,Melaka,110,77,33,2007
2007-03-23,Melaka,14,2,12,2007
2007-03-24,Melaka,7,6,1,2007
2007-03-25,Melaka,118,65,53,2007
2007-03-26,Melaka,33,25,8,2007
2007-03-27,Melaka,21,7,14,2007
2007-03-28,Melaka,181,145,36,2007
2007-03-29,Melaka,92,72,20,2007
2007-03-30,Melaka,46,32,14,2007
2007-03-31,Melaka,40,33,7,2007
2007-04-01,Melaka,116,84,32,2007
2007-04-02,Melaka,12,4,8,2007
2007-04-03,Melaka,25,15,10,2007
2007-04-04,Melaka,10,3,7,2007
2007-04-05,Melaka,39,21,18,2007
2007-04-06,Melaka,40,34,6,2007
2007-04-07,Melaka,49,31,18,2007
2007-04-08,Melaka,85,70,15,2007
2007-04-09,Melaka,90,65,25,2007
2007-04-10,Melaka,37,20,17,2007
2007-04-11,Melaka,39,31,8,2007
2007-04-12,Melaka,18,7,11,2007
2007-04-13,Melaka,22,11,11,2007
2007-04-14,Melaka,50,34,16,2007
2007-04-15,Melaka,98,46,52,2007
2007-04-16,Melaka,0,0,0,2007
2007-04-17,Melaka,53,41,12,2007
2007-04-18,Melaka,31,21,10,2007
2007-04-19,Melaka,104,59,45,2007
2007-04-20,Melaka,17,12,5,2007
2007-04-21,Melaka,31,18,13,2007
2007-04-22,Melaka,3,3,0,2007
2007-04-23,Melaka,97,74,23,2007
2007-04-24,Melaka,73,58,15,2007
2007-04-25,Melaka,66,53,13,2007
2007-04-26,Melaka,0,0,0,2007
2007-04-27,Melaka,24,22,2,2007
2007-04-28,Melaka,122,90,32,2007
2007-04-29,Melaka,45,36,9,2007
2007-04-30,Melaka,61,40,21,2007
2007-05-01,Melaka,189,128,61,2007
2007-05-02,Melaka,2,1,1,2007
2007-05-03,Melaka,13,3,10,2007
2007-05-04,Melaka,15,9,6,2007
2007-05-05,Melaka,94,82,12,2007
2007-05-06,Melaka,41,40,1,2007
2007-05-07,Melaka,87,41,46,2007
2007-05-08,Melaka,100,81,19,2007
2007-05-09,Melaka,6,3,3,2007
2007-05-10,Melaka,54,37,17,2007
2007-05-11,Melaka,46,32,14,2007
2007-05-12,Melaka,9,7,2,2007
2007-05-13,Melaka,57,27,30,2007
2007-05-14,Melaka,198,147,51,2007
2007-05-15,Melaka,13,5,8,2007
2007-05-16,Melaka,29,21,8,2007
2007-05-17,Melaka,186,162,24,2007
2007-05-18,Melaka,61,49,12,2007
2007-05-19,Melaka,84,79,5,2007
2007-05-20,Melaka,6,2,4,2007
2007-05-21,Melaka,16,5,11,2007
2007-05-22,Melaka,193,179,14,2007
2007-05-23,Melaka,89,61,28,2007
2007-05-24,Melaka,12,5,7,2007
2007-05-25,Melaka,16,8,8,2007
2007-05-26,Melaka,52,44,8,2007
2007-05-27,Melaka,36,28,8,2007
2007-05-28,Melaka,84,63,21,2007
2007-05-29,Melaka,56,31,25,2007
2007-05-30,Melaka,22,10,12,2007
2007-05-31,Melaka,249,221,28,2007
2007-06-01,Melaka,59,50,9,2007
2007-06-02,Melaka,2,2,0,2007
2007-06-03,Melaka,58,47,11,2007
2007-06-04,Melaka,79,73,6,2007
2007-06-05,Melaka,20,10,10,2007
2007-06-06,Melaka,61,52,9,2007
2007-06-07,Melaka,23,9,14,2007
2007-06-08,Melaka,11,1,10,2007
2007-06-09,Melaka,2,1,1,2007
2007-06-10,Melaka,225,125,100,2007
2007-06-11,Melaka,20,3,17,2007
2007-06-12,Melaka,39,33,6,2007
2007-06-13,Melaka,101,85,16,2007
2007-06-14,Melaka,47,30,17,2007
2007-06-15,Melaka,27,19,8,2007
2007-06-16,Melaka,86,54,32,2007
2007-06-17,Melaka,357,209,148,2007
2007-06-18,Melaka,22,6,16,2007
2007-06-19,Melaka,27,17,10,2007
2007-06-20,Melaka,83,61,22,2007
2007-06-21,Melaka,9,3,6,2007
2007-06-22,Melaka,20,9,11,2007
2007-06-23,Melaka,0,0,0,2007
2007-06-24,Melaka,122,79,43,2007
2007-06-25,Melaka,36,25,11,2007
2007-06-26,Melaka,47,31,16,2007
2007-06-27,Melaka,6,3,3,2007
2007-06-28,Melaka,30,10,20,2007
2007-06-29,Melaka,8,1,7,2007
2007-06-30,Melaka,55,38,17,2007
2007-07-01,Melaka,53,36,17,2007
2007-07-02,Melaka,47,25,22,2007
2007-07-03,Melaka,40,26,14,2007
2007-07-04,Melaka,198,120,78,2007
2007-07-05,Melaka,23,12,11,2007
2007-07-06,Melaka,84,64,20,2007
2007-07-07,Melaka,122,95,27,2007
2007-07-08,Melaka,146,107,39,2007
2007-07-09,Melaka,19,7,12,2007
2007-07-10,Melaka,85,48,37,2007
2007-07-11,Melaka,50,23,27,2007
2007-07-12,Melaka,68,54,14,2007
2007-07-13,Melaka,19,8,11,2007
2007-07-14,Melaka,51,35,16,2007
2007-07-15,Melaka,54,41,13,2007
2007-07-16,Melaka,14,2,12,2007
2007-07-17,Melaka,71,30,41,2007
2007-07-18,Melaka,54,43,11,2007
2007-07-19,Melaka,52,36,16,2007
2007-07-20,Melaka,40,20,20,2007
2007-07-21,Melaka,61,45,16,2007
2007-07-22,Melaka,68,44,24,2007
2007-07-23,Melaka,43,20,23,2007
2007-07-24,Melaka,63,38,25,2007
2007-07-25,Melaka,103,54,49,2007
2007-07-26,Melaka,108,58,50,2007
2007-07-27,Melaka,46,29,17,2007
2007-07-28,Melaka,101,81,20,2007
2007-07-29,Melaka,84,59,25,2007
2007-07-30,Melaka,12,2,10,2007
2007-07-31,Melaka,129,99,30,2007
2007-08-01,Melaka,18,3,15,2007
2007-08-02,Melaka,38,15,23,2007
2007-08-03,Melaka,100,62,38,2007
2007-08-04,Melaka,92,56,36,2007
2007-08-05,Melaka,142,87,55,2007
2007-08-06,Melaka,14,7,7,2007
2007-08-07,Melaka,78,30,48,2007
2007-08-08,Melaka,62,38,24,2007
2007-08-09,Melaka,57,41,16,2007
2007-08-10,Melaka,13,4,9,2007
2007-08-11,Melaka,0,0,0,2007
2007-08-12,Melaka,95,74,21,2007
2007-08-13,Melaka,9,2,7,2007
2007-08-14,Melaka,113,75,38,2007
2007-08-15,Melaka,109,82,27,2007
2007-08-16,Melaka,80,59,21,2007
2007-08-17,Melaka,15,2,13,2007
2007-08-18,Melaka,50,36,14,2007
2007-08-19,Melaka,149,49,100,2007
2007-08-20,Melaka,13,12,1,2007
2007-08-21,Melaka,180,138,42,2007
2007-08-22,Melaka,57,52,5,2007
2007-08-23,Melaka,69,53,16,2007
2007-08-24,Melaka,16,5,11,2007
2007-08-25,Melaka,56,25,31,2007
2007-08-26,Melaka,275,206,69,2007
2007-08-27,Melaka,12,2,10,2007
2007-08-28,Melaka,194,101,93,2007
2007-08-29,Melaka,76,55,21,2007
2007-08-30,Melaka,140,110,30,2007
2007-08-31,Melaka,164,149,15,2007
2007-09-01,Melaka,59,36,23,2007
2007-09-02,Melaka,37,17,20,2007
2007-09-03,Melaka,10,3,7,2007
2007-09-04,Melaka,192,162,30,2007
2007-09-05,Melaka,57,25,32,2007
2007-09-06,Melaka,35,25,10,2007
2007-09-07,Melaka,50,38,12,2007
2007-09-08,Melaka,129,88,41,2007
2007-09-09,Melaka,222,83,139,2007
2007-09-10,Melaka,89,46,43,2007
2007-09-11,Melaka,112,65,47,2007
2007-09-12,Melaka,115,81,34,2007
2007-09-13,Melaka,20,9,11,2007
2007-09-14,Melaka,3,0,3,2007
2007-09-15,Melaka,51,34,17,2007
2007-09-16,Melaka,88,42,46,2007
2007-09-17,Melaka,13,3,10,2007
2007-09-18,Melaka,38,16,22,2007
2007-09-19,Melaka,28,15,13,2007
2007-09-20,Melaka,142,97,45,2007
2007-09-21,Melaka,0,0,0,2007
2007-09-22,Melaka,98,60,38,2007
2007-09-23,Melaka,88,57,31,2007
2007-09-24,Melaka,4,2,2,2007
2007-09-25,Melaka,44,33,11,2007
2007-09-26,Melaka,49,30,19,2007
2007-09-27,Melaka,4,2,2,2007
2007-09-28,Melaka,11,5,6,2007
2007-09-29,Melaka,19,10,9,2007
2007-09-30,Melaka,161,89,72,2007
2007-10-01,Melaka,42,9,33,2007
2007-10-02,Melaka,158,134,24,2007
2007-10-03,Melaka,5,2,3,2007
2007-10-04,Melaka,102,62,40,2007
2007-10-05,Melaka,1,1,0,2007
2007-10-06,Melaka,71,41,30,2007
2007-10-07,Melaka,135,67,68,2007
2007-10-08,Melaka,124,104,20,2007
2007-10-09,Melaka,69,21,48,2007
2007-10-10,Melaka,87,60,27,2007
2007-10-11,Melaka,53,29,24,2007
2007-10-12,Melaka,7,2,5,2007
2007-10-13,Melaka,0,0,0,2007
2007-10-14,Melaka,38,23,15,2007
2007-10-15,Melaka,50,37,13,2007
2007-10-16,Melaka,53,29,24,2007
2007-10-17,Melaka,44,18,26,2007
2007-10-18,Melaka,83,39,44,2007
2007-10-19,Melaka,17,1,16,2007
2007-10-20,Melaka,77,40,37,2007
2007-10-21,Melaka,165,83,82,2007
2007-10-22,Melaka,23,4,19,2007
2007-10-23,Melaka,36,30,6,2007
2007-10-24,Melaka,12,3,9,2007
2007-10-25,Melaka,202,127,75,2007
2007-10-26,Melaka,66,37,29,2007
2007-10-27,Melaka,1,1,0,2007
2007-10-28,Melaka,198,143,55,2007
2007-10-29,Melaka,25,5,20,2007
2007-10-30,Melaka,149,84,65,2007
2007-10-31,Melaka,65,47,18,2007
2007-11-01,Melaka,159,117,42,2007
2007-11-02,Melaka,141,122,19,2007
2007-11-03,Melaka,0,0,0,2007
2007-11-04,Melaka,252,131,121,2007
2007-11-05,Melaka,19,4,15,2007
2007-11-06,Melaka,152,81,71,2007
2007-11-07,Melaka,130,95,35,2007
2007-11-08,Melaka,1,1,0,2007
2007-11-09,Melaka,19,2,17,2007
2007-11-10,Melaka,31,24,7,2007
2007-11-11,Melaka,83,28,55,2007
2007-11-12,Melaka,18,2,16,2007
2007-11-13,Melaka,68,43,25,2007
2007-11-14,Melaka,129,112,17,2007
2007-11-15,Melaka,34,12,22,2007
2007-11-16,Melaka,53,23,30,2007
2007-11-17,Melaka,0,0,0,2007
2007-11-18,Melaka,110,42,68,2007
2007-11-19,Melaka,18,3,15,2007
2007-11-20,Melaka,45,20,25,2007
2007-11-21,Melaka,40,15,25,2007
2007-11-22,Melaka,44,16,28,2007
2007-11-23,Melaka,37,19,18,2007
2007-11-24,Melaka,33,12,21,2007
2007-11-25,Melaka,95,53,42,2007
2007-11-26,Melaka,23,5,18,2007
2007-11-27,Melaka,119,98,21,2007
2007-11-28,Melaka,100,57,43,2007
2007-11-29,Melaka,132,80,52,2007
2007-11-30,Melaka,105,48,57,2007
2007-12-01,Melaka,77,46,31,2007
2007-12-02,Melaka,140,62,78,2007
2007-12-03,Melaka,35,15,20,2007
2007-12-04,Melaka,16,6,10,2007
2007-12-05,Melaka,24,10,14,2007
2007-12-06,Melaka,65,32,33,2007
2007-12-07,Melaka,35,17,18,2007
2007-12-08,Melaka,1,0,1,2007
2007-12-09,Melaka,40,20,20,2007
2007-12-10,Melaka,100,80,20,2007
2007-12-11,Melaka,96,83,13,2007
2007-12-12,Melaka,47,36,11,2007
2007-12-13,Melaka,82,60,22,2007
2007-12-14,Melaka,38,21,17,2007
2007-12-15,Melaka,77,63,14,2007
2007-12-16,Melaka,262,122,140,2007
2007-12-17,Melaka,18,0,18,2007
2007-12-18,Melaka,85,59,26,2007
2007-12-19,Melaka,14,4,10,2007
2007-12-20,Melaka,1,0,1,2007
2007-12-21,Melaka,32,11,21,2007
2007-12-22,Melaka,0,0,0,2007
2007-12-23,Melaka,162,77,85,2007
2007-12-24,Melaka,24,3,21,2007
2007-12-25,Melaka,0,0,0,2007
2007-12-26,Melaka,61,33,28,2007
2007-12-27,Melaka,31,18,13,2007
2007-12-28,Melaka,31,22,9,2007
2007-12-29,Melaka,41,23,18,2007
2007-12-30,Melaka,58,17,41,2007
2007-12-31,Melaka,16,2,14,2007
2008-01-01,Melaka,76,47,29,2008
2008-01-02,Melaka,13,1,12,2008
2008-01-03,Melaka,38,19,19,2008
2008-01-04,Melaka,35,19,16,2008
2008-01-05,Melaka,71,34,37,2008
2008-01-06,Melaka,61,17,44,2008
2008-01-07,Melaka,43,12,31,2008
2008-01-08,Melaka,66,30,36,2008
2008-01-09,Melaka,72,36,36,2008
2008-01-10,Melaka,0,0,0,2008
2008-01-11,Melaka,38,17,21,2008
2008-01-12,Melaka,40,22,18,2008
2008-01-13,Melaka,57,28,29,2008
2008-01-14,Melaka,22,6,16,2008
2008-01-15,Melaka,248,186,62,2008
2008-01-16,Melaka,128,58,70,2008
2008-01-17,Melaka,97,43,54,2008
2008-01-18,Melaka,140,86,54,2008
2008-01-19,Melaka,1,1,0,2008
2008-01-20,Melaka,202,94,108,2008
2008-01-21,Melaka,11,1,10,2008
2008-01-22,Melaka,11,0,11,2008
2008-01-23,Melaka,72,56,16,2008
2008-01-24,Melaka,191,114,77,2008
2008-01-25,Melaka,49,18,31,2008
2008-01-26,Melaka,57,39,18,2008
2008-01-27,Melaka,48,28,20,2008
2008-01-28,Melaka,130,43,87,2008
2008-01-29,Melaka,186,113,73,2008
2008-01-30,Melaka,158,76,82,2008
2008-01-31,Melaka,149,89,60,2008
2008-02-01,Melaka,80,30,50,2008
2008-02-02,Melaka,176,119,57,2008
2008-02-03,Melaka,30,16,14,2008
2008-02-04,Melaka,131,57,74,2008
2008-02-05,Melaka,233,158,75,2008
2008-02-06,Melaka,33,16,17,2008
2008-02-07,Melaka,0,0,0,2008
2008-02-08,Melaka,4,0,4,2008
2008-02-09,Melaka,49,33,16,2008
2008-02-10,Melaka,54,23,31,2008
2008-02-11,Melaka,39,20,19,2008
2008-02-12,Melaka,87,40,47,2008
2008-02-13,Melaka,106,65,41,2008
2008-02-14,Melaka,105,69,36,2008
2008-02-15,Melaka,11,3,8,2008
2008-02-16,Melaka,22,15,7,2008
2008-02-17,Melaka,142,63,79,2008
2008-02-18,Melaka,87,36,51,2008
2008-02-19,Melaka,121,50,71,2008
2008-02-20,Melaka,10,2,8,2008
2008-02-21,Melaka,222,121,101,2008
2008-02-22,Melaka,2,1,1,2008
2008-02-23,Melaka,109,93,16,2008
2008-02-24,Melaka,44,40,4,2008
2008-02-25,Melaka,49,21,28,2008
2008-02-26,Melaka,139,60,79,2008
2008-02-27,Melaka,86,39,47,2008
2008-02-28,Melaka,38,21,17,2008
2008-02-29,Melaka,20,6,14,2008
2008-03-01,Melaka,49,45,4,2008
2008-03-02,Melaka,46,13,33,2008
2008-03-03,Melaka,34,24,10,2008
2008-03-04,Melaka,85,32,53,2008
2008-03-05,Melaka,79,52,27,2008
2008-03-06,Melaka,7,0,7,2008
2008-03-07,Melaka,33,15,18,2008
2008-03-08,Melaka,0,0,0,2008
2008-03-09,Melaka,251,88,163,2008
2008-03-10,Melaka,14,2,12,2008
2008-03-11,Melaka,54,17,37,2008
2008-03-12,Melaka,8,1,7,2008
2008-03-13,Melaka,54,23,31,2008
2008-03-14,Melaka,7,1,6,2008
2008-03-15,Melaka,173,90,83,2008
2008-03-16,Melaka,154,70,84,2008
2008-03-17,Melaka,304,209,95,2008
2008-03-18,Melaka,41,23,18,2008
2008-03-19,Melaka,12,3,9,2008
2008-03-20,Melaka,39,27,12,2008
2008-03-21,Melaka,51,20,31,2008
2008-03-22,Melaka,168,112,56,2008
2008-03-23,Melaka,165,82,83,2008
2008-03-24,Melaka,19,2,17,2008
2008-03-25,Melaka,8,1,7,2008
2008-03-26,Melaka,93,30,63,2008
2008-03-27,Melaka,17,2,15,2008
2008-03-28,Melaka,58,31,27,2008
2008-03-29,Melaka,83,43,40,2008
2008-03-30,Melaka,100,55,45,2008
2008-03-31,Melaka,40,19,21,2008
2008-04-01,Melaka,8,1,7,2008
2008-04-02,Melaka,118,71,47,2008
2008-04-03,Melaka,74,52,22,2008
2008-04-04,Melaka,10,3,7,2008
2008-04-05,Melaka,83,28,55,2008
2008-04-06,Melaka,94,45,49,2008
2008-04-07,Melaka,68,32,36,2008
2008-04-08,Melaka,38,17,21,2008
2008-04-09,Melaka,113,39,74,2008
2008-04-10,Melaka,11,1,10,2008
2008-04-11,Melaka,20,7,13,2008
2008-04-12,Melaka,31,17,14,2008
2008-04-13,Melaka,139,46,93,2008
2008-04-14,Melaka,12,1,11,2008
2008-04-15,Melaka,34,29,5,2008
2008-04-16,Melaka,90,59,31,2008
2008-04-17,Melaka,37,21,16,2008
2008-04-18,Melaka,26,16,10,2008
2008-04-19,Melaka,33,17,16,2008
2008-04-20,Melaka,98,35,63,2008
2008-04-21,Melaka,32,24,8,2008
2008-04-22,Melaka,48,27,21,2008
2008-04-23,Melaka,105,74,31,2008
2008-04-24,Melaka,63,46,17,2008
2008-04-25,Melaka,19,7,12,2008
2008-04-26,Melaka,88,60,28,2008
2008-04-27,Melaka,35,18,17,2008
2008-04-28,Melaka,51,23,28,2008
2008-04-29,Melaka,71,44,27,2008
2008-04-30,Melaka,57,30,27,2008
2008-05-01,Melaka,99,44,55,2008
2008-05-02,Melaka,27,10,17,2008
2008-05-03,Melaka,43,22,21,2008
2008-05-04,Melaka,221,92,129,2008
2008-05-05,Melaka,28,11,17,2008
2008-05-06,Melaka,26,17,9,2008
2008-05-07,Melaka,53,44,9,2008
2008-05-08,Melaka,37,22,15,2008
2008-05-09,Melaka,56,28,28,2008
2008-05-10,Melaka,66,45,21,2008
2008-05-11,Melaka,148,85,63,2008
2008-05-12,Melaka,11,4,7,2008
2008-05-13,Melaka,52,34,18,2008
2008-05-14,Melaka,35,6,29,2008
2008-05-15,Melaka,127,89,38,2008
2008-05-16,Melaka,18,7,11,2008
2008-05-17,Melaka,186,174,12,2008
2008-05-18,Melaka,272,148,124,2008
2008-05-19,Melaka,60,28,32,2008
2008-05-20,Melaka,35,14,21,2008
2008-05-21,Melaka,14,3,11,2008
2008-05-22,Melaka,143,54,89,2008
2008-05-23,Melaka,53,35,18,2008
2008-05-24,Melaka,117,67,50,2008
2008-05-25,Melaka,75,38,37,2008
2008-05-26,Melaka,53,31,22,2008
2008-05-27,Melaka,67,21,46,2008
2008-05-28,Melaka,135,75,60,2008
2008-05-29,Melaka,53,31,22,2008
2008-05-30,Melaka,32,10,22,2008
2008-05-31,Melaka,90,65,25,2008
2008-06-01,Melaka,74,40,34,2008
2008-06-02,Melaka,22,10,12,2008
2008-06-03,Melaka,79,60,19,2008
2008-06-04,Melaka,145,97,48,2008
2008-06-05,Melaka,128,74,54,2008
2008-06-06,Melaka,37,13,24,2008
2008-06-07,Melaka,53,30,23,2008
2008-06-08,Melaka,67,40,27,2008
2008-06-09,Melaka,15,3,12,2008
2008-06-10,Melaka,13,3,10,2008
2008-06-11,Melaka,185,94,91,2008
2008-06-12,Melaka,44,11,33,2008
2008-06-13,Melaka,35,15,20,2008
2008-06-14,Melaka,108,49,59,2008
2008-06-15,Melaka,102,36,66,2008
2008-06-16,Melaka,37,14,23,2008
2008-06-17,Melaka,84,57,27,2008
2008-06-18,Melaka,51,18,33,2008
2008-06-19,Melaka,7,1,6,2008
2008-06-20,Melaka,36,20,16,2008
2008-06-21,Melaka,75,55,20,2008
2008-06-22,Melaka,86,49,37,2008
2008-06-23,Melaka,23,7,16,2008
2008-06-24,Melaka,106,65,41,2008
2008-06-25,Melaka,58,25,33,2008
2008-06-26,Melaka,45,15,30,2008
2008-06-27,Melaka,14,3,11,2008
2008-06-28,Melaka,98,48,50,2008
2008-06-29,Melaka,145,48,97,2008
2008-06-30,Melaka,15,0,15,2008
2008-07-01,Melaka,37,18,19,2008
2008-07-02,Melaka,13,0,13,2008
2008-07-03,Melaka,20,10,10,2008
2008-07-04,Melaka,22,9,13,2008
2008-07-05,Melaka,37,25,12,2008
2008-07-06,Melaka,175,34,141,2008
2008-07-07,Melaka,74,10,64,2008
2008-07-08,Melaka,113,25,88,2008
2008-07-09,Melaka,61,26,35,2008
2008-07-10,Melaka,36,16,20,2008
2008-07-11,Melaka,101,38,63,2008
2008-07-12,Melaka,39,26,13,2008
2008-07-13,Melaka,204,55,149,2008
2008-07-14,Melaka,7,1,6,2008
2008-07-15,Melaka,60,20,40,2008
2008-07-16,Melaka,88,44,44,2008
2008-07-17,Melaka,38,24,14,2008
2008-07-18,Melaka,24,14,10,2008
2008-07-19,Melaka,60,31,29,2008
2008-07-20,Melaka,73,33,40,2008
2008-07-21,Melaka,121,69,52,2008
2008-07-22,Melaka,12,2,10,2008
2008-07-23,Melaka,28,16,12,2008
2008-07-24,Melaka,57,35,22,2008
2008-07-25,Melaka,22,5,17,2008
2008-07-26,Melaka,56,26,30,2008
2008-07-27,Melaka,52,29,23,2008
2008-07-28,Melaka,192,132,60,2008
2008-07-29,Melaka,188,104,84,2008
2008-07-30,Melaka,123,114,9,2008
2008-07-31,Melaka,149,64,85,2008
2008-08-01,Melaka,39,20,19,2008
2008-08-02,Melaka,10,7,3,2008
2008-08-03,Melaka,110,57,53,2008
2008-08-04,Melaka,11,4,7,2008
2008-08-05,Melaka,24,12,12,2008
2008-08-06,Melaka,27,13,14,2008
2008-08-07,Melaka,14,1,13,2008
2008-08-08,Melaka,80,21,59,2008
2008-08-09,Melaka,36,27,9,2008
2008-08-10,Melaka,131,44,87,2008
2008-08-11,Melaka,65,32,33,2008
2008-08-12,Melaka,133,62,71,2008
2008-08-13,Melaka,10,0,10,2008
2008-08-14,Melaka,77,34,43,2008
2008-08-15,Melaka,11,1,10,2008
2008-08-16,Melaka,49,38,11,2008
2008-08-17,Melaka,329,84,245,2008
2008-08-18,Melaka,32,10,22,2008
2008-08-19,Melaka,51,21,30,2008
2008-08-20,Melaka,39,8,31,2008
2008-08-21,Melaka,51,14,37,2008
2008-08-22,Melaka,10,0,10,2008
2008-08-23,Melaka,124,114,10,2008
2008-08-24,Melaka,305,130,175,2008
2008-08-25,Melaka,100,68,32,2008
2008-08-26,Melaka,35,6,29,2008
2008-08-27,Melaka,149,66,83,2008
2008-08-28,Melaka,215,88,127,2008
2008-08-29,Melaka,86,26,60,2008
2008-08-30,Melaka,199,105,94,2008
2008-08-31,Melaka,166,50,116,2008
2008-09-01,Melaka,4,0,4,2008
2008-09-02,Melaka,0,0,0,2008
2008-09-03,Melaka,18,8,10,2008
2008-09-04,Melaka,56,35,21,2008
2008-09-05,Melaka,58,39,19,2008
2008-09-06,Melaka,33,20,13,2008
2008-09-07,Melaka,62,27,35,2008
2008-09-08,Melaka,37,18,19,2008
2008-09-09,Melaka,226,204,22,2008
2008-09-10,Melaka,33,18,15,2008
2008-09-11,Melaka,24,12,12,2008
2008-09-12,Melaka,18,8,10,2008
2008-09-13,Melaka,22,16,6,2008
2008-09-14,Melaka,8,3,5,2008
2008-09-15,Melaka,151,102,49,2008
2008-09-16,Melaka,134,85,49,2008
2008-09-17,Melaka,46,21,25,2008
2008-09-18,Melaka,118,65,53,2008
2008-09-19,Melaka,86,62,24,2008
2008-09-20,Melaka,11,7,4,2008
2008-09-21,Melaka,61,15,46,2008
2008-09-22,Melaka,55,33,22,2008
2008-09-23,Melaka,110,45,65,2008
2008-09-24,Melaka,111,72,39,2008
2008-09-25,Melaka,26,7,19,2008
2008-09-26,Melaka,44,12,32,2008
2008-09-27,Melaka,13,5,8,2008
2008-09-28,Melaka,128,62,66,2008
2008-09-29,Melaka,21,6,15,2008
2008-09-30,Melaka,7,0,7,2008
2008-10-01,Melaka,0,0,0,2008
2008-10-02,Melaka,0,0,0,2008
2008-10-03,Melaka,35,12,23,2008
2008-10-04,Melaka,38,26,12,2008
2008-10-05,Melaka,72,19,53,2008
2008-10-06,Melaka,29,7,22,2008
2008-10-07,Melaka,12,3,9,2008
2008-10-08,Melaka,97,59,38,2008
2008-10-09,Melaka,78,29,49,2008
2008-10-10,Melaka,99,51,48,2008
2008-10-11,Melaka,197,63,134,2008
2008-10-12,Melaka,22,5,17,2008
2008-10-13,Melaka,64,39,25,2008
2008-10-14,Melaka,138,87,51,2008
2008-10-15,Melaka,240,126,114,2008
2008-10-16,Melaka,137,91,46,2008
2008-10-17,Melaka,52,24,28,2008
2008-10-18,Melaka,48,14,34,2008
2008-10-19,Melaka,0,0,0,2008
2008-10-20,Melaka,150,78,72,2008
2008-10-21,Melaka,11,1,10,2008
2008-10-22,Melaka,75,26,49,2008
2008-10-23,Melaka,78,42,36,2008
2008-10-24,Melaka,14,1,13,2008
2008-10-25,Melaka,8,1,7,2008
2008-10-26,Melaka,50,16,34,2008
2008-10-27,Melaka,47,33,14,2008
2008-10-28,Melaka,8,2,6,2008
2008-10-29,Melaka,51,21,30,2008
2008-10-30,Melaka,49,18,31,2008
2008-10-31,Melaka,30,10,20,2008
2008-11-01,Melaka,87,28,59,2008
2008-11-02,Melaka,39,16,23,2008
2008-11-03,Melaka,10,2,8,2008
2008-11-04,Melaka,97,40,57,2008
2008-11-05,Melaka,21,2,19,2008
2008-11-06,Melaka,128,79,49,2008
2008-11-07,Melaka,142,68,74,2008
2008-11-08,Melaka,63,32,31,2008
2008-11-09,Melaka,111,46,65,2008
2008-11-10,Melaka,32,10,22,2008
2008-11-11,Melaka,185,73,112,2008
2008-11-12,Melaka,73,28,45,2008
2008-11-13,Melaka,40,11,29,2008
2008-11-14,Melaka,88,47,41,2008
2008-11-15,Melaka,65,23,42,2008
2008-11-16,Melaka,140,41,99,2008
2008-11-17,Melaka,10,1,9,2008
2008-11-18,Melaka,64,17,47,2008
2008-11-19,Melaka,49,22,27,2008
2008-11-20,Melaka,34,11,23,2008
2008-11-21,Melaka,7,0,7,2008
2008-11-22,Melaka,14,4,10,2008
2008-11-23,Melaka,74,20,54,2008
2008-11-24,Melaka,61,36,25,2008
2008-11-25,Melaka,7,0,7,2008
2008-11-26,Melaka,31,13,18,2008
2008-11-27,Melaka,138,59,79,2008
2008-11-28,Melaka,57,25,32,2008
2008-11-29,Melaka,50,28,22,2008
2008-11-30,Melaka,308,67,241,2008
2008-12-01,Melaka,8,2,6,2008
2008-12-02,Melaka,116,52,64,2008
2008-12-03,Melaka,74,50,24,2008
2008-12-04,Melaka,63,32,31,2008
2008-12-05,Melaka,18,9,9,2008
2008-12-06,Melaka,111,45,66,2008
2008-12-07,Melaka,316,91,225,2008
2008-12-08,Melaka,0,0,0,2008
2008-12-09,Melaka,77,29,48,2008
2008-12-10,Melaka,81,42,39,2008
2008-12-11,Melaka,192,92,100,2008
2008-12-12,Melaka,42,12,30,2008
2008-12-13,Melaka,51,35,16,2008
2008-12-14,Melaka,174,79,95,2008
2008-12-15,Melaka,65,9,56,2008
2008-12-16,Melaka,48,31,17,2008
2008-12-17,Melaka,43,28,15,2008
2008-12-18,Melaka,164,65,99,2008
2008-12-19,Melaka,12,0,12,2008
2008-12-20,Melaka,17,6,11,2008
2008-12-21,Melaka,81,52,29,2008
2008-12-22,Melaka,8,0,8,2008
2008-12-23,Melaka,53,20,33,2008
2008-12-24,Melaka,41,13,28,2008
2008-12-25,Melaka,0,0,0,2008
2008-12-26,Melaka,34,15,19,2008
2008-12-27,Melaka,78,36,42,2008
2008-12-28,Melaka,105,36,69,2008
2008-12-29,Melaka,0,0,0,2008
2008-12-30,Melaka,16,3,13,2008
2008-12-31,Melaka,34,15,19,2008
2009-01-01,Melaka,30,20,10,2009
2009-01-02,Melaka,151,66,85,2009
2009-01-03,Melaka,0,0,0,2009
2009-01-04,Melaka,128,47,81,2009
2009-01-05,Melaka,16,3,13,2009
2009-01-06,Melaka,70,42,28,2009
2009-01-07,Melaka,26,13,13,2009
2009-01-08,Melaka,59,9,50,2009
2009-01-09,Melaka,15,3,12,2009
2009-01-10,Melaka,21,11,10,2009
2009-01-11,Melaka,63,45,18,2009
2009-01-12,Melaka,23,4,19,2009
2009-01-13,Melaka,90,53,37,2009
2009-01-14,Melaka,243,138,105,2009
2009-01-15,Melaka,7,0,7,2009
2009-01-16,Melaka,0,0,0,2009
2009-01-17,Melaka,94,76,18,2009
2009-01-18,Melaka,83,33,50,2009
2009-01-19,Melaka,44,19,25,2009
2009-01-20,Melaka,68,38,30,2009
2009-01-21,Melaka,162,85,77,2009
2009-01-22,Melaka,211,119,92,2009
2009-01-23,Melaka,11,2,9,2009
2009-01-24,Melaka,20,9,11,2009
2009-01-25,Melaka,55,34,21,2009
2009-01-26,Melaka,15,7,8,2009
2009-01-27,Melaka,0,0,0,2009
2009-01-28,Melaka,63,25,38,2009
2009-01-29,Melaka,97,53,44,2009
2009-01-30,Melaka,156,77,79,2009
2009-01-31,Melaka,293,258,35,2009
2009-02-01,Melaka,0,0,0,2009
2009-02-02,Melaka,51,27,24,2009
2009-02-03,Melaka,8,1,7,2009
2009-02-04,Melaka,273,137,136,2009
2009-02-05,Melaka,182,135,47,2009
2009-02-06,Melaka,7,1,6,2009
2009-02-07,Melaka,213,171,42,2009
2009-02-08,Melaka,192,161,31,2009
2009-02-09,Melaka,20,4,16,2009
2009-02-10,Melaka,100,49,51,2009
2009-02-11,Melaka,248,149,99,2009
2009-02-12,Melaka,118,44,74,2009
2009-02-13,Melaka,11,3,8,2009
2009-02-14,Melaka,89,86,3,2009
2009-02-15,Melaka,59,20,39,2009
2009-02-16,Melaka,84,50,34,2009
2009-02-17,Melaka,54,25,29,2009
2009-02-18,Melaka,73,33,40,2009
2009-02-19,Melaka,75,56,19,2009
2009-02-20,Melaka,41,29,12,2009
2009-02-21,Melaka,113,104,9,2009
2009-02-22,Melaka,168,62,106,2009
2009-02-23,Melaka,99,56,43,2009
2009-02-24,Melaka,200,95,105,2009
2009-02-25,Melaka,89,69,20,2009
2009-02-26,Melaka,13,2,11,2009
2009-02-27,Melaka,13,1,12,2009
2009-02-28,Melaka,135,57,78,2009
2009-03-01,Melaka,189,90,99,2009
2009-03-02,Melaka,114,45,69,2009
2009-03-03,Melaka,146,82,64,2009
2009-03-04,Melaka,148,94,54,2009
2009-03-05,Melaka,44,38,6,2009
2009-03-06,Melaka,61,22,39,2009
2009-03-07,Melaka,107,90,17,2009
2009-03-08,Melaka,266,66,200,2009
2009-03-09,Melaka,0,0,0,2009
2009-03-10,Melaka,69,42,27,2009
2009-03-11,Melaka,70,42,28,2009
2009-03-12,Melaka,30,16,14,2009
2009-03-13,Melaka,57,28,29,2009
2009-03-14,Melaka,122,90,32,2009
2009-03-15,Melaka,132,58,74,2009
2009-03-16,Melaka,95,41,54,2009
2009-03-17,Melaka,91,35,56,2009
2009-03-18,Melaka,102,49,53,2009
2009-03-19,Melaka,9,0,9,2009
2009-03-20,Melaka,15,1,14,2009
2009-03-21,Melaka,40,19,21,2009
2009-03-22,Melaka,77,35,42,2009
2009-03-23,Melaka,164,72,92,2009
2009-03-24,Melaka,136,76,60,2009
2009-03-25,Melaka,100,49,51,2009
2009-03-26,Melaka,78,27,51,2009
2009-03-27,Melaka,35,12,23,2009
2009-03-28,Melaka,77,30,47,2009
2009-03-29,Melaka,19,5,14,2009
2009-03-30,Melaka,11,3,8,2009
2009-03-31,Melaka,10,2,8,2009
2009-04-01,Melaka,45,23,22,2009
2009-04-02,Melaka,9,0,9,2009
2009-04-03,Melaka,23,4,19,2009
2009-04-04,Melaka,70,22,48,2009
2009-04-05,Melaka,62,17,45,2009
2009-04-06,Melaka,11,1,10,2009
2009-04-07,Melaka,71,13,58,2009
2009-04-08,Melaka,181,117,64,2009
2009-04-09,Melaka,71,12,59,2009
2009-04-10,Melaka,13,2,11,2009
2009-04-11,Melaka,0,0,0,2009
2009-04-12,Melaka,48,22,26,2009
2009-04-13,Melaka,11,3,8,2009
2009-04-14,Melaka,80,49,31,2009
2009-04-15,Melaka,68,33,35,2009
2009-04-16,Melaka,101,55,46,2009
2009-04-17,Melaka,60,20,40,2009
2009-04-18,Melaka,38,15,23,2009
2009-04-19,Melaka,131,26,105,2009
2009-04-20,Melaka,31,18,13,2009
2009-04-21,Melaka,42,7,35,2009
2009-04-22,Melaka,93,69,24,2009
2009-04-23,Melaka,49,32,17,2009
2009-04-24,Melaka,37,23,14,2009
2009-04-25,Melaka,239,207,32,2009
2009-04-26,Melaka,142,40,102,2009
2009-04-27,Melaka,62,6,56,2009
2009-04-28,Melaka,84,51,33,2009
2009-04-29,Melaka,91,60,31,2009
2009-04-30,Melaka,125,86,39,2009
2009-05-01,Melaka,51,21,30,2009
2009-05-02,Melaka,121,93,28,2009
2009-05-03,Melaka,187,36,151,2009
2009-05-04,Melaka,40,11,29,2009
2009-05-05,Melaka,68,30,38,2009
2009-05-06,Melaka,13,1,12,2009
2009-05-07,Melaka,93,50,43,2009
2009-05-08,Melaka,41,16,25,2009
2009-05-09,Melaka,83,31,52,2009
2009-05-10,Melaka,72,33,39,2009
2009-05-11,Melaka,35,2,33,2009
2009-05-12,Melaka,10,1,9,2009
2009-05-13,Melaka,99,61,38,2009
2009-05-14,Melaka,214,101,113,2009
2009-05-15,Melaka,52,20,32,2009
2009-05-16,Melaka,34,33,1,2009
2009-05-17,Melaka,125,60,65,2009
2009-05-18,Melaka,11,0,11,2009
2009-05-19,Melaka,19,4,15,2009
2009-05-20,Melaka,203,95,108,2009
2009-05-21,Melaka,13,1,12,2009
2009-05-22,Melaka,56,30,26,2009
2009-05-23,Melaka,44,36,8,2009
2009-05-24,Melaka,100,47,53,2009
2009-05-25,Melaka,158,53,105,2009
2009-05-26,Melaka,34,14,20,2009
2009-05-27,Melaka,57,19,38,2009
2009-05-28,Melaka,115,98,17,2009
2009-05-29,Melaka,14,2,12,2009
2009-05-30,Melaka,97,91,6,2009
2009-05-31,Melaka,358,73,285,2009
2009-06-01,Melaka,80,29,51,2009
2009-06-02,Melaka,85,37,48,2009
2009-06-03,Melaka,10,4,6,2009
2009-06-04,Melaka,50,17,33,2009
2009-06-05,Melaka,13,1,12,2009
2009-06-06,Melaka,60,27,33,2009
2009-06-07,Melaka,112,48,64,2009
2009-06-08,Melaka,11,0,11,2009
2009-06-09,Melaka,14,4,10,2009
2009-06-10,Melaka,138,66,72,2009
2009-06-11,Melaka,49,21,28,2009
2009-06-12,Melaka,30,12,18,2009
2009-06-13,Melaka,25,15,10,2009
2009-06-14,Melaka,97,37,60,2009
2009-06-15,Melaka,220,96,124,2009
2009-06-16,Melaka,54,14,40,2009
2009-06-17,Melaka,56,27,29,2009
2009-06-18,Melaka,15,1,14,2009
2009-06-19,Melaka,31,15,16,2009
2009-06-20,Melaka,67,42,25,2009
2009-06-21,Melaka,164,92,72,2009
2009-06-22,Melaka,13,1,12,2009
2009-06-23,Melaka,43,27,16,2009
2009-06-24,Melaka,11,1,10,2009
2009-06-25,Melaka,13,4,9,2009
2009-06-26,Melaka,113,67,46,2009
2009-06-27,Melaka,54,28,26,2009
2009-06-28,Melaka,80,10,70,2009
2009-06-29,Melaka,40,19,21,2009
2009-06-30,Melaka,126,49,77,2009
2009-07-01,Melaka,180,85,95,2009
2009-07-02,Melaka,89,56,33,2009
2009-07-03,Melaka,95,55,40,2009
2009-07-04,Melaka,31,13,18,2009
2009-07-05,Melaka,50,18,32,2009
2009-07-06,Melaka,18,3,15,2009
2009-07-07,Melaka,54,29,25,2009
2009-07-08,Melaka,10,2,8,2009
2009-07-09,Melaka,165,108,57,2009
2009-07-10,Melaka,13,1,12,2009
2009-07-11,Melaka,32,23,9,2009
2009-07-12,Melaka,284,69,215,2009
2009-07-13,Melaka,8,1,7,2009
2009-07-14,Melaka,35,17,18,2009
2009-07-15,Melaka,10,2,8,2009
2009-07-16,Melaka,38,8,30,2009
2009-07-17,Melaka,31,9,22,2009
2009-07-18,Melaka,128,53,75,2009
2009-07-19,Melaka,0,0,0,2009
2009-07-20,Melaka,41,25,16,2009
2009-07-21,Melaka,6,0,6,2009
2009-07-22,Melaka,161,78,83,2009
2009-07-23,Melaka,107,93,14,2009
2009-07-24,Melaka,12,1,11,2009
2009-07-25,Melaka,54,32,22,2009
2009-07-26,Melaka,147,84,63,2009
2009-07-27,Melaka,12,1,11,2009
2009-07-28,Melaka,14,6,8,2009
2009-07-29,Melaka,101,53,48,2009
2009-07-30,Melaka,57,35,22,2009
2009-07-31,Melaka,256,128,128,2009
2009-08-01,Melaka,20,20,0,2009
2009-08-02,Melaka,120,63,57,2009
2009-08-03,Melaka,83,17,66,2009
2009-08-04,Melaka,60,11,49,2009
2009-08-05,Melaka,10,3,7,2009
2009-08-06,Melaka,6,0,6,2009
2009-08-07,Melaka,263,244,19,2009
2009-08-08,Melaka,28,16,12,2009
2009-08-09,Melaka,140,35,105,2009
2009-08-10,Melaka,17,4,13,2009
2009-08-11,Melaka,43,7,36,2009
2009-08-12,Melaka,104,38,66,2009
2009-08-13,Melaka,63,36,27,2009
2009-08-14,Melaka,110,28,82,2009
2009-08-15,Melaka,116,62,54,2009
2009-08-16,Melaka,175,17,158,2009
2009-08-17,Melaka,56,23,33,2009
2009-08-18,Melaka,195,132,63,2009
2009-08-19,Melaka,95,74,21,2009
2009-08-20,Melaka,143,68,75,2009
2009-08-21,Melaka,189,98,91,2009
2009-08-22,Melaka,33,19,14,2009
2009-08-23,Melaka,22,6,16,2009
2009-08-24,Melaka,4,0,4,2009
2009-08-25,Melaka,10,7,3,2009
2009-08-26,Melaka,99,81,18,2009
2009-08-27,Melaka,18,4,14,2009
2009-08-28,Melaka,13,0,13,2009
2009-08-29,Melaka,15,8,7,2009
2009-08-30,Melaka,117,25,92,2009
2009-08-31,Melaka,32,21,11,2009
2009-09-01,Melaka,30,11,19,2009
2009-09-02,Melaka,193,88,105,2009
2009-09-03,Melaka,120,57,63,2009
2009-09-04,Melaka,28,13,15,2009
2009-09-05,Melaka,68,18,50,2009
2009-09-06,Melaka,176,67,109,2009
2009-09-07,Melaka,146,60,86,2009
2009-09-08,Melaka,36,23,13,2009
2009-09-09,Melaka,186,115,71,2009
2009-09-10,Melaka,34,11,23,2009
2009-09-11,Melaka,16,8,8,2009
2009-09-12,Melaka,0,0,0,2009
2009-09-13,Melaka,90,35,55,2009
2009-09-14,Melaka,16,4,12,2009
2009-09-15,Melaka,95,52,43,2009
2009-09-16,Melaka,3,0,3,2009
2009-09-17,Melaka,69,41,28,2009
2009-09-18,Melaka,17,6,11,2009
2009-09-19,Melaka,0,0,0,2009
2009-09-20,Melaka,0,0,0,2009
2009-09-21,Melaka,0,0,0,2009
2009-09-22,Melaka,2,0,2,2009
2009-09-23,Melaka,62,22,40,2009
2009-09-24,Melaka,50,22,28,2009
2009-09-25,Melaka,21,6,15,2009
2009-09-26,Melaka,20,12,8,2009
2009-09-27,Melaka,55,17,38,2009
2009-09-28,Melaka,38,8,30,2009
2009-09-29,Melaka,90,40,50,2009
2009-09-30,Melaka,53,27,26,2009
2009-10-01,Melaka,16,5,11,2009
2009-10-02,Melaka,25,10,15,2009
2009-10-03,Melaka,42,16,26,2009
2009-10-04,Melaka,0,0,0,2009
2009-10-05,Melaka,11,2,9,2009
2009-10-06,Melaka,14,0,14,2009
2009-10-07,Melaka,140,52,88,2009
2009-10-08,Melaka,90,16,74,2009
2009-10-09,Melaka,15,2,13,2009
2009-10-10,Melaka,1,1,0,2009
2009-10-11,Melaka,0,0,0,2009
2009-10-12,Melaka,17,4,13,2009
2009-10-13,Melaka,9,3,6,2009
2009-10-14,Melaka,150,53,97,2009
2009-10-15,Melaka,93,42,51,2009
2009-10-16,Melaka,106,47,59,2009
2009-10-17,Melaka,54,33,21,2009
2009-10-18,Melaka,1,1,0,2009
2009-10-19,Melaka,16,1,15,2009
2009-10-20,Melaka,10,1,9,2009
2009-10-21,Melaka,36,6,30,2009
2009-10-22,Melaka,233,150,83,2009
2009-10-23,Melaka,17,2,15,2009
2009-10-24,Melaka,0,0,0,2009
2009-10-25,Melaka,0,0,0,2009
2009-10-26,Melaka,26,6,20,2009
2009-10-27,Melaka,116,40,76,2009
2009-10-28,Melaka,112,55,57,2009
2009-10-29,Melaka,52,34,18,2009
2009-10-30,Melaka,50,27,23,2009
2009-10-31,Melaka,86,47,39,2009
2009-11-01,Melaka,100,35,65,2009
2009-11-02,Melaka,34,14,20,2009
2009-11-03,Melaka,86,43,43,2009
2009-11-04,Melaka,39,24,15,2009
2009-11-05,Melaka,11,1,10,2009
2009-11-06,Melaka,25,7,18,2009
2009-11-07,Melaka,11,8,3,2009
2009-11-08,Melaka,115,31,84,2009
2009-11-09,Melaka,11,1,10,2009
2009-11-10,Melaka,31,14,17,2009
2009-11-11,Melaka,34,7,27,2009
2009-11-12,Melaka,134,73,61,2009
2009-11-13,Melaka,24,6,18,2009
2009-11-14,Melaka,42,26,16,2009
2009-11-15,Melaka,147,62,85,2009
2009-11-16,Melaka,91,42,49,2009
2009-11-17,Melaka,97,42,55,2009
2009-11-18,Melaka,98,41,57,2009
2009-11-19,Melaka,43,19,24,2009
2009-11-20,Melaka,5,4,1,2009
2009-11-21,Melaka,44,25,19,2009
2009-11-22,Melaka,127,28,99,2009
2009-11-23,Melaka,41,19,22,2009
2009-11-24,Melaka,154,101,53,2009
2009-11-25,Melaka,20,7,13,2009
2009-11-26,Melaka,25,10,15,2009
2009-11-27,Melaka,0,0,0,2009
2009-11-28,Melaka,27,14,13,2009
2009-11-29,Melaka,314,59,255,2009
2009-11-30,Melaka,16,0,16,2009
2009-12-01,Melaka,19,2,17,2009
2009-12-02,Melaka,51,19,32,2009
2009-12-03,Melaka,69,33,36,2009
2009-12-04,Melaka,140,70,70,2009
2009-12-05,Melaka,71,36,35,2009
2009-12-06,Melaka,369,86,283,2009
2009-12-07,Melaka,22,2,20,2009
2009-12-08,Melaka,10,1,9,2009
2009-12-09,Melaka,85,22,63,2009
2009-12-10,Melaka,87,29,58,2009
2009-12-11,Melaka,42,7,35,2009
2009-12-12,Melaka,108,50,58,2009
2009-12-13,Melaka,147,47,100,2009
2009-12-14,Melaka,121,23,98,2009
2009-12-15,Melaka,35,17,18,2009
2009-12-16,Melaka,87,50,37,2009
2009-12-17,Melaka,168,68,100,2009
2009-12-18,Melaka,8,5,3,2009
2009-12-19,Melaka,78,40,38,2009
2009-12-20,Melaka,61,28,33,2009
2009-12-21,Melaka,17,0,17,2009
2009-12-22,Melaka,143,55,88,2009
2009-12-23,Melaka,18,4,14,2009
2009-12-24,Melaka,162,74,88,2009
2009-12-25,Melaka,72,22,50,2009
2009-12-26,Melaka,60,38,22,2009
2009-12-27,Melaka,122,60,62,2009
2009-12-28,Melaka,25,5,20,2009
2009-12-29,Melaka,18,5,13,2009
2009-12-30,Melaka,90,36,54,2009
2009-12-31,Melaka,77,38,39,2009
2010-01-01,Melaka,53,27,26,2010
2010-01-02,Melaka,37,13,24,2010
2010-01-03,Melaka,31,5,26,2010
2010-01-04,Melaka,20,3,17,2010
2010-01-05,Melaka,22,6,16,2010
2010-01-06,Melaka,88,28,60,2010
2010-01-07,Melaka,115,41,74,2010
2010-01-08,Melaka,56,21,35,2010
2010-01-09,Melaka,129,71,58,2010
2010-01-10,Melaka,53,36,17,2010
2010-01-11,Melaka,41,14,27,2010
2010-01-12,Melaka,54,19,35,2010
2010-01-13,Melaka,206,103,103,2010
2010-01-14,Melaka,87,35,52,2010
2010-01-15,Melaka,21,3,18,2010
2010-01-16,Melaka,0,0,0,2010
2010-01-17,Melaka,48,24,24,2010
2010-01-18,Melaka,17,1,16,2010
2010-01-19,Melaka,36,22,14,2010
2010-01-20,Melaka,232,135,97,2010
2010-01-21,Melaka,258,130,128,2010
2010-01-22,Melaka,220,90,130,2010
2010-01-23,Melaka,26,19,7,2010
2010-01-24,Melaka,64,26,38,2010
2010-01-25,Melaka,75,8,67,2010
2010-01-26,Melaka,9,1,8,2010
2010-01-27,Melaka,56,23,33,2010
2010-01-28,Melaka,103,66,37,2010
2010-01-29,Melaka,78,24,54,2010
2010-01-30,Melaka,108,55,53,2010
2010-01-31,Melaka,188,80,108,2010
2010-02-01,Melaka,111,37,74,2010
2010-02-02,Melaka,157,68,89,2010
2010-02-03,Melaka,393,298,95,2010
2010-02-04,Melaka,8,0,8,2010
2010-02-05,Melaka,11,0,11,2010
2010-02-06,Melaka,172,105,67,2010
2010-02-07,Melaka,0,0,0,2010
2010-02-08,Melaka,17,2,15,2010
2010-02-09,Melaka,81,29,52,2010
2010-02-10,Melaka,26,7,19,2010
2010-02-11,Melaka,224,124,100,2010
2010-02-12,Melaka,20,5,15,2010
2010-02-13,Melaka,34,22,12,2010
2010-02-14,Melaka,10,2,8,2010
2010-02-15,Melaka,21,13,8,2010
2010-02-16,Melaka,0,0,0,2010
2010-02-17,Melaka,135,63,72,2010
2010-02-18,Melaka,171,88,83,2010
2010-02-19,Melaka,21,2,19,2010
2010-02-20,Melaka,79,66,13,2010
2010-02-21,Melaka,80,35,45,2010
2010-02-22,Melaka,52,16,36,2010
2010-02-23,Melaka,21,1,20,2010
2010-02-24,Melaka,156,93,63,2010
2010-02-25,Melaka,12,0,12,2010
2010-02-26,Melaka,49,21,28,2010
2010-02-27,Melaka,192,179,13,2010
2010-02-28,Melaka,16,12,4,2010
2010-03-01,Melaka,23,6,17,2010
2010-03-02,Melaka,72,27,45,2010
2010-03-03,Melaka,178,70,108,2010
2010-03-04,Melaka,95,79,16,2010
2010-03-05,Melaka,23,3,20,2010
2010-03-06,Melaka,49,21,28,2010
2010-03-07,Melaka,139,27,112,2010
2010-03-08,Melaka,47,21,26,2010
2010-03-09,Melaka,214,110,104,2010
2010-03-10,Melaka,159,80,79,2010
2010-03-11,Melaka,133,84,49,2010
2010-03-12,Melaka,29,15,14,2010
2010-03-13,Melaka,124,49,75,2010
2010-03-14,Melaka,315,55,260,2010
2010-03-15,Melaka,89,42,47,2010
2010-03-16,Melaka,2,2,0,2010
2010-03-17,Melaka,62,32,30,2010
2010-03-18,Melaka,52,40,12,2010
2010-03-19,Melaka,86,46,40,2010
2010-03-20,Melaka,99,61,38,2010
2010-03-21,Melaka,146,39,107,2010
2010-03-22,Melaka,7,1,6,2010
2010-03-23,Melaka,79,19,60,2010
2010-03-24,Melaka,156,87,69,2010
2010-03-25,Melaka,112,49,63,2010
2010-03-26,Melaka,12,6,6,2010
2010-03-27,Melaka,133,75,58,2010
2010-03-28,Melaka,109,52,57,2010
2010-03-29,Melaka,14,3,11,2010
2010-03-30,Melaka,117,38,79,2010
2010-03-31,Melaka,0,0,0,2010
2010-04-01,Melaka,67,24,43,2010
2010-04-02,Melaka,18,2,16,2010
2010-04-03,Melaka,82,57,25,2010
2010-04-04,Melaka,131,63,68,2010
2010-04-05,Melaka,13,1,12,2010
2010-04-06,Melaka,9,1,8,2010
2010-04-07,Melaka,66,28,38,2010
2010-04-08,Melaka,130,25,105,2010
2010-04-09,Melaka,12,2,10,2010
2010-04-10,Melaka,0,0,0,2010
2010-04-11,Melaka,34,14,20,2010
2010-04-12,Melaka,55,23,32,2010
2010-04-13,Melaka,137,65,72,2010
2010-04-14,Melaka,4,0,4,2010
2010-04-15,Melaka,92,35,57,2010
2010-04-16,Melaka,10,0,10,2010
2010-04-17,Melaka,79,31,48,2010
2010-04-18,Melaka,162,26,136,2010
2010-04-19,Melaka,34,13,21,2010
2010-04-20,Melaka,134,66,68,2010
2010-04-21,Melaka,50,20,30,2010
2010-04-22,Melaka,72,44,28,2010
2010-04-23,Melaka,15,4,11,2010
2010-04-24,Melaka,0,0,0,2010
2010-04-25,Melaka,0,0,0,2010
2010-04-26,Melaka,19,2,17,2010
2010-04-27,Melaka,46,29,17,2010
2010-04-28,Melaka,108,83,25,2010
2010-04-29,Melaka,125,55,70,2010
2010-04-30,Melaka,8,2,6,2010
2010-05-01,Melaka,142,81,61,2010
2010-05-02,Melaka,76,22,54,2010
2010-05-03,Melaka,19,1,18,2010
2010-05-04,Melaka,52,30,22,2010
2010-05-05,Melaka,82,49,33,2010
2010-05-06,Melaka,14,1,13,2010
2010-05-07,Melaka,11,2,9,2010
2010-05-08,Melaka,76,70,6,2010
2010-05-09,Melaka,223,63,160,2010
2010-05-10,Melaka,92,43,49,2010
2010-05-11,Melaka,64,39,25,2010
2010-05-12,Melaka,60,35,25,2010
2010-05-13,Melaka,99,60,39,2010
2010-05-14,Melaka,6,0,6,2010
2010-05-15,Melaka,56,50,6,2010
2010-05-16,Melaka,113,36,77,2010
2010-05-17,Melaka,51,11,40,2010
2010-05-18,Melaka,69,53,16,2010
2010-05-19,Melaka,271,74,197,2010
2010-05-20,Melaka,194,120,74,2010
2010-05-21,Melaka,14,2,12,2010
2010-05-22,Melaka,171,98,73,2010
2010-05-23,Melaka,91,13,78,2010
2010-05-24,Melaka,47,11,36,2010
2010-05-25,Melaka,104,31,73,2010
2010-05-26,Melaka,69,51,18,2010
2010-05-27,Melaka,22,5,17,2010
2010-05-28,Melaka,37,10,27,2010
2010-05-29,Melaka,119,47,72,2010
2010-05-30,Melaka,398,67,331,2010
2010-05-31,Melaka,12,1,11,2010
2010-06-01,Melaka,0,0,0,2010
2010-06-02,Melaka,240,79,161,2010
2010-06-03,Melaka,41,6,35,2010
2010-06-04,Melaka,7,0,7,2010
2010-06-05,Melaka,0,0,0,2010
2010-06-06,Melaka,73,41,32,2010
2010-06-07,Melaka,150,43,107,2010
2010-06-08,Melaka,37,6,31,2010
2010-06-09,Melaka,34,11,23,2010
2010-06-10,Melaka,142,73,69,2010
2010-06-11,Melaka,8,0,8,2010
2010-06-12,Melaka,40,15,25,2010
2010-06-13,Melaka,42,20,22,2010
2010-06-14,Melaka,22,3,19,2010
2010-06-15,Melaka,40,13,27,2010
2010-06-16,Melaka,34,8,26,2010
2010-06-17,Melaka,290,118,172,2010
2010-06-18,Melaka,30,13,17,2010
2010-06-19,Melaka,0,0,0,2010
2010-06-20,Melaka,84,25,59,2010
2010-06-21,Melaka,14,4,10,2010
2010-06-22,Melaka,13,2,11,2010
2010-06-23,Melaka,138,76,62,2010
2010-06-24,Melaka,139,57,82,2010
2010-06-25,Melaka,75,32,43,2010
2010-06-26,Melaka,56,26,30,2010
2010-06-27,Melaka,130,50,80,2010
2010-06-28,Melaka,14,3,11,2010
2010-06-29,Melaka,97,38,59,2010
2010-06-30,Melaka,10,0,10,2010
2010-07-01,Melaka,99,39,60,2010
2010-07-02,Melaka,5,0,5,2010
2010-07-03,Melaka,29,15,14,2010
2010-07-04,Melaka,195,54,141,2010
2010-07-05,Melaka,19,5,14,2010
2010-07-06,Melaka,9,2,7,2010
2010-07-07,Melaka,123,41,82,2010
2010-07-08,Melaka,174,54,120,2010
2010-07-09,Melaka,3,1,2,2010
2010-07-10,Melaka,76,29,47,2010
2010-07-11,Melaka,221,45,176,2010
2010-07-12,Melaka,14,4,10,2010
2010-07-13,Melaka,36,8,28,2010
2010-07-14,Melaka,40,9,31,2010
2010-07-15,Melaka,89,32,57,2010
2010-07-16,Melaka,14,1,13,2010
2010-07-17,Melaka,0,0,0,2010
2010-07-18,Melaka,191,69,122,2010
2010-07-19,Melaka,55,26,29,2010
2010-07-20,Melaka,62,35,27,2010
2010-07-21,Melaka,94,40,54,2010
2010-07-22,Melaka,60,32,28,2010
2010-07-23,Melaka,37,12,25,2010
2010-07-24,Melaka,168,104,64,2010
2010-07-25,Melaka,120,39,81,2010
2010-07-26,Melaka,52,5,47,2010
2010-07-27,Melaka,61,16,45,2010
2010-07-28,Melaka,106,47,59,2010
2010-07-29,Melaka,69,53,16,2010
2010-07-30,Melaka,41,20,21,2010
2010-07-31,Melaka,81,37,44,2010
2010-08-01,Melaka,99,25,74,2010
2010-08-02,Melaka,75,26,49,2010
2010-08-03,Melaka,100,23,77,2010
2010-08-04,Melaka,81,41,40,2010
2010-08-05,Melaka,83,31,52,2010
2010-08-06,Melaka,193,167,26,2010
2010-08-07,Melaka,89,45,44,2010
2010-08-08,Melaka,55,21,34,2010
2010-08-09,Melaka,106,38,68,2010
2010-08-10,Melaka,208,78,130,2010
2010-08-11,Melaka,0,0,0,2010
2010-08-12,Melaka,4,0,4,2010
2010-08-13,Melaka,69,11,58,2010
2010-08-14,Melaka,0,0,0,2010
2010-08-15,Melaka,159,46,113,2010
2010-08-16,Melaka,46,30,16,2010
2010-08-17,Melaka,57,35,22,2010
2010-08-18,Melaka,21,11,10,2010
2010-08-19,Melaka,9,1,8,2010
2010-08-20,Melaka,43,13,30,2010
2010-08-21,Melaka,1,0,1,2010
2010-08-22,Melaka,82,17,65,2010
2010-08-23,Melaka,12,2,10,2010
2010-08-24,Melaka,89,37,52,2010
2010-08-25,Melaka,80,30,50,2010
2010-08-26,Melaka,38,9,29,2010
2010-08-27,Melaka,60,21,39,2010
2010-08-28,Melaka,80,37,43,2010
2010-08-29,Melaka,189,51,138,2010
2010-08-30,Melaka,7,1,6,2010
2010-08-31,Melaka,35,9,26,2010
2010-09-01,Melaka,156,101,55,2010
2010-09-02,Melaka,49,20,29,2010
2010-09-03,Melaka,173,61,112,2010
2010-09-04,Melaka,0,0,0,2010
2010-09-05,Melaka,173,42,131,2010
2010-09-06,Melaka,3,0,3,2010
2010-09-07,Melaka,53,10,43,2010
2010-09-08,Melaka,8,0,8,2010
2010-09-09,Melaka,7,0,7,2010
2010-09-10,Melaka,1,0,1,2010
2010-09-11,Melaka,0,0,0,2010
2010-09-12,Melaka,53,11,42,2010
2010-09-13,Melaka,18,4,14,2010
2010-09-14,Melaka,24,4,20,2010
2010-09-15,Melaka,47,10,37,2010
2010-09-16,Melaka,67,34,33,2010
2010-09-17,Melaka,51,25,26,2010
2010-09-18,Melaka,68,34,34,2010
2010-09-19,Melaka,168,45,123,2010
2010-09-20,Melaka,23,2,21,2010
2010-09-21,Melaka,71,38,33,2010
2010-09-22,Melaka,89,37,52,2010
2010-09-23,Melaka,136,81,55,2010
2010-09-24,Melaka,190,171,19,2010
2010-09-25,Melaka,22,4,18,2010
2010-09-26,Melaka,184,40,144,2010
2010-09-27,Melaka,57,14,43,2010
2010-09-28,Melaka,164,81,83,2010
2010-09-29,Melaka,139,75,64,2010
2010-09-30,Melaka,83,34,49,2010
2010-10-01,Melaka,95,34,61,2010
2010-10-02,Melaka,0,0,0,2010
2010-10-03,Melaka,76,17,59,2010
2010-10-04,Melaka,14,2,12,2010
2010-10-05,Melaka,171,42,129,2010
2010-10-06,Melaka,59,30,29,2010
2010-10-07,Melaka,9,1,8,2010
2010-10-08,Melaka,73,46,27,2010
2010-10-09,Melaka,79,69,10,2010
2010-10-10,Melaka,112,40,72,2010
2010-10-11,Melaka,38,7,31,2010
2010-10-12,Melaka,20,2,18,2010
2010-10-13,Melaka,183,107,76,2010
2010-10-14,Melaka,83,18,65,2010
2010-10-15,Melaka,14,0,14,2010
2010-10-16,Melaka,61,47,14,2010
2010-10-17,Melaka,61,18,43,2010
2010-10-18,Melaka,66,18,48,2010
2010-10-19,Melaka,125,27,98,2010
2010-10-20,Melaka,103,28,75,2010
2010-10-21,Melaka,56,20,36,2010
2010-10-22,Melaka,19,2,17,2010
2010-10-23,Melaka,66,47,19,2010
2010-10-24,Melaka,103,24,79,2010
2010-10-25,Melaka,20,3,17,2010
2010-10-26,Melaka,20,12,8,2010
2010-10-27,Melaka,36,12,24,2010
2010-10-28,Melaka,32,12,20,2010
2010-10-29,Melaka,31,14,17,2010
2010-10-30,Melaka,95,35,60,2010
2010-10-31,Melaka,126,33,93,2010
2010-11-01,Melaka,91,31,60,2010
2010-11-02,Melaka,15,1,14,2010
2010-11-03,Melaka,34,18,16,2010
2010-11-04,Melaka,78,21,57,2010
2010-11-05,Melaka,0,0,0,2010
2010-11-06,Melaka,0,0,0,2010
2010-11-07,Melaka,48,19,29,2010
2010-11-08,Melaka,115,38,77,2010
2010-11-09,Melaka,143,45,98,2010
2010-11-10,Melaka,250,125,125,2010
2010-11-11,Melaka,30,8,22,2010
2010-11-12,Melaka,13,4,9,2010
2010-11-13,Melaka,28,8,20,2010
2010-11-14,Melaka,235,52,183,2010
2010-11-15,Melaka,67,18,49,2010
2010-11-16,Melaka,17,6,11,2010
2010-11-17,Melaka,0,0,0,2010
2010-11-18,Melaka,27,5,22,2010
2010-11-19,Melaka,26,15,11,2010
2010-11-20,Melaka,0,0,0,2010
2010-11-21,Melaka,142,34,108,2010
2010-11-22,Melaka,36,11,25,2010
2010-11-23,Melaka,54,22,32,2010
2010-11-24,Melaka,75,14,61,2010
2010-11-25,Melaka,67,30,37,2010
2010-11-26,Melaka,44,15,29,2010
2010-11-27,Melaka,0,0,0,2010
2010-11-28,Melaka,296,45,251,2010
2010-11-29,Melaka,61,37,24,2010
2010-11-30,Melaka,73,60,13,2010
2010-12-01,Melaka,12,2,10,2010
2010-12-02,Melaka,39,18,21,2010
2010-12-03,Melaka,14,1,13,2010
2010-12-04,Melaka,93,35,58,2010
2010-12-05,Melaka,128,43,85,2010
2010-12-06,Melaka,18,0,18,2010
2010-12-07,Melaka,3,0,3,2010
2010-12-08,Melaka,75,13,62,2010
2010-12-09,Melaka,73,22,51,2010
2010-12-10,Melaka,46,8,38,2010
2010-12-11,Melaka,63,27,36,2010
2010-12-12,Melaka,427,75,352,2010
2010-12-13,Melaka,80,12,68,2010
2010-12-14,Melaka,200,88,112,2010
2010-12-15,Melaka,9,1,8,2010
2010-12-16,Melaka,100,33,67,2010
2010-12-17,Melaka,15,1,14,2010
2010-12-18,Melaka,110,60,50,2010
2010-12-19,Melaka,235,75,160,2010
2010-12-20,Melaka,18,2,16,2010
2010-12-21,Melaka,73,17,56,2010
2010-12-22,Melaka,51,5,46,2010
2010-12-23,Melaka,3,0,3,2010
2010-12-24,Melaka,32,13,19,2010
2010-12-25,Melaka,40,17,23,2010
2010-12-26,Melaka,67,17,50,2010
2010-12-27,Melaka,24,3,21,2010
2010-12-28,Melaka,16,1,15,2010
2010-12-29,Melaka,79,40,39,2010
2010-12-30,Melaka,56,22,34,2010
2010-12-31,Melaka,0,0,0,2010
2011-01-01,Melaka,0,0,0,2011
2011-01-02,Melaka,98,26,72,2011
2011-01-03,Melaka,19,3,16,2011
2011-01-04,Melaka,77,46,31,2011
2011-01-05,Melaka,77,56,21,2011
2011-01-06,Melaka,175,57,118,2011
2011-01-07,Melaka,3,0,3,2011
2011-01-08,Melaka,0,0,0,2011
2011-01-09,Melaka,0,0,0,2011
2011-01-10,Melaka,95,33,62,2011
2011-01-11,Melaka,99,35,64,2011
2011-01-12,Melaka,12,1,11,2011
2011-01-13,Melaka,202,56,146,2011
2011-01-14,Melaka,13,0,13,2011
2011-01-15,Melaka,0,0,0,2011
2011-01-16,Melaka,0,0,0,2011
2011-01-17,Melaka,102,28,74,2011
2011-01-18,Melaka,41,9,32,2011
2011-01-19,Melaka,65,29,36,2011
2011-01-20,Melaka,172,107,65,2011
2011-01-21,Melaka,8,1,7,2011
2011-01-22,Melaka,103,41,62,2011
2011-01-23,Melaka,173,67,106,2011
2011-01-24,Melaka,162,84,78,2011
2011-01-25,Melaka,103,39,64,2011
2011-01-26,Melaka,95,43,52,2011
2011-01-27,Melaka,104,65,39,2011
2011-01-28,Melaka,315,199,116,2011
2011-01-29,Melaka,14,11,3,2011
2011-01-30,Melaka,25,11,14,2011
2011-01-31,Melaka,9,1,8,2011
2011-02-01,Melaka,159,41,118,2011
2011-02-02,Melaka,23,4,19,2011
2011-02-03,Melaka,1,0,1,2011
2011-02-04,Melaka,0,0,0,2011
2011-02-05,Melaka,0,0,0,2011
2011-02-06,Melaka,0,0,0,2011
2011-02-07,Melaka,83,27,56,2011
2011-02-08,Melaka,120,34,86,2011
2011-02-09,Melaka,54,30,24,2011
2011-02-10,Melaka,162,78,84,2011
2011-02-11,Melaka,16,3,13,2011
2011-02-12,Melaka,33,16,17,2011
2011-02-13,Melaka,55,18,37,2011
2011-02-14,Melaka,47,16,31,2011
2011-02-15,Melaka,0,0,0,2011
2011-02-16,Melaka,238,101,137,2011
2011-02-17,Melaka,146,77,69,2011
2011-02-18,Melaka,18,2,16,2011
2011-02-19,Melaka,6,4,2,2011
2011-02-20,Melaka,45,16,29,2011
2011-02-21,Melaka,19,2,17,2011
2011-02-22,Melaka,61,35,26,2011
2011-02-23,Melaka,110,46,64,2011
2011-02-24,Melaka,112,49,63,2011
2011-02-25,Melaka,15,7,8,2011
2011-02-26,Melaka,138,126,12,2011
2011-02-27,Melaka,223,93,130,2011
2011-02-28,Melaka,38,9,29,2011
2011-03-01,Melaka,61,19,42,2011
2011-03-02,Melaka,12,2,10,2011
2011-03-03,Melaka,136,72,64,2011
2011-03-04,Melaka,16,1,15,2011
2011-03-05,Melaka,215,202,13,2011
2011-03-06,Melaka,0,0,0,2011
2011-03-07,Melaka,18,2,16,2011
2011-03-08,Melaka,73,30,43,2011
2011-03-09,Melaka,59,25,34,2011
2011-03-10,Melaka,40,19,21,2011
2011-03-11,Melaka,24,8,16,2011
2011-03-12,Melaka,123,46,77,2011
2011-03-13,Melaka,20,6,14,2011
2011-03-14,Melaka,21,2,19,2011
2011-03-15,Melaka,66,33,33,2011
2011-03-16,Melaka,186,37,149,2011
2011-03-17,Melaka,0,0,0,2011
2011-03-18,Melaka,56,36,20,2011
2011-03-19,Melaka,0,0,0,2011
2011-03-20,Melaka,234,166,68,2011
2011-03-21,Melaka,0,0,0,2011
2011-03-22,Melaka,115,34,81,2011
2011-03-23,Melaka,165,77,88,2011
2011-03-24,Melaka,60,28,32,2011
2011-03-25,Melaka,17,0,17,2011
2011-03-26,Melaka,95,39,56,2011
2011-03-27,Melaka,162,44,118,2011
2011-03-28,Melaka,12,2,10,2011
2011-03-29,Melaka,49,41,8,2011
2011-03-30,Melaka,49,23,26,2011
2011-03-31,Melaka,50,28,22,2011
2011-04-01,Melaka,21,3,18,2011
2011-04-02,Melaka,14,3,11,2011
2011-04-03,Melaka,84,44,40,2011
2011-04-04,Melaka,18,4,14,2011
2011-04-05,Melaka,67,19,48,2011
2011-04-06,Melaka,90,41,49,2011
2011-04-07,Melaka,67,28,39,2011
2011-04-08,Melaka,8,0,8,2011
2011-04-09,Melaka,44,15,29,2011
2011-04-10,Melaka,349,78,271,2011
2011-04-11,Melaka,81,22,59,2011
2011-04-12,Melaka,170,44,126,2011
2011-04-13,Melaka,128,48,80,2011
2011-04-14,Melaka,80,14,66,2011
2011-04-15,Melaka,14,6,8,2011
2011-04-16,Melaka,19,7,12,2011
2011-04-17,Melaka,124,14,110,2011
2011-04-18,Melaka,56,25,31,2011
2011-04-19,Melaka,112,37,75,2011
2011-04-20,Melaka,57,29,28,2011
2011-04-21,Melaka,50,26,24,2011
2011-04-22,Melaka,51,13,38,2011
2011-04-23,Melaka,115,49,66,2011
2011-04-24,Melaka,151,19,132,2011
2011-04-25,Melaka,59,46,13,2011
2011-04-26,Melaka,84,26,58,2011
2011-04-27,Melaka,26,21,5,2011
2011-04-28,Melaka,127,41,86,2011
2011-04-29,Melaka,10,0,10,2011
2011-04-30,Melaka,59,40,19,2011
2011-05-01,Melaka,210,60,150,2011
2011-05-02,Melaka,80,23,57,2011
2011-05-03,Melaka,13,0,13,2011
2011-05-04,Melaka,119,82,37,2011
2011-05-05,Melaka,54,21,33,2011
2011-05-06,Melaka,0,0,0,2011
2011-05-07,Melaka,162,55,107,2011
2011-05-08,Melaka,204,57,147,2011
2011-05-09,Melaka,62,37,25,2011
2011-05-10,Melaka,70,31,39,2011
2011-05-11,Melaka,17,11,6,2011
2011-05-12,Melaka,120,41,79,2011
2011-05-13,Melaka,6,3,3,2011
2011-05-14,Melaka,11,6,5,2011
2011-05-15,Melaka,122,31,91,2011
2011-05-16,Melaka,19,3,16,2011
2011-05-17,Melaka,64,14,50,2011
2011-05-18,Melaka,43,14,29,2011
2011-05-19,Melaka,174,97,77,2011
2011-05-20,Melaka,8,0,8,2011
2011-05-21,Melaka,126,62,64,2011
2011-05-22,Melaka,66,34,32,2011
2011-05-23,Melaka,17,1,16,2011
2011-05-24,Melaka,117,35,82,2011
2011-05-25,Melaka,34,19,15,2011
2011-05-26,Melaka,5,0,5,2011
2011-05-27,Melaka,18,3,15,2011
2011-05-28,Melaka,33,16,17,2011
2011-05-29,Melaka,73,21,52,2011
2011-05-30,Melaka,12,2,10,2011
2011-05-31,Melaka,68,32,36,2011
2011-06-01,Melaka,95,50,45,2011
2011-06-02,Melaka,69,32,37,2011
2011-06-03,Melaka,29,5,24,2011
2011-06-04,Melaka,59,28,31,2011
2011-06-05,Melaka,57,15,42,2011
2011-06-06,Melaka,16,3,13,2011
2011-06-07,Melaka,35,4,31,2011
2011-06-08,Melaka,63,20,43,2011
2011-06-09,Melaka,55,21,34,2011
2011-06-10,Melaka,71,24,47,2011
2011-06-11,Melaka,167,77,90,2011
2011-06-12,Melaka,160,70,90,2011
2011-06-13,Melaka,15,2,13,2011
2011-06-14,Melaka,31,11,20,2011
2011-06-15,Melaka,22,5,17,2011
2011-06-16,Melaka,78,38,40,2011
2011-06-17,Melaka,14,4,10,2011
2011-06-18,Melaka,26,12,14,2011
2011-06-19,Melaka,0,0,0,2011
2011-06-20,Melaka,109,35,74,2011
2011-06-21,Melaka,208,75,133,2011
2011-06-22,Melaka,305,116,189,2011
2011-06-23,Melaka,95,34,61,2011
2011-06-24,Melaka,8,2,6,2011
2011-06-25,Melaka,80,65,15,2011
2011-06-26,Melaka,126,46,80,2011
2011-06-27,Melaka,10,2,8,2011
2011-06-28,Melaka,327,100,227,2011
2011-06-29,Melaka,9,2,7,2011
2011-06-30,Melaka,146,68,78,2011
2011-07-01,Melaka,16,5,11,2011
2011-07-02,Melaka,42,15,27,2011
2011-07-03,Melaka,175,40,135,2011
2011-07-04,Melaka,31,2,29,2011
2011-07-05,Melaka,111,56,55,2011
2011-07-06,Melaka,147,81,66,2011
2011-07-07,Melaka,228,126,102,2011
2011-07-08,Melaka,10,2,8,2011
2011-07-09,Melaka,229,203,26,2011
2011-07-10,Melaka,105,29,76,2011
2011-07-11,Melaka,54,34,20,2011
2011-07-12,Melaka,146,88,58,2011
2011-07-13,Melaka,75,33,42,2011
2011-07-14,Melaka,289,121,168,2011
2011-07-15,Melaka,4,0,4,2011
2011-07-16,Melaka,93,64,29,2011
2011-07-17,Melaka,124,33,91,2011
2011-07-18,Melaka,13,1,12,2011
2011-07-19,Melaka,134,50,84,2011
2011-07-20,Melaka,171,59,112,2011
2011-07-21,Melaka,62,36,26,2011
2011-07-22,Melaka,10,3,7,2011
2011-07-23,Melaka,52,24,28,2011
2011-07-24,Melaka,94,72,22,2011
2011-07-25,Melaka,19,3,16,2011
2011-07-26,Melaka,161,74,87,2011
2011-07-27,Melaka,101,23,78,2011
2011-07-28,Melaka,170,62,108,2011
2011-07-29,Melaka,163,56,107,2011
2011-07-30,Melaka,115,48,67,2011
2011-07-31,Melaka,213,74,139,2011
2011-08-01,Melaka,0,0,0,2011
2011-08-02,Melaka,20,6,14,2011
2011-08-03,Melaka,70,33,37,2011
2011-08-04,Melaka,68,38,30,2011
2011-08-05,Melaka,5,2,3,2011
2011-08-06,Melaka,1,0,1,2011
2011-08-07,Melaka,138,24,114,2011
2011-08-08,Melaka,9,2,7,2011
2011-08-09,Melaka,36,12,24,2011
2011-08-10,Melaka,8,0,8,2011
2011-08-11,Melaka,126,38,88,2011
2011-08-12,Melaka,56,10,46,2011
2011-08-13,Melaka,13,6,7,2011
2011-08-14,Melaka,252,39,213,2011
2011-08-15,Melaka,4,1,3,2011
2011-08-16,Melaka,79,33,46,2011
2011-08-17,Melaka,53,33,20,2011
2011-08-18,Melaka,100,35,65,2011
2011-08-19,Melaka,8,0,8,2011
2011-08-20,Melaka,50,24,26,2011
2011-08-21,Melaka,235,66,169,2011
2011-08-22,Melaka,120,62,58,2011
2011-08-23,Melaka,9,1,8,2011
2011-08-24,Melaka,65,48,17,2011
2011-08-25,Melaka,70,21,49,2011
2011-08-26,Melaka,28,16,12,2011
2011-08-27,Melaka,18,7,11,2011
2011-08-28,Melaka,224,56,168,2011
2011-08-29,Melaka,6,0,6,2011
2011-08-30,Melaka,0,0,0,2011
2011-08-31,Melaka,3,0,3,2011
2011-09-01,Melaka,0,0,0,2011
2011-09-02,Melaka,39,8,31,2011
2011-09-03,Melaka,35,16,19,2011
2011-09-04,Melaka,126,39,87,2011
2011-09-05,Melaka,16,2,14,2011
2011-09-06,Melaka,34,6,28,2011
2011-09-07,Melaka,13,1,12,2011
2011-09-08,Melaka,83,39,44,2011
2011-09-09,Melaka,168,91,77,2011
2011-09-10,Melaka,293,239,54,2011
2011-09-11,Melaka,150,27,123,2011
2011-09-12,Melaka,16,1,15,2011
2011-09-13,Melaka,110,52,58,2011
2011-09-14,Melaka,11,0,11,2011
2011-09-15,Melaka,64,30,34,2011
2011-09-16,Melaka,0,0,0,2011
2011-09-17,Melaka,109,45,64,2011
2011-09-18,Melaka,123,15,108,2011
2011-09-19,Melaka,29,4,25,2011
2011-09-20,Melaka,94,19,75,2011
2011-09-21,Melaka,81,43,38,2011
2011-09-22,Melaka,11,2,9,2011
2011-09-23,Melaka,24,2,22,2011
2011-09-24,Melaka,72,26,46,2011
2011-09-25,Melaka,176,65,111,2011
2011-09-26,Melaka,86,21,65,2011
2011-09-27,Melaka,75,10,65,2011
2011-09-28,Melaka,148,72,76,2011
2011-09-29,Melaka,154,56,98,2011
2011-09-30,Melaka,150,69,81,2011
2011-10-01,Melaka,69,37,32,2011
2011-10-02,Melaka,71,30,41,2011
2011-10-03,Melaka,39,11,28,2011
2011-10-04,Melaka,132,57,75,2011
2011-10-05,Melaka,11,2,9,2011
2011-10-06,Melaka,38,21,17,2011
2011-10-07,Melaka,125,48,77,2011
2011-10-08,Melaka,0,0,0,2011
2011-10-09,Melaka,146,20,126,2011
2011-10-10,Melaka,23,2,21,2011
2011-10-11,Melaka,268,120,148,2011
2011-10-12,Melaka,5,0,5,2011
2011-10-13,Melaka,160,51,109,2011
2011-10-14,Melaka,71,16,55,2011
2011-10-15,Melaka,90,58,32,2011
2011-10-16,Melaka,44,13,31,2011
2011-10-17,Melaka,15,3,12,2011
2011-10-18,Melaka,151,101,50,2011
2011-10-19,Melaka,21,5,16,2011
2011-10-20,Melaka,90,45,45,2011
2011-10-21,Melaka,10,1,9,2011
2011-10-22,Melaka,110,67,43,2011
2011-10-23,Melaka,74,37,37,2011
2011-10-24,Melaka,36,9,27,2011
2011-10-25,Melaka,15,2,13,2011
2011-10-26,Melaka,35,17,18,2011
2011-10-27,Melaka,18,8,10,2011
2011-10-28,Melaka,0,0,0,2011
2011-10-29,Melaka,162,59,103,2011
2011-10-30,Melaka,67,18,49,2011
2011-10-31,Melaka,4,2,2,2011
2011-11-01,Melaka,46,17,29,2011
2011-11-02,Melaka,53,20,33,2011
2011-11-03,Melaka,79,26,53,2011
2011-11-04,Melaka,71,61,10,2011
2011-11-05,Melaka,68,25,43,2011
2011-11-06,Melaka,0,0,0,2011
2011-11-07,Melaka,0,0,0,2011
2011-11-08,Melaka,102,37,65,2011
2011-11-09,Melaka,145,79,66,2011
2011-11-10,Melaka,290,134,156,2011
2011-11-11,Melaka,70,40,30,2011
2011-11-12,Melaka,123,114,9,2011
2011-11-13,Melaka,161,29,132,2011
2011-11-14,Melaka,12,0,12,2011
2011-11-15,Melaka,11,2,9,2011
2011-11-16,Melaka,58,21,37,2011
2011-11-17,Melaka,33,6,27,2011
2011-11-18,Melaka,41,12,29,2011
2011-11-19,Melaka,109,53,56,2011
2011-11-20,Melaka,54,3,51,2011
2011-11-21,Melaka,35,15,20,2011
2011-11-22,Melaka,38,17,21,2011
2011-11-23,Melaka,117,47,70,2011
2011-11-24,Melaka,67,22,45,2011
2011-11-25,Melaka,72,17,55,2011
2011-11-26,Melaka,46,26,20,2011
2011-11-27,Melaka,66,22,44,2011
2011-11-28,Melaka,0,0,0,2011
2011-11-29,Melaka,79,40,39,2011
2011-11-30,Melaka,130,52,78,2011
2011-12-01,Melaka,13,1,12,2011
2011-12-02,Melaka,32,8,24,2011
2011-12-03,Melaka,21,9,12,2011
2011-12-04,Melaka,271,27,244,2011
2011-12-05,Melaka,10,2,8,2011
2011-12-06,Melaka,63,25,38,2011
2011-12-07,Melaka,20,3,17,2011
2011-12-08,Melaka,110,33,77,2011
2011-12-09,Melaka,49,21,28,2011
2011-12-10,Melaka,61,20,41,2011
2011-12-11,Melaka,139,35,104,2011
2011-12-12,Melaka,59,7,52,2011
2011-12-13,Melaka,51,23,28,2011
2011-12-14,Melaka,98,33,65,2011
2011-12-15,Melaka,61,19,42,2011
2011-12-16,Melaka,61,24,37,2011
2011-12-17,Melaka,0,0,0,2011
2011-12-18,Melaka,39,5,34,2011
2011-12-19,Melaka,13,3,10,2011
2011-12-20,Melaka,186,40,146,2011
2011-12-21,Melaka,11,2,9,2011
2011-12-22,Melaka,33,17,16,2011
2011-12-23,Melaka,28,5,23,2011
2011-12-24,Melaka,50,23,27,2011
2011-12-25,Melaka,53,20,33,2011
2011-12-26,Melaka,0,0,0,2011
2011-12-27,Melaka,94,18,76,2011
2011-12-28,Melaka,176,68,108,2011
2011-12-29,Melaka,84,32,52,2011
2011-12-30,Melaka,9,0,9,2011
2011-12-31,Melaka,276,190,86,2011
2012-01-01,Melaka,122,42,80,2012
2012-01-02,Melaka,0,0,0,2012
2012-01-03,Melaka,42,8,34,2012
2012-01-04,Melaka,128,36,92,2012
2012-01-05,Melaka,110,22,88,2012
2012-01-06,Melaka,58,10,48,2012
2012-01-07,Melaka,25,10,15,2012
2012-01-08,Melaka,66,33,33,2012
2012-01-09,Melaka,30,5,25,2012
2012-01-10,Melaka,12,1,11,2012
2012-01-11,Melaka,269,165,104,2012
2012-01-12,Melaka,89,14,75,2012
2012-01-13,Melaka,45,26,19,2012
2012-01-14,Melaka,84,23,61,2012
2012-01-15,Melaka,65,26,39,2012
2012-01-16,Melaka,71,25,46,2012
2012-01-17,Melaka,55,14,41,2012
2012-01-18,Melaka,90,51,39,2012
2012-01-19,Melaka,286,131,155,2012
2012-01-20,Melaka,8,0,8,2012
2012-01-21,Melaka,0,0,0,2012
2012-01-22,Melaka,51,20,31,2012
2012-01-23,Melaka,48,33,15,2012
2012-01-24,Melaka,0,0,0,2012
2012-01-25,Melaka,58,26,32,2012
2012-01-26,Melaka,97,49,48,2012
2012-01-27,Melaka,80,53,27,2012
2012-01-28,Melaka,206,136,70,2012
2012-01-29,Melaka,145,74,71,2012
2012-01-30,Melaka,19,1,18,2012
2012-01-31,Melaka,25,4,21,2012
2012-02-01,Melaka,116,54,62,2012
2012-02-02,Melaka,70,35,35,2012
2012-02-03,Melaka,92,29,63,2012
2012-02-04,Melaka,33,15,18,2012
2012-02-05,Melaka,74,22,52,2012
2012-02-06,Melaka,0,0,0,2012
2012-02-07,Melaka,87,23,64,2012
2012-02-08,Melaka,84,24,60,2012
2012-02-09,Melaka,217,108,109,2012
2012-02-10,Melaka,22,4,18,2012
2012-02-11,Melaka,70,23,47,2012
2012-02-12,Melaka,24,7,17,2012
2012-02-13,Melaka,125,38,87,2012
2012-02-14,Melaka,143,66,77,2012
2012-02-15,Melaka,57,33,24,2012
2012-02-16,Melaka,104,61,43,2012
2012-02-17,Melaka,13,0,13,2012
2012-02-18,Melaka,91,82,9,2012
2012-02-19,Melaka,130,32,98,2012
2012-02-20,Melaka,44,21,23,2012
2012-02-21,Melaka,65,37,28,2012
2012-02-22,Melaka,83,45,38,2012
2012-02-23,Melaka,13,2,11,2012
2012-02-24,Melaka,18,1,17,2012
2012-02-25,Melaka,182,176,6,2012
2012-02-26,Melaka,26,13,13,2012
2012-02-27,Melaka,26,5,21,2012
2012-02-28,Melaka,98,56,42,2012
2012-02-29,Melaka,76,47,29,2012
2012-03-01,Melaka,16,2,14,2012
2012-03-02,Melaka,14,2,12,2012
2012-03-03,Melaka,153,78,75,2012
2012-03-04,Melaka,191,62,129,2012
2012-03-05,Melaka,19,11,8,2012
2012-03-06,Melaka,43,16,27,2012
2012-03-07,Melaka,95,47,48,2012
2012-03-08,Melaka,37,21,16,2012
2012-03-09,Melaka,7,1,6,2012
2012-03-10,Melaka,21,9,12,2012
2012-03-11,Melaka,0,0,0,2012
2012-03-12,Melaka,12,4,8,2012
2012-03-13,Melaka,63,28,35,2012
2012-03-14,Melaka,44,14,30,2012
2012-03-15,Melaka,72,34,38,2012
2012-03-16,Melaka,12,2,10,2012
2012-03-17,Melaka,20,9,11,2012
2012-03-18,Melaka,121,48,73,2012
2012-03-19,Melaka,127,77,50,2012
2012-03-20,Melaka,67,25,42,2012
2012-03-21,Melaka,12,3,9,2012
2012-03-22,Melaka,67,24,43,2012
2012-03-23,Melaka,27,9,18,2012
2012-03-24,Melaka,114,47,67,2012
2012-03-25,Melaka,79,32,47,2012
2012-03-26,Melaka,133,70,63,2012
2012-03-27,Melaka,10,3,7,2012
2012-03-28,Melaka,15,2,13,2012
2012-03-29,Melaka,63,26,37,2012
2012-03-30,Melaka,13,1,12,2012
2012-03-31,Melaka,122,52,70,2012
2012-04-01,Melaka,126,40,86,2012
2012-04-02,Melaka,212,27,185,2012
2012-04-03,Melaka,23,3,20,2012
2012-04-04,Melaka,116,48,68,2012
2012-04-05,Melaka,170,78,92,2012
2012-04-06,Melaka,32,22,10,2012
2012-04-07,Melaka,34,22,12,2012
2012-04-08,Melaka,114,16,98,2012
2012-04-09,Melaka,12,2,10,2012
2012-04-10,Melaka,18,3,15,2012
2012-04-11,Melaka,56,23,33,2012
2012-04-12,Melaka,118,24,94,2012
2012-04-13,Melaka,0,0,0,2012
2012-04-14,Melaka,15,8,7,2012
2012-04-15,Melaka,229,134,95,2012
2012-04-16,Melaka,0,0,0,2012
2012-04-17,Melaka,87,45,42,2012
2012-04-18,Melaka,75,38,37,2012
2012-04-19,Melaka,101,53,48,2012
2012-04-20,Melaka,11,1,10,2012
2012-04-21,Melaka,65,13,52,2012
2012-04-22,Melaka,53,20,33,2012
2012-04-23,Melaka,25,5,20,2012
2012-04-24,Melaka,61,23,38,2012
2012-04-25,Melaka,119,54,65,2012
2012-04-26,Melaka,39,26,13,2012
2012-04-27,Melaka,2,0,2,2012
2012-04-28,Melaka,64,45,19,2012
2012-04-29,Melaka,185,21,164,2012
2012-04-30,Melaka,20,1,19,2012
2012-05-01,Melaka,176,51,125,2012
2012-05-02,Melaka,67,21,46,2012
2012-05-03,Melaka,57,38,19,2012
2012-05-04,Melaka,11,1,10,2012
2012-05-05,Melaka,122,29,93,2012
2012-05-06,Melaka,250,60,190,2012
2012-05-07,Melaka,26,3,23,2012
2012-05-08,Melaka,24,4,20,2012
2012-05-09,Melaka,74,40,34,2012
2012-05-10,Melaka,87,56,31,2012
2012-05-11,Melaka,14,1,13,2012
2012-05-12,Melaka,42,26,16,2012
2012-05-13,Melaka,188,40,148,2012
2012-05-14,Melaka,10,3,7,2012
2012-05-15,Melaka,47,18,29,2012
2012-05-16,Melaka,36,17,19,2012
2012-05-17,Melaka,145,85,60,2012
2012-05-18,Melaka,30,5,25,2012
2012-05-19,Melaka,129,72,57,2012
2012-05-20,Melaka,50,16,34,2012
2012-05-21,Melaka,40,19,21,2012
2012-05-22,Melaka,94,17,77,2012
2012-05-23,Melaka,85,30,55,2012
2012-05-24,Melaka,42,18,24,2012
2012-05-25,Melaka,40,15,25,2012
2012-05-26,Melaka,99,36,63,2012
2012-05-27,Melaka,194,61,133,2012
2012-05-28,Melaka,14,3,11,2012
2012-05-29,Melaka,50,21,29,2012
2012-05-30,Melaka,85,41,44,2012
2012-05-31,Melaka,69,27,42,2012
2012-06-01,Melaka,10,0,10,2012
2012-06-02,Melaka,43,15,28,2012
2012-06-03,Melaka,116,40,76,2012
2012-06-04,Melaka,18,3,15,2012
2012-06-05,Melaka,56,23,33,2012
2012-06-06,Melaka,16,1,15,2012
2012-06-07,Melaka,82,16,66,2012
2012-06-08,Melaka,52,20,32,2012
2012-06-09,Melaka,173,87,86,2012
2012-06-10,Melaka,80,33,47,2012
2012-06-11,Melaka,72,3,69,2012
2012-06-12,Melaka,51,6,45,2012
2012-06-13,Melaka,70,41,29,2012
2012-06-14,Melaka,127,55,72,2012
2012-06-15,Melaka,17,2,15,2012
2012-06-16,Melaka,0,0,0,2012
2012-06-17,Melaka,119,39,80,2012
2012-06-18,Melaka,26,3,23,2012
2012-06-19,Melaka,171,50,121,2012
2012-06-20,Melaka,42,13,29,2012
2012-06-21,Melaka,58,20,38,2012
2012-06-22,Melaka,11,0,11,2012
2012-06-23,Melaka,166,158,8,2012
2012-06-24,Melaka,92,13,79,2012
2012-06-25,Melaka,16,2,14,2012
2012-06-26,Melaka,63,16,47,2012
2012-06-27,Melaka,91,42,49,2012
2012-06-28,Melaka,223,69,154,2012
2012-06-29,Melaka,52,36,16,2012
2012-06-30,Melaka,66,24,42,2012
2012-07-01,Melaka,71,30,41,2012
2012-07-02,Melaka,99,23,76,2012
2012-07-03,Melaka,331,121,210,2012
2012-07-04,Melaka,183,72,111,2012
2012-07-05,Melaka,68,15,53,2012
2012-07-06,Melaka,70,31,39,2012
2012-07-07,Melaka,141,124,17,2012
2012-07-08,Melaka,176,46,130,2012
2012-07-09,Melaka,81,20,61,2012
2012-07-10,Melaka,66,11,55,2012
2012-07-11,Melaka,121,37,84,2012
2012-07-12,Melaka,222,80,142,2012
2012-07-13,Melaka,93,31,62,2012
2012-07-14,Melaka,111,42,69,2012
2012-07-15,Melaka,261,72,189,2012
2012-07-16,Melaka,161,34,127,2012
2012-07-17,Melaka,171,72,99,2012
2012-07-18,Melaka,107,66,41,2012
2012-07-19,Melaka,226,91,135,2012
2012-07-20,Melaka,71,20,51,2012
2012-07-21,Melaka,66,18,48,2012
2012-07-22,Melaka,230,53,177,2012
2012-07-23,Melaka,9,1,8,2012
2012-07-24,Melaka,5,1,4,2012
2012-07-25,Melaka,47,5,42,2012
2012-07-26,Melaka,5,1,4,2012
2012-07-27,Melaka,3,2,1,2012
2012-07-28,Melaka,18,1,17,2012
2012-07-29,Melaka,172,67,105,2012
2012-07-30,Melaka,7,3,4,2012
2012-07-31,Melaka,39,14,25,2012
2012-08-01,Melaka,4,1,3,2012
2012-08-02,Melaka,99,53,46,2012
2012-08-03,Melaka,2,0,2,2012
2012-08-04,Melaka,41,10,31,2012
2012-08-05,Melaka,96,16,80,2012
2012-08-06,Melaka,27,8,19,2012
2012-08-07,Melaka,135,71,64,2012
2012-08-08,Melaka,55,32,23,2012
2012-08-09,Melaka,104,41,63,2012
2012-08-10,Melaka,3,1,2,2012
2012-08-11,Melaka,5,1,4,2012
2012-08-12,Melaka,117,22,95,2012
2012-08-13,Melaka,3,0,3,2012
2012-08-14,Melaka,88,33,55,2012
2012-08-15,Melaka,56,33,23,2012
2012-08-16,Melaka,88,36,52,2012
2012-08-17,Melaka,35,1,34,2012
2012-08-18,Melaka,5,0,5,2012
2012-08-19,Melaka,0,0,0,2012
2012-08-20,Melaka,0,0,0,2012
2012-08-21,Melaka,3,0,3,2012
2012-08-22,Melaka,19,3,16,2012
2012-08-23,Melaka,14,1,13,2012
2012-08-24,Melaka,37,12,25,2012
2012-08-25,Melaka,37,13,24,2012
2012-08-26,Melaka,227,40,187,2012
2012-08-27,Melaka,13,1,12,2012
2012-08-28,Melaka,120,49,71,2012
2012-08-29,Melaka,135,74,61,2012
2012-08-30,Melaka,24,4,20,2012
2012-08-31,Melaka,14,6,8,2012
2012-09-01,Melaka,56,23,33,2012
2012-09-02,Melaka,184,40,144,2012
2012-09-03,Melaka,20,4,16,2012
2012-09-04,Melaka,74,24,50,2012
2012-09-05,Melaka,81,27,54,2012
2012-09-06,Melaka,59,26,33,2012
2012-09-07,Melaka,113,42,71,2012
2012-09-08,Melaka,2,0,2,2012
2012-09-09,Melaka,106,22,84,2012
2012-09-10,Melaka,98,38,60,2012
2012-09-11,Melaka,292,198,94,2012
2012-09-12,Melaka,85,51,34,2012
2012-09-13,Melaka,57,23,34,2012
2012-09-14,Melaka,272,234,38,2012
2012-09-15,Melaka,66,27,39,2012
2012-09-16,Melaka,119,22,97,2012
2012-09-17,Melaka,20,3,17,2012
2012-09-18,Melaka,23,2,21,2012
2012-09-19,Melaka,20,2,18,2012
2012-09-20,Melaka,62,36,26,2012
2012-09-21,Melaka,17,3,14,2012
2012-09-22,Melaka,65,16,49,2012
2012-09-23,Melaka,0,0,0,2012
2012-09-24,Melaka,41,20,21,2012
2012-09-25,Melaka,194,81,113,2012
2012-09-26,Melaka,161,54,107,2012
2012-09-27,Melaka,170,70,100,2012
2012-09-28,Melaka,217,132,85,2012
2012-09-29,Melaka,63,15,48,2012
2012-09-30,Melaka,115,17,98,2012
2012-10-01,Melaka,21,3,18,2012
2012-10-02,Melaka,50,11,39,2012
2012-10-03,Melaka,14,1,13,2012
2012-10-04,Melaka,39,17,22,2012
2012-10-05,Melaka,10,2,8,2012
2012-10-06,Melaka,111,44,67,2012
2012-10-07,Melaka,208,99,109,2012
2012-10-08,Melaka,59,9,50,2012
2012-10-09,Melaka,3,0,3,2012
2012-10-10,Melaka,30,8,22,2012
2012-10-11,Melaka,93,20,73,2012
2012-10-12,Melaka,17,1,16,2012
2012-10-13,Melaka,72,17,55,2012
2012-10-14,Melaka,64,23,41,2012
2012-10-15,Melaka,11,2,9,2012
2012-10-16,Melaka,99,60,39,2012
2012-10-17,Melaka,167,46,121,2012
2012-10-18,Melaka,73,7,66,2012
2012-10-19,Melaka,11,1,10,2012
2012-10-20,Melaka,77,38,39,2012
2012-10-21,Melaka,256,57,199,2012
2012-10-22,Melaka,41,9,32,2012
2012-10-23,Melaka,77,17,60,2012
2012-10-24,Melaka,26,14,12,2012
2012-10-25,Melaka,81,26,55,2012
2012-10-26,Melaka,0,0,0,2012
2012-10-27,Melaka,62,21,41,2012
2012-10-28,Melaka,149,45,104,2012
2012-10-29,Melaka,32,7,25,2012
2012-10-30,Melaka,40,7,33,2012
2012-10-31,Melaka,11,0,11,2012
2012-11-01,Melaka,15,1,14,2012
2012-11-02,Melaka,47,15,32,2012
2012-11-03,Melaka,58,21,37,2012
2012-11-04,Melaka,239,87,152,2012
2012-11-05,Melaka,18,1,17,2012
2012-11-06,Melaka,103,29,74,2012
2012-11-07,Melaka,233,92,141,2012
2012-11-08,Melaka,142,58,84,2012
2012-11-09,Melaka,8,1,7,2012
2012-11-10,Melaka,65,18,47,2012
2012-11-11,Melaka,30,8,22,2012
2012-11-12,Melaka,59,15,44,2012
2012-11-13,Melaka,0,0,0,2012
2012-11-14,Melaka,25,6,19,2012
2012-11-15,Melaka,0,0,0,2012
2012-11-16,Melaka,153,130,23,2012
2012-11-17,Melaka,93,56,37,2012
2012-11-18,Melaka,106,9,97,2012
2012-11-19,Melaka,14,2,12,2012
2012-11-20,Melaka,92,37,55,2012
2012-11-21,Melaka,175,66,109,2012
2012-11-22,Melaka,97,28,69,2012
2012-11-23,Melaka,172,40,132,2012
2012-11-24,Melaka,118,35,83,2012
2012-11-25,Melaka,174,41,133,2012
2012-11-26,Melaka,153,86,67,2012
2012-11-27,Melaka,99,36,63,2012
2012-11-28,Melaka,92,28,64,2012
2012-11-29,Melaka,28,14,14,2012
2012-11-30,Melaka,9,3,6,2012
2012-12-01,Melaka,56,27,29,2012
2012-12-02,Melaka,120,13,107,2012
2012-12-03,Melaka,81,20,61,2012
2012-12-04,Melaka,151,63,88,2012
2012-12-05,Melaka,155,66,89,2012
2012-12-06,Melaka,62,22,40,2012
2012-12-07,Melaka,8,3,5,2012
2012-12-08,Melaka,9,5,4,2012
2012-12-09,Melaka,265,43,222,2012
2012-12-10,Melaka,27,5,22,2012
2012-12-11,Melaka,65,30,35,2012
2012-12-12,Melaka,9,1,8,2012
2012-12-13,Melaka,88,23,65,2012
2012-12-14,Melaka,12,2,10,2012
2012-12-15,Melaka,60,25,35,2012
2012-12-16,Melaka,26,5,21,2012
2012-12-17,Melaka,13,0,13,2012
2012-12-18,Melaka,76,29,47,2012
2012-12-19,Melaka,154,78,76,2012
2012-12-20,Melaka,172,79,93,2012
2012-12-21,Melaka,10,1,9,2012
2012-12-22,Melaka,22,14,8,2012
2012-12-23,Melaka,101,21,80,2012
2012-12-24,Melaka,16,1,15,2012
2012-12-25,Melaka,53,30,23,2012
2012-12-26,Melaka,39,10,29,2012
2012-12-27,Melaka,29,9,20,2012
2012-12-28,Melaka,36,7,29,2012
2012-12-29,Melaka,137,33,104,2012
2012-12-30,Melaka,88,27,61,2012
2012-12-31,Melaka,43,14,29,2012
2013-01-01,Melaka,61,31,30,2013
2013-01-02,Melaka,17,4,13,2013
2013-01-03,Melaka,26,3,23,2013
2013-01-04,Melaka,17,3,14,2013
2013-01-05,Melaka,42,3,39,2013
2013-01-06,Melaka,54,22,32,2013
2013-01-07,Melaka,63,24,39,2013
2013-01-08,Melaka,72,22,50,2013
2013-01-09,Melaka,101,45,56,2013
2013-01-10,Melaka,85,40,45,2013
2013-01-11,Melaka,252,102,150,2013
2013-01-12,Melaka,189,103,86,2013
2013-01-13,Melaka,61,22,39,2013
2013-01-14,Melaka,37,11,26,2013
2013-01-15,Melaka,130,62,68,2013
2013-01-16,Melaka,13,0,13,2013
2013-01-17,Melaka,110,39,71,2013
2013-01-18,Melaka,249,165,84,2013
2013-01-19,Melaka,102,42,60,2013
2013-01-20,Melaka,15,7,8,2013
2013-01-21,Melaka,247,130,117,2013
2013-01-22,Melaka,15,2,13,2013
2013-01-23,Melaka,114,54,60,2013
2013-01-24,Melaka,14,7,7,2013
2013-01-25,Melaka,127,48,79,2013
2013-01-26,Melaka,163,68,95,2013
2013-01-27,Melaka,77,33,44,2013
2013-01-28,Melaka,21,3,18,2013
2013-01-29,Melaka,100,40,60,2013
2013-01-30,Melaka,197,103,94,2013
2013-01-31,Melaka,9,0,9,2013
2013-02-01,Melaka,64,17,47,2013
2013-02-02,Melaka,100,57,43,2013
2013-02-03,Melaka,72,32,40,2013
2013-02-04,Melaka,31,4,27,2013
2013-02-05,Melaka,19,2,17,2013
2013-02-06,Melaka,83,22,61,2013
2013-02-07,Melaka,80,26,54,2013
2013-02-08,Melaka,50,14,36,2013
2013-02-09,Melaka,88,35,53,2013
2013-02-10,Melaka,0,0,0,2013
2013-02-11,Melaka,88,36,52,2013
2013-02-12,Melaka,68,26,42,2013
2013-02-13,Melaka,10,1,9,2013
2013-02-14,Melaka,27,6,21,2013
2013-02-15,Melaka,124,62,62,2013
2013-02-16,Melaka,67,27,40,2013
2013-02-17,Melaka,40,21,19,2013
2013-02-18,Melaka,43,14,29,2013
2013-02-19,Melaka,176,117,59,2013
2013-02-20,Melaka,164,87,77,2013
2013-02-21,Melaka,181,85,96,2013
2013-02-22,Melaka,39,17,22,2013
2013-02-23,Melaka,106,94,12,2013
2013-02-24,Melaka,54,22,32,2013
2013-02-25,Melaka,24,3,21,2013
2013-02-26,Melaka,159,71,88,2013
2013-02-27,Melaka,147,93,54,2013
2013-02-28,Melaka,18,0,18,2013
2013-03-01,Melaka,13,2,11,2013
2013-03-02,Melaka,202,107,95,2013
2013-03-03,Melaka,220,86,134,2013
2013-03-04,Melaka,16,0,16,2013
2013-03-05,Melaka,73,31,42,2013
2013-03-06,Melaka,74,33,41,2013
2013-03-07,Melaka,127,79,48,2013
2013-03-08,Melaka,143,116,27,2013
2013-03-09,Melaka,106,101,5,2013
2013-03-10,Melaka,95,18,77,2013
2013-03-11,Melaka,20,5,15,2013
2013-03-12,Melaka,10,3,7,2013
2013-03-13,Melaka,0,0,0,2013
2013-03-14,Melaka,42,13,29,2013
2013-03-15,Melaka,85,45,40,2013
2013-03-16,Melaka,44,13,31,2013
2013-03-17,Melaka,58,20,38,2013
2013-03-18,Melaka,21,4,17,2013
2013-03-19,Melaka,81,35,46,2013
2013-03-20,Melaka,167,67,100,2013
2013-03-21,Melaka,196,76,120,2013
2013-03-22,Melaka,33,14,19,2013
2013-03-23,Melaka,111,50,61,2013
2013-03-24,Melaka,164,73,91,2013
2013-03-25,Melaka,17,2,15,2013
2013-03-26,Melaka,71,20,51,2013
2013-03-27,Melaka,102,61,41,2013
2013-03-28,Melaka,97,31,66,2013
2013-03-29,Melaka,56,15,41,2013
2013-03-30,Melaka,76,32,44,2013
2013-03-31,Melaka,124,66,58,2013
2013-04-01,Melaka,13,0,13,2013
2013-04-02,Melaka,43,20,23,2013
2013-04-03,Melaka,48,31,17,2013
2013-04-04,Melaka,48,14,34,2013
2013-04-05,Melaka,15,3,12,2013
2013-04-06,Melaka,79,42,37,2013
2013-04-07,Melaka,160,55,105,2013
2013-04-08,Melaka,11,0,11,2013
2013-04-09,Melaka,40,20,20,2013
2013-04-10,Melaka,49,11,38,2013
2013-04-11,Melaka,211,49,162,2013
2013-04-12,Melaka,66,19,47,2013
2013-04-13,Melaka,40,15,25,2013
2013-04-14,Melaka,36,13,23,2013
2013-04-15,Melaka,83,42,41,2013
2013-04-16,Melaka,18,0,18,2013
2013-04-17,Melaka,39,13,26,2013
2013-04-18,Melaka,178,62,116,2013
2013-04-19,Melaka,11,2,9,2013
2013-04-20,Melaka,159,71,88,2013
2013-04-21,Melaka,107,20,87,2013
2013-04-22,Melaka,56,32,24,2013
2013-04-23,Melaka,72,50,22,2013
2013-04-24,Melaka,59,32,27,2013
2013-04-25,Melaka,54,32,22,2013
2013-04-26,Melaka,65,19,46,2013
2013-04-27,Melaka,74,29,45,2013
2013-04-28,Melaka,61,13,48,2013
2013-04-29,Melaka,24,1,23,2013
2013-04-30,Melaka,65,30,35,2013
2013-05-01,Melaka,116,25,91,2013
2013-05-02,Melaka,44,29,15,2013
2013-05-03,Melaka,14,3,11,2013
2013-05-04,Melaka,38,10,28,2013
2013-05-05,Melaka,0,0,0,2013
2013-05-06,Melaka,50,20,30,2013
2013-05-07,Melaka,75,39,36,2013
2013-05-08,Melaka,180,75,105,2013
2013-05-09,Melaka,248,142,106,2013
2013-05-10,Melaka,14,1,13,2013
2013-05-11,Melaka,70,41,29,2013
2013-05-12,Melaka,97,42,55,2013
2013-05-13,Melaka,64,10,54,2013
2013-05-14,Melaka,144,72,72,2013
2013-05-15,Melaka,181,91,90,2013
2013-05-16,Melaka,206,73,133,2013
2013-05-17,Melaka,157,99,58,2013
2013-05-18,Melaka,32,30,2,2013
2013-05-19,Melaka,238,42,196,2013
2013-05-20,Melaka,17,4,13,2013
2013-05-21,Melaka,94,23,71,2013
2013-05-22,Melaka,139,54,85,2013
2013-05-23,Melaka,17,3,14,2013
2013-05-24,Melaka,116,31,85,2013
2013-05-25,Melaka,98,42,56,2013
2013-05-26,Melaka,298,38,260,2013
2013-05-27,Melaka,129,47,82,2013
2013-05-28,Melaka,116,50,66,2013
2013-05-29,Melaka,12,2,10,2013
2013-05-30,Melaka,75,26,49,2013
2013-05-31,Melaka,138,53,85,2013
2013-06-01,Melaka,16,3,13,2013
2013-06-02,Melaka,273,69,204,2013
2013-06-03,Melaka,10,0,10,2013
2013-06-04,Melaka,86,22,64,2013
2013-06-05,Melaka,16,6,10,2013
2013-06-06,Melaka,48,17,31,2013
2013-06-07,Melaka,30,6,24,2013
2013-06-08,Melaka,86,30,56,2013
2013-06-09,Melaka,20,9,11,2013
2013-06-10,Melaka,72,30,42,2013
2013-06-11,Melaka,9,0,9,2013
2013-06-12,Melaka,42,18,24,2013
2013-06-13,Melaka,93,38,55,2013
2013-06-14,Melaka,8,0,8,2013
2013-06-15,Melaka,0,0,0,2013
2013-06-16,Melaka,94,14,80,2013
2013-06-17,Melaka,99,73,26,2013
2013-06-18,Melaka,181,46,135,2013
2013-06-19,Melaka,37,18,19,2013
2013-06-20,Melaka,127,63,64,2013
2013-06-21,Melaka,338,94,244,2013
2013-06-22,Melaka,93,36,57,2013
2013-06-23,Melaka,60,14,46,2013
2013-06-24,Melaka,39,7,32,2013
2013-06-25,Melaka,16,2,14,2013
2013-06-26,Melaka,16,0,16,2013
2013-06-27,Melaka,30,9,21,2013
2013-06-28,Melaka,68,12,56,2013
2013-06-29,Melaka,80,28,52,2013
2013-06-30,Melaka,146,31,115,2013
2013-07-01,Melaka,34,3,31,2013
2013-07-02,Melaka,48,11,37,2013
2013-07-03,Melaka,66,20,46,2013
2013-07-04,Melaka,126,28,98,2013
2013-07-05,Melaka,121,43,78,2013
2013-07-06,Melaka,132,57,75,2013
2013-07-07,Melaka,206,74,132,2013
2013-07-08,Melaka,93,35,58,2013
2013-07-09,Melaka,111,41,70,2013
2013-07-10,Melaka,0,0,0,2013
2013-07-11,Melaka,11,0,11,2013
2013-07-12,Melaka,10,5,5,2013
2013-07-13,Melaka,37,8,29,2013
2013-07-14,Melaka,225,36,189,2013
2013-07-15,Melaka,6,0,6,2013
2013-07-16,Melaka,73,24,49,2013
2013-07-17,Melaka,8,0,8,2013
2013-07-18,Melaka,3,0,3,2013
2013-07-19,Melaka,74,36,38,2013
2013-07-20,Melaka,0,0,0,2013
2013-07-21,Melaka,118,22,96,2013
2013-07-22,Melaka,130,66,64,2013
2013-07-23,Melaka,171,86,85,2013
2013-07-24,Melaka,229,131,98,2013
2013-07-25,Melaka,111,55,56,2013
2013-07-26,Melaka,9,1,8,2013
2013-07-27,Melaka,53,23,30,2013
2013-07-28,Melaka,179,66,113,2013
2013-07-29,Melaka,6,1,5,2013
2013-07-30,Melaka,58,42,16,2013
2013-07-31,Melaka,223,97,126,2013
2013-08-01,Melaka,66,53,13,2013
2013-08-02,Melaka,3,0,3,2013
2013-08-03,Melaka,0,0,0,2013
2013-08-04,Melaka,106,15,91,2013
2013-08-05,Melaka,3,0,3,2013
2013-08-06,Melaka,49,24,25,2013
2013-08-07,Melaka,11,3,8,2013
2013-08-08,Melaka,0,0,0,2013
2013-08-09,Melaka,5,0,5,2013
2013-08-10,Melaka,3,0,3,2013
2013-08-11,Melaka,42,9,33,2013
2013-08-12,Melaka,0,0,0,2013
2013-08-13,Melaka,43,16,27,2013
2013-08-14,Melaka,47,16,31,2013
2013-08-15,Melaka,13,0,13,2013
2013-08-16,Melaka,310,217,93,2013
2013-08-17,Melaka,42,17,25,2013
2013-08-18,Melaka,212,34,178,2013
2013-08-19,Melaka,28,6,22,2013
2013-08-20,Melaka,59,11,48,2013
2013-08-21,Melaka,40,9,31,2013
2013-08-22,Melaka,97,39,58,2013
2013-08-23,Melaka,13,0,13,2013
2013-08-24,Melaka,94,22,72,2013
2013-08-25,Melaka,53,10,43,2013
2013-08-26,Melaka,84,20,64,2013
2013-08-27,Melaka,43,13,30,2013
2013-08-28,Melaka,124,52,72,2013
2013-08-29,Melaka,44,10,34,2013
2013-08-30,Melaka,5,0,5,2013
2013-08-31,Melaka,206,63,143,2013
2013-09-01,Melaka,72,24,48,2013
2013-09-02,Melaka,12,1,11,2013
2013-09-03,Melaka,87,60,27,2013
2013-09-04,Melaka,91,69,22,2013
2013-09-05,Melaka,114,48,66,2013
2013-09-06,Melaka,16,1,15,2013
2013-09-07,Melaka,51,22,29,2013
2013-09-08,Melaka,68,7,61,2013
2013-09-09,Melaka,12,2,10,2013
2013-09-10,Melaka,110,27,83,2013
2013-09-11,Melaka,201,63,138,2013
2013-09-12,Melaka,123,25,98,2013
2013-09-13,Melaka,16,1,15,2013
2013-09-14,Melaka,19,3,16,2013
2013-09-15,Melaka,92,21,71,2013
2013-09-16,Melaka,93,44,49,2013
2013-09-17,Melaka,20,2,18,2013
2013-09-18,Melaka,112,40,72,2013
2013-09-19,Melaka,117,60,57,2013
2013-09-20,Melaka,11,2,9,2013
2013-09-21,Melaka,178,103,75,2013
2013-09-22,Melaka,150,23,127,2013
2013-09-23,Melaka,29,3,26,2013
2013-09-24,Melaka,157,76,81,2013
2013-09-25,Melaka,183,78,105,2013
2013-09-26,Melaka,115,36,79,2013
2013-09-27,Melaka,58,24,34,2013
2013-09-28,Melaka,139,50,89,2013
2013-09-29,Melaka,110,27,83,2013
2013-09-30,Melaka,13,2,11,2013
2013-10-01,Melaka,42,8,34,2013
2013-10-02,Melaka,33,7,26,2013
2013-10-03,Melaka,80,34,46,2013
2013-10-04,Melaka,0,0,0,2013
2013-10-05,Melaka,134,81,53,2013
2013-10-06,Melaka,147,40,107,2013
2013-10-07,Melaka,38,8,30,2013
2013-10-08,Melaka,18,1,17,2013
2013-10-09,Melaka,73,19,54,2013
2013-10-10,Melaka,79,35,44,2013
2013-10-11,Melaka,111,92,19,2013
2013-10-12,Melaka,97,89,8,2013
2013-10-13,Melaka,424,174,250,2013
2013-10-14,Melaka,18,2,16,2013
2013-10-15,Melaka,0,0,0,2013
2013-10-16,Melaka,44,13,31,2013
2013-10-17,Melaka,49,21,28,2013
2013-10-18,Melaka,62,10,52,2013
2013-10-19,Melaka,98,52,46,2013
2013-10-20,Melaka,239,44,195,2013
2013-10-21,Melaka,41,7,34,2013
2013-10-22,Melaka,29,14,15,2013
2013-10-23,Melaka,25,5,20,2013
2013-10-24,Melaka,0,0,0,2013
2013-10-25,Melaka,176,107,69,2013
2013-10-26,Melaka,73,23,50,2013
2013-10-27,Melaka,97,22,75,2013
2013-10-28,Melaka,78,14,64,2013
2013-10-29,Melaka,72,23,49,2013
2013-10-30,Melaka,240,51,189,2013
2013-10-31,Melaka,61,22,39,2013
2013-11-01,Melaka,112,56,56,2013
2013-11-02,Melaka,35,14,21,2013
2013-11-03,Melaka,77,26,51,2013
2013-11-04,Melaka,37,4,33,2013
2013-11-05,Melaka,0,0,0,2013
2013-11-06,Melaka,111,46,65,2013
2013-11-07,Melaka,54,15,39,2013
2013-11-08,Melaka,117,48,69,2013
2013-11-09,Melaka,50,23,27,2013
2013-11-10,Melaka,89,13,76,2013
2013-11-11,Melaka,14,2,12,2013
2013-11-12,Melaka,31,6,25,2013
2013-11-13,Melaka,76,22,54,2013
2013-11-14,Melaka,93,35,58,2013
2013-11-15,Melaka,10,2,8,2013
2013-11-16,Melaka,24,15,9,2013
2013-11-17,Melaka,138,23,115,2013
2013-11-18,Melaka,61,8,53,2013
2013-11-19,Melaka,97,26,71,2013
2013-11-20,Melaka,180,52,128,2013
2013-11-21,Melaka,92,46,46,2013
2013-11-22,Melaka,11,2,9,2013
2013-11-23,Melaka,35,17,18,2013
2013-11-24,Melaka,96,36,60,2013
2013-11-25,Melaka,9,0,9,2013
2013-11-26,Melaka,46,11,35,2013
2013-11-27,Melaka,25,1,24,2013
2013-11-28,Melaka,59,12,47,2013
2013-11-29,Melaka,23,5,18,2013
2013-11-30,Melaka,33,11,22,2013
2013-12-01,Melaka,55,29,26,2013
2013-12-02,Melaka,40,15,25,2013
2013-12-03,Melaka,25,5,20,2013
2013-12-04,Melaka,18,2,16,2013
2013-12-05,Melaka,151,65,86,2013
2013-12-06,Melaka,37,9,28,2013
2013-12-07,Melaka,89,35,54,2013
2013-12-08,Melaka,392,56,336,2013
2013-12-09,Melaka,48,29,19,2013
2013-12-10,Melaka,141,84,57,2013
2013-12-11,Melaka,189,79,110,2013
2013-12-12,Melaka,22,3,19,2013
2013-12-13,Melaka,52,24,28,2013
2013-12-14,Melaka,51,21,30,2013
2013-12-15,Melaka,68,12,56,2013
2013-12-16,Melaka,13,0,13,2013
2013-12-17,Melaka,54,17,37,2013
2013-12-18,Melaka,50,10,40,2013
2013-12-19,Melaka,97,21,76,2013
2013-12-20,Melaka,3,0,3,2013
2013-12-21,Melaka,56,17,39,2013
2013-12-22,Melaka,145,20,125,2013
2013-12-23,Melaka,69,17,52,2013
2013-12-24,Melaka,173,67,106,2013
2013-12-25,Melaka,0,0,0,2013
2013-12-26,Melaka,84,21,63,2013
2013-12-27,Melaka,22,3,19,2013
2013-12-28,Melaka,57,25,32,2013
2013-12-29,Melaka,163,75,88,2013
2013-12-30,Melaka,165,99,66,2013
2013-12-31,Melaka,49,9,40,2013
2014-01-01,Melaka,95,37,58,2014
2014-01-02,Melaka,10,2,8,2014
2014-01-03,Melaka,76,33,43,2014
2014-01-04,Melaka,107,42,65,2014
2014-01-05,Melaka,83,25,58,2014
2014-01-06,Melaka,16,2,14,2014
2014-01-07,Melaka,148,61,87,2014
2014-01-08,Melaka,226,116,110,2014
2014-01-09,Melaka,12,1,11,2014
2014-01-10,Melaka,135,40,95,2014
2014-01-11,Melaka,146,63,83,2014
2014-01-12,Melaka,69,14,55,2014
2014-01-13,Melaka,66,10,56,2014
2014-01-14,Melaka,0,0,0,2014
2014-01-15,Melaka,77,42,35,2014
2014-01-16,Melaka,161,27,134,2014
2014-01-17,Melaka,37,14,23,2014
2014-01-18,Melaka,107,35,72,2014
2014-01-19,Melaka,94,32,62,2014
2014-01-20,Melaka,139,63,76,2014
2014-01-21,Melaka,42,21,21,2014
2014-01-22,Melaka,87,57,30,2014
2014-01-23,Melaka,57,13,44,2014
2014-01-24,Melaka,102,60,42,2014
2014-01-25,Melaka,55,22,33,2014
2014-01-26,Melaka,80,25,55,2014
2014-01-27,Melaka,102,61,41,2014
2014-01-28,Melaka,31,3,28,2014
2014-01-29,Melaka,175,84,91,2014
2014-01-30,Melaka,45,30,15,2014
2014-01-31,Melaka,46,16,30,2014
2014-02-01,Melaka,58,24,34,2014
2014-02-02,Melaka,43,14,29,2014
2014-02-03,Melaka,17,0,17,2014
2014-02-04,Melaka,54,28,26,2014
2014-02-05,Melaka,46,13,33,2014
2014-02-06,Melaka,74,26,48,2014
2014-02-07,Melaka,14,1,13,2014
2014-02-08,Melaka,72,18,54,2014
2014-02-09,Melaka,83,32,51,2014
2014-02-10,Melaka,11,0,11,2014
2014-02-11,Melaka,10,0,10,2014
2014-02-12,Melaka,59,34,25,2014
2014-02-13,Melaka,163,96,67,2014
2014-02-14,Melaka,275,173,102,2014
2014-02-15,Melaka,98,64,34,2014
2014-02-16,Melaka,76,27,49,2014
2014-02-17,Melaka,9,0,9,2014
2014-02-18,Melaka,52,19,33,2014
2014-02-19,Melaka,29,4,25,2014
2014-02-20,Melaka,73,28,45,2014
2014-02-21,Melaka,12,0,12,2014
2014-02-22,Melaka,47,16,31,2014
2014-02-23,Melaka,156,34,122,2014
2014-02-24,Melaka,168,82,86,2014
2014-02-25,Melaka,139,57,82,2014
2014-02-26,Melaka,149,55,94,2014
2014-02-27,Melaka,114,50,64,2014
2014-02-28,Melaka,159,47,112,2014
2014-03-01,Melaka,31,18,13,2014
2014-03-02,Melaka,125,19,106,2014
2014-03-03,Melaka,57,23,34,2014
2014-03-04,Melaka,18,0,18,2014
2014-03-05,Melaka,40,8,32,2014
2014-03-06,Melaka,11,1,10,2014
2014-03-07,Melaka,87,72,15,2014
2014-03-08,Melaka,194,112,82,2014
2014-03-09,Melaka,225,83,142,2014
2014-03-10,Melaka,12,0,12,2014
2014-03-11,Melaka,152,46,106,2014
2014-03-12,Melaka,198,80,118,2014
2014-03-13,Melaka,111,52,59,2014
2014-03-14,Melaka,62,10,52,2014
2014-03-15,Melaka,177,167,10,2014
2014-03-16,Melaka,99,23,76,2014
2014-03-17,Melaka,175,62,113,2014
2014-03-18,Melaka,100,63,37,2014
2014-03-19,Melaka,11,0,11,2014
2014-03-20,Melaka,94,31,63,2014
2014-03-21,Melaka,96,28,68,2014
2014-03-22,Melaka,129,35,94,2014
2014-03-23,Melaka,77,16,61,2014
2014-03-24,Melaka,22,2,20,2014
2014-03-25,Melaka,46,15,31,2014
2014-03-26,Melaka,10,1,9,2014
2014-03-27,Melaka,90,29,61,2014
2014-03-28,Melaka,14,0,14,2014
2014-03-29,Melaka,235,142,93,2014
2014-03-30,Melaka,83,22,61,2014
2014-03-31,Melaka,20,1,19,2014
2014-04-01,Melaka,226,72,154,2014
2014-04-02,Melaka,53,9,44,2014
2014-04-03,Melaka,11,2,9,2014
2014-04-04,Melaka,6,1,5,2014
2014-04-05,Melaka,90,39,51,2014
2014-04-06,Melaka,80,25,55,2014
2014-04-07,Melaka,37,10,27,2014
2014-04-08,Melaka,19,2,17,2014
2014-04-09,Melaka,148,31,117,2014
2014-04-10,Melaka,14,2,12,2014
2014-04-11,Melaka,71,22,49,2014
2014-04-12,Melaka,67,26,41,2014
2014-04-13,Melaka,0,0,0,2014
2014-04-14,Melaka,16,4,12,2014
2014-04-15,Melaka,47,9,38,2014
2014-04-16,Melaka,40,20,20,2014
2014-04-17,Melaka,51,16,35,2014
2014-04-18,Melaka,10,3,7,2014
2014-04-19,Melaka,41,14,27,2014
2014-04-20,Melaka,199,34,165,2014
2014-04-21,Melaka,63,33,30,2014
2014-04-22,Melaka,61,24,37,2014
2014-04-23,Melaka,37,19,18,2014
2014-04-24,Melaka,149,59,90,2014
2014-04-25,Melaka,56,10,46,2014
2014-04-26,Melaka,55,27,28,2014
2014-04-27,Melaka,71,17,54,2014
2014-04-28,Melaka,93,42,51,2014
2014-04-29,Melaka,101,56,45,2014
2014-04-30,Melaka,81,46,35,2014
2014-05-01,Melaka,121,26,95,2014
2014-05-02,Melaka,11,4,7,2014
2014-05-03,Melaka,30,8,22,2014
2014-05-04,Melaka,172,38,134,2014
2014-05-05,Melaka,21,2,19,2014
2014-05-06,Melaka,28,11,17,2014
2014-05-07,Melaka,48,41,7,2014
2014-05-08,Melaka,114,57,57,2014
2014-05-09,Melaka,25,9,16,2014
2014-05-10,Melaka,65,15,50,2014
2014-05-11,Melaka,176,28,148,2014
2014-05-12,Melaka,95,37,58,2014
2014-05-13,Melaka,57,12,45,2014
2014-05-14,Melaka,83,42,41,2014
2014-05-15,Melaka,168,136,32,2014
2014-05-16,Melaka,15,1,14,2014
2014-05-17,Melaka,76,28,48,2014
2014-05-18,Melaka,316,50,266,2014
2014-05-19,Melaka,46,9,37,2014
2014-05-20,Melaka,59,14,45,2014
2014-05-21,Melaka,16,2,14,2014
2014-05-22,Melaka,75,12,63,2014
2014-05-23,Melaka,8,2,6,2014
2014-05-24,Melaka,129,58,71,2014
2014-05-25,Melaka,174,44,130,2014
2014-05-26,Melaka,128,41,87,2014
2014-05-27,Melaka,111,40,71,2014
2014-05-28,Melaka,66,11,55,2014
2014-05-29,Melaka,129,34,95,2014
2014-05-30,Melaka,36,10,26,2014
2014-05-31,Melaka,81,28,53,2014
2014-06-01,Melaka,97,36,61,2014
2014-06-02,Melaka,19,1,18,2014
2014-06-03,Melaka,35,12,23,2014
2014-06-04,Melaka,15,2,13,2014
2014-06-05,Melaka,25,8,17,2014
2014-06-06,Melaka,78,21,57,2014
2014-06-07,Melaka,82,73,9,2014
2014-06-08,Melaka,42,16,26,2014
2014-06-09,Melaka,14,4,10,2014
2014-06-10,Melaka,55,10,45,2014
2014-06-11,Melaka,72,22,50,2014
2014-06-12,Melaka,102,28,74,2014
2014-06-13,Melaka,17,0,17,2014
2014-06-14,Melaka,0,0,0,2014
2014-06-15,Melaka,75,12,63,2014
2014-06-16,Melaka,61,25,36,2014
2014-06-17,Melaka,98,48,50,2014
2014-06-18,Melaka,195,60,135,2014
2014-06-19,Melaka,30,2,28,2014
2014-06-20,Melaka,20,4,16,2014
2014-06-21,Melaka,136,87,49,2014
2014-06-22,Melaka,248,41,207,2014
2014-06-23,Melaka,114,67,47,2014
2014-06-24,Melaka,137,88,49,2014
2014-06-25,Melaka,70,8,62,2014
2014-06-26,Melaka,84,17,67,2014
2014-06-27,Melaka,85,21,64,2014
2014-06-28,Melaka,93,21,72,2014
2014-06-29,Melaka,0,0,0,2014
2014-06-30,Melaka,24,4,20,2014
2014-07-01,Melaka,84,29,55,2014
2014-07-02,Melaka,121,53,68,2014
2014-07-03,Melaka,163,74,89,2014
2014-07-04,Melaka,8,0,8,2014
2014-07-05,Melaka,2,0,2,2014
2014-07-06,Melaka,96,20,76,2014
2014-07-07,Melaka,35,6,29,2014
2014-07-08,Melaka,40,14,26,2014
2014-07-09,Melaka,37,23,14,2014
2014-07-10,Melaka,119,81,38,2014
2014-07-11,Melaka,66,31,35,2014
2014-07-12,Melaka,0,0,0,2014
2014-07-13,Melaka,95,14,81,2014
2014-07-14,Melaka,108,63,45,2014
2014-07-15,Melaka,9,0,9,2014
2014-07-16,Melaka,74,33,41,2014
2014-07-17,Melaka,73,50,23,2014
2014-07-18,Melaka,272,242,30,2014
2014-07-19,Melaka,23,8,15,2014
2014-07-20,Melaka,180,65,115,2014
2014-07-21,Melaka,11,1,10,2014
2014-07-22,Melaka,40,9,31,2014
2014-07-23,Melaka,44,12,32,2014
2014-07-24,Melaka,63,16,47,2014
2014-07-25,Melaka,27,9,18,2014
2014-07-26,Melaka,3,0,3,2014
2014-07-27,Melaka,149,26,123,2014
2014-07-28,Melaka,0,0,0,2014
2014-07-29,Melaka,3,0,3,2014
2014-07-30,Melaka,36,12,24,2014
2014-07-31,Melaka,42,12,30,2014
2014-08-01,Melaka,9,0,9,2014
2014-08-02,Melaka,0,0,0,2014
2014-08-03,Melaka,46,12,34,2014
2014-08-04,Melaka,37,7,30,2014
2014-08-05,Melaka,11,0,11,2014
2014-08-06,Melaka,12,3,9,2014
2014-08-07,Melaka,108,50,58,2014
2014-08-08,Melaka,68,33,35,2014
2014-08-09,Melaka,62,19,43,2014
2014-08-10,Melaka,244,108,136,2014
2014-08-11,Melaka,19,2,17,2014
2014-08-12,Melaka,116,55,61,2014
2014-08-13,Melaka,62,9,53,2014
2014-08-14,Melaka,265,54,211,2014
2014-08-15,Melaka,128,41,87,2014
2014-08-16,Melaka,21,3,18,2014
2014-08-17,Melaka,161,19,142,2014
2014-08-18,Melaka,213,55,158,2014
2014-08-19,Melaka,107,44,63,2014
2014-08-20,Melaka,30,7,23,2014
2014-08-21,Melaka,70,39,31,2014
2014-08-22,Melaka,10,1,9,2014
2014-08-23,Melaka,47,19,28,2014
2014-08-24,Melaka,154,28,126,2014
2014-08-25,Melaka,18,2,16,2014
2014-08-26,Melaka,83,29,54,2014
2014-08-27,Melaka,128,74,54,2014
2014-08-28,Melaka,57,21,36,2014
2014-08-29,Melaka,13,0,13,2014
2014-08-30,Melaka,85,27,58,2014
2014-08-31,Melaka,187,46,141,2014
2014-09-01,Melaka,0,0,0,2014
2014-09-02,Melaka,53,11,42,2014
2014-09-03,Melaka,55,9,46,2014
2014-09-04,Melaka,39,13,26,2014
2014-09-05,Melaka,215,188,27,2014
2014-09-06,Melaka,41,16,25,2014
2014-09-07,Melaka,103,12,91,2014
2014-09-08,Melaka,18,0,18,2014
2014-09-09,Melaka,160,81,79,2014
2014-09-10,Melaka,54,18,36,2014
2014-09-11,Melaka,36,9,27,2014
2014-09-12,Melaka,30,5,25,2014
2014-09-13,Melaka,23,3,20,2014
2014-09-14,Melaka,81,21,60,2014
2014-09-15,Melaka,22,5,17,2014
2014-09-16,Melaka,47,16,31,2014
2014-09-17,Melaka,98,38,60,2014
2014-09-18,Melaka,97,31,66,2014
2014-09-19,Melaka,11,1,10,2014
2014-09-20,Melaka,90,22,68,2014
2014-09-21,Melaka,245,59,186,2014
2014-09-22,Melaka,141,79,62,2014
2014-09-23,Melaka,90,45,45,2014
2014-09-24,Melaka,228,86,142,2014
2014-09-25,Melaka,86,20,66,2014
2014-09-26,Melaka,19,2,17,2014
2014-09-27,Melaka,108,36,72,2014
2014-09-28,Melaka,130,26,104,2014
2014-09-29,Melaka,44,13,31,2014
2014-09-30,Melaka,115,68,47,2014
2014-10-01,Melaka,122,72,50,2014
2014-10-02,Melaka,49,22,27,2014
2014-10-03,Melaka,23,7,16,2014
2014-10-04,Melaka,37,14,23,2014
2014-10-05,Melaka,0,0,0,2014
2014-10-06,Melaka,33,9,24,2014
2014-10-07,Melaka,75,16,59,2014
2014-10-08,Melaka,154,42,112,2014
2014-10-09,Melaka,79,25,54,2014
2014-10-10,Melaka,0,0,0,2014
2014-10-11,Melaka,46,17,29,2014
2014-10-12,Melaka,166,40,126,2014
2014-10-13,Melaka,20,3,17,2014
2014-10-14,Melaka,73,26,47,2014
2014-10-15,Melaka,39,9,30,2014
2014-10-16,Melaka,15,3,12,2014
2014-10-17,Melaka,14,0,14,2014
2014-10-18,Melaka,117,108,9,2014
2014-10-19,Melaka,103,14,89,2014
2014-10-20,Melaka,158,85,73,2014
2014-10-21,Melaka,31,6,25,2014
2014-10-22,Melaka,72,28,44,2014
2014-10-23,Melaka,37,9,28,2014
2014-10-24,Melaka,17,1,16,2014
2014-10-25,Melaka,76,46,30,2014
2014-10-26,Melaka,65,26,39,2014
2014-10-27,Melaka,9,0,9,2014
2014-10-28,Melaka,112,17,95,2014
2014-10-29,Melaka,22,2,20,2014
2014-10-30,Melaka,17,1,16,2014
2014-10-31,Melaka,92,34,58,2014
2014-11-01,Melaka,126,51,75,2014
2014-11-02,Melaka,43,20,23,2014
2014-11-03,Melaka,56,13,43,2014
2014-11-04,Melaka,49,14,35,2014
2014-11-05,Melaka,70,29,41,2014
2014-11-06,Melaka,132,27,105,2014
2014-11-07,Melaka,16,2,14,2014
2014-11-08,Melaka,55,19,36,2014
2014-11-09,Melaka,68,9,59,2014
2014-11-10,Melaka,29,10,19,2014
2014-11-11,Melaka,101,50,51,2014
2014-11-12,Melaka,111,22,89,2014
2014-11-13,Melaka,44,12,32,2014
2014-11-14,Melaka,59,12,47,2014
2014-11-15,Melaka,30,19,11,2014
2014-11-16,Melaka,75,12,63,2014
2014-11-17,Melaka,18,2,16,2014
2014-11-18,Melaka,21,3,18,2014
2014-11-19,Melaka,54,32,22,2014
2014-11-20,Melaka,86,69,17,2014
2014-11-21,Melaka,171,94,77,2014
2014-11-22,Melaka,57,21,36,2014
2014-11-23,Melaka,71,30,41,2014
2014-11-24,Melaka,29,5,24,2014
2014-11-25,Melaka,7,1,6,2014
2014-11-26,Melaka,83,29,54,2014
2014-11-27,Melaka,139,56,83,2014
2014-11-28,Melaka,54,10,44,2014
2014-11-29,Melaka,31,11,20,2014
2014-11-30,Melaka,315,106,209,2014
2014-12-01,Melaka,15,0,15,2014
2014-12-02,Melaka,66,26,40,2014
2014-12-03,Melaka,117,45,72,2014
2014-12-04,Melaka,157,48,109,2014
2014-12-05,Melaka,30,11,19,2014
2014-12-06,Melaka,68,19,49,2014
2014-12-07,Melaka,413,88,325,2014
2014-12-08,Melaka,12,1,11,2014
2014-12-09,Melaka,133,50,83,2014
2014-12-10,Melaka,106,42,64,2014
2014-12-11,Melaka,149,66,83,2014
2014-12-12,Melaka,15,2,13,2014
2014-12-13,Melaka,105,57,48,2014
2014-12-14,Melaka,296,55,241,2014
2014-12-15,Melaka,17,0,17,2014
2014-12-16,Melaka,25,7,18,2014
2014-12-17,Melaka,29,9,20,2014
2014-12-18,Melaka,44,4,40,2014
2014-12-19,Melaka,22,4,18,2014
2014-12-20,Melaka,52,19,33,2014
2014-12-21,Melaka,42,20,22,2014
2014-12-22,Melaka,65,10,55,2014
2014-12-23,Melaka,117,40,77,2014
2014-12-24,Melaka,8,1,7,2014
2014-12-25,Melaka,24,16,8,2014
2014-12-26,Melaka,15,1,14,2014
2014-12-27,Melaka,28,6,22,2014
2014-12-28,Melaka,99,25,74,2014
2014-12-29,Melaka,97,37,60,2014
2014-12-30,Melaka,14,0,14,2014
2014-12-31,Melaka,71,37,34,2014
2015-01-01,Melaka,69,21,48,2015
2015-01-02,Melaka,110,41,69,2015
2015-01-03,Melaka,66,25,41,2015
2015-01-04,Melaka,92,17,75,2015
2015-01-05,Melaka,43,9,34,2015
2015-01-06,Melaka,46,17,29,2015
2015-01-07,Melaka,32,7,25,2015
2015-01-08,Melaka,26,5,21,2015
2015-01-09,Melaka,122,42,80,2015
2015-01-10,Melaka,155,55,100,2015
2015-01-11,Melaka,127,18,109,2015
2015-01-12,Melaka,33,5,28,2015
2015-01-13,Melaka,50,29,21,2015
2015-01-14,Melaka,160,109,51,2015
2015-01-15,Melaka,188,84,104,2015
2015-01-16,Melaka,15,2,13,2015
2015-01-17,Melaka,165,63,102,2015
2015-01-18,Melaka,165,59,106,2015
2015-01-19,Melaka,197,106,91,2015
2015-01-20,Melaka,82,58,24,2015
2015-01-21,Melaka,59,39,20,2015
2015-01-22,Melaka,120,82,38,2015
2015-01-23,Melaka,11,4,7,2015
2015-01-24,Melaka,258,243,15,2015
2015-01-25,Melaka,80,39,41,2015
2015-01-26,Melaka,49,3,46,2015
2015-01-27,Melaka,51,16,35,2015
2015-01-28,Melaka,35,21,14,2015
2015-01-29,Melaka,306,162,144,2015
2015-01-30,Melaka,21,3,18,2015
2015-01-31,Melaka,158,104,54,2015
2015-02-01,Melaka,48,18,30,2015
2015-02-02,Melaka,24,6,18,2015
2015-02-03,Melaka,122,65,57,2015
2015-02-04,Melaka,181,99,82,2015
2015-02-05,Melaka,46,11,35,2015
2015-02-06,Melaka,10,0,10,2015
2015-02-07,Melaka,158,65,93,2015
2015-02-08,Melaka,19,8,11,2015
2015-02-09,Melaka,13,0,13,2015
2015-02-10,Melaka,30,4,26,2015
2015-02-11,Melaka,27,4,23,2015
2015-02-12,Melaka,116,24,92,2015
2015-02-13,Melaka,25,3,22,2015
2015-02-14,Melaka,40,17,23,2015
2015-02-15,Melaka,38,9,29,2015
2015-02-16,Melaka,59,13,46,2015
2015-02-17,Melaka,38,8,30,2015
2015-02-18,Melaka,53,23,30,2015
2015-02-19,Melaka,40,9,31,2015
2015-02-20,Melaka,1,0,1,2015
2015-02-21,Melaka,11,2,9,2015
2015-02-22,Melaka,71,24,47,2015
2015-02-23,Melaka,30,6,24,2015
2015-02-24,Melaka,33,2,31,2015
2015-02-25,Melaka,54,29,25,2015
2015-02-26,Melaka,124,64,60,2015
2015-02-27,Melaka,15,3,12,2015
2015-02-28,Melaka,177,58,119,2015
2015-03-01,Melaka,153,22,131,2015
2015-03-02,Melaka,13,1,12,2015
2015-03-03,Melaka,42,13,29,2015
2015-03-04,Melaka,90,41,49,2015
2015-03-05,Melaka,47,14,33,2015
2015-03-06,Melaka,34,13,21,2015
2015-03-07,Melaka,96,26,70,2015
2015-03-08,Melaka,224,47,177,2015
2015-03-09,Melaka,54,17,37,2015
2015-03-10,Melaka,66,25,41,2015
2015-03-11,Melaka,39,11,28,2015
2015-03-12,Melaka,49,15,34,2015
2015-03-13,Melaka,17,4,13,2015
2015-03-14,Melaka,135,51,84,2015
2015-03-15,Melaka,126,40,86,2015
2015-03-16,Melaka,128,37,91,2015
2015-03-17,Melaka,12,1,11,2015
2015-03-18,Melaka,104,38,66,2015
2015-03-19,Melaka,76,31,45,2015
2015-03-20,Melaka,35,10,25,2015
2015-03-21,Melaka,52,28,24,2015
2015-03-22,Melaka,162,94,68,2015
2015-03-23,Melaka,40,8,32,2015
2015-03-24,Melaka,32,4,28,2015
2015-03-25,Melaka,146,86,60,2015
2015-03-26,Melaka,57,16,41,2015
2015-03-27,Melaka,35,10,25,2015
2015-03-28,Melaka,136,58,78,2015
2015-03-29,Melaka,113,38,75,2015
2015-03-30,Melaka,38,7,31,2015
2015-03-31,Melaka,42,12,30,2015
2015-04-01,Melaka,44,13,31,2015
2015-04-02,Melaka,161,93,68,2015
2015-04-03,Melaka,45,13,32,2015
2015-04-04,Melaka,127,49,78,2015
2015-04-05,Melaka,53,21,32,2015
2015-04-06,Melaka,21,1,20,2015
2015-04-07,Melaka,240,115,125,2015
2015-04-08,Melaka,124,60,64,2015
2015-04-09,Melaka,25,6,19,2015
2015-04-10,Melaka,40,11,29,2015
2015-04-11,Melaka,58,17,41,2015
2015-04-12,Melaka,135,47,88,2015
2015-04-13,Melaka,45,13,32,2015
2015-04-14,Melaka,118,57,61,2015
2015-04-15,Melaka,25,14,11,2015
2015-04-16,Melaka,55,24,31,2015
2015-04-17,Melaka,5,0,5,2015
2015-04-18,Melaka,67,17,50,2015
2015-04-19,Melaka,63,9,54,2015
2015-04-20,Melaka,18,2,16,2015
2015-04-21,Melaka,78,33,45,2015
2015-04-22,Melaka,87,32,55,2015
2015-04-23,Melaka,57,20,37,2015
2015-04-24,Melaka,52,19,33,2015
2015-04-25,Melaka,36,13,23,2015
2015-04-26,Melaka,188,51,137,2015
2015-04-27,Melaka,9,1,8,2015
2015-04-28,Melaka,39,18,21,2015
2015-04-29,Melaka,22,6,16,2015
2015-04-30,Melaka,38,14,24,2015
2015-05-01,Melaka,80,29,51,2015
2015-05-02,Melaka,0,0,0,2015
2015-05-03,Melaka,84,23,61,2015
2015-05-04,Melaka,4,0,4,2015
2015-05-05,Melaka,154,86,68,2015
2015-05-06,Melaka,299,127,172,2015
2015-05-07,Melaka,15,1,14,2015
2015-05-08,Melaka,113,71,42,2015
2015-05-09,Melaka,70,20,50,2015
2015-05-10,Melaka,187,45,142,2015
2015-05-11,Melaka,51,27,24,2015
2015-05-12,Melaka,78,19,59,2015
2015-05-13,Melaka,20,3,17,2015
2015-05-14,Melaka,135,48,87,2015
2015-05-15,Melaka,14,2,12,2015
2015-05-16,Melaka,141,31,110,2015
2015-05-17,Melaka,296,58,238,2015
2015-05-18,Melaka,53,10,43,2015
2015-05-19,Melaka,37,12,25,2015
2015-05-20,Melaka,23,6,17,2015
2015-05-21,Melaka,104,38,66,2015
2015-05-22,Melaka,57,16,41,2015
2015-05-23,Melaka,113,45,68,2015
2015-05-24,Melaka,158,27,131,2015
2015-05-25,Melaka,95,28,67,2015
2015-05-26,Melaka,44,12,32,2015
2015-05-27,Melaka,282,182,100,2015
2015-05-28,Melaka,65,34,31,2015
2015-05-29,Melaka,8,0,8,2015
2015-05-30,Melaka,28,13,15,2015
2015-05-31,Melaka,77,23,54,2015
2015-06-01,Melaka,15,2,13,2015
2015-06-02,Melaka,24,1,23,2015
2015-06-03,Melaka,44,9,35,2015
2015-06-04,Melaka,0,0,0,2015
2015-06-05,Melaka,39,10,29,2015
2015-06-06,Melaka,27,10,17,2015
2015-06-07,Melaka,103,17,86,2015
2015-06-08,Melaka,62,13,49,2015
2015-06-09,Melaka,31,12,19,2015
2015-06-10,Melaka,82,41,41,2015
2015-06-11,Melaka,114,33,81,2015
2015-06-12,Melaka,130,39,91,2015
2015-06-13,Melaka,76,26,50,2015
2015-06-14,Melaka,0,0,0,2015
2015-06-15,Melaka,95,20,75,2015
2015-06-16,Melaka,131,54,77,2015
2015-06-17,Melaka,54,10,44,2015
2015-06-18,Melaka,0,0,0,2015
2015-06-19,Melaka,5,0,5,2015
2015-06-20,Melaka,12,2,10,2015
2015-06-21,Melaka,231,34,197,2015
2015-06-22,Melaka,4,0,4,2015
2015-06-23,Melaka,5,0,5,2015
2015-06-24,Melaka,8,0,8,2015
2015-06-25,Melaka,72,38,34,2015
2015-06-26,Melaka,92,52,40,2015
2015-06-27,Melaka,18,2,16,2015
2015-06-28,Melaka,95,12,83,2015
2015-06-29,Melaka,88,41,47,2015
2015-06-30,Melaka,90,67,23,2015
2015-07-01,Melaka,47,19,28,2015
2015-07-02,Melaka,38,13,25,2015
2015-07-03,Melaka,289,255,34,2015
2015-07-04,Melaka,0,0,0,2015
2015-07-05,Melaka,218,92,126,2015
2015-07-06,Melaka,68,43,25,2015
2015-07-07,Melaka,74,47,27,2015
2015-07-08,Melaka,53,38,15,2015
2015-07-09,Melaka,33,4,29,2015
2015-07-10,Melaka,8,1,7,2015
2015-07-11,Melaka,31,3,28,2015
2015-07-12,Melaka,71,21,50,2015
2015-07-13,Melaka,67,19,48,2015
2015-07-14,Melaka,119,33,86,2015
2015-07-15,Melaka,36,3,33,2015
2015-07-16,Melaka,6,1,5,2015
2015-07-17,Melaka,0,0,0,2015
2015-07-18,Melaka,4,0,4,2015
2015-07-19,Melaka,57,6,51,2015
2015-07-20,Melaka,27,2,25,2015
2015-07-21,Melaka,64,10,54,2015
2015-07-22,Melaka,39,5,34,2015
2015-07-23,Melaka,55,6,49,2015
2015-07-24,Melaka,134,80,54,2015
2015-07-25,Melaka,84,19,65,2015
2015-07-26,Melaka,127,31,96,2015
2015-07-27,Melaka,126,37,89,2015
2015-07-28,Melaka,132,30,102,2015
2015-07-29,Melaka,144,50,94,2015
2015-07-30,Melaka,35,14,21,2015
2015-07-31,Melaka,16,0,16,2015
2015-08-01,Melaka,0,0,0,2015
2015-08-02,Melaka,42,12,30,2015
2015-08-03,Melaka,88,22,66,2015
2015-08-04,Melaka,69,18,51,2015
2015-08-05,Melaka,105,47,58,2015
2015-08-06,Melaka,85,26,59,2015
2015-08-07,Melaka,9,0,9,2015
2015-08-08,Melaka,73,42,31,2015
2015-08-09,Melaka,81,18,63,2015
2015-08-10,Melaka,23,4,19,2015
2015-08-11,Melaka,66,17,49,2015
2015-08-12,Melaka,286,169,117,2015
2015-08-13,Melaka,101,18,83,2015
2015-08-14,Melaka,88,15,73,2015
2015-08-15,Melaka,109,41,68,2015
2015-08-16,Melaka,234,49,185,2015
2015-08-17,Melaka,65,15,50,2015
2015-08-18,Melaka,17,3,14,2015
2015-08-19,Melaka,260,139,121,2015
2015-08-20,Melaka,227,127,100,2015
2015-08-21,Melaka,9,1,8,2015
2015-08-22,Melaka,87,40,47,2015
2015-08-23,Melaka,56,19,37,2015
2015-08-24,Melaka,25,3,22,2015
2015-08-25,Melaka,94,50,44,2015
2015-08-26,Melaka,16,1,15,2015
2015-08-27,Melaka,81,26,55,2015
2015-08-28,Melaka,135,57,78,2015
2015-08-29,Melaka,148,37,111,2015
2015-08-30,Melaka,140,43,97,2015
2015-08-31,Melaka,2,0,2,2015
2015-09-01,Melaka,38,11,27,2015
2015-09-02,Melaka,44,12,32,2015
2015-09-03,Melaka,26,5,21,2015
2015-09-04,Melaka,179,135,44,2015
2015-09-05,Melaka,32,15,17,2015
2015-09-06,Melaka,48,5,43,2015
2015-09-07,Melaka,148,104,44,2015
2015-09-08,Melaka,35,5,30,2015
2015-09-09,Melaka,74,48,26,2015
2015-09-10,Melaka,51,27,24,2015
2015-09-11,Melaka,7,1,6,2015
2015-09-12,Melaka,104,41,63,2015
2015-09-13,Melaka,179,115,64,2015
2015-09-14,Melaka,44,23,21,2015
2015-09-15,Melaka,25,2,23,2015
2015-09-16,Melaka,11,5,6,2015
2015-09-17,Melaka,56,23,33,2015
2015-09-18,Melaka,23,3,20,2015
2015-09-19,Melaka,166,44,122,2015
2015-09-20,Melaka,257,37,220,2015
2015-09-21,Melaka,32,11,21,2015
2015-09-22,Melaka,109,45,64,2015
2015-09-23,Melaka,59,12,47,2015
2015-09-24,Melaka,3,0,3,2015
2015-09-25,Melaka,58,15,43,2015
2015-09-26,Melaka,23,8,15,2015
2015-09-27,Melaka,167,26,141,2015
2015-09-28,Melaka,41,8,33,2015
2015-09-29,Melaka,27,3,24,2015
2015-09-30,Melaka,38,9,29,2015
2015-10-01,Melaka,35,12,23,2015
2015-10-02,Melaka,58,17,41,2015
2015-10-03,Melaka,72,23,49,2015
2015-10-04,Melaka,102,43,59,2015
2015-10-05,Melaka,10,0,10,2015
2015-10-06,Melaka,7,0,7,2015
2015-10-07,Melaka,115,33,82,2015
2015-10-08,Melaka,216,105,111,2015
2015-10-09,Melaka,42,8,34,2015
2015-10-10,Melaka,77,32,45,2015
2015-10-11,Melaka,103,33,70,2015
2015-10-12,Melaka,19,1,18,2015
2015-10-13,Melaka,73,24,49,2015
2015-10-14,Melaka,110,35,75,2015
2015-10-15,Melaka,38,6,32,2015
2015-10-16,Melaka,77,19,58,2015
2015-10-17,Melaka,37,11,26,2015
2015-10-18,Melaka,136,36,100,2015
2015-10-19,Melaka,73,28,45,2015
2015-10-20,Melaka,95,22,73,2015
2015-10-21,Melaka,27,8,19,2015
2015-10-22,Melaka,39,10,29,2015
2015-10-23,Melaka,31,10,21,2015
2015-10-24,Melaka,50,17,33,2015
2015-10-25,Melaka,275,59,216,2015
2015-10-26,Melaka,9,1,8,2015
2015-10-27,Melaka,41,14,27,2015
2015-10-28,Melaka,28,5,23,2015
2015-10-29,Melaka,139,65,74,2015
2015-10-30,Melaka,35,11,24,2015
2015-10-31,Melaka,207,51,156,2015
2015-11-01,Melaka,217,40,177,2015
2015-11-02,Melaka,72,16,56,2015
2015-11-03,Melaka,116,49,67,2015
2015-11-04,Melaka,31,9,22,2015
2015-11-05,Melaka,17,2,15,2015
2015-11-06,Melaka,20,2,18,2015
2015-11-07,Melaka,34,12,22,2015
2015-11-08,Melaka,124,39,85,2015
2015-11-09,Melaka,15,2,13,2015
2015-11-10,Melaka,125,47,78,2015
2015-11-11,Melaka,51,19,32,2015
2015-11-12,Melaka,124,19,105,2015
2015-11-13,Melaka,71,25,46,2015
2015-11-14,Melaka,68,17,51,2015
2015-11-15,Melaka,129,21,108,2015
2015-11-16,Melaka,67,11,56,2015
2015-11-17,Melaka,83,35,48,2015
2015-11-18,Melaka,150,49,101,2015
2015-11-19,Melaka,55,12,43,2015
2015-11-20,Melaka,61,24,37,2015
2015-11-21,Melaka,49,23,26,2015
2015-11-22,Melaka,259,53,206,2015
2015-11-23,Melaka,27,2,25,2015
2015-11-24,Melaka,44,21,23,2015
2015-11-25,Melaka,112,31,81,2015
2015-11-26,Melaka,170,78,92,2015
2015-11-27,Melaka,67,19,48,2015
2015-11-28,Melaka,48,20,28,2015
2015-11-29,Melaka,269,156,113,2015
2015-11-30,Melaka,84,22,62,2015
2015-12-01,Melaka,55,11,44,2015
2015-12-02,Melaka,143,58,85,2015
2015-12-03,Melaka,126,41,85,2015
2015-12-04,Melaka,24,7,17,2015
2015-12-05,Melaka,135,48,87,2015
2015-12-06,Melaka,329,49,280,2015
2015-12-07,Melaka,15,3,12,2015
2015-12-08,Melaka,39,9,30,2015
2015-12-09,Melaka,158,55,103,2015
2015-12-10,Melaka,81,25,56,2015
2015-12-11,Melaka,10,1,9,2015
2015-12-12,Melaka,38,11,27,2015
2015-12-13,Melaka,62,22,40,2015
2015-12-14,Melaka,17,0,17,2015
2015-12-15,Melaka,79,25,54,2015
2015-12-16,Melaka,153,65,88,2015
2015-12-17,Melaka,16,0,16,2015
2015-12-18,Melaka,125,66,59,2015
2015-12-19,Melaka,74,22,52,2015
2015-12-20,Melaka,119,33,86,2015
2015-12-21,Melaka,15,1,14,2015
2015-12-22,Melaka,143,41,102,2015
2015-12-23,Melaka,112,39,73,2015
2015-12-24,Melaka,70,22,48,2015
2015-12-25,Melaka,98,30,68,2015
2015-12-26,Melaka,15,8,7,2015
2015-12-27,Melaka,73,12,61,2015
2015-12-28,Melaka,16,1,15,2015
2015-12-29,Melaka,65,22,43,2015
2015-12-30,Melaka,18,1,17,2015
2015-12-31,Melaka,60,9,51,2015
2016-01-01,Melaka,74,18,56,2016
2016-01-02,Melaka,42,14,28,2016
2016-01-03,Melaka,84,50,34,2016
2016-01-04,Melaka,21,4,17,2016
2016-01-05,Melaka,40,12,28,2016
2016-01-06,Melaka,148,78,70,2016
2016-01-07,Melaka,158,73,85,2016
2016-01-08,Melaka,11,1,10,2016
2016-01-09,Melaka,43,14,29,2016
2016-01-10,Melaka,149,57,92,2016
2016-01-11,Melaka,261,56,205,2016
2016-01-12,Melaka,296,88,208,2016
2016-01-13,Melaka,110,38,72,2016
2016-01-14,Melaka,56,34,22,2016
2016-01-15,Melaka,14,1,13,2016
2016-01-16,Melaka,0,0,0,2016
2016-01-17,Melaka,162,39,123,2016
2016-01-18,Melaka,43,13,30,2016
2016-01-19,Melaka,153,80,73,2016
2016-01-20,Melaka,15,0,15,2016
2016-01-21,Melaka,36,8,28,2016
2016-01-22,Melaka,220,104,116,2016
2016-01-23,Melaka,57,21,36,2016
2016-01-24,Melaka,181,54,127,2016
2016-01-25,Melaka,46,8,38,2016
2016-01-26,Melaka,59,12,47,2016
2016-01-27,Melaka,9,4,5,2016
2016-01-28,Melaka,128,85,43,2016
2016-01-29,Melaka,8,0,8,2016
2016-01-30,Melaka,45,18,27,2016
2016-01-31,Melaka,31,13,18,2016
2016-02-01,Melaka,24,0,24,2016
2016-02-02,Melaka,29,6,23,2016
2016-02-03,Melaka,50,19,31,2016
2016-02-04,Melaka,65,19,46,2016
2016-02-05,Melaka,19,3,16,2016
2016-02-06,Melaka,78,16,62,2016
2016-02-07,Melaka,18,8,10,2016
2016-02-08,Melaka,47,13,34,2016
2016-02-09,Melaka,49,12,37,2016
2016-02-10,Melaka,12,0,12,2016
2016-02-11,Melaka,100,45,55,2016
2016-02-12,Melaka,44,7,37,2016
2016-02-13,Melaka,31,3,28,2016
2016-02-14,Melaka,43,5,38,2016
2016-02-15,Melaka,22,1,21,2016
2016-02-16,Melaka,231,87,144,2016
2016-02-17,Melaka,183,88,95,2016
2016-02-18,Melaka,146,76,70,2016
2016-02-19,Melaka,77,31,46,2016
2016-02-20,Melaka,6,0,6,2016
2016-02-21,Melaka,78,28,50,2016
2016-02-22,Melaka,100,76,24,2016
2016-02-23,Melaka,36,8,28,2016
2016-02-24,Melaka,239,46,193,2016
2016-02-25,Melaka,22,2,20,2016
2016-02-26,Melaka,13,2,11,2016
2016-02-27,Melaka,43,5,38,2016
2016-02-28,Melaka,218,20,198,2016
2016-02-29,Melaka,109,72,37,2016
2016-03-01,Melaka,139,68,71,2016
2016-03-02,Melaka,73,12,61,2016
2016-03-03,Melaka,156,58,98,2016
2016-03-04,Melaka,16,1,15,2016
2016-03-05,Melaka,102,56,46,2016
2016-03-06,Melaka,113,15,98,2016
2016-03-07,Melaka,99,73,26,2016
2016-03-08,Melaka,8,0,8,2016
2016-03-09,Melaka,121,70,51,2016
2016-03-10,Melaka,44,14,30,2016
2016-03-11,Melaka,23,3,20,2016
2016-03-12,Melaka,79,24,55,2016
2016-03-13,Melaka,185,50,135,2016
2016-03-14,Melaka,161,49,112,2016
2016-03-15,Melaka,117,65,52,2016
2016-03-16,Melaka,101,30,71,2016
2016-03-17,Melaka,70,27,43,2016
2016-03-18,Melaka,34,21,13,2016
2016-03-19,Melaka,71,31,40,2016
2016-03-20,Melaka,234,45,189,2016
2016-03-21,Melaka,187,78,109,2016
2016-03-22,Melaka,164,72,92,2016
2016-03-23,Melaka,78,31,47,2016
2016-03-24,Melaka,55,23,32,2016
2016-03-25,Melaka,28,9,19,2016
2016-03-26,Melaka,29,9,20,2016
2016-03-27,Melaka,122,38,84,2016
2016-03-28,Melaka,101,27,74,2016
2016-03-29,Melaka,113,53,60,2016
2016-03-30,Melaka,68,27,41,2016
2016-03-31,Melaka,51,9,42,2016
2016-04-01,Melaka,5,0,5,2016
2016-04-02,Melaka,97,32,65,2016
2016-04-03,Melaka,95,28,67,2016
2016-04-04,Melaka,71,12,59,2016
2016-04-05,Melaka,99,55,44,2016
2016-04-06,Melaka,94,36,58,2016
2016-04-07,Melaka,34,12,22,2016
2016-04-08,Melaka,12,0,12,2016
2016-04-09,Melaka,51,21,30,2016
2016-04-10,Melaka,211,32,179,2016
2016-04-11,Melaka,15,2,13,2016
2016-04-12,Melaka,39,13,26,2016
2016-04-13,Melaka,57,30,27,2016
2016-04-14,Melaka,22,1,21,2016
2016-04-15,Melaka,37,8,29,2016
2016-04-16,Melaka,96,43,53,2016
2016-04-17,Melaka,150,51,99,2016
2016-04-18,Melaka,23,1,22,2016
2016-04-19,Melaka,79,47,32,2016
2016-04-20,Melaka,65,37,28,2016
2016-04-21,Melaka,180,111,69,2016
2016-04-22,Melaka,30,9,21,2016
2016-04-23,Melaka,60,26,34,2016
2016-04-24,Melaka,81,22,59,2016
2016-04-25,Melaka,75,24,51,2016
2016-04-26,Melaka,65,42,23,2016
2016-04-27,Melaka,129,66,63,2016
2016-04-28,Melaka,255,92,163,2016
2016-04-29,Melaka,40,14,26,2016
2016-04-30,Melaka,67,14,53,2016
2016-05-01,Melaka,86,20,66,2016
2016-05-02,Melaka,0,0,0,2016
2016-05-03,Melaka,58,13,45,2016
2016-05-04,Melaka,99,55,44,2016
2016-05-05,Melaka,130,34,96,2016
2016-05-06,Melaka,117,54,63,2016
2016-05-07,Melaka,69,19,50,2016
2016-05-08,Melaka,160,33,127,2016
2016-05-09,Melaka,46,18,28,2016
2016-05-10,Melaka,117,67,50,2016
2016-05-11,Melaka,70,34,36,2016
2016-05-12,Melaka,202,69,133,2016
2016-05-13,Melaka,7,3,4,2016
2016-05-14,Melaka,181,53,128,2016
2016-05-15,Melaka,230,43,187,2016
2016-05-16,Melaka,21,0,21,2016
2016-05-17,Melaka,55,13,42,2016
2016-05-18,Melaka,56,10,46,2016
2016-05-19,Melaka,22,5,17,2016
2016-05-20,Melaka,55,30,25,2016
2016-05-21,Melaka,165,62,103,2016
2016-05-22,Melaka,210,24,186,2016
2016-05-23,Melaka,186,36,150,2016
2016-05-24,Melaka,130,36,94,2016
2016-05-25,Melaka,192,48,144,2016
2016-05-26,Melaka,34,4,30,2016
2016-05-27,Melaka,16,0,16,2016
2016-05-28,Melaka,81,30,51,2016
2016-05-29,Melaka,46,17,29,2016
2016-05-30,Melaka,142,47,95,2016
2016-05-31,Melaka,99,23,76,2016
2016-06-01,Melaka,185,50,135,2016
2016-06-02,Melaka,87,24,63,2016
2016-06-03,Melaka,24,4,20,2016
2016-06-04,Melaka,160,46,114,2016
2016-06-05,Melaka,157,53,104,2016
2016-06-06,Melaka,0,0,0,2016
2016-06-07,Melaka,24,7,17,2016
2016-06-08,Melaka,24,6,18,2016
2016-06-09,Melaka,70,30,40,2016
2016-06-10,Melaka,63,37,26,2016
2016-06-11,Melaka,4,0,4,2016
2016-06-12,Melaka,217,30,187,2016
2016-06-13,Melaka,5,0,5,2016
2016-06-14,Melaka,50,11,39,2016
2016-06-15,Melaka,47,21,26,2016
2016-06-16,Melaka,88,49,39,2016
2016-06-17,Melaka,2,0,2,2016
2016-06-18,Melaka,31,8,23,2016
2016-06-19,Melaka,255,21,234,2016
2016-06-20,Melaka,16,0,16,2016
2016-06-21,Melaka,17,4,13,2016
2016-06-22,Melaka,19,4,15,2016
2016-06-23,Melaka,32,10,22,2016
2016-06-24,Melaka,228,210,18,2016
2016-06-25,Melaka,30,13,17,2016
2016-06-26,Melaka,59,15,44,2016
2016-06-27,Melaka,15,2,13,2016
2016-06-28,Melaka,80,50,30,2016
2016-06-29,Melaka,126,94,32,2016
2016-06-30,Melaka,61,28,33,2016
2016-07-01,Melaka,97,48,49,2016
2016-07-02,Melaka,0,0,0,2016
2016-07-03,Melaka,50,3,47,2016
2016-07-04,Melaka,33,7,26,2016
2016-07-05,Melaka,9,1,8,2016
2016-07-06,Melaka,0,0,0,2016
2016-07-07,Melaka,4,0,4,2016
2016-07-08,Melaka,42,13,29,2016
2016-07-09,Melaka,56,20,36,2016
2016-07-10,Melaka,17,4,13,2016
2016-07-11,Melaka,31,5,26,2016
2016-07-12,Melaka,43,5,38,2016
2016-07-13,Melaka,29,3,26,2016
2016-07-14,Melaka,82,19,63,2016
2016-07-15,Melaka,19,4,15,2016
2016-07-16,Melaka,117,27,90,2016
2016-07-17,Melaka,243,64,179,2016
2016-07-18,Melaka,20,0,20,2016
2016-07-19,Melaka,56,15,41,2016
2016-07-20,Melaka,138,55,83,2016
2016-07-21,Melaka,19,3,16,2016
2016-07-22,Melaka,36,19,17,2016
2016-07-23,Melaka,21,8,13,2016
2016-07-24,Melaka,110,36,74,2016
2016-07-25,Melaka,41,10,31,2016
2016-07-26,Melaka,11,0,11,2016
2016-07-27,Melaka,90,16,74,2016
2016-07-28,Melaka,154,84,70,2016
2016-07-29,Melaka,25,0,25,2016
2016-07-30,Melaka,95,14,81,2016
2016-07-31,Melaka,107,27,80,2016
2016-08-01,Melaka,28,4,24,2016
2016-08-02,Melaka,59,11,48,2016
2016-08-03,Melaka,178,62,116,2016
2016-08-04,Melaka,72,12,60,2016
2016-08-05,Melaka,18,3,15,2016
2016-08-06,Melaka,101,21,80,2016
2016-08-07,Melaka,148,19,129,2016
2016-08-08,Melaka,41,9,32,2016
2016-08-09,Melaka,132,31,101,2016
2016-08-10,Melaka,137,38,99,2016
2016-08-11,Melaka,78,20,58,2016
2016-08-12,Melaka,415,80,335,2016
2016-08-13,Melaka,76,20,56,2016
2016-08-14,Melaka,300,72,228,2016
2016-08-15,Melaka,133,65,68,2016
2016-08-16,Melaka,118,50,68,2016
2016-08-17,Melaka,63,10,53,2016
2016-08-18,Melaka,16,3,13,2016
2016-08-19,Melaka,194,122,72,2016
2016-08-20,Melaka,122,49,73,2016
2016-08-21,Melaka,65,18,47,2016
2016-08-22,Melaka,77,43,34,2016
2016-08-23,Melaka,38,6,32,2016
2016-08-24,Melaka,111,34,77,2016
2016-08-25,Melaka,169,75,94,2016
2016-08-26,Melaka,206,65,141,2016
2016-08-27,Melaka,175,51,124,2016
2016-08-28,Melaka,57,13,44,2016
2016-08-29,Melaka,78,19,59,2016
2016-08-30,Melaka,104,39,65,2016
2016-08-31,Melaka,0,0,0,2016
2016-09-01,Melaka,14,0,14,2016
2016-09-02,Melaka,176,115,61,2016
2016-09-03,Melaka,2,0,2,2016
2016-09-04,Melaka,116,20,96,2016
2016-09-05,Melaka,84,9,75,2016
2016-09-06,Melaka,14,3,11,2016
2016-09-07,Melaka,111,24,87,2016
2016-09-08,Melaka,39,4,35,2016
2016-09-09,Melaka,43,8,35,2016
2016-09-10,Melaka,64,23,41,2016
2016-09-11,Melaka,266,42,224,2016
2016-09-12,Melaka,0,0,0,2016
2016-09-13,Melaka,29,6,23,2016
2016-09-14,Melaka,42,16,26,2016
2016-09-15,Melaka,46,12,34,2016
2016-09-16,Melaka,167,76,91,2016
2016-09-17,Melaka,64,27,37,2016
2016-09-18,Melaka,146,22,124,2016
2016-09-19,Melaka,104,44,60,2016
2016-09-20,Melaka,187,93,94,2016
2016-09-21,Melaka,13,3,10,2016
2016-09-22,Melaka,11,2,9,2016
2016-09-23,Melaka,88,23,65,2016
2016-09-24,Melaka,91,23,68,2016
2016-09-25,Melaka,60,13,47,2016
2016-09-26,Melaka,24,1,23,2016
2016-09-27,Melaka,75,13,62,2016
2016-09-28,Melaka,76,26,50,2016
2016-09-29,Melaka,88,27,61,2016
2016-09-30,Melaka,38,10,28,2016
2016-10-01,Melaka,28,9,19,2016
2016-10-02,Melaka,186,24,162,2016
2016-10-03,Melaka,3,0,3,2016
2016-10-04,Melaka,195,84,111,2016
2016-10-05,Melaka,89,43,46,2016
2016-10-06,Melaka,40,11,29,2016
2016-10-07,Melaka,43,14,29,2016
2016-10-08,Melaka,122,42,80,2016
2016-10-09,Melaka,167,49,118,2016
2016-10-10,Melaka,15,1,14,2016
2016-10-11,Melaka,117,50,67,2016
2016-10-12,Melaka,56,13,43,2016
2016-10-13,Melaka,69,29,40,2016
2016-10-14,Melaka,53,7,46,2016
2016-10-15,Melaka,86,30,56,2016
2016-10-16,Melaka,88,38,50,2016
2016-10-17,Melaka,18,2,16,2016
2016-10-18,Melaka,54,11,43,2016
2016-10-19,Melaka,109,61,48,2016
2016-10-20,Melaka,56,11,45,2016
2016-10-21,Melaka,13,2,11,2016
2016-10-22,Melaka,133,40,93,2016
2016-10-23,Melaka,235,34,201,2016
2016-10-24,Melaka,21,0,21,2016
2016-10-25,Melaka,56,20,36,2016
2016-10-26,Melaka,33,3,30,2016
2016-10-27,Melaka,33,10,23,2016
2016-10-28,Melaka,15,4,11,2016
2016-10-29,Melaka,144,70,74,2016
2016-10-30,Melaka,52,13,39,2016
2016-10-31,Melaka,33,10,23,2016
2016-11-01,Melaka,56,6,50,2016
2016-11-02,Melaka,142,96,46,2016
2016-11-03,Melaka,84,25,59,2016
2016-11-04,Melaka,15,5,10,2016
2016-11-05,Melaka,142,40,102,2016
2016-11-06,Melaka,85,43,42,2016
2016-11-07,Melaka,12,2,10,2016
2016-11-08,Melaka,33,4,29,2016
2016-11-09,Melaka,126,49,77,2016
2016-11-10,Melaka,103,44,59,2016
2016-11-11,Melaka,14,0,14,2016
2016-11-12,Melaka,0,0,0,2016
2016-11-13,Melaka,136,43,93,2016
2016-11-14,Melaka,36,9,27,2016
2016-11-15,Melaka,130,37,93,2016
2016-11-16,Melaka,93,17,76,2016
2016-11-17,Melaka,56,13,43,2016
2016-11-18,Melaka,75,29,46,2016
2016-11-19,Melaka,123,35,88,2016
2016-11-20,Melaka,124,16,108,2016
2016-11-21,Melaka,16,0,16,2016
2016-11-22,Melaka,16,0,16,2016
2016-11-23,Melaka,157,53,104,2016
2016-11-24,Melaka,144,28,116,2016
2016-11-25,Melaka,127,41,86,2016
2016-11-26,Melaka,48,16,32,2016
2016-11-27,Melaka,104,39,65,2016
2016-11-28,Melaka,21,1,20,2016
2016-11-29,Melaka,40,5,35,2016
2016-11-30,Melaka,52,8,44,2016
2016-12-01,Melaka,67,7,60,2016
2016-12-02,Melaka,8,1,7,2016
2016-12-03,Melaka,3,0,3,2016
2016-12-04,Melaka,398,73,325,2016
2016-12-05,Melaka,15,3,12,2016
2016-12-06,Melaka,11,1,10,2016
2016-12-07,Melaka,433,209,224,2016
2016-12-08,Melaka,13,1,12,2016
2016-12-09,Melaka,68,29,39,2016
2016-12-10,Melaka,12,2,10,2016
2016-12-11,Melaka,0,0,0,2016
2016-12-12,Melaka,43,9,34,2016
2016-12-13,Melaka,43,6,37,2016
2016-12-14,Melaka,152,92,60,2016
2016-12-15,Melaka,129,71,58,2016
2016-12-16,Melaka,14,2,12,2016
2016-12-17,Melaka,112,30,82,2016
2016-12-18,Melaka,212,46,166,2016
2016-12-19,Melaka,21,2,19,2016
2016-12-20,Melaka,49,5,44,2016
2016-12-21,Melaka,49,13,36,2016
2016-12-22,Melaka,119,32,87,2016
2016-12-23,Melaka,5,0,5,2016
2016-12-24,Melaka,65,9,56,2016
2016-12-25,Melaka,0,0,0,2016
2016-12-26,Melaka,57,14,43,2016
2016-12-27,Melaka,67,20,47,2016
2016-12-28,Melaka,16,1,15,2016
2016-12-29,Melaka,81,11,70,2016
2016-12-30,Melaka,17,2,15,2016
2016-12-31,Melaka,43,7,36,2016
2017-01-01,Melaka,0,0,0,2017
2017-01-02,Melaka,67,17,50,2017
2017-01-03,Melaka,19,3,16,2017
2017-01-04,Melaka,80,35,45,2017
2017-01-05,Melaka,89,34,55,2017
2017-01-06,Melaka,51,9,42,2017
2017-01-07,Melaka,49,10,39,2017
2017-01-08,Melaka,162,34,128,2017
2017-01-09,Melaka,21,2,19,2017
2017-01-10,Melaka,146,61,85,2017
2017-01-11,Melaka,166,68,98,2017
2017-01-12,Melaka,157,75,82,2017
2017-01-13,Melaka,9,1,8,2017
2017-01-14,Melaka,187,71,116,2017
2017-01-15,Melaka,178,55,123,2017
2017-01-16,Melaka,14,1,13,2017
2017-01-17,Melaka,46,6,40,2017
2017-01-18,Melaka,43,17,26,2017
2017-01-19,Melaka,161,81,80,2017
2017-01-20,Melaka,264,135,129,2017
2017-01-21,Melaka,79,17,62,2017
2017-01-22,Melaka,143,26,117,2017
2017-01-23,Melaka,29,5,24,2017
2017-01-24,Melaka,19,3,16,2017
2017-01-25,Melaka,247,162,85,2017
2017-01-26,Melaka,78,20,58,2017
2017-01-27,Melaka,12,3,9,2017
2017-01-28,Melaka,62,23,39,2017
2017-01-29,Melaka,0,0,0,2017
2017-01-30,Melaka,58,24,34,2017
2017-01-31,Melaka,54,7,47,2017
2017-02-01,Melaka,122,35,87,2017
2017-02-02,Melaka,48,18,30,2017
2017-02-03,Melaka,70,40,30,2017
2017-02-04,Melaka,68,40,28,2017
2017-02-05,Melaka,119,29,90,2017
2017-02-06,Melaka,21,4,17,2017
2017-02-07,Melaka,16,1,15,2017
2017-02-08,Melaka,51,13,38,2017
2017-02-09,Melaka,104,25,79,2017
2017-02-10,Melaka,44,31,13,2017
2017-02-11,Melaka,84,16,68,2017
2017-02-12,Melaka,122,20,102,2017
2017-02-13,Melaka,20,5,15,2017
2017-02-14,Melaka,103,39,64,2017
2017-02-15,Melaka,92,17,75,2017
2017-02-16,Melaka,133,90,43,2017
2017-02-17,Melaka,25,3,22,2017
2017-02-18,Melaka,139,38,101,2017
2017-02-19,Melaka,222,31,191,2017
2017-02-20,Melaka,16,0,16,2017
2017-02-21,Melaka,42,15,27,2017
2017-02-22,Melaka,93,29,64,2017
2017-02-23,Melaka,94,29,65,2017
2017-02-24,Melaka,11,0,11,2017
2017-02-25,Melaka,168,51,117,2017
2017-02-26,Melaka,144,11,133,2017
2017-02-27,Melaka,166,72,94,2017
2017-02-28,Melaka,245,109,136,2017
2017-03-01,Melaka,80,30,50,2017
2017-03-02,Melaka,216,92,124,2017
2017-03-03,Melaka,11,0,11,2017
2017-03-04,Melaka,78,40,38,2017
2017-03-05,Melaka,295,124,171,2017
2017-03-06,Melaka,13,0,13,2017
2017-03-07,Melaka,35,11,24,2017
2017-03-08,Melaka,83,21,62,2017
2017-03-09,Melaka,62,20,42,2017
2017-03-10,Melaka,11,2,9,2017
2017-03-11,Melaka,162,68,94,2017
2017-03-12,Melaka,68,11,57,2017
2017-03-13,Melaka,146,47,99,2017
2017-03-14,Melaka,88,29,59,2017
2017-03-15,Melaka,149,69,80,2017
2017-03-16,Melaka,155,75,80,2017
2017-03-17,Melaka,3,1,2,2017
2017-03-18,Melaka,110,33,77,2017
2017-03-19,Melaka,187,46,141,2017
2017-03-20,Melaka,68,40,28,2017
2017-03-21,Melaka,19,0,19,2017
2017-03-22,Melaka,96,41,55,2017
2017-03-23,Melaka,77,28,49,2017
2017-03-24,Melaka,7,0,7,2017
2017-03-25,Melaka,99,53,46,2017
2017-03-26,Melaka,53,7,46,2017
2017-03-27,Melaka,24,1,23,2017
2017-03-28,Melaka,211,68,143,2017
2017-03-29,Melaka,166,59,107,2017
2017-03-30,Melaka,93,34,59,2017
2017-03-31,Melaka,19,0,19,2017
2017-04-01,Melaka,43,7,36,2017
2017-04-02,Melaka,129,41,88,2017
2017-04-03,Melaka,109,39,70,2017
2017-04-04,Melaka,21,1,20,2017
2017-04-05,Melaka,23,1,22,2017
2017-04-06,Melaka,166,75,91,2017
2017-04-07,Melaka,10,1,9,2017
2017-04-08,Melaka,106,43,63,2017
2017-04-09,Melaka,261,35,226,2017
2017-04-10,Melaka,129,76,53,2017
2017-04-11,Melaka,91,52,39,2017
2017-04-12,Melaka,49,27,22,2017
2017-04-13,Melaka,90,54,36,2017
2017-04-14,Melaka,9,1,8,2017
2017-04-15,Melaka,146,33,113,2017
2017-04-16,Melaka,115,84,31,2017
2017-04-17,Melaka,28,11,17,2017
2017-04-18,Melaka,142,94,48,2017
2017-04-19,Melaka,101,60,41,2017
2017-04-20,Melaka,95,35,60,2017
2017-04-21,Melaka,79,25,54,2017
2017-04-22,Melaka,19,6,13,2017
2017-04-23,Melaka,188,46,142,2017
2017-04-24,Melaka,3,0,3,2017
2017-04-25,Melaka,162,53,109,2017
2017-04-26,Melaka,25,4,21,2017
2017-04-27,Melaka,105,42,63,2017
2017-04-28,Melaka,17,1,16,2017
2017-04-29,Melaka,46,12,34,2017
2017-04-30,Melaka,204,22,182,2017
2017-05-01,Melaka,65,20,45,2017
2017-05-02,Melaka,91,18,73,2017
2017-05-03,Melaka,74,16,58,2017
2017-05-04,Melaka,64,17,47,2017
2017-05-05,Melaka,5,2,3,2017
2017-05-06,Melaka,76,22,54,2017
2017-05-07,Melaka,120,31,89,2017
2017-05-08,Melaka,178,46,132,2017
2017-05-09,Melaka,51,17,34,2017
2017-05-10,Melaka,132,84,48,2017
2017-05-11,Melaka,14,1,13,2017
2017-05-12,Melaka,7,1,6,2017
2017-05-13,Melaka,176,61,115,2017
2017-05-14,Melaka,69,9,60,2017
2017-05-15,Melaka,42,3,39,2017
2017-05-16,Melaka,97,32,65,2017
2017-05-17,Melaka,101,30,71,2017
2017-05-18,Melaka,73,15,58,2017
2017-05-19,Melaka,12,2,10,2017
2017-05-20,Melaka,152,27,125,2017
2017-05-21,Melaka,189,48,141,2017
2017-05-22,Melaka,62,7,55,2017
2017-05-23,Melaka,37,13,24,2017
2017-05-24,Melaka,44,6,38,2017
2017-05-25,Melaka,26,13,13,2017
2017-05-26,Melaka,18,2,16,2017
2017-05-27,Melaka,0,0,0,2017
2017-05-28,Melaka,100,8,92,2017
2017-05-29,Melaka,5,1,4,2017
2017-05-30,Melaka,32,13,19,2017
2017-05-31,Melaka,5,0,5,2017
2017-06-01,Melaka,20,6,14,2017
2017-06-02,Melaka,5,1,4,2017
2017-06-03,Melaka,125,32,93,2017
2017-06-04,Melaka,115,16,99,2017
2017-06-05,Melaka,79,29,50,2017
2017-06-06,Melaka,64,27,37,2017
2017-06-07,Melaka,26,2,24,2017
2017-06-08,Melaka,43,13,30,2017
2017-06-09,Melaka,51,11,40,2017
2017-06-10,Melaka,77,10,67,2017
2017-06-11,Melaka,56,6,50,2017
2017-06-12,Melaka,30,10,20,2017
2017-06-13,Melaka,67,28,39,2017
2017-06-14,Melaka,84,58,26,2017
2017-06-15,Melaka,90,73,17,2017
2017-06-16,Melaka,197,192,5,2017
2017-06-17,Melaka,73,68,5,2017
2017-06-18,Melaka,61,21,40,2017
2017-06-19,Melaka,5,0,5,2017
2017-06-20,Melaka,106,40,66,2017
2017-06-21,Melaka,64,26,38,2017
2017-06-22,Melaka,33,10,23,2017
2017-06-23,Melaka,20,3,17,2017
2017-06-24,Melaka,3,0,3,2017
2017-06-25,Melaka,0,0,0,2017
2017-06-26,Melaka,0,0,0,2017
2017-06-27,Melaka,39,11,28,2017
2017-06-28,Melaka,59,16,43,2017
2017-06-29,Melaka,82,23,59,2017
2017-06-30,Melaka,52,10,42,2017
2017-07-01,Melaka,278,64,214,2017
2017-07-02,Melaka,160,29,131,2017
2017-07-03,Melaka,118,28,90,2017
2017-07-04,Melaka,50,13,37,2017
2017-07-05,Melaka,100,23,77,2017
2017-07-06,Melaka,84,15,69,2017
2017-07-07,Melaka,79,25,54,2017
2017-07-08,Melaka,94,17,77,2017
2017-07-09,Melaka,120,43,77,2017
2017-07-10,Melaka,65,14,51,2017
2017-07-11,Melaka,86,35,51,2017
2017-07-12,Melaka,35,3,32,2017
2017-07-13,Melaka,260,99,161,2017
2017-07-14,Melaka,26,6,20,2017
2017-07-15,Melaka,150,50,100,2017
2017-07-16,Melaka,82,21,61,2017
2017-07-17,Melaka,51,14,37,2017
2017-07-18,Melaka,80,21,59,2017
2017-07-19,Melaka,40,1,39,2017
2017-07-20,Melaka,116,47,69,2017
2017-07-21,Melaka,13,4,9,2017
2017-07-22,Melaka,44,3,41,2017
2017-07-23,Melaka,187,54,133,2017
2017-07-24,Melaka,17,3,14,2017
2017-07-25,Melaka,142,62,80,2017
2017-07-26,Melaka,47,9,38,2017
2017-07-27,Melaka,162,82,80,2017
2017-07-28,Melaka,12,2,10,2017
2017-07-29,Melaka,18,4,14,2017
2017-07-30,Melaka,209,49,160,2017
2017-07-31,Melaka,22,6,16,2017
2017-08-01,Melaka,91,50,41,2017
2017-08-02,Melaka,17,8,9,2017
2017-08-03,Melaka,47,10,37,2017
2017-08-04,Melaka,10,0,10,2017
2017-08-05,Melaka,212,33,179,2017
2017-08-06,Melaka,255,63,192,2017
2017-08-07,Melaka,14,1,13,2017
2017-08-08,Melaka,15,3,12,2017
2017-08-09,Melaka,180,42,138,2017
2017-08-10,Melaka,81,32,49,2017
2017-08-11,Melaka,154,112,42,2017
2017-08-12,Melaka,30,12,18,2017
2017-08-13,Melaka,117,10,107,2017
2017-08-14,Melaka,99,18,81,2017
2017-08-15,Melaka,54,10,44,2017
2017-08-16,Melaka,13,0,13,2017
2017-08-17,Melaka,74,13,61,2017
2017-08-18,Melaka,83,16,67,2017
2017-08-19,Melaka,49,34,15,2017
2017-08-20,Melaka,239,27,212,2017
2017-08-21,Melaka,19,4,15,2017
2017-08-22,Melaka,172,61,111,2017
2017-08-23,Melaka,75,38,37,2017
2017-08-24,Melaka,16,1,15,2017
2017-08-25,Melaka,34,16,18,2017
2017-08-26,Melaka,128,31,97,2017
2017-08-27,Melaka,145,95,50,2017
2017-08-28,Melaka,113,24,89,2017
2017-08-29,Melaka,46,22,24,2017
2017-08-30,Melaka,35,8,27,2017
2017-08-31,Melaka,0,0,0,2017
2017-09-01,Melaka,0,0,0,2017
2017-09-02,Melaka,98,39,59,2017
2017-09-03,Melaka,170,20,150,2017
2017-09-04,Melaka,0,0,0,2017
2017-09-05,Melaka,17,0,17,2017
2017-09-06,Melaka,63,18,45,2017
2017-09-07,Melaka,38,9,29,2017
2017-09-08,Melaka,22,0,22,2017
2017-09-09,Melaka,98,13,85,2017
2017-09-10,Melaka,126,15,111,2017
2017-09-11,Melaka,13,1,12,2017
2017-09-12,Melaka,51,11,40,2017
2017-09-13,Melaka,111,43,68,2017
2017-09-14,Melaka,133,39,94,2017
2017-09-15,Melaka,48,9,39,2017
2017-09-16,Melaka,91,30,61,2017
2017-09-17,Melaka,100,17,83,2017
2017-09-18,Melaka,16,2,14,2017
2017-09-19,Melaka,32,11,21,2017
2017-09-20,Melaka,55,16,39,2017
2017-09-21,Melaka,65,21,44,2017
2017-09-22,Melaka,57,8,49,2017
2017-09-23,Melaka,68,18,50,2017
2017-09-24,Melaka,120,32,88,2017
2017-09-25,Melaka,10,1,9,2017
2017-09-26,Melaka,57,7,50,2017
2017-09-27,Melaka,120,56,64,2017
2017-09-28,Melaka,38,4,34,2017
2017-09-29,Melaka,46,9,37,2017
2017-09-30,Melaka,42,5,37,2017
2017-10-01,Melaka,86,16,70,2017
2017-10-02,Melaka,21,3,18,2017
2017-10-03,Melaka,61,16,45,2017
2017-10-04,Melaka,121,22,99,2017
2017-10-05,Melaka,152,38,114,2017
2017-10-06,Melaka,105,42,63,2017
2017-10-07,Melaka,49,11,38,2017
2017-10-08,Melaka,118,34,84,2017
2017-10-09,Melaka,81,13,68,2017
2017-10-10,Melaka,131,18,113,2017
2017-10-11,Melaka,278,115,163,2017
2017-10-12,Melaka,42,10,32,2017
2017-10-13,Melaka,36,7,29,2017
2017-10-14,Melaka,119,35,84,2017
2017-10-15,Melaka,156,36,120,2017
2017-10-16,Melaka,176,51,125,2017
2017-10-17,Melaka,89,10,79,2017
2017-10-18,Melaka,79,17,62,2017
2017-10-19,Melaka,70,21,49,2017
2017-10-20,Melaka,15,0,15,2017
2017-10-21,Melaka,99,26,73,2017
2017-10-22,Melaka,144,26,118,2017
2017-10-23,Melaka,10,2,8,2017
2017-10-24,Melaka,19,1,18,2017
2017-10-25,Melaka,167,47,120,2017
2017-10-26,Melaka,181,95,86,2017
2017-10-27,Melaka,216,136,80,2017
2017-10-28,Melaka,102,25,77,2017
2017-10-29,Melaka,75,16,59,2017
2017-10-30,Melaka,55,17,38,2017
2017-10-31,Melaka,41,6,35,2017
2017-11-01,Melaka,42,15,27,2017
2017-11-02,Melaka,64,13,51,2017
2017-11-03,Melaka,147,63,84,2017
2017-11-04,Melaka,141,40,101,2017
2017-11-05,Melaka,164,35,129,2017
2017-11-06,Melaka,33,6,27,2017
2017-11-07,Melaka,21,2,19,2017
2017-11-08,Melaka,53,9,44,2017
2017-11-09,Melaka,192,29,163,2017
2017-11-10,Melaka,95,19,76,2017
2017-11-11,Melaka,40,7,33,2017
2017-11-12,Melaka,141,17,124,2017
2017-11-13,Melaka,75,22,53,2017
2017-11-14,Melaka,66,12,54,2017
2017-11-15,Melaka,41,10,31,2017
2017-11-16,Melaka,134,32,102,2017
2017-11-17,Melaka,13,1,12,2017
2017-11-18,Melaka,51,14,37,2017
2017-11-19,Melaka,126,3,123,2017
2017-11-20,Melaka,13,1,12,2017
2017-11-21,Melaka,48,11,37,2017
2017-11-22,Melaka,137,66,71,2017
2017-11-23,Melaka,114,31,83,2017
2017-11-24,Melaka,86,35,51,2017
2017-11-25,Melaka,80,18,62,2017
2017-11-26,Melaka,173,98,75,2017
2017-11-27,Melaka,55,9,46,2017
2017-11-28,Melaka,17,4,13,2017
2017-11-29,Melaka,9,3,6,2017
2017-11-30,Melaka,59,15,44,2017
2017-12-01,Melaka,68,28,40,2017
2017-12-02,Melaka,52,19,33,2017
2017-12-03,Melaka,389,44,345,2017
2017-12-04,Melaka,21,4,17,2017
2017-12-05,Melaka,137,52,85,2017
2017-12-06,Melaka,193,76,117,2017
2017-12-07,Melaka,62,9,53,2017
2017-12-08,Melaka,13,0,13,2017
2017-12-09,Melaka,58,19,39,2017
2017-12-10,Melaka,142,41,101,2017
2017-12-11,Melaka,21,3,18,2017
2017-12-12,Melaka,77,17,60,2017
2017-12-13,Melaka,36,2,34,2017
2017-12-14,Melaka,30,17,13,2017
2017-12-15,Melaka,55,17,38,2017
2017-12-16,Melaka,160,35,125,2017
2017-12-17,Melaka,189,25,164,2017
2017-12-18,Melaka,11,0,11,2017
2017-12-19,Melaka,47,8,39,2017
2017-12-20,Melaka,117,18,99,2017
2017-12-21,Melaka,39,8,31,2017
2017-12-22,Melaka,9,1,8,2017
2017-12-23,Melaka,72,21,51,2017
2017-12-24,Melaka,167,38,129,2017
2017-12-25,Melaka,84,17,67,2017
2017-12-26,Melaka,13,0,13,2017
2017-12-27,Melaka,61,20,41,2017
2017-12-28,Melaka,24,3,21,2017
2017-12-29,Melaka,21,9,12,2017
2017-12-30,Melaka,73,18,55,2017
2017-12-31,Melaka,89,18,71,2017
2018-01-01,Melaka,0,0,0,2018
2018-01-02,Melaka,15,4,11,2018
2018-01-03,Melaka,49,9,40,2018
2018-01-04,Melaka,71,16,55,2018
2018-01-05,Melaka,41,10,31,2018
2018-01-06,Melaka,99,35,64,2018
2018-01-07,Melaka,118,19,99,2018
2018-01-08,Melaka,11,2,9,2018
2018-01-09,Melaka,55,13,42,2018
2018-01-10,Melaka,113,78,35,2018
2018-01-11,Melaka,186,88,98,2018
2018-01-12,Melaka,57,17,40,2018
2018-01-13,Melaka,70,44,26,2018
2018-01-14,Melaka,90,13,77,2018
2018-01-15,Melaka,139,54,85,2018
2018-01-16,Melaka,201,75,126,2018
2018-01-17,Melaka,14,2,12,2018
2018-01-18,Melaka,12,0,12,2018
2018-01-19,Melaka,173,63,110,2018
2018-01-20,Melaka,100,27,73,2018
2018-01-21,Melaka,95,39,56,2018
2018-01-22,Melaka,16,4,12,2018
2018-01-23,Melaka,113,29,84,2018
2018-01-24,Melaka,123,71,52,2018
2018-01-25,Melaka,16,1,15,2018
2018-01-26,Melaka,306,156,150,2018
2018-01-27,Melaka,8,0,8,2018
2018-01-28,Melaka,138,28,110,2018
2018-01-29,Melaka,9,0,9,2018
2018-01-30,Melaka,59,24,35,2018
2018-01-31,Melaka,345,72,273,2018
2018-02-01,Melaka,91,58,33,2018
2018-02-02,Melaka,14,1,13,2018
2018-02-03,Melaka,18,4,14,2018
2018-02-04,Melaka,114,40,74,2018
2018-02-05,Melaka,5,0,5,2018
2018-02-06,Melaka,54,9,45,2018
2018-02-07,Melaka,85,39,46,2018
2018-02-08,Melaka,70,23,47,2018
2018-02-09,Melaka,7,0,7,2018
2018-02-10,Melaka,38,7,31,2018
2018-02-11,Melaka,55,16,39,2018
2018-02-12,Melaka,24,3,21,2018
2018-02-13,Melaka,117,25,92,2018
2018-02-14,Melaka,92,19,73,2018
2018-02-15,Melaka,65,6,59,2018
2018-02-16,Melaka,86,27,59,2018
2018-02-17,Melaka,98,64,34,2018
2018-02-18,Melaka,45,12,33,2018
2018-02-19,Melaka,30,3,27,2018
2018-02-20,Melaka,127,34,93,2018
2018-02-21,Melaka,36,6,30,2018
2018-02-22,Melaka,150,57,93,2018
2018-02-23,Melaka,38,19,19,2018
2018-02-24,Melaka,46,7,39,2018
2018-02-25,Melaka,97,32,65,2018
2018-02-26,Melaka,206,84,122,2018
2018-02-27,Melaka,49,27,22,2018
2018-02-28,Melaka,106,67,39,2018
2018-03-01,Melaka,47,6,41,2018
2018-03-02,Melaka,13,2,11,2018
2018-03-03,Melaka,60,11,49,2018
2018-03-04,Melaka,210,27,183,2018
2018-03-05,Melaka,17,1,16,2018
2018-03-06,Melaka,134,51,83,2018
2018-03-07,Melaka,138,50,88,2018
2018-03-08,Melaka,113,51,62,2018
2018-03-09,Melaka,6,2,4,2018
2018-03-10,Melaka,130,59,71,2018
2018-03-11,Melaka,217,62,155,2018
2018-03-12,Melaka,17,2,15,2018
2018-03-13,Melaka,32,11,21,2018
2018-03-14,Melaka,11,1,10,2018
2018-03-15,Melaka,48,9,39,2018
2018-03-16,Melaka,60,29,31,2018
2018-03-17,Melaka,72,16,56,2018
2018-03-18,Melaka,165,66,99,2018
2018-03-19,Melaka,140,36,104,2018
2018-03-20,Melaka,29,9,20,2018
2018-03-21,Melaka,145,44,101,2018
2018-03-22,Melaka,15,1,14,2018
2018-03-23,Melaka,54,9,45,2018
2018-03-24,Melaka,99,19,80,2018
2018-03-25,Melaka,344,45,299,2018
2018-03-26,Melaka,39,10,29,2018
2018-03-27,Melaka,70,11,59,2018
2018-03-28,Melaka,130,53,77,2018
2018-03-29,Melaka,71,20,51,2018
2018-03-30,Melaka,210,78,132,2018
2018-03-31,Melaka,166,42,124,2018
2018-04-01,Melaka,0,0,0,2018
2018-04-02,Melaka,76,51,25,2018
2018-04-03,Melaka,211,45,166,2018
2018-04-04,Melaka,68,13,55,2018
2018-04-05,Melaka,99,34,65,2018
2018-04-06,Melaka,10,0,10,2018
2018-04-07,Melaka,75,23,52,2018
2018-04-08,Melaka,88,23,65,2018
2018-04-09,Melaka,105,69,36,2018
2018-04-10,Melaka,140,47,93,2018
2018-04-11,Melaka,35,5,30,2018
2018-04-12,Melaka,86,16,70,2018
2018-04-13,Melaka,54,7,47,2018
2018-04-14,Melaka,36,7,29,2018
2018-04-15,Melaka,107,57,50,2018
2018-04-16,Melaka,35,14,21,2018
2018-04-17,Melaka,110,44,66,2018
2018-04-18,Melaka,105,27,78,2018
2018-04-19,Melaka,119,31,88,2018
2018-04-20,Melaka,38,24,14,2018
2018-04-21,Melaka,176,49,127,2018
2018-04-22,Melaka,159,63,96,2018
2018-04-23,Melaka,103,54,49,2018
2018-04-24,Melaka,119,59,60,2018
2018-04-25,Melaka,101,60,41,2018
2018-04-26,Melaka,75,11,64,2018
2018-04-27,Melaka,63,13,50,2018
2018-04-28,Melaka,157,41,116,2018
2018-04-29,Melaka,82,21,61,2018
2018-04-30,Melaka,21,1,20,2018
2018-05-01,Melaka,100,31,69,2018
2018-05-02,Melaka,12,1,11,2018
2018-05-03,Melaka,13,2,11,2018
2018-05-04,Melaka,49,27,22,2018
2018-05-05,Melaka,156,30,126,2018
2018-05-06,Melaka,130,26,104,2018
2018-05-07,Melaka,116,24,92,2018
2018-05-08,Melaka,83,10,73,2018
2018-05-09,Melaka,0,0,0,2018
2018-05-10,Melaka,4,1,3,2018
2018-05-11,Melaka,2,0,2,2018
2018-05-12,Melaka,175,39,136,2018
2018-05-13,Melaka,298,67,231,2018
2018-05-14,Melaka,20,0,20,2018
2018-05-15,Melaka,66,5,61,2018
2018-05-16,Melaka,75,13,62,2018
2018-05-17,Melaka,0,0,0,2018
2018-05-18,Melaka,5,0,5,2018
2018-05-19,Melaka,3,0,3,2018
2018-05-20,Melaka,150,28,122,2018
2018-05-21,Melaka,11,2,9,2018
2018-05-22,Melaka,10,1,9,2018
2018-05-23,Melaka,6,0,6,2018
2018-05-24,Melaka,356,165,191,2018
2018-05-25,Melaka,6,0,6,2018
2018-05-26,Melaka,38,18,20,2018
2018-05-27,Melaka,228,35,193,2018
2018-05-28,Melaka,12,2,10,2018
2018-05-29,Melaka,114,25,89,2018
2018-05-30,Melaka,41,8,33,2018
2018-05-31,Melaka,8,1,7,2018
2018-06-01,Melaka,74,25,49,2018
2018-06-02,Melaka,25,16,9,2018
2018-06-03,Melaka,332,29,303,2018
2018-06-04,Melaka,12,3,9,2018
2018-06-05,Melaka,10,0,10,2018
2018-06-06,Melaka,70,31,39,2018
2018-06-07,Melaka,64,26,38,2018
2018-06-08,Melaka,249,224,25,2018
2018-06-09,Melaka,0,0,0,2018
2018-06-10,Melaka,104,9,95,2018
2018-06-11,Melaka,5,1,4,2018
2018-06-12,Melaka,82,14,68,2018
2018-06-13,Melaka,52,13,39,2018
2018-06-14,Melaka,3,0,3,2018
2018-06-15,Melaka,0,0,0,2018
2018-06-16,Melaka,0,0,0,2018
2018-06-17,Melaka,42,6,36,2018
2018-06-18,Melaka,14,0,14,2018
2018-06-19,Melaka,53,9,44,2018
2018-06-20,Melaka,49,7,42,2018
2018-06-21,Melaka,47,8,39,2018
2018-06-22,Melaka,22,1,21,2018
2018-06-23,Melaka,158,33,125,2018
2018-06-24,Melaka,164,42,122,2018
2018-06-25,Melaka,20,1,19,2018
2018-06-26,Melaka,12,0,12,2018
2018-06-27,Melaka,57,7,50,2018
2018-06-28,Melaka,124,28,96,2018
2018-06-29,Melaka,11,0,11,2018
2018-06-30,Melaka,50,7,43,2018
2018-07-01,Melaka,127,30,97,2018
2018-07-02,Melaka,80,18,62,2018
2018-07-03,Melaka,13,2,11,2018
2018-07-04,Melaka,109,35,74,2018
2018-07-05,Melaka,49,15,34,2018
2018-07-06,Melaka,22,2,20,2018
2018-07-07,Melaka,64,7,57,2018
2018-07-08,Melaka,10,2,8,2018
2018-07-09,Melaka,17,1,16,2018
2018-07-10,Melaka,68,10,58,2018
2018-07-11,Melaka,92,38,54,2018
2018-07-12,Melaka,190,57,133,2018
2018-07-13,Melaka,19,5,14,2018
2018-07-14,Melaka,80,26,54,2018
2018-07-15,Melaka,123,29,94,2018
2018-07-16,Melaka,19,4,15,2018
2018-07-17,Melaka,101,45,56,2018
2018-07-18,Melaka,161,77,84,2018
2018-07-19,Melaka,96,26,70,2018
2018-07-20,Melaka,18,2,16,2018
2018-07-21,Melaka,0,0,0,2018
2018-07-22,Melaka,283,95,188,2018
2018-07-23,Melaka,196,31,165,2018
2018-07-24,Melaka,18,4,14,2018
2018-07-25,Melaka,23,3,20,2018
2018-07-26,Melaka,92,18,74,2018
2018-07-27,Melaka,56,26,30,2018
2018-07-28,Melaka,195,48,147,2018
2018-07-29,Melaka,120,51,69,2018
2018-07-30,Melaka,16,2,14,2018
2018-07-31,Melaka,51,10,41,2018
2018-08-01,Melaka,62,15,47,2018
2018-08-02,Melaka,113,34,79,2018
2018-08-03,Melaka,15,1,14,2018
2018-08-04,Melaka,96,21,75,2018
2018-08-05,Melaka,76,35,41,2018
2018-08-06,Melaka,58,11,47,2018
2018-08-07,Melaka,281,87,194,2018
2018-08-08,Melaka,289,65,224,2018
2018-08-09,Melaka,107,27,80,2018
2018-08-10,Melaka,9,2,7,2018
2018-08-11,Melaka,191,44,147,2018
2018-08-12,Melaka,173,26,147,2018
2018-08-13,Melaka,15,1,14,2018
2018-08-14,Melaka,66,39,27,2018
2018-08-15,Melaka,163,39,124,2018
2018-08-16,Melaka,147,70,77,2018
2018-08-17,Melaka,91,20,71,2018
2018-08-18,Melaka,211,43,168,2018
2018-08-19,Melaka,437,120,317,2018
2018-08-20,Melaka,12,0,12,2018
2018-08-21,Melaka,13,0,13,2018
2018-08-22,Melaka,0,0,0,2018
2018-08-23,Melaka,66,18,48,2018
2018-08-24,Melaka,100,33,67,2018
2018-08-25,Melaka,186,41,145,2018
2018-08-26,Melaka,159,9,150,2018
2018-08-27,Melaka,11,2,9,2018
2018-08-28,Melaka,116,29,87,2018
2018-08-29,Melaka,102,44,58,2018
2018-08-30,Melaka,50,15,35,2018
2018-08-31,Melaka,150,41,109,2018
2018-09-01,Melaka,58,17,41,2018
2018-09-02,Melaka,171,41,130,2018
2018-09-03,Melaka,13,0,13,2018
2018-09-04,Melaka,112,26,86,2018
2018-09-05,Melaka,110,46,64,2018
2018-09-06,Melaka,161,59,102,2018
2018-09-07,Melaka,5,1,4,2018
2018-09-08,Melaka,99,28,71,2018
2018-09-09,Melaka,191,34,157,2018
2018-09-10,Melaka,0,0,0,2018
2018-09-11,Melaka,0,0,0,2018
2018-09-12,Melaka,13,2,11,2018
2018-09-13,Melaka,53,13,40,2018
2018-09-14,Melaka,254,146,108,2018
2018-09-15,Melaka,74,20,54,2018
2018-09-16,Melaka,202,40,162,2018
2018-09-17,Melaka,0,0,0,2018
2018-09-18,Melaka,166,91,75,2018
2018-09-19,Melaka,161,106,55,2018
2018-09-20,Melaka,13,1,12,2018
2018-09-21,Melaka,74,16,58,2018
2018-09-22,Melaka,106,40,66,2018
2018-09-23,Melaka,44,10,34,2018
2018-09-24,Melaka,21,1,20,2018
2018-09-25,Melaka,13,0,13,2018
2018-09-26,Melaka,32,8,24,2018
2018-09-27,Melaka,52,11,41,2018
2018-09-28,Melaka,44,6,38,2018
2018-09-29,Melaka,93,19,74,2018
2018-09-30,Melaka,119,14,105,2018
2018-10-01,Melaka,12,0,12,2018
2018-10-02,Melaka,112,28,84,2018
2018-10-03,Melaka,114,41,73,2018
2018-10-04,Melaka,103,29,74,2018
2018-10-05,Melaka,11,0,11,2018
2018-10-06,Melaka,103,24,79,2018
2018-10-07,Melaka,118,15,103,2018
2018-10-08,Melaka,20,5,15,2018
2018-10-09,Melaka,74,17,57,2018
2018-10-10,Melaka,85,21,64,2018
2018-10-11,Melaka,155,71,84,2018
2018-10-12,Melaka,87,26,61,2018
2018-10-13,Melaka,89,19,70,2018
2018-10-14,Melaka,125,35,90,2018
2018-10-15,Melaka,12,1,11,2018
2018-10-16,Melaka,66,6,60,2018
2018-10-17,Melaka,78,13,65,2018
2018-10-18,Melaka,10,0,10,2018
2018-10-19,Melaka,164,53,111,2018
2018-10-20,Melaka,52,6,46,2018
2018-10-21,Melaka,169,46,123,2018
2018-10-22,Melaka,23,2,21,2018
2018-10-23,Melaka,125,63,62,2018
2018-10-24,Melaka,65,9,56,2018
2018-10-25,Melaka,22,2,20,2018
2018-10-26,Melaka,57,17,40,2018
2018-10-27,Melaka,68,21,47,2018
2018-10-28,Melaka,166,25,141,2018
2018-10-29,Melaka,34,12,22,2018
2018-10-30,Melaka,71,25,46,2018
2018-10-31,Melaka,108,33,75,2018
2018-11-01,Melaka,95,27,68,2018
2018-11-02,Melaka,9,1,8,2018
2018-11-03,Melaka,99,21,78,2018
2018-11-04,Melaka,59,6,53,2018
2018-11-05,Melaka,13,0,13,2018
2018-11-06,Melaka,0,0,0,2018
2018-11-07,Melaka,51,11,40,2018
2018-11-08,Melaka,116,24,92,2018
2018-11-09,Melaka,11,1,10,2018
2018-11-10,Melaka,192,57,135,2018
2018-11-11,Melaka,80,7,73,2018
2018-11-12,Melaka,133,36,97,2018
2018-11-13,Melaka,35,10,25,2018
2018-11-14,Melaka,103,22,81,2018
2018-11-15,Melaka,49,12,37,2018
2018-11-16,Melaka,11,2,9,2018
2018-11-17,Melaka,83,18,65,2018
2018-11-18,Melaka,75,17,58,2018
2018-11-19,Melaka,56,8,48,2018
2018-11-20,Melaka,1,0,1,2018
2018-11-21,Melaka,153,46,107,2018
2018-11-22,Melaka,89,18,71,2018
2018-11-23,Melaka,22,4,18,2018
2018-11-24,Melaka,143,39,104,2018
2018-11-25,Melaka,174,67,107,2018
2018-11-26,Melaka,17,2,15,2018
2018-11-27,Melaka,24,4,20,2018
2018-11-28,Melaka,144,40,104,2018
2018-11-29,Melaka,93,36,57,2018
2018-11-30,Melaka,71,17,54,2018
2018-12-01,Melaka,9,2,7,2018
2018-12-02,Melaka,460,36,424,2018
2018-12-03,Melaka,16,1,15,2018
2018-12-04,Melaka,16,1,15,2018
2018-12-05,Melaka,75,21,54,2018
2018-12-06,Melaka,40,6,34,2018
2018-12-07,Melaka,11,0,11,2018
2018-12-08,Melaka,34,4,30,2018
2018-12-09,Melaka,105,32,73,2018
2018-12-10,Melaka,16,0,16,2018
2018-12-11,Melaka,93,36,57,2018
2018-12-12,Melaka,131,41,90,2018
2018-12-13,Melaka,179,72,107,2018
2018-12-14,Melaka,8,1,7,2018
2018-12-15,Melaka,102,23,79,2018
2018-12-16,Melaka,43,1,42,2018
2018-12-17,Melaka,21,1,20,2018
2018-12-18,Melaka,78,17,61,2018
2018-12-19,Melaka,114,27,87,2018
2018-12-20,Melaka,12,3,9,2018
2018-12-21,Melaka,12,1,11,2018
2018-12-22,Melaka,19,5,14,2018
2018-12-23,Melaka,274,70,204,2018
2018-12-24,Melaka,15,1,14,2018
2018-12-25,Melaka,81,14,67,2018
2018-12-26,Melaka,17,0,17,2018
2018-12-27,Melaka,35,2,33,2018
2018-12-28,Melaka,15,2,13,2018
2018-12-29,Melaka,105,20,85,2018
2018-12-30,Melaka,140,25,115,2018
2018-12-31,Melaka,16,0,16,2018
2019-01-01,Melaka,83,8,75,2019
2019-01-02,Melaka,57,13,44,2019
2019-01-03,Melaka,22,3,19,2019
2019-01-04,Melaka,13,0,13,2019
2019-01-05,Melaka,97,20,77,2019
2019-01-06,Melaka,116,19,97,2019
2019-01-07,Melaka,13,1,12,2019
2019-01-08,Melaka,12,1,11,2019
2019-01-09,Melaka,353,67,286,2019
2019-01-10,Melaka,20,2,18,2019
2019-01-11,Melaka,49,14,35,2019
2019-01-12,Melaka,36,8,28,2019
2019-01-13,Melaka,80,16,64,2019
2019-01-14,Melaka,21,3,18,2019
2019-01-15,Melaka,158,74,84,2019
2019-01-16,Melaka,13,3,10,2019
2019-01-17,Melaka,142,39,103,2019
2019-01-18,Melaka,222,86,136,2019
2019-01-19,Melaka,66,20,46,2019
2019-01-20,Melaka,136,30,106,2019
2019-01-21,Melaka,14,1,13,2019
2019-01-22,Melaka,16,2,14,2019
2019-01-23,Melaka,137,60,77,2019
2019-01-24,Melaka,8,0,8,2019
2019-01-25,Melaka,54,13,41,2019
2019-01-26,Melaka,175,29,146,2019
2019-01-27,Melaka,140,28,112,2019
2019-01-28,Melaka,21,4,17,2019
2019-01-29,Melaka,69,25,44,2019
2019-01-30,Melaka,42,19,23,2019
2019-01-31,Melaka,176,70,106,2019
2019-02-01,Melaka,25,5,20,2019
2019-02-02,Melaka,133,33,100,2019
2019-02-03,Melaka,126,30,96,2019
2019-02-04,Melaka,88,13,75,2019
2019-02-05,Melaka,88,26,62,2019
2019-02-06,Melaka,52,10,42,2019
2019-02-07,Melaka,74,23,51,2019
2019-02-08,Melaka,14,2,12,2019
2019-02-09,Melaka,94,25,69,2019
2019-02-10,Melaka,170,53,117,2019
2019-02-11,Melaka,18,1,17,2019
2019-02-12,Melaka,41,16,25,2019
2019-02-13,Melaka,99,41,58,2019
2019-02-14,Melaka,159,52,107,2019
2019-02-15,Melaka,17,0,17,2019
2019-02-16,Melaka,131,41,90,2019
2019-02-17,Melaka,97,27,70,2019
2019-02-18,Melaka,79,39,40,2019
2019-02-19,Melaka,11,2,9,2019
2019-02-20,Melaka,97,24,73,2019
2019-02-21,Melaka,13,1,12,2019
2019-02-22,Melaka,266,127,139,2019
2019-02-23,Melaka,82,22,60,2019
2019-02-24,Melaka,218,17,201,2019
2019-02-25,Melaka,12,2,10,2019
2019-02-26,Melaka,104,23,81,2019
2019-02-27,Melaka,10,1,9,2019
2019-02-28,Melaka,150,90,60,2019
2019-03-01,Melaka,9,1,8,2019
2019-03-02,Melaka,10,3,7,2019
2019-03-03,Melaka,115,15,100,2019
2019-03-04,Melaka,28,5,23,2019
2019-03-05,Melaka,67,14,53,2019
2019-03-06,Melaka,208,97,111,2019
2019-03-07,Melaka,130,58,72,2019
2019-03-08,Melaka,13,0,13,2019
2019-03-09,Melaka,11,1,10,2019
2019-03-10,Melaka,231,47,184,2019
2019-03-11,Melaka,13,0,13,2019
2019-03-12,Melaka,12,1,11,2019
2019-03-13,Melaka,96,15,81,2019
2019-03-14,Melaka,16,1,15,2019
2019-03-15,Melaka,8,0,8,2019
2019-03-16,Melaka,180,44,136,2019
2019-03-17,Melaka,256,67,189,2019
2019-03-18,Melaka,93,14,79,2019
2019-03-19,Melaka,339,120,219,2019
2019-03-20,Melaka,93,34,59,2019
2019-03-21,Melaka,110,50,60,2019
2019-03-22,Melaka,9,0,9,2019
2019-03-23,Melaka,31,9,22,2019
2019-03-24,Melaka,231,53,178,2019
2019-03-25,Melaka,20,1,19,2019
2019-03-26,Melaka,125,48,77,2019
2019-03-27,Melaka,107,34,73,2019
2019-03-28,Melaka,109,28,81,2019
2019-03-29,Melaka,11,0,11,2019
2019-03-30,Melaka,7,0,7,2019
2019-03-31,Melaka,69,23,46,2019
2019-04-01,Melaka,11,1,10,2019
2019-04-02,Melaka,145,51,94,2019
2019-04-03,Melaka,97,69,28,2019
2019-04-04,Melaka,98,25,73,2019
2019-04-05,Melaka,7,0,7,2019
2019-04-06,Melaka,155,32,123,2019
2019-04-07,Melaka,112,19,93,2019
2019-04-08,Melaka,67,35,32,2019
2019-04-09,Melaka,123,54,69,2019
2019-04-10,Melaka,131,72,59,2019
2019-04-11,Melaka,109,35,74,2019
2019-04-12,Melaka,13,1,12,2019
2019-04-13,Melaka,39,12,27,2019
2019-04-14,Melaka,131,26,105,2019
2019-04-15,Melaka,170,35,135,2019
2019-04-16,Melaka,81,43,38,2019
2019-04-17,Melaka,18,5,13,2019
2019-04-18,Melaka,115,94,21,2019
2019-04-19,Melaka,13,2,11,2019
2019-04-20,Melaka,157,52,105,2019
2019-04-21,Melaka,124,37,87,2019
2019-04-22,Melaka,77,21,56,2019
2019-04-23,Melaka,111,36,75,2019
2019-04-24,Melaka,138,41,97,2019
2019-04-25,Melaka,98,47,51,2019
2019-04-26,Melaka,103,44,59,2019
2019-04-27,Melaka,182,36,146,2019
2019-04-28,Melaka,184,30,154,2019
2019-04-29,Melaka,125,58,67,2019
2019-04-30,Melaka,78,52,26,2019
2019-05-01,Melaka,243,37,206,2019
2019-05-02,Melaka,78,22,56,2019
2019-05-03,Melaka,23,2,21,2019
2019-05-04,Melaka,103,16,87,2019
2019-05-05,Melaka,185,25,160,2019
2019-05-06,Melaka,0,0,0,2019
2019-05-07,Melaka,7,1,6,2019
2019-05-08,Melaka,7,0,7,2019
2019-05-09,Melaka,37,9,28,2019
2019-05-10,Melaka,4,0,4,2019
2019-05-11,Melaka,62,14,48,2019
2019-05-12,Melaka,106,11,95,2019
2019-05-13,Melaka,9,0,9,2019
2019-05-14,Melaka,43,11,32,2019
2019-05-15,Melaka,194,125,69,2019
2019-05-16,Melaka,173,97,76,2019
2019-05-17,Melaka,7,1,6,2019
2019-05-18,Melaka,126,35,91,2019
2019-05-19,Melaka,150,21,129,2019
2019-05-20,Melaka,54,12,42,2019
2019-05-21,Melaka,55,23,32,2019
2019-05-22,Melaka,65,37,28,2019
2019-05-23,Melaka,7,1,6,2019
2019-05-24,Melaka,238,217,21,2019
2019-05-25,Melaka,70,21,49,2019
2019-05-26,Melaka,110,15,95,2019
2019-05-27,Melaka,54,16,38,2019
2019-05-28,Melaka,24,4,20,2019
2019-05-29,Melaka,123,51,72,2019
2019-05-30,Melaka,31,4,27,2019
2019-05-31,Melaka,5,0,5,2019
2019-06-01,Melaka,62,17,45,2019
2019-06-02,Melaka,187,13,174,2019
2019-06-03,Melaka,55,16,39,2019
2019-06-04,Melaka,8,0,8,2019
2019-06-05,Melaka,0,0,0,2019
2019-06-06,Melaka,0,0,0,2019
2019-06-07,Melaka,32,5,27,2019
2019-06-08,Melaka,33,7,26,2019
2019-06-09,Melaka,134,22,112,2019
2019-06-10,Melaka,21,2,19,2019
2019-06-11,Melaka,57,28,29,2019
2019-06-12,Melaka,62,4,58,2019
2019-06-13,Melaka,9,1,8,2019
2019-06-14,Melaka,148,17,131,2019
2019-06-15,Melaka,0,0,0,2019
2019-06-16,Melaka,93,26,67,2019
2019-06-17,Melaka,93,12,81,2019
2019-06-18,Melaka,134,21,113,2019
2019-06-19,Melaka,16,0,16,2019
2019-06-20,Melaka,73,9,64,2019
2019-06-21,Melaka,15,1,14,2019
2019-06-22,Melaka,99,17,82,2019
2019-06-23,Melaka,232,48,184,2019
2019-06-24,Melaka,19,1,18,2019
2019-06-25,Melaka,51,8,43,2019
2019-06-26,Melaka,70,15,55,2019
2019-06-27,Melaka,95,18,77,2019
2019-06-28,Melaka,49,6,43,2019
2019-06-29,Melaka,115,17,98,2019
2019-06-30,Melaka,153,25,128,2019
2019-07-01,Melaka,21,0,21,2019
2019-07-02,Melaka,44,7,37,2019
2019-07-03,Melaka,127,66,61,2019
2019-07-04,Melaka,165,57,108,2019
2019-07-05,Melaka,63,24,39,2019
2019-07-06,Melaka,139,24,115,2019
2019-07-07,Melaka,225,58,167,2019
2019-07-08,Melaka,47,6,41,2019
2019-07-09,Melaka,100,11,89,2019
2019-07-10,Melaka,169,78,91,2019
2019-07-11,Melaka,83,32,51,2019
2019-07-12,Melaka,15,1,14,2019
2019-07-13,Melaka,183,40,143,2019
2019-07-14,Melaka,156,29,127,2019
2019-07-15,Melaka,17,2,15,2019
2019-07-16,Melaka,64,5,59,2019
2019-07-17,Melaka,70,13,57,2019
2019-07-18,Melaka,41,13,28,2019
2019-07-19,Melaka,20,2,18,2019
2019-07-20,Melaka,142,31,111,2019
2019-07-21,Melaka,222,41,181,2019
2019-07-22,Melaka,15,3,12,2019
2019-07-23,Melaka,23,3,20,2019
2019-07-24,Melaka,144,47,97,2019
2019-07-25,Melaka,223,59,164,2019
2019-07-26,Melaka,156,45,111,2019
2019-07-27,Melaka,86,15,71,2019
2019-07-28,Melaka,125,40,85,2019
2019-07-29,Melaka,22,1,21,2019
2019-07-30,Melaka,140,37,103,2019
2019-07-31,Melaka,56,20,36,2019
2019-08-01,Melaka,11,3,8,2019
2019-08-02,Melaka,52,19,33,2019
2019-08-03,Melaka,125,29,96,2019
2019-08-04,Melaka,186,60,126,2019
2019-08-05,Melaka,50,18,32,2019
2019-08-06,Melaka,59,12,47,2019
2019-08-07,Melaka,107,21,86,2019
2019-08-08,Melaka,19,1,18,2019
2019-08-09,Melaka,164,35,129,2019
2019-08-10,Melaka,1,0,1,2019
2019-08-11,Melaka,0,0,0,2019
2019-08-12,Melaka,83,13,70,2019
2019-08-13,Melaka,18,0,18,2019
2019-08-14,Melaka,82,11,71,2019
2019-08-15,Melaka,46,23,23,2019
2019-08-16,Melaka,93,17,76,2019
2019-08-17,Melaka,136,28,108,2019
2019-08-18,Melaka,215,22,193,2019
2019-08-19,Melaka,12,2,10,2019
2019-08-20,Melaka,109,35,74,2019
2019-08-21,Melaka,106,51,55,2019
2019-08-22,Melaka,85,29,56,2019
2019-08-23,Melaka,6,0,6,2019
2019-08-24,Melaka,294,54,240,2019
2019-08-25,Melaka,330,70,260,2019
2019-08-26,Melaka,62,14,48,2019
2019-08-27,Melaka,7,0,7,2019
2019-08-28,Melaka,13,1,12,2019
2019-08-29,Melaka,0,0,0,2019
2019-08-30,Melaka,10,1,9,2019
2019-08-31,Melaka,44,12,32,2019
2019-09-01,Melaka,85,12,73,2019
2019-09-02,Melaka,0,0,0,2019
2019-09-03,Melaka,9,0,9,2019
2019-09-04,Melaka,116,33,83,2019
2019-09-05,Melaka,144,62,82,2019
2019-09-06,Melaka,13,1,12,2019
2019-09-07,Melaka,107,25,82,2019
2019-09-08,Melaka,102,11,91,2019
2019-09-09,Melaka,0,0,0,2019
2019-09-10,Melaka,11,1,10,2019
2019-09-11,Melaka,235,72,163,2019
2019-09-12,Melaka,12,1,11,2019
2019-09-13,Melaka,8,0,8,2019
2019-09-14,Melaka,61,16,45,2019
2019-09-15,Melaka,144,23,121,2019
2019-09-16,Melaka,99,20,79,2019
2019-09-17,Melaka,70,11,59,2019
2019-09-18,Melaka,183,37,146,2019
2019-09-19,Melaka,30,5,25,2019
2019-09-20,Melaka,47,9,38,2019
2019-09-21,Melaka,127,29,98,2019
2019-09-22,Melaka,164,28,136,2019
2019-09-23,Melaka,17,0,17,2019
2019-09-24,Melaka,17,1,16,2019
2019-09-25,Melaka,14,2,12,2019
2019-09-26,Melaka,82,33,49,2019
2019-09-27,Melaka,69,19,50,2019
2019-09-28,Melaka,23,4,19,2019
2019-09-29,Melaka,212,43,169,2019
2019-09-30,Melaka,69,18,51,2019
2019-10-01,Melaka,11,1,10,2019
2019-10-02,Melaka,29,4,25,2019
2019-10-03,Melaka,122,31,91,2019
2019-10-04,Melaka,19,2,17,2019
2019-10-05,Melaka,64,19,45,2019
2019-10-06,Melaka,153,23,130,2019
2019-10-07,Melaka,287,204,83,2019
2019-10-08,Melaka,10,0,10,2019
2019-10-09,Melaka,17,1,16,2019
2019-10-10,Melaka,11,1,10,2019
2019-10-11,Melaka,30,11,19,2019
2019-10-12,Melaka,77,18,59,2019
2019-10-13,Melaka,124,18,106,2019
2019-10-14,Melaka,17,2,15,2019
2019-10-15,Melaka,88,18,70,2019
2019-10-16,Melaka,19,1,18,2019
2019-10-17,Melaka,107,18,89,2019
2019-10-18,Melaka,13,1,12,2019
2019-10-19,Melaka,191,40,151,2019
2019-10-20,Melaka,118,20,98,2019
2019-10-21,Melaka,21,3,18,2019
2019-10-22,Melaka,137,62,75,2019
2019-10-23,Melaka,13,2,11,2019
2019-10-24,Melaka,83,21,62,2019
2019-10-25,Melaka,172,58,114,2019
2019-10-26,Melaka,62,13,49,2019
2019-10-27,Melaka,0,0,0,2019
2019-10-28,Melaka,89,19,70,2019
2019-10-29,Melaka,16,3,13,2019
2019-10-30,Melaka,12,0,12,2019
2019-10-31,Melaka,42,8,34,2019
2019-11-01,Melaka,12,0,12,2019
2019-11-02,Melaka,128,35,93,2019
2019-11-03,Melaka,130,72,58,2019
2019-11-04,Melaka,9,0,9,2019
2019-11-05,Melaka,58,10,48,2019
2019-11-06,Melaka,32,8,24,2019
2019-11-07,Melaka,68,25,43,2019
2019-11-08,Melaka,9,0,9,2019
2019-11-09,Melaka,123,21,102,2019
2019-11-10,Melaka,194,36,158,2019
2019-11-11,Melaka,16,0,16,2019
2019-11-12,Melaka,47,9,38,2019
2019-11-13,Melaka,93,15,78,2019
2019-11-14,Melaka,63,7,56,2019
2019-11-15,Melaka,19,4,15,2019
2019-11-16,Melaka,39,17,22,2019
2019-11-17,Melaka,36,4,32,2019
2019-11-18,Melaka,18,1,17,2019
2019-11-19,Melaka,71,9,62,2019
2019-11-20,Melaka,95,38,57,2019
2019-11-21,Melaka,35,11,24,2019
2019-11-22,Melaka,11,1,10,2019
2019-11-23,Melaka,48,7,41,2019
2019-11-24,Melaka,235,81,154,2019
2019-11-25,Melaka,16,0,16,2019
2019-11-26,Melaka,123,42,81,2019
2019-11-27,Melaka,81,10,71,2019
2019-11-28,Melaka,50,7,43,2019
2019-11-29,Melaka,114,42,72,2019
2019-11-30,Melaka,33,21,12,2019
2019-12-01,Melaka,400,28,372,2019
2019-12-02,Melaka,20,3,17,2019
2019-12-03,Melaka,12,2,10,2019
2019-12-04,Melaka,76,60,16,2019
2019-12-05,Melaka,158,88,70,2019
2019-12-06,Melaka,52,6,46,2019
2019-12-07,Melaka,206,54,152,2019
2019-12-08,Melaka,185,36,149,2019
2019-12-09,Melaka,51,13,38,2019
2019-12-10,Melaka,63,9,54,2019
2019-12-11,Melaka,95,58,37,2019
2019-12-12,Melaka,80,13,67,2019
2019-12-13,Melaka,12,2,10,2019
2019-12-14,Melaka,186,35,151,2019
2019-12-15,Melaka,233,58,175,2019
2019-12-16,Melaka,10,0,10,2019
2019-12-17,Melaka,39,5,34,2019
2019-12-18,Melaka,44,10,34,2019
2019-12-19,Melaka,92,20,72,2019
2019-12-20,Melaka,5,1,4,2019
2019-12-21,Melaka,58,12,46,2019
2019-12-22,Melaka,142,18,124,2019
2019-12-23,Melaka,12,1,11,2019
2019-12-24,Melaka,60,11,49,2019
2019-12-25,Melaka,142,22,120,2019
2019-12-26,Melaka,22,4,18,2019
2019-12-27,Melaka,14,1,13,2019
2019-12-28,Melaka,189,41,148,2019
2019-12-29,Melaka,82,43,39,2019
2019-12-30,Melaka,48,25,23,2019
2019-12-31,Melaka,81,14,67,2019
2020-01-01,Melaka,123,29,94,2020
2020-01-02,Melaka,9,3,6,2020
2020-01-03,Melaka,9,3,6,2020
2020-01-04,Melaka,114,19,95,2020
2020-01-05,Melaka,92,51,41,2020
2020-01-06,Melaka,6,1,5,2020
2020-01-07,Melaka,109,29,80,2020
2020-01-08,Melaka,151,50,101,2020
2020-01-09,Melaka,18,2,16,2020
2020-01-10,Melaka,265,163,102,2020
2020-01-11,Melaka,132,34,98,2020
2020-01-12,Melaka,80,10,70,2020
2020-01-13,Melaka,18,1,17,2020
2020-01-14,Melaka,71,22,49,2020
2020-01-15,Melaka,135,58,77,2020
2020-01-16,Melaka,79,17,62,2020
2020-01-17,Melaka,39,9,30,2020
2020-01-18,Melaka,79,24,55,2020
2020-01-19,Melaka,63,13,50,2020
2020-01-20,Melaka,124,31,93,2020
2020-01-21,Melaka,47,8,39,2020
2020-01-22,Melaka,63,15,48,2020
2020-01-23,Melaka,56,12,44,2020
2020-01-24,Melaka,7,1,6,2020
2020-01-25,Melaka,85,27,58,2020
2020-01-26,Melaka,124,35,89,2020
2020-01-27,Melaka,0,0,0,2020
2020-01-28,Melaka,104,23,81,2020
2020-01-29,Melaka,72,21,51,2020
2020-01-30,Melaka,113,32,81,2020
2020-01-31,Melaka,9,2,7,2020
2020-02-01,Melaka,72,20,52,2020
2020-02-02,Melaka,164,45,119,2020
2020-02-03,Melaka,20,1,19,2020
2020-02-04,Melaka,56,14,42,2020
2020-02-05,Melaka,36,10,26,2020
2020-02-06,Melaka,229,86,143,2020
2020-02-07,Melaka,19,0,19,2020
2020-02-08,Melaka,106,30,76,2020
2020-02-09,Melaka,158,29,129,2020
2020-02-10,Melaka,11,3,8,2020
2020-02-11,Melaka,57,6,51,2020
2020-02-12,Melaka,69,32,37,2020
2020-02-13,Melaka,77,38,39,2020
2020-02-14,Melaka,15,1,14,2020
2020-02-15,Melaka,190,47,143,2020
2020-02-16,Melaka,187,15,172,2020
2020-02-17,Melaka,77,34,43,2020
2020-02-18,Melaka,76,27,49,2020
2020-02-19,Melaka,130,25,105,2020
2020-02-20,Melaka,143,35,108,2020
2020-02-21,Melaka,221,133,88,2020
2020-02-22,Melaka,102,21,81,2020
2020-02-23,Melaka,188,33,155,2020
2020-02-24,Melaka,170,57,113,2020
2020-02-25,Melaka,136,68,68,2020
2020-02-26,Melaka,155,32,123,2020
2020-02-27,Melaka,35,6,29,2020
2020-02-28,Melaka,11,0,11,2020
2020-02-29,Melaka,63,14,49,2020
2020-03-01,Melaka,171,35,136,2020
2020-03-02,Melaka,35,8,27,2020
2020-03-03,Melaka,58,10,48,2020
2020-03-04,Melaka,69,26,43,2020
2020-03-05,Melaka,128,68,60,2020
2020-03-06,Melaka,10,0,10,2020
2020-03-07,Melaka,166,39,127,2020
2020-03-08,Melaka,197,25,172,2020
2020-03-09,Melaka,55,19,36,2020
2020-03-10,Melaka,64,23,41,2020
2020-03-11,Melaka,16,2,14,2020
2020-03-12,Melaka,162,73,89,2020
2020-03-13,Melaka,97,30,67,2020
2020-03-14,Melaka,56,8,48,2020
2020-03-15,Melaka,117,9,108,2020
2020-03-16,Melaka,14,1,13,2020
2020-03-17,Melaka,24,1,23,2020
2020-03-18,Melaka,25,1,24,2020
2020-03-19,Melaka,40,9,31,2020
2020-03-20,Melaka,42,5,37,2020
2020-03-21,Melaka,27,5,22,2020
2020-03-22,Melaka,11,0,11,2020
2020-03-23,Melaka,105,26,79,2020
2020-03-24,Melaka,93,21,72,2020
2020-03-25,Melaka,98,35,63,2020
2020-03-26,Melaka,64,21,43,2020
2020-03-27,Melaka,55,9,46,2020
2020-03-28,Melaka,18,2,16,2020
2020-03-29,Melaka,30,11,19,2020
2020-03-30,Melaka,53,15,38,2020
2020-03-31,Melaka,40,3,37,2020
2020-04-01,Melaka,128,27,101,2020
2020-04-02,Melaka,44,7,37,2020
2020-04-03,Melaka,37,13,24,2020
2020-04-04,Melaka,7,0,7,2020
2020-04-05,Melaka,56,8,48,2020
2020-04-06,Melaka,14,3,11,2020
2020-04-07,Melaka,110,28,82,2020
2020-04-08,Melaka,11,1,10,2020
2020-04-09,Melaka,56,19,37,2020
2020-04-10,Melaka,16,3,13,2020
2020-04-11,Melaka,6,0,6,2020
2020-04-12,Melaka,4,1,3,2020
2020-04-13,Melaka,24,3,21,2020
2020-04-14,Melaka,62,10,52,2020
2020-04-15,Melaka,72,14,58,2020
2020-04-16,Melaka,55,14,41,2020
2020-04-17,Melaka,45,7,38,2020
2020-04-18,Melaka,86,11,75,2020
2020-04-19,Melaka,9,1,8,2020
2020-04-20,Melaka,63,8,55,2020
2020-04-21,Melaka,52,13,39,2020
2020-04-22,Melaka,98,29,69,2020
2020-04-23,Melaka,105,18,87,2020
2020-04-24,Melaka,0,0,0,2020
2020-04-25,Melaka,2,0,2,2020
2020-04-26,Melaka,78,6,72,2020
2020-04-27,Melaka,73,45,28,2020
2020-04-28,Melaka,33,0,33,2020
2020-04-29,Melaka,135,25,110,2020
2020-04-30,Melaka,104,10,94,2020
2020-05-01,Melaka,58,5,53,2020
2020-05-02,Melaka,38,4,34,2020
2020-05-03,Melaka,24,0,24,2020
2020-05-04,Melaka,106,36,70,2020
2020-05-05,Melaka,41,5,36,2020
2020-05-06,Melaka,74,27,47,2020
2020-05-07,Melaka,140,14,126,2020
2020-05-08,Melaka,33,3,30,2020
2020-05-09,Melaka,50,6,44,2020
2020-05-10,Melaka,35,2,33,2020
2020-05-11,Melaka,74,21,53,2020
2020-05-12,Melaka,19,1,18,2020
2020-05-13,Melaka,29,4,25,2020
2020-05-14,Melaka,32,3,29,2020
2020-05-15,Melaka,23,7,16,2020
2020-05-16,Melaka,45,4,41,2020
2020-05-17,Melaka,52,8,44,2020
2020-05-18,Melaka,71,23,48,2020
2020-05-19,Melaka,82,12,70,2020
2020-05-20,Melaka,125,69,56,2020
2020-05-21,Melaka,53,3,50,2020
2020-05-22,Melaka,110,20,90,2020
2020-05-23,Melaka,24,5,19,2020
2020-05-24,Melaka,0,0,0,2020
2020-05-25,Melaka,3,0,3,2020
2020-05-26,Melaka,125,32,93,2020
2020-05-27,Melaka,63,12,51,2020
2020-05-28,Melaka,120,20,100,2020
2020-05-29,Melaka,80,11,69,2020
2020-05-30,Melaka,165,28,137,2020
2020-05-31,Melaka,231,53,178,2020
2020-06-01,Melaka,30,2,28,2020
2020-06-02,Melaka,127,31,96,2020
2020-06-03,Melaka,63,6,57,2020
2020-06-04,Melaka,47,2,45,2020
2020-06-05,Melaka,50,9,41,2020
2020-06-06,Melaka,157,50,107,2020
2020-06-07,Melaka,127,24,103,2020
2020-06-08,Melaka,102,21,81,2020
2020-06-09,Melaka,58,12,46,2020
2020-06-10,Melaka,99,24,75,2020
2020-06-11,Melaka,53,7,46,2020
2020-06-12,Melaka,12,2,10,2020
2020-06-13,Melaka,141,36,105,2020
2020-06-14,Melaka,128,19,109,2020
2020-06-15,Melaka,17,2,15,2020
2020-06-16,Melaka,44,10,34,2020
2020-06-17,Melaka,116,38,78,2020
2020-06-18,Melaka,73,11,62,2020
2020-06-19,Melaka,12,0,12,2020
2020-06-20,Melaka,109,31,78,2020
2020-06-21,Melaka,133,17,116,2020
2020-06-22,Melaka,19,1,18,2020
2020-06-23,Melaka,54,5,49,2020
2020-06-24,Melaka,56,12,44,2020
2020-06-25,Melaka,100,25,75,2020
2020-06-26,Melaka,11,0,11,2020
2020-06-27,Melaka,126,34,92,2020
2020-06-28,Melaka,132,27,105,2020
2020-06-29,Melaka,14,3,11,2020
2020-06-30,Melaka,80,15,65,2020
2020-07-01,Melaka,80,27,53,2020
2020-07-02,Melaka,41,8,33,2020
2020-07-03,Melaka,12,0,12,2020
2020-07-04,Melaka,71,14,57,2020
2020-07-05,Melaka,161,25,136,2020
2020-07-06,Melaka,20,2,18,2020
2020-07-07,Melaka,42,12,30,2020
2020-07-08,Melaka,95,19,76,2020
2020-07-09,Melaka,37,10,27,2020
2020-07-10,Melaka,12,0,12,2020
2020-07-11,Melaka,125,32,93,2020
2020-07-12,Melaka,100,24,76,2020
2020-07-13,Melaka,6,0,6,2020
2020-07-14,Melaka,11,0,11,2020
2020-07-15,Melaka,122,15,107,2020
2020-07-16,Melaka,36,5,31,2020
2020-07-17,Melaka,45,13,32,2020
2020-07-18,Melaka,96,21,75,2020
2020-07-19,Melaka,86,14,72,2020
2020-07-20,Melaka,16,0,16,2020
2020-07-21,Melaka,73,18,55,2020
2020-07-22,Melaka,114,27,87,2020
2020-07-23,Melaka,73,16,57,2020
2020-07-24,Melaka,10,1,9,2020
2020-07-25,Melaka,115,23,92,2020
2020-07-26,Melaka,87,13,74,2020
2020-07-27,Melaka,43,11,32,2020
2020-07-28,Melaka,83,16,67,2020
2020-07-29,Melaka,76,12,64,2020
2020-07-30,Melaka,25,4,21,2020
2020-07-31,Melaka,0,0,0,2020
2020-08-01,Melaka,71,12,59,2020
2020-08-02,Melaka,77,18,59,2020
2020-08-03,Melaka,75,7,68,2020
2020-08-04,Melaka,132,31,101,2020
2020-08-05,Melaka,85,12,73,2020
2020-08-06,Melaka,88,28,60,2020
2020-08-07,Melaka,13,1,12,2020
2020-08-08,Melaka,183,32,151,2020
2020-08-09,Melaka,159,29,130,2020
2020-08-10,Melaka,81,15,66,2020
2020-08-11,Melaka,127,24,103,2020
2020-08-12,Melaka,152,28,124,2020
2020-08-13,Melaka,222,59,163,2020
2020-08-14,Melaka,32,5,27,2020
2020-08-15,Melaka,217,66,151,2020
2020-08-16,Melaka,154,24,130,2020
2020-08-17,Melaka,84,28,56,2020
2020-08-18,Melaka,80,31,49,2020
2020-08-19,Melaka,195,88,107,2020
2020-08-20,Melaka,127,40,87,2020
2020-08-21,Melaka,10,0,10,2020
2020-08-22,Melaka,31,8,23,2020
2020-08-23,Melaka,240,25,215,2020
2020-08-24,Melaka,17,2,15,2020
2020-08-25,Melaka,15,1,14,2020
2020-08-26,Melaka,89,17,72,2020
2020-08-27,Melaka,111,18,93,2020
2020-08-28,Melaka,8,1,7,2020
2020-08-29,Melaka,111,30,81,2020
2020-08-30,Melaka,319,45,274,2020
2020-08-31,Melaka,126,24,102,2020
2020-09-01,Melaka,82,29,53,2020
2020-09-02,Melaka,63,14,49,2020
2020-09-03,Melaka,9,0,9,2020
2020-09-04,Melaka,7,0,7,2020
2020-09-05,Melaka,67,13,54,2020
2020-09-06,Melaka,92,21,71,2020
2020-09-07,Melaka,14,2,12,2020
2020-09-08,Melaka,92,37,55,2020
2020-09-09,Melaka,57,23,34,2020
2020-09-10,Melaka,75,35,40,2020
2020-09-11,Melaka,98,19,79,2020
2020-09-12,Melaka,122,11,111,2020
2020-09-13,Melaka,133,26,107,2020
2020-09-14,Melaka,10,2,8,2020
2020-09-15,Melaka,42,2,40,2020
2020-09-16,Melaka,164,42,122,2020
2020-09-17,Melaka,45,9,36,2020
2020-09-18,Melaka,6,0,6,2020
2020-09-19,Melaka,210,33,177,2020
2020-09-20,Melaka,102,28,74,2020
2020-09-21,Melaka,21,1,20,2020
2020-09-22,Melaka,74,26,48,2020
2020-09-23,Melaka,88,19,69,2020
2020-09-24,Melaka,112,41,71,2020
2020-09-25,Melaka,5,0,5,2020
2020-09-26,Melaka,121,48,73,2020
2020-09-27,Melaka,96,12,84,2020
2020-09-28,Melaka,78,27,51,2020
2020-09-29,Melaka,11,0,11,2020
2020-09-30,Melaka,9,0,9,2020
2020-10-01,Melaka,64,12,52,2020
2020-10-02,Melaka,9,1,8,2020
2020-10-03,Melaka,133,30,103,2020
2020-10-04,Melaka,156,38,118,2020
2020-10-05,Melaka,174,36,138,2020
2020-10-06,Melaka,72,46,26,2020
2020-10-07,Melaka,39,1,38,2020
2020-10-08,Melaka,9,0,9,2020
2020-10-09,Melaka,78,24,54,2020
2020-10-10,Melaka,129,21,108,2020
2020-10-11,Melaka,154,48,106,2020
2020-10-12,Melaka,14,1,13,2020
2020-10-13,Melaka,70,8,62,2020
2020-10-14,Melaka,45,8,37,2020
2020-10-15,Melaka,100,13,87,2020
2020-10-16,Melaka,17,1,16,2020
2020-10-17,Melaka,149,37,112,2020
2020-10-18,Melaka,173,28,145,2020
2020-10-19,Melaka,8,0,8,2020
2020-10-20,Melaka,64,9,55,2020
2020-10-21,Melaka,84,62,22,2020
2020-10-22,Melaka,57,9,48,2020
2020-10-23,Melaka,7,0,7,2020
2020-10-24,Melaka,77,22,55,2020
2020-10-25,Melaka,249,76,173,2020
2020-10-26,Melaka,13,0,13,2020
2020-10-27,Melaka,91,17,74,2020
2020-10-28,Melaka,28,4,24,2020
2020-10-29,Melaka,135,22,113,2020
2020-10-30,Melaka,11,1,10,2020
2020-10-31,Melaka,95,18,77,2020
2020-11-01,Melaka,127,10,117,2020
2020-11-02,Melaka,38,8,30,2020
2020-11-03,Melaka,35,3,32,2020
2020-11-04,Melaka,48,6,42,2020
2020-11-05,Melaka,44,8,36,2020
2020-11-06,Melaka,5,0,5,2020
2020-11-07,Melaka,202,60,142,2020
2020-11-08,Melaka,130,18,112,2020
2020-11-09,Melaka,5,0,5,2020
2020-11-10,Melaka,70,9,61,2020
2020-11-11,Melaka,34,12,22,2020
2020-11-12,Melaka,54,8,46,2020
2020-11-13,Melaka,8,0,8,2020
2020-11-14,Melaka,112,22,90,2020
2020-11-15,Melaka,133,22,111,2020
2020-11-16,Melaka,6,0,6,2020
2020-11-17,Melaka,60,13,47,2020
2020-11-18,Melaka,92,15,77,2020
2020-11-19,Melaka,58,12,46,2020
2020-11-20,Melaka,8,0,8,2020
2020-11-21,Melaka,108,9,99,2020
2020-11-22,Melaka,136,14,122,2020
2020-11-23,Melaka,13,1,12,2020
2020-11-24,Melaka,83,12,71,2020
2020-11-25,Melaka,55,13,42,2020
2020-11-26,Melaka,89,18,71,2020
2020-11-27,Melaka,11,1,10,2020
2020-11-28,Melaka,63,20,43,2020
2020-11-29,Melaka,257,47,210,2020
2020-11-30,Melaka,11,1,10,2020
2020-12-01,Melaka,51,7,44,2020
2020-12-02,Melaka,74,14,60,2020
2020-12-03,Melaka,1,0,1,2020
2020-12-04,Melaka,4,0,4,2020
2020-12-05,Melaka,0,0,0,2020
2020-12-06,Melaka,0,0,0,2020
2020-12-07,Melaka,28,1,27,2020
2020-12-08,Melaka,96,8,88,2020
2020-12-09,Melaka,77,10,67,2020
2020-12-10,Melaka,75,13,62,2020
2020-12-11,Melaka,16,1,15,2020
2020-12-12,Melaka,100,21,79,2020
2020-12-13,Melaka,207,16,191,2020
2020-12-14,Melaka,25,2,23,2020
2020-12-15,Melaka,88,17,71,2020
2020-12-16,Melaka,69,17,52,2020
2020-12-17,Melaka,82,35,47,2020
2020-12-18,Melaka,9,2,7,2020
2020-12-19,Melaka,116,26,90,2020
2020-12-20,Melaka,113,9,104,2020
2020-12-21,Melaka,11,0,11,2020
2020-12-22,Melaka,82,9,73,2020
2020-12-23,Melaka,73,15,58,2020
2020-12-24,Melaka,36,2,34,2020
2020-12-25,Melaka,59,24,35,2020
2020-12-26,Melaka,130,30,100,2020
2020-12-27,Melaka,161,21,140,2020
2020-12-28,Melaka,7,0,7,2020
2020-12-29,Melaka,81,17,64,2020
2020-12-30,Melaka,25,4,21,2020
2020-12-31,Melaka,83,14,69,2020
2021-01-01,Melaka,106,26,80,2021
2021-01-02,Melaka,145,27,118,2021
2021-01-03,Melaka,156,47,109,2021
2021-01-04,Melaka,12,0,12,2021
2021-01-05,Melaka,39,8,31,2021
2021-01-06,Melaka,63,17,46,2021
2021-01-07,Melaka,60,14,46,2021
2021-01-08,Melaka,5,0,5,2021
2021-01-09,Melaka,70,9,61,2021
2021-01-10,Melaka,79,16,63,2021
2021-01-11,Melaka,9,3,6,2021
2021-01-12,Melaka,60,9,51,2021
2021-01-13,Melaka,29,5,24,2021
2021-01-14,Melaka,41,6,35,2021
2021-01-15,Melaka,14,0,14,2021
2021-01-16,Melaka,125,29,96,2021
2021-01-17,Melaka,147,33,114,2021
2021-01-18,Melaka,7,0,7,2021
2021-01-19,Melaka,59,17,42,2021
2021-01-20,Melaka,90,20,70,2021
2021-01-21,Melaka,87,15,72,2021
2021-01-22,Melaka,9,0,9,2021
2021-01-23,Melaka,147,26,121,2021
2021-01-24,Melaka,159,16,143,2021
2021-01-25,Melaka,50,14,36,2021
2021-01-26,Melaka,85,17,68,2021
2021-01-27,Melaka,59,8,51,2021
2021-01-28,Melaka,109,16,93,2021
2021-01-29,Melaka,13,1,12,2021
2021-01-30,Melaka,111,27,84,2021
2021-01-31,Melaka,124,32,92,2021
2021-02-01,Melaka,45,5,40,2021
2021-02-02,Melaka,79,15,64,2021
2021-02-03,Melaka,83,32,51,2021
2021-02-04,Melaka,108,46,62,2021
2021-02-05,Melaka,7,0,7,2021
2021-02-06,Melaka,99,24,75,2021
2021-02-07,Melaka,136,30,106,2021
2021-02-08,Melaka,6,0,6,2021
2021-02-09,Melaka,116,53,63,2021
2021-02-10,Melaka,65,16,49,2021
2021-02-11,Melaka,60,14,46,2021
2021-02-12,Melaka,111,24,87,2021
2021-02-13,Melaka,115,29,86,2021
2021-02-14,Melaka,169,30,139,2021
2021-02-15,Melaka,9,0,9,2021
2021-02-16,Melaka,81,16,65,2021
2021-02-17,Melaka,76,13,63,2021
2021-02-18,Melaka,80,16,64,2021
2021-02-19,Melaka,3,0,3,2021
2021-02-20,Melaka,184,29,155,2021
2021-02-21,Melaka,158,22,136,2021
2021-02-22,Melaka,10,0,10,2021
2021-02-23,Melaka,71,12,59,2021
2021-02-24,Melaka,81,13,68,2021
2021-02-25,Melaka,135,41,94,2021
2021-02-26,Melaka,88,45,43,2021
2021-02-27,Melaka,120,22,98,2021
2021-02-28,Melaka,146,23,123,2021
2021-03-01,Melaka,11,0,11,2021
2021-03-02,Melaka,79,12,67,2021
2021-03-03,Melaka,88,14,74,2021
2021-03-04,Melaka,181,34,147,2021
2021-03-05,Melaka,9,0,9,2021
2021-03-06,Melaka,149,27,122,2021
2021-03-07,Melaka,134,19,115,2021
2021-03-08,Melaka,14,0,14,2021
2021-03-09,Melaka,90,27,63,2021
2021-03-10,Melaka,138,27,111,2021
2021-03-11,Melaka,154,37,117,2021
2021-03-12,Melaka,6,0,6,2021
2021-03-13,Melaka,55,12,43,2021
2021-03-14,Melaka,144,19,125,2021
2021-03-15,Melaka,15,1,14,2021
2021-03-16,Melaka,70,11,59,2021
2021-03-17,Melaka,114,30,84,2021
2021-03-18,Melaka,129,33,96,2021
2021-03-19,Melaka,6,0,6,2021
2021-03-20,Melaka,39,5,34,2021
2021-03-21,Melaka,145,18,127,2021
2021-03-22,Melaka,10,2,8,2021
2021-03-23,Melaka,135,54,81,2021
2021-03-24,Melaka,30,7,23,2021
2021-03-25,Melaka,104,15,89,2021
2021-03-26,Melaka,16,2,14,2021
2021-03-27,Melaka,106,11,95,2021
2021-03-28,Melaka,171,24,147,2021
2021-03-29,Melaka,10,0,10,2021
2021-03-30,Melaka,92,19,73,2021
2021-03-31,Melaka,25,3,22,2021
2021-04-01,Melaka,92,13,79,2021
2021-04-02,Melaka,75,16,59,2021
2021-04-03,Melaka,113,47,66,2021
2021-04-04,Melaka,207,20,187,2021
2021-04-05,Melaka,11,2,9,2021
2021-04-06,Melaka,57,9,48,2021
2021-04-07,Melaka,54,22,32,2021
2021-04-08,Melaka,59,15,44,2021
2021-04-09,Melaka,119,33,86,2021
2021-04-10,Melaka,110,14,96,2021
2021-04-11,Melaka,263,30,233,2021
2021-04-12,Melaka,21,6,15,2021
2021-04-13,Melaka,0,0,0,2021
2021-04-14,Melaka,52,12,40,2021
2021-04-15,Melaka,101,8,93,2021
2021-04-16,Melaka,5,0,5,2021
2021-04-17,Melaka,62,13,49,2021
2021-04-18,Melaka,85,22,63,2021
2021-04-19,Melaka,7,0,7,2021
2021-04-20,Melaka,51,5,46,2021
2021-04-21,Melaka,32,7,25,2021
2021-04-22,Melaka,43,6,37,2021
2021-04-23,Melaka,4,0,4,2021
2021-04-24,Melaka,91,21,70,2021
2021-04-25,Melaka,146,11,135,2021
2021-04-26,Melaka,3,0,3,2021
2021-04-27,Melaka,79,49,30,2021
2021-04-28,Melaka,89,35,54,2021
2021-04-29,Melaka,63,43,20,2021
2021-04-30,Melaka,6,0,6,2021
2021-05-01,Melaka,64,5,59,2021
2021-05-02,Melaka,119,10,109,2021
2021-05-03,Melaka,2,0,2,2021
2021-05-04,Melaka,91,23,68,2021
2021-05-05,Melaka,27,5,22,2021
2021-05-06,Melaka,104,25,79,2021
2021-05-07,Melaka,4,0,4,2021
2021-05-08,Melaka,69,16,53,2021
2021-05-09,Melaka,48,8,40,2021
2021-05-10,Melaka,75,4,71,2021
2021-05-11,Melaka,57,10,47,2021
2021-05-12,Melaka,10,0,10,2021
2021-05-13,Melaka,0,0,0,2021
2021-05-14,Melaka,2,0,2,2021
2021-05-15,Melaka,136,17,119,2021
2021-05-16,Melaka,157,31,126,2021
2021-05-17,Melaka,10,1,9,2021
2021-05-18,Melaka,77,8,69,2021
2021-05-19,Melaka,119,18,101,2021
2021-05-20,Melaka,53,11,42,2021
2021-05-21,Melaka,7,2,5,2021
2021-05-22,Melaka,85,14,71,2021
2021-05-23,Melaka,139,18,121,2021
2021-05-24,Melaka,10,1,9,2021
2021-05-25,Melaka,31,2,29,2021
2021-05-26,Melaka,126,29,97,2021
2021-05-27,Melaka,59,5,54,2021
2021-05-28,Melaka,16,0,16,2021
2021-05-29,Melaka,136,28,108,2021
2021-05-30,Melaka,141,20,121,2021
2021-05-31,Melaka,13,0,13,2021
2021-06-01,Melaka,36,7,29,2021
2021-06-02,Melaka,106,22,84,2021
2021-06-03,Melaka,91,11,80,2021
2021-06-04,Melaka,10,1,9,2021
2021-06-05,Melaka,136,23,113,2021
2021-06-06,Melaka,86,17,69,2021
2021-06-07,Melaka,103,18,85,2021
2021-06-08,Melaka,87,16,71,2021
2021-06-09,Melaka,93,16,77,2021
2021-06-10,Melaka,83,9,74,2021
2021-06-11,Melaka,10,6,4,2021
2021-06-12,Melaka,152,32,120,2021
2021-06-13,Melaka,154,37,117,2021
2021-06-14,Melaka,117,11,106,2021
2021-06-15,Melaka,168,43,125,2021
2021-06-16,Melaka,145,33,112,2021
2021-06-17,Melaka,137,32,105,2021
2021-06-18,Melaka,70,16,54,2021
2021-06-19,Melaka,120,26,94,2021
2021-06-20,Melaka,175,31,144,2021
2021-06-21,Melaka,11,1,10,2021
2021-06-22,Melaka,74,15,59,2021
2021-06-23,Melaka,74,14,60,2021
2021-06-24,Melaka,57,4,53,2021
2021-06-25,Melaka,62,17,45,2021
2021-06-26,Melaka,156,32,124,2021
2021-06-27,Melaka,105,17,88,2021
2021-06-28,Melaka,8,1,7,2021
2021-06-29,Melaka,28,4,24,2021
2021-06-30,Melaka,63,13,50,2021
2021-07-01,Melaka,71,12,59,2021
2021-07-02,Melaka,7,0,7,2021
2021-07-03,Melaka,88,11,77,2021
2021-07-04,Melaka,179,52,127,2021
2021-07-05,Melaka,7,0,7,2021
2021-07-06,Melaka,63,12,51,2021
2021-07-07,Melaka,99,26,73,2021
2021-07-08,Melaka,29,8,21,2021
2021-07-09,Melaka,40,7,33,2021
2021-07-10,Melaka,95,15,80,2021
2021-07-11,Melaka,98,24,74,2021
2021-07-12,Melaka,6,0,6,2021
2021-07-13,Melaka,28,3,25,2021
2021-07-14,Melaka,49,5,44,2021
2021-07-15,Melaka,35,2,33,2021
2021-07-16,Melaka,56,12,44,2021
2021-07-17,Melaka,106,17,89,2021
2021-07-18,Melaka,106,22,84,2021
2021-07-19,Melaka,9,0,9,2021
2021-07-20,Melaka,0,0,0,2021
2021-07-21,Melaka,24,4,20,2021
2021-07-22,Melaka,30,6,24,2021
2021-07-23,Melaka,48,9,39,2021
2021-07-24,Melaka,168,32,136,2021
2021-07-25,Melaka,208,53,155,2021
2021-07-26,Melaka,33,11,22,2021
2021-07-27,Melaka,81,20,61,2021
2021-07-28,Melaka,49,5,44,2021
2021-07-29,Melaka,46,16,30,2021
2021-07-30,Melaka,8,3,5,2021
2021-07-31,Melaka,164,33,131,2021
2021-08-01,Melaka,133,26,107,2021
2021-08-02,Melaka,6,0,6,2021
2021-08-03,Melaka,90,19,71,2021
2021-08-04,Melaka,70,10,60,2021
2021-08-05,Melaka,63,7,56,2021
2021-08-06,Melaka,222,53,169,2021
2021-08-07,Melaka,76,21,55,2021
2021-08-08,Melaka,188,57,131,2021
2021-08-09,Melaka,9,4,5,2021
2021-08-10,Melaka,65,10,55,2021
2021-08-11,Melaka,65,9,56,2021
2021-08-12,Melaka,62,13,49,2021
2021-08-13,Melaka,37,12,25,2021
2021-08-14,Melaka,105,16,89,2021
2021-08-15,Melaka,196,33,163,2021
2021-08-16,Melaka,8,1,7,2021
2021-08-17,Melaka,34,6,28,2021
2021-08-18,Melaka,71,7,64,2021
2021-08-19,Melaka,69,6,63,2021
2021-08-20,Melaka,8,2,6,2021
2021-08-21,Melaka,126,15,111,2021
2021-08-22,Melaka,155,26,129,2021
2021-08-23,Melaka,4,0,4,2021
2021-08-24,Melaka,82,10,72,2021
2021-08-25,Melaka,114,20,94,2021
2021-08-26,Melaka,43,6,37,2021
2021-08-27,Melaka,66,10,56,2021
2021-08-28,Melaka,82,13,69,2021
2021-08-29,Melaka,80,14,66,2021
2021-08-30,Melaka,45,9,36,2021
2021-08-31,Melaka,201,24,177,2021
2021-09-01,Melaka,34,6,28,2021
2021-09-02,Melaka,34,4,30,2021
2021-09-03,Melaka,9,1,8,2021
2021-09-04,Melaka,91,11,80,2021
2021-09-05,Melaka,137,33,104,2021
2021-09-06,Melaka,1,0,1,2021
2021-09-07,Melaka,78,17,61,2021
2021-09-08,Melaka,63,5,58,2021
2021-09-09,Melaka,65,17,48,2021
2021-09-10,Melaka,15,2,13,2021
2021-09-11,Melaka,68,14,54,2021
2021-09-12,Melaka,107,8,99,2021
2021-09-13,Melaka,16,0,16,2021
2021-09-14,Melaka,35,5,30,2021
2021-09-15,Melaka,104,16,88,2021
2021-09-16,Melaka,144,25,119,2021
2021-09-17,Melaka,8,1,7,2021
2021-09-18,Melaka,155,27,128,2021
2021-09-19,Melaka,249,25,224,2021
2021-09-20,Melaka,40,6,34,2021
2021-09-21,Melaka,14,1,13,2021
2021-09-22,Melaka,8,3,5,2021
2021-09-23,Melaka,69,12,57,2021
2021-09-24,Melaka,27,1,26,2021
2021-09-25,Melaka,76,9,67,2021
2021-09-26,Melaka,196,34,162,2021
2021-09-27,Melaka,8,1,7,2021
2021-09-28,Melaka,49,2,47,2021
2021-09-29,Melaka,65,11,54,2021
2021-09-30,Melaka,108,16,92,2021
2021-10-01,Melaka,7,0,7,2021
2021-10-02,Melaka,127,13,114,2021
2021-10-03,Melaka,81,19,62,2021
2021-10-04,Melaka,9,0,9,2021
2021-10-05,Melaka,44,8,36,2021
2021-10-06,Melaka,62,10,52,2021
2021-10-07,Melaka,78,16,62,2021
2021-10-08,Melaka,12,0,12,2021
2021-10-09,Melaka,129,18,111,2021
2021-10-10,Melaka,145,35,110,2021
2021-10-11,Melaka,76,7,69,2021
2021-10-12,Melaka,12,2,10,2021
2021-10-13,Melaka,70,7,63,2021
2021-10-14,Melaka,135,32,103,2021
2021-10-15,Melaka,4,0,4,2021
2021-10-16,Melaka,141,15,126,2021
2021-10-17,Melaka,137,26,111,2021
2021-10-18,Melaka,10,1,9,2021
2021-10-19,Melaka,76,15,61,2021
2021-10-20,Melaka,37,5,32,2021
2021-10-21,Melaka,109,20,89,2021
2021-10-22,Melaka,17,6,11,2021
2021-10-23,Melaka,93,20,73,2021
2021-10-24,Melaka,181,28,153,2021
2021-10-25,Melaka,10,0,10,2021
2021-10-26,Melaka,49,7,42,2021
2021-10-27,Melaka,70,16,54,2021
2021-10-28,Melaka,55,9,46,2021
2021-10-29,Melaka,24,2,22,2021
2021-10-30,Melaka,110,16,94,2021
2021-10-31,Melaka,212,37,175,2021
2021-11-01,Melaka,8,1,7,2021
2021-11-02,Melaka,71,13,58,2021
2021-11-03,Melaka,80,22,58,2021
2021-11-04,Melaka,83,10,73,2021
2021-11-05,Melaka,15,0,15,2021
2021-11-06,Melaka,80,20,60,2021
2021-11-07,Melaka,151,13,138,2021
2021-11-08,Melaka,7,1,6,2021
2021-11-09,Melaka,65,14,51,2021
2021-11-10,Melaka,72,15,57,2021
2021-11-11,Melaka,63,7,56,2021
2021-11-12,Melaka,31,6,25,2021
2021-11-13,Melaka,144,29,115,2021
2021-11-14,Melaka,153,30,123,2021
2021-11-15,Melaka,166,53,113,2021
2021-11-16,Melaka,36,10,26,2021
2021-11-17,Melaka,112,64,48,2021
2021-11-18,Melaka,104,26,78,2021
2021-11-19,Melaka,5,0,5,2021
2021-11-20,Melaka,54,11,43,2021
2021-11-21,Melaka,173,9,164,2021
2021-11-22,Melaka,7,0,7,2021
2021-11-23,Melaka,10,1,9,2021
2021-11-24,Melaka,100,17,83,2021
2021-11-25,Melaka,168,70,98,2021
2021-11-26,Melaka,7,0,7,2021
2021-11-27,Melaka,103,26,77,2021
2021-11-28,Melaka,232,35,197,2021
2021-11-29,Melaka,19,1,18,2021
2021-11-30,Melaka,21,1,20,2021
2021-12-01,Melaka,91,10,81,2021
2021-12-02,Melaka,74,10,64,2021
2021-12-03,Melaka,13,1,12,2021
2021-12-04,Melaka,13,1,12,2021
2021-12-05,Melaka,305,32,273,2021
2021-12-06,Melaka,10,0,10,2021
2021-12-07,Melaka,46,4,42,2021
2021-12-08,Melaka,105,32,73,2021
2021-12-09,Melaka,104,52,52,2021
2021-12-10,Melaka,17,2,15,2021
2021-12-11,Melaka,154,28,126,2021
2021-12-12,Melaka,208,21,187,2021
2021-12-13,Melaka,17,1,16,2021
2021-12-14,Melaka,51,7,44,2021
2021-12-15,Melaka,82,41,41,2021
2021-12-16,Melaka,93,40,53,2021
2021-12-17,Melaka,42,4,38,2021
2021-12-18,Melaka,54,12,42,2021
2021-12-19,Melaka,157,16,141,2021
2021-12-20,Melaka,21,0,21,2021
2021-12-21,Melaka,90,15,75,2021
2021-12-22,Melaka,64,6,58,2021
2021-12-23,Melaka,101,37,64,2021
2021-12-24,Melaka,15,1,14,2021
2021-12-25,Melaka,177,20,157,2021
2021-12-26,Melaka,266,45,221,2021
2021-12-27,Melaka,11,0,11,2021
2021-12-28,Melaka,98,16,82,2021
2021-12-29,Melaka,91,13,78,2021
2021-12-30,Melaka,48,4,44,2021
2021-12-31,Melaka,15,0,15,2021
2022-01-01,Melaka,71,14,57,2022
2022-01-02,Melaka,115,15,100,2022
2022-01-03,Melaka,7,2,5,2022
2022-01-04,Melaka,46,7,39,2022
2022-01-05,Melaka,62,6,56,2022
2022-01-06,Melaka,55,6,49,2022
2022-01-07,Melaka,10,0,10,2022
2022-01-08,Melaka,146,20,126,2022
2022-01-09,Melaka,128,25,103,2022
2022-01-10,Melaka,21,4,17,2022
2022-01-11,Melaka,59,8,51,2022
2022-01-12,Melaka,74,7,67,2022
2022-01-13,Melaka,82,13,69,2022
2022-01-14,Melaka,15,1,14,2022
2022-01-15,Melaka,155,19,136,2022
2022-01-16,Melaka,147,20,127,2022
2022-01-17,Melaka,19,0,19,2022
2022-01-18,Melaka,66,14,52,2022
2022-01-19,Melaka,15,1,14,2022
2022-01-20,Melaka,135,59,76,2022
2022-01-21,Melaka,23,7,16,2022
2022-01-22,Melaka,139,17,122,2022
2022-01-23,Melaka,130,16,114,2022
2022-01-24,Melaka,47,3,44,2022
2022-01-25,Melaka,77,9,68,2022
2022-01-26,Melaka,118,15,103,2022
2022-01-27,Melaka,49,13,36,2022
2022-01-28,Melaka,10,0,10,2022
2022-01-29,Melaka,114,17,97,2022
2022-01-30,Melaka,110,19,91,2022
2022-01-31,Melaka,19,0,19,2022
2022-02-01,Melaka,70,8,62,2022
2022-02-02,Melaka,89,13,76,2022
2022-02-03,Melaka,57,11,46,2022
2022-02-04,Melaka,14,0,14,2022
2022-02-05,Melaka,134,17,117,2022
2022-02-06,Melaka,125,22,103,2022
2022-02-07,Melaka,13,0,13,2022
2022-02-08,Melaka,41,6,35,2022
2022-02-09,Melaka,91,13,78,2022
2022-02-10,Melaka,34,3,31,2022
2022-02-11,Melaka,16,2,14,2022
2022-02-12,Melaka,133,24,109,2022
2022-02-13,Melaka,107,21,86,2022
2022-02-14,Melaka,11,1,10,2022
2022-02-15,Melaka,42,5,37,2022
2022-02-16,Melaka,95,13,82,2022
2022-02-17,Melaka,112,22,90,2022
2022-02-18,Melaka,15,8,7,2022
2022-02-19,Melaka,133,18,115,2022
2022-02-20,Melaka,157,23,134,2022
2022-02-21,Melaka,10,0,10,2022
2022-02-22,Melaka,95,17,78,2022
2022-02-23,Melaka,51,6,45,2022
2022-02-24,Melaka,74,12,62,2022
2022-02-25,Melaka,20,0,20,2022
2022-02-26,Melaka,176,47,129,2022
2022-02-27,Melaka,133,21,112,2022
2022-02-28,Melaka,19,0,19,2022
2022-03-01,Melaka,75,4,71,2022
2022-03-02,Melaka,74,13,61,2022
2022-03-03,Melaka,91,20,71,2022
2022-03-04,Melaka,7,1,6,2022
2022-03-05,Melaka,160,24,136,2022
2022-03-06,Melaka,181,35,146,2022
2022-03-07,Melaka,8,1,7,2022
2022-03-08,Melaka,60,10,50,2022
2022-03-09,Melaka,83,8,75,2022
2022-03-10,Melaka,47,7,40,2022
2022-03-11,Melaka,11,0,11,2022
2022-03-12,Melaka,102,14,88,2022
2022-03-13,Melaka,163,22,141,2022
2022-03-14,Melaka,10,2,8,2022
2022-03-15,Melaka,59,8,51,2022
2022-03-16,Melaka,233,102,131,2022
2022-03-17,Melaka,38,7,31,2022
2022-03-18,Melaka,13,2,11,2022
2022-03-19,Melaka,178,23,155,2022
2022-03-20,Melaka,255,27,228,2022
2022-03-21,Melaka,18,1,17,2022
2022-03-22,Melaka,81,12,69,2022
2022-03-23,Melaka,71,8,63,2022
2022-03-24,Melaka,26,1,25,2022
2022-03-25,Melaka,61,6,55,2022
2022-03-26,Melaka,137,32,105,2022
2022-03-27,Melaka,216,32,184,2022
2022-03-28,Melaka,15,1,14,2022
2022-03-29,Melaka,179,72,107,2022
2022-03-30,Melaka,96,48,48,2022
2022-03-31,Melaka,68,10,58,2022
2022-04-01,Melaka,48,6,42,2022
2022-04-02,Melaka,116,6,110,2022
2022-04-03,Melaka,0,0,0,2022
2022-04-04,Melaka,20,1,19,2022
2022-04-05,Melaka,31,8,23,2022
2022-04-06,Melaka,65,16,49,2022
2022-04-07,Melaka,30,2,28,2022
2022-04-08,Melaka,16,2,14,2022
2022-04-09,Melaka,84,12,72,2022
2022-04-10,Melaka,137,112,25,2022
2022-04-11,Melaka,4,0,4,2022
2022-04-12,Melaka,81,15,66,2022
2022-04-13,Melaka,130,47,83,2022
2022-04-14,Melaka,62,31,31,2022
2022-04-15,Melaka,86,9,77,2022
2022-04-16,Melaka,111,31,80,2022
2022-04-17,Melaka,189,28,161,2022
2022-04-18,Melaka,9,1,8,2022
2022-04-19,Melaka,57,9,48,2022
2022-04-20,Melaka,96,56,40,2022
2022-04-21,Melaka,94,55,39,2022
2022-04-22,Melaka,85,14,71,2022
2022-04-23,Melaka,80,17,63,2022
2022-04-24,Melaka,125,8,117,2022
2022-04-25,Melaka,121,29,92,2022
2022-04-26,Melaka,95,30,65,2022
2022-04-27,Melaka,68,24,44,2022
2022-04-28,Melaka,38,6,32,2022
2022-04-29,Melaka,97,12,85,2022
2022-04-30,Melaka,73,19,54,2022
2022-05-01,Melaka,54,17,37,2022
2022-05-02,Melaka,0,0,0,2022
2022-05-03,Melaka,0,0,0,2022
2022-05-04,Melaka,36,5,31,2022
2022-05-05,Melaka,32,4,28,2022
2022-05-06,Melaka,67,4,63,2022
2022-05-07,Melaka,60,7,53,2022
2022-05-08,Melaka,198,17,181,2022
2022-05-09,Melaka,114,13,101,2022
2022-05-10,Melaka,142,39,103,2022
2022-05-11,Melaka,75,10,65,2022
2022-05-12,Melaka,59,9,50,2022
2022-05-13,Melaka,15,1,14,2022
2022-05-14,Melaka,207,70,137,2022
2022-05-15,Melaka,236,46,190,2022
2022-05-16,Melaka,103,17,86,2022
2022-05-17,Melaka,9,0,9,2022
2022-05-18,Melaka,98,11,87,2022
2022-05-19,Melaka,39,1,38,2022
2022-05-20,Melaka,18,1,17,2022
2022-05-21,Melaka,132,17,115,2022
2022-05-22,Melaka,293,41,252,2022
2022-05-23,Melaka,15,1,14,2022
2022-05-24,Melaka,146,45,101,2022
2022-05-25,Melaka,101,7,94,2022
2022-05-26,Melaka,92,22,70,2022
2022-05-27,Melaka,14,1,13,2022
2022-05-28,Melaka,100,19,81,2022
2022-05-29,Melaka,188,29,159,2022
2022-05-30,Melaka,15,1,14,2022
2022-05-31,Melaka,82,13,69,2022
2022-06-01,Melaka,14,4,10,2022
2022-06-02,Melaka,46,8,38,2022
2022-06-03,Melaka,57,5,52,2022
2022-06-04,Melaka,175,36,139,2022
2022-06-05,Melaka,166,32,134,2022
2022-06-06,Melaka,0,0,0,2022
2022-06-07,Melaka,49,4,45,2022
2022-06-08,Melaka,113,36,77,2022
2022-06-09,Melaka,83,10,73,2022
2022-06-10,Melaka,16,1,15,2022
2022-06-11,Melaka,44,16,28,2022
2022-06-12,Melaka,266,59,207,2022
2022-06-13,Melaka,14,1,13,2022
2022-06-14,Melaka,210,38,172,2022
2022-06-15,Melaka,160,37,123,2022
2022-06-16,Melaka,143,62,81,2022
2022-06-17,Melaka,49,7,42,2022
2022-06-18,Melaka,64,11,53,2022
2022-06-19,Melaka,238,99,139,2022
2022-06-20,Melaka,17,2,15,2022
2022-06-21,Melaka,71,28,43,2022
2022-06-22,Melaka,98,56,42,2022
2022-06-23,Melaka,15,0,15,2022
2022-06-24,Melaka,13,2,11,2022
2022-06-25,Melaka,126,23,103,2022
2022-06-26,Melaka,128,14,114,2022
2022-06-27,Melaka,158,76,82,2022
2022-06-28,Melaka,80,10,70,2022
2022-06-29,Melaka,119,31,88,2022
2022-06-30,Melaka,69,13,56,2022
2022-07-01,Melaka,15,1,14,2022
2022-07-02,Melaka,0,0,0,2022
2022-07-03,Melaka,117,15,102,2022
2022-07-04,Melaka,17,0,17,2022
2022-07-05,Melaka,106,15,91,2022
2022-07-06,Melaka,94,13,81,2022
2022-07-07,Melaka,91,16,75,2022
2022-07-08,Melaka,105,11,94,2022
2022-07-09,Melaka,2,0,2,2022
2022-07-10,Melaka,0,0,0,2022
2022-07-11,Melaka,149,35,114,2022
2022-07-12,Melaka,10,2,8,2022
2022-07-13,Melaka,80,12,68,2022
2022-07-14,Melaka,108,12,96,2022
2022-07-15,Melaka,18,3,15,2022
2022-07-16,Melaka,92,26,66,2022
2022-07-17,Melaka,176,41,135,2022
2022-07-18,Melaka,15,0,15,2022
2022-07-19,Melaka,76,13,63,2022
2022-07-20,Melaka,63,8,55,2022
2022-07-21,Melaka,115,20,95,2022
2022-07-22,Melaka,28,5,23,2022
2022-07-23,Melaka,148,21,127,2022
2022-07-24,Melaka,244,44,200,2022
2022-07-25,Melaka,16,1,15,2022
2022-07-26,Melaka,63,8,55,2022
2022-07-27,Melaka,174,44,130,2022
2022-07-28,Melaka,102,20,82,2022
2022-07-29,Melaka,17,1,16,2022
2022-07-30,Melaka,198,31,167,2022
2022-07-31,Melaka,112,13,99,2022
2022-08-01,Melaka,11,0,11,2022
2022-08-02,Melaka,93,21,72,2022
2022-08-03,Melaka,40,17,23,2022
2022-08-04,Melaka,110,27,83,2022
2022-08-05,Melaka,106,39,67,2022
2022-08-06,Melaka,137,16,121,2022
2022-08-07,Melaka,99,12,87,2022
2022-08-08,Melaka,127,99,28,2022
2022-08-09,Melaka,20,2,18,2022
2022-08-10,Melaka,243,67,176,2022
2022-08-11,Melaka,240,74,166,2022
2022-08-12,Melaka,9,0,9,2022
2022-08-13,Melaka,160,22,138,2022
2022-08-14,Melaka,167,28,139,2022
2022-08-15,Melaka,230,65,165,2022
2022-08-16,Melaka,15,0,15,2022
2022-08-17,Melaka,94,19,75,2022
2022-08-18,Melaka,66,13,53,2022
2022-08-19,Melaka,16,1,15,2022
2022-08-20,Melaka,119,27,92,2022
2022-08-21,Melaka,78,8,70,2022
2022-08-22,Melaka,14,0,14,2022
2022-08-23,Melaka,115,40,75,2022
2022-08-24,Melaka,147,18,129,2022
2022-08-25,Melaka,72,22,50,2022
2022-08-26,Melaka,6,0,6,2022
2022-08-27,Melaka,198,27,171,2022
2022-08-28,Melaka,163,27,136,2022
2022-08-29,Melaka,6,0,6,2022
2022-08-30,Melaka,108,21,87,2022
2022-08-31,Melaka,174,18,156,2022
2022-09-01,Melaka,152,84,68,2022
2022-09-02,Melaka,16,3,13,2022
2022-09-03,Melaka,91,10,81,2022
2022-09-04,Melaka,93,15,78,2022
2022-09-05,Melaka,13,0,13,2022
2022-09-06,Melaka,86,65,21,2022
2022-09-07,Melaka,51,5,46,2022
2022-09-08,Melaka,99,66,33,2022
2022-09-09,Melaka,11,3,8,2022
2022-09-10,Melaka,86,17,69,2022
2022-09-11,Melaka,151,16,135,2022
2022-09-12,Melaka,14,1,13,2022
2022-09-13,Melaka,89,56,33,2022
2022-09-14,Melaka,60,18,42,2022
2022-09-15,Melaka,147,55,92,2022
2022-09-16,Melaka,61,8,53,2022
2022-09-17,Melaka,138,25,113,2022
2022-09-18,Melaka,167,19,148,2022
2022-09-19,Melaka,26,1,25,2022
2022-09-20,Melaka,73,49,24,2022
2022-09-21,Melaka,71,28,43,2022
2022-09-22,Melaka,9,2,7,2022
2022-09-23,Melaka,38,11,27,2022
2022-09-24,Melaka,110,23,87,2022
2022-09-25,Melaka,123,19,104,2022
2022-09-26,Melaka,15,1,14,2022
2022-09-27,Melaka,182,107,75,2022
2022-09-28,Melaka,11,0,11,2022
2022-09-29,Melaka,10,1,9,2022
2022-09-30,Melaka,215,189,26,2022
2022-10-01,Melaka,149,13,136,2022
2022-10-02,Melaka,154,24,130,2022
2022-10-03,Melaka,12,4,8,2022
2022-10-04,Melaka,131,42,89,2022
2022-10-05,Melaka,72,11,61,2022
2022-10-06,Melaka,64,6,58,2022
2022-10-07,Melaka,61,4,57,2022
2022-10-08,Melaka,128,14,114,2022
2022-10-09,Melaka,97,18,79,2022
2022-10-10,Melaka,88,15,73,2022
2022-10-11,Melaka,13,0,13,2022
2022-10-12,Melaka,81,10,71,2022
2022-10-13,Melaka,153,22,131,2022
2022-10-14,Melaka,11,0,11,2022
2022-10-15,Melaka,76,15,61,2022
2022-10-16,Melaka,96,44,52,2022
2022-10-17,Melaka,15,0,15,2022
2022-10-18,Melaka,49,11,38,2022
2022-10-19,Melaka,230,42,188,2022
2022-10-20,Melaka,17,1,16,2022
2022-10-21,Melaka,16,0,16,2022
2022-10-22,Melaka,104,29,75,2022
2022-10-23,Melaka,151,30,121,2022
2022-10-24,Melaka,112,19,93,2022
2022-10-25,Melaka,76,20,56,2022
2022-10-26,Melaka,20,1,19,2022
2022-10-27,Melaka,91,43,48,2022
2022-10-28,Melaka,12,2,10,2022
2022-10-29,Melaka,117,17,100,2022
2022-10-30,Melaka,137,24,113,2022
2022-10-31,Melaka,15,0,15,2022
2022-11-01,Melaka,11,1,10,2022
2022-11-02,Melaka,122,76,46,2022
2022-11-03,Melaka,59,14,45,2022
2022-11-04,Melaka,9,0,9,2022
2022-11-05,Melaka,117,17,100,2022
2022-11-06,Melaka,217,31,186,2022
2022-11-07,Melaka,199,63,136,2022
2022-11-08,Melaka,20,1,19,2022
2022-11-09,Melaka,164,63,101,2022
2022-11-10,Melaka,19,1,18,2022
2022-11-11,Melaka,10,0,10,2022
2022-11-12,Melaka,146,18,128,2022
2022-11-13,Melaka,153,25,128,2022
2022-11-14,Melaka,13,0,13,2022
2022-11-15,Melaka,167,42,125,2022
2022-11-16,Melaka,118,36,82,2022
2022-11-17,Melaka,68,4,64,2022
2022-11-18,Melaka,0,0,0,2022
2022-11-19,Melaka,0,0,0,2022
2022-11-20,Melaka,192,24,168,2022
2022-11-21,Melaka,10,1,9,2022
2022-11-22,Melaka,87,17,70,2022
2022-11-23,Melaka,26,5,21,2022
2022-11-24,Melaka,68,12,56,2022
2022-11-25,Melaka,128,97,31,2022
2022-11-26,Melaka,67,18,49,2022
2022-11-27,Melaka,141,10,131,2022
2022-11-28,Melaka,0,0,0,2022
2022-11-29,Melaka,120,26,94,2022
2022-11-30,Melaka,30,5,25,2022
2022-12-01,Melaka,10,0,10,2022
2022-12-02,Melaka,13,0,13,2022
2022-12-03,Melaka,58,10,48,2022
2022-12-04,Melaka,492,49,443,2022
2022-12-05,Melaka,10,0,10,2022
2022-12-06,Melaka,48,12,36,2022
2022-12-07,Melaka,12,1,11,2022
2022-12-08,Melaka,0,0,0,2022
2022-12-09,Melaka,129,58,71,2022
2022-12-10,Melaka,25,2,23,2022
2022-12-11,Melaka,135,17,118,2022
2022-12-12,Melaka,16,0,16,2022
2022-12-13,Melaka,124,75,49,2022
2022-12-14,Melaka,123,72,51,2022
2022-12-15,Melaka,27,1,26,2022
2022-12-16,Melaka,14,0,14,2022
2022-12-17,Melaka,183,39,144,2022
2022-12-18,Melaka,97,22,75,2022
2022-12-19,Melaka,14,2,12,2022
2022-12-20,Melaka,82,7,75,2022
2022-12-21,Melaka,62,26,36,2022
2022-12-22,Melaka,117,48,69,2022
2022-12-23,Melaka,16,3,13,2022
2022-12-24,Melaka,87,5,82,2022
2022-12-25,Melaka,137,7,130,2022
2022-12-26,Melaka,0,0,0,2022
2022-12-27,Melaka,91,20,71,2022
2022-12-28,Melaka,10,1,9,2022
2022-12-29,Melaka,100,49,51,2022
2022-12-30,Melaka,18,0,18,2022
2022-12-31,Melaka,153,14,139,2022
2023-01-01,Melaka,182,21,161,2023
2023-01-02,Melaka,89,7,82,2023
2023-01-03,Melaka,11,1,10,2023
2023-01-04,Melaka,52,11,41,2023
2023-01-05,Melaka,70,6,64,2023
2023-01-06,Melaka,14,3,11,2023
2023-01-07,Melaka,47,20,27,2023
2023-01-08,Melaka,111,12,99,2023
2023-01-09,Melaka,13,0,13,2023
2023-01-10,Melaka,68,9,59,2023
2023-01-11,Melaka,172,61,111,2023
2023-01-12,Melaka,7,0,7,2023
2023-01-13,Melaka,19,1,18,2023
2023-01-14,Melaka,142,34,108,2023
2023-01-15,Melaka,104,20,84,2023
2023-01-16,Melaka,18,1,17,2023
2023-01-17,Melaka,87,44,43,2023
2023-01-18,Melaka,94,44,50,2023
2023-01-19,Melaka,74,31,43,2023
2023-01-20,Melaka,25,1,24,2023
2023-01-21,Melaka,6,0,6,2023
2023-01-22,Melaka,80,6,74,2023
2023-01-23,Melaka,102,9,93,2023
2023-01-24,Melaka,63,13,50,2023
2023-01-25,Melaka,12,1,11,2023
2023-01-26,Melaka,78,46,32,2023
2023-01-27,Melaka,15,3,12,2023
2023-01-28,Melaka,136,20,116,2023
2023-01-29,Melaka,40,8,32,2023
2023-01-30,Melaka,18,0,18,2023
2023-01-31,Melaka,80,7,73,2023
2023-02-01,Melaka,115,26,89,2023
2023-02-02,Melaka,71,19,52,2023
2023-02-03,Melaka,56,10,46,2023
2023-02-04,Melaka,81,11,70,2023
2023-02-05,Melaka,130,17,113,2023
2023-02-06,Melaka,19,1,18,2023
2023-02-07,Melaka,68,6,62,2023
2023-02-08,Melaka,24,4,20,2023
2023-02-09,Melaka,13,1,12,2023
2023-02-10,Melaka,203,138,65,2023
2023-02-11,Melaka,99,9,90,2023
2023-02-12,Melaka,143,20,123,2023
2023-02-13,Melaka,12,1,11,2023
2023-02-14,Melaka,48,5,43,2023
2023-02-15,Melaka,74,9,65,2023
2023-02-16,Melaka,114,28,86,2023
2023-02-17,Melaka,17,1,16,2023
2023-02-18,Melaka,180,39,141,2023
2023-02-19,Melaka,70,8,62,2023
2023-02-20,Melaka,15,0,15,2023
2023-02-21,Melaka,58,4,54,2023
2023-02-22,Melaka,72,2,70,2023
2023-02-23,Melaka,57,15,42,2023
2023-02-24,Melaka,16,1,15,2023
2023-02-25,Melaka,122,24,98,2023
2023-02-26,Melaka,141,22,119,2023
2023-02-27,Melaka,63,5,58,2023
2023-02-28,Melaka,34,19,15,2023
2023-03-01,Melaka,30,2,28,2023
2023-03-02,Melaka,63,17,46,2023
2023-03-03,Melaka,22,2,20,2023
2023-03-04,Melaka,150,22,128,2023
2023-03-05,Melaka,0,0,0,2023
2023-03-06,Melaka,17,2,15,2023
2023-03-07,Melaka,146,34,112,2023
2023-03-08,Melaka,117,30,87,2023
2023-03-09,Melaka,12,0,12,2023
2023-03-10,Melaka,76,54,22,2023
2023-03-11,Melaka,116,5,111,2023
2023-03-12,Melaka,134,8,126,2023
2023-03-13,Melaka,75,16,59,2023
2023-03-14,Melaka,152,61,91,2023
2023-03-15,Melaka,116,43,73,2023
2023-03-16,Melaka,76,9,67,2023
2023-03-17,Melaka,14,1,13,2023
2023-03-18,Melaka,197,17,180,2023
2023-03-19,Melaka,234,31,203,2023
2023-03-20,Melaka,154,40,114,2023
2023-03-21,Melaka,206,52,154,2023
2023-03-22,Melaka,176,52,124,2023
2023-03-23,Melaka,0,0,0,2023
2023-03-24,Melaka,9,1,8,2023
2023-03-25,Melaka,42,1,41,2023
2023-03-26,Melaka,144,10,134,2023
2023-03-27,Melaka,16,0,16,2023
2023-03-28,Melaka,36,5,31,2023
2023-03-29,Melaka,68,9,59,2023
2023-03-30,Melaka,22,2,20,2023
2023-03-31,Melaka,60,7,53,2023
2023-04-01,Melaka,104,18,86,2023
2023-04-02,Melaka,116,17,99,2023
2023-04-03,Melaka,39,3,36,2023
2023-04-04,Melaka,93,62,31,2023
2023-04-05,Melaka,135,100,35,2023
2023-04-06,Melaka,32,4,28,2023
2023-04-07,Melaka,58,7,51,2023
2023-04-08,Melaka,72,8,64,2023
2023-04-09,Melaka,121,23,98,2023
2023-04-10,Melaka,141,66,75,2023
2023-04-11,Melaka,117,60,57,2023
2023-04-12,Melaka,86,37,49,2023
2023-04-13,Melaka,193,103,90,2023
2023-04-14,Melaka,6,0,6,2023
2023-04-15,Melaka,71,10,61,2023
2023-04-16,Melaka,75,16,59,2023
2023-04-17,Melaka,167,59,108,2023
2023-04-18,Melaka,52,7,45,2023
2023-04-19,Melaka,26,0,26,2023
2023-04-20,Melaka,23,3,20,2023
2023-04-21,Melaka,0,0,0,2023
2023-04-22,Melaka,0,0,0,2023
2023-04-23,Melaka,0,0,0,2023
2023-04-24,Melaka,39,5,34,2023
2023-04-25,Melaka,40,4,36,2023
2023-04-26,Melaka,55,5,50,2023
2023-04-27,Melaka,56,17,39,2023
2023-04-28,Melaka,15,3,12,2023
2023-04-29,Melaka,115,11,104,2023
2023-04-30,Melaka,171,18,153,2023
2023-05-01,Melaka,193,19,174,2023
2023-05-02,Melaka,14,1,13,2023
2023-05-03,Melaka,34,11,23,2023
2023-05-04,Melaka,200,40,160,2023
2023-05-05,Melaka,17,0,17,2023
2023-05-06,Melaka,112,9,103,2023
2023-05-07,Melaka,92,11,81,2023
2023-05-08,Melaka,17,0,17,2023
2023-05-09,Melaka,103,12,91,2023
2023-05-10,Melaka,67,7,60,2023
2023-05-11,Melaka,59,12,47,2023
2023-05-12,Melaka,12,0,12,2023
2023-05-13,Melaka,214,29,185,2023
2023-05-14,Melaka,147,16,131,2023
2023-05-15,Melaka,113,16,97,2023
2023-05-16,Melaka,14,1,13,2023
2023-05-17,Melaka,76,45,31,2023
2023-05-18,Melaka,20,2,18,2023
2023-05-19,Melaka,74,22,52,2023
2023-05-20,Melaka,176,27,149,2023
2023-05-21,Melaka,166,29,137,2023
2023-05-22,Melaka,17,1,16,2023
2023-05-23,Melaka,107,38,69,2023
2023-05-24,Melaka,16,0,16,2023
2023-05-25,Melaka,72,17,55,2023
2023-05-26,Melaka,11,1,10,2023
2023-05-27,Melaka,89,13,76,2023
2023-05-28,Melaka,147,17,130,2023
2023-05-29,Melaka,11,0,11,2023
2023-05-30,Melaka,74,13,61,2023
2023-05-31,Melaka,105,20,85,2023
2023-06-01,Melaka,80,8,72,2023
2023-06-02,Melaka,15,3,12,2023
2023-06-03,Melaka,124,17,107,2023
2023-06-04,Melaka,132,15,117,2023
2023-06-05,Melaka,0,0,0,2023
2023-06-06,Melaka,76,31,45,2023
2023-06-07,Melaka,183,72,111,2023
2023-06-08,Melaka,52,6,46,2023
2023-06-09,Melaka,18,2,16,2023
2023-06-10,Melaka,138,18,120,2023
2023-06-11,Melaka,126,14,112,2023
2023-06-12,Melaka,65,29,36,2023
2023-06-13,Melaka,127,77,50,2023
2023-06-14,Melaka,198,65,133,2023
2023-06-15,Melaka,131,21,110,2023
2023-06-16,Melaka,13,1,12,2023
2023-06-17,Melaka,116,12,104,2023
2023-06-18,Melaka,200,21,179,2023
2023-06-19,Melaka,11,0,11,2023
2023-06-20,Melaka,128,52,76,2023
2023-06-21,Melaka,132,46,86,2023
2023-06-22,Melaka,16,1,15,2023
2023-06-23,Melaka,11,0,11,2023
2023-06-24,Melaka,86,27,59,2023
2023-06-25,Melaka,168,24,144,2023
2023-06-26,Melaka,13,3,10,2023
2023-06-27,Melaka,130,23,107,2023
2023-06-28,Melaka,16,1,15,2023
2023-06-29,Melaka,0,0,0,2023
2023-06-30,Melaka,12,0,12,2023
2023-07-01,Melaka,136,20,116,2023
2023-07-02,Melaka,75,32,43,2023
2023-07-03,Melaka,11,1,10,2023
2023-07-04,Melaka,213,35,178,2023
2023-07-05,Melaka,221,36,185,2023
2023-07-06,Melaka,11,0,11,2023
2023-07-07,Melaka,11,1,10,2023
2023-07-08,Melaka,77,10,67,2023
2023-07-09,Melaka,100,9,91,2023
2023-07-10,Melaka,17,1,16,2023
2023-07-11,Melaka,214,54,160,2023
2023-07-12,Melaka,131,25,106,2023
2023-07-13,Melaka,133,28,105,2023
2023-07-14,Melaka,20,0,20,2023
2023-07-15,Melaka,69,9,60,2023
2023-07-16,Melaka,177,32,145,2023
2023-07-17,Melaka,10,0,10,2023
2023-07-18,Melaka,160,70,90,2023
2023-07-19,Melaka,128,26,102,2023
2023-07-20,Melaka,11,0,11,2023
2023-07-21,Melaka,16,0,16,2023
2023-07-22,Melaka,0,0,0,2023
2023-07-23,Melaka,115,8,107,2023
2023-07-24,Melaka,23,0,23,2023
2023-07-25,Melaka,122,30,92,2023
2023-07-26,Melaka,64,9,55,2023
2023-07-27,Melaka,93,22,71,2023
2023-07-28,Melaka,6,2,4,2023
2023-07-29,Melaka,155,22,133,2023
2023-07-30,Melaka,121,20,101,2023
2023-07-31,Melaka,17,4,13,2023
2023-08-01,Melaka,72,7,65,2023
2023-08-02,Melaka,130,59,71,2023
2023-08-03,Melaka,37,7,30,2023
2023-08-04,Melaka,11,0,11,2023
2023-08-05,Melaka,67,9,58,2023
2023-08-06,Melaka,161,16,145,2023
2023-08-07,Melaka,15,0,15,2023
2023-08-08,Melaka,77,12,65,2023
2023-08-09,Melaka,89,6,83,2023
2023-08-10,Melaka,58,12,46,2023
2023-08-11,Melaka,11,1,10,2023
2023-08-12,Melaka,83,19,64,2023
2023-08-13,Melaka,196,28,168,2023
2023-08-14,Melaka,167,45,122,2023
2023-08-15,Melaka,131,31,100,2023
2023-08-16,Melaka,96,27,69,2023
2023-08-17,Melaka,13,2,11,2023
2023-08-18,Melaka,49,11,38,2023
2023-08-19,Melaka,6,1,5,2023
2023-08-20,Melaka,123,15,108,2023
2023-08-21,Melaka,19,2,17,2023
2023-08-22,Melaka,14,1,13,2023
2023-08-23,Melaka,163,113,50,2023
2023-08-24,Melaka,125,17,108,2023
2023-08-25,Melaka,17,1,16,2023
2023-08-26,Melaka,84,9,75,2023
2023-08-27,Melaka,105,6,99,2023
2023-08-28,Melaka,19,2,17,2023
2023-08-29,Melaka,118,30,88,2023
2023-08-30,Melaka,12,0,12,2023
2023-08-31,Melaka,165,22,143,2023
2023-09-01,Melaka,17,0,17,2023
2023-09-02,Melaka,70,10,60,2023
2023-09-03,Melaka,173,23,150,2023
2023-09-04,Melaka,17,0,17,2023
2023-09-05,Melaka,88,9,79,2023
2023-09-06,Melaka,59,7,52,2023
2023-09-07,Melaka,11,0,11,2023
2023-09-08,Melaka,12,0,12,2023
2023-09-09,Melaka,97,3,94,2023
2023-09-10,Melaka,128,25,103,2023
2023-09-11,Melaka,22,3,19,2023
2023-09-12,Melaka,114,43,71,2023
2023-09-13,Melaka,140,54,86,2023
2023-09-14,Melaka,69,34,35,2023
2023-09-15,Melaka,13,0,13,2023
2023-09-16,Melaka,147,20,127,2023
2023-09-17,Melaka,120,10,110,2023
2023-09-18,Melaka,19,1,18,2023
2023-09-19,Melaka,203,32,171,2023
2023-09-20,Melaka,11,0,11,2023
2023-09-21,Melaka,73,14,59,2023
2023-09-22,Melaka,15,1,14,2023
2023-09-23,Melaka,66,12,54,2023
2023-09-24,Melaka,164,16,148,2023
2023-09-25,Melaka,28,3,25,2023
2023-09-26,Melaka,73,15,58,2023
2023-09-27,Melaka,118,62,56,2023
2023-09-28,Melaka,50,10,40,2023
2023-09-29,Melaka,17,3,14,2023
2023-09-30,Melaka,83,10,73,2023
2023-10-01,Melaka,188,28,160,2023
2023-10-02,Melaka,13,1,12,2023
2023-10-03,Melaka,56,4,52,2023
2023-10-04,Melaka,53,8,45,2023
2023-10-05,Melaka,19,0,19,2023
2023-10-06,Melaka,219,180,39,2023
2023-10-07,Melaka,92,16,76,2023
2023-10-08,Melaka,83,5,78,2023
2023-10-09,Melaka,26,2,24,2023
2023-10-10,Melaka,74,18,56,2023
2023-10-11,Melaka,104,46,58,2023
2023-10-12,Melaka,156,72,84,2023
2023-10-13,Melaka,12,0,12,2023
2023-10-14,Melaka,127,9,118,2023
2023-10-15,Melaka,54,10,44,2023
2023-10-16,Melaka,14,0,14,2023
2023-10-17,Melaka,9,1,8,2023
2023-10-18,Melaka,104,41,63,2023
2023-10-19,Melaka,166,50,116,2023
2023-10-20,Melaka,9,1,8,2023
2023-10-21,Melaka,101,13,88,2023
2023-10-22,Melaka,149,15,134,2023
2023-10-23,Melaka,16,0,16,2023
2023-10-24,Melaka,13,2,11,2023
2023-10-25,Melaka,101,81,20,2023
2023-10-26,Melaka,140,26,114,2023
2023-10-27,Melaka,95,19,76,2023
2023-10-28,Melaka,102,20,82,2023
2023-10-29,Melaka,153,16,137,2023
2023-10-30,Melaka,17,1,16,2023
2023-10-31,Melaka,59,16,43,2023
2023-11-01,Melaka,166,55,111,2023
2023-11-02,Melaka,104,72,32,2023
2023-11-03,Melaka,0,0,0,2023
2023-11-04,Melaka,186,33,153,2023
2023-11-05,Melaka,151,30,121,2023
2023-11-06,Melaka,0,0,0,2023
2023-11-07,Melaka,0,0,0,2023
2023-11-08,Melaka,97,48,49,2023
2023-11-09,Melaka,0,0,0,2023
2023-11-10,Melaka,0,0,0,2023
2023-11-11,Melaka,155,20,135,2023
2023-11-12,Melaka,181,29,152,2023
2023-11-13,Melaka,189,24,165,2023
2023-11-14,Melaka,20,2,18,2023
2023-11-15,Melaka,78,11,67,2023
2023-11-16,Melaka,96,12,84,2023
2023-11-17,Melaka,30,1,29,2023
2023-11-18,Melaka,0,0,0,2023
2023-11-19,Melaka,148,15,133,2023
2023-11-20,Melaka,29,2,27,2023
2023-11-21,Melaka,23,0,23,2023
2023-11-22,Melaka,112,28,84,2023
2023-11-23,Melaka,153,39,114,2023
2023-11-24,Melaka,5,0,5,2023
2023-11-25,Melaka,171,25,146,2023
2023-11-26,Melaka,89,6,83,2023
2023-11-27,Melaka,20,2,18,2023
2023-11-28,Melaka,44,18,26,2023
2023-11-29,Melaka,86,19,67,2023
2023-11-30,Melaka,51,5,46,2023
2023-12-01,Melaka,13,1,12,2023
2023-12-02,Melaka,7,2,5,2023
2023-12-03,Melaka,295,15,280,2023
2023-12-04,Melaka,20,1,19,2023
2023-12-05,Melaka,18,0,18,2023
2023-12-06,Melaka,67,35,32,2023
2023-12-07,Melaka,66,15,51,2023
2023-12-08,Melaka,19,0,19,2023
2023-12-09,Melaka,71,10,61,2023
2023-12-10,Melaka,119,15,104,2023
2023-12-11,Melaka,16,1,15,2023
2023-12-12,Melaka,13,2,11,2023
2023-12-13,Melaka,116,11,105,2023
2023-12-14,Melaka,84,17,67,2023
2023-12-15,Melaka,11,0,11,2023
2023-12-16,Melaka,90,9,81,2023
2023-12-17,Melaka,202,45,157,2023
2023-12-18,Melaka,14,1,13,2023
2023-12-19,Melaka,66,7,59,2023
2023-12-20,Melaka,56,7,49,2023
2023-12-21,Melaka,63,10,53,2023
2023-12-22,Melaka,62,6,56,2023
2023-12-23,Melaka,9,2,7,2023
2023-12-24,Melaka,144,11,133,2023
2023-12-25,Melaka,107,11,96,2023
2023-12-26,Melaka,48,5,43,2023
2023-12-27,Melaka,50,10,40,2023
2023-12-28,Melaka,59,9,50,2023
2023-12-29,Melaka,9,2,7,2023
2023-12-30,Melaka,68,8,60,2023
2023-12-31,Melaka,120,18,102,2023
2024-01-01,Melaka,148,22,126,2024
2024-01-02,Melaka,70,9,61,2024
2024-01-03,Melaka,11,2,9,2024
2024-01-04,Melaka,77,14,63,2024
2024-01-05,Melaka,8,0,8,2024
2024-01-06,Melaka,123,18,105,2024
2024-01-07,Melaka,176,23,153,2024
2024-01-08,Melaka,65,12,53,2024
2024-01-09,Melaka,83,29,54,2024
2024-01-10,Melaka,15,0,15,2024
2024-01-11,Melaka,47,3,44,2024
2024-01-12,Melaka,8,0,8,2024
2024-01-13,Melaka,147,21,126,2024
2024-01-14,Melaka,154,19,135,2024
2024-01-15,Melaka,14,1,13,2024
2024-01-16,Melaka,100,30,70,2024
2024-01-17,Melaka,86,8,78,2024
2024-01-18,Melaka,109,55,54,2024
2024-01-19,Melaka,8,0,8,2024
2024-01-20,Melaka,42,4,38,2024
2024-01-21,Melaka,160,18,142,2024
2024-01-22,Melaka,19,1,18,2024
2024-01-23,Melaka,62,9,53,2024
2024-01-24,Melaka,105,24,81,2024
2024-01-25,Melaka,57,7,50,2024
2024-01-26,Melaka,14,1,13,2024
2024-01-27,Melaka,98,19,79,2024
2024-01-28,Melaka,184,37,147,2024
2024-01-29,Melaka,15,0,15,2024
2024-01-30,Melaka,76,21,55,2024
2024-01-31,Melaka,66,17,49,2024
2024-02-01,Melaka,87,23,64,2024
2024-02-02,Melaka,12,3,9,2024
2006-01-01,Negeri Sembilan,0,0,0,2006
2006-01-02,Negeri Sembilan,0,0,0,2006
2006-01-03,Negeri Sembilan,0,0,0,2006
2006-01-04,Negeri Sembilan,0,0,0,2006
2006-01-05,Negeri Sembilan,0,0,0,2006
2006-01-06,Negeri Sembilan,0,0,0,2006
2006-01-07,Negeri Sembilan,0,0,0,2006
2006-01-08,Negeri Sembilan,0,0,0,2006
2006-01-09,Negeri Sembilan,0,0,0,2006
2006-01-10,Negeri Sembilan,0,0,0,2006
2006-01-11,Negeri Sembilan,0,0,0,2006
2006-01-12,Negeri Sembilan,0,0,0,2006
2006-01-13,Negeri Sembilan,0,0,0,2006
2006-01-14,Negeri Sembilan,0,0,0,2006
2006-01-15,Negeri Sembilan,0,0,0,2006
2006-01-16,Negeri Sembilan,0,0,0,2006
2006-01-17,Negeri Sembilan,0,0,0,2006
2006-01-18,Negeri Sembilan,0,0,0,2006
2006-01-19,Negeri Sembilan,0,0,0,2006
2006-01-20,Negeri Sembilan,0,0,0,2006
2006-01-21,Negeri Sembilan,0,0,0,2006
2006-01-22,Negeri Sembilan,0,0,0,2006
2006-01-23,Negeri Sembilan,0,0,0,2006
2006-01-24,Negeri Sembilan,0,0,0,2006
2006-01-25,Negeri Sembilan,0,0,0,2006
2006-01-26,Negeri Sembilan,0,0,0,2006
2006-01-27,Negeri Sembilan,0,0,0,2006
2006-01-28,Negeri Sembilan,0,0,0,2006
2006-01-29,Negeri Sembilan,0,0,0,2006
2006-01-30,Negeri Sembilan,0,0,0,2006
2006-01-31,Negeri Sembilan,0,0,0,2006
2006-02-01,Negeri Sembilan,0,0,0,2006
2006-02-02,Negeri Sembilan,0,0,0,2006
2006-02-03,Negeri Sembilan,0,0,0,2006
2006-02-04,Negeri Sembilan,0,0,0,2006
2006-02-05,Negeri Sembilan,0,0,0,2006
2006-02-06,Negeri Sembilan,0,0,0,2006
2006-02-07,Negeri Sembilan,0,0,0,2006
2006-02-08,Negeri Sembilan,0,0,0,2006
2006-02-09,Negeri Sembilan,0,0,0,2006
2006-02-10,Negeri Sembilan,0,0,0,2006
2006-02-11,Negeri Sembilan,0,0,0,2006
2006-02-12,Negeri Sembilan,0,0,0,2006
2006-02-13,Negeri Sembilan,0,0,0,2006
2006-02-14,Negeri Sembilan,0,0,0,2006
2006-02-15,Negeri Sembilan,0,0,0,2006
2006-02-16,Negeri Sembilan,0,0,0,2006
2006-02-17,Negeri Sembilan,0,0,0,2006
2006-02-18,Negeri Sembilan,0,0,0,2006
2006-02-19,Negeri Sembilan,0,0,0,2006
2006-02-20,Negeri Sembilan,0,0,0,2006
2006-02-21,Negeri Sembilan,0,0,0,2006
2006-02-22,Negeri Sembilan,0,0,0,2006
2006-02-23,Negeri Sembilan,0,0,0,2006
2006-02-24,Negeri Sembilan,0,0,0,2006
2006-02-25,Negeri Sembilan,0,0,0,2006
2006-02-26,Negeri Sembilan,0,0,0,2006
2006-02-27,Negeri Sembilan,0,0,0,2006
2006-02-28,Negeri Sembilan,0,0,0,2006
2006-03-01,Negeri Sembilan,0,0,0,2006
2006-03-02,Negeri Sembilan,0,0,0,2006
2006-03-03,Negeri Sembilan,0,0,0,2006
2006-03-04,Negeri Sembilan,0,0,0,2006
2006-03-05,Negeri Sembilan,0,0,0,2006
2006-03-06,Negeri Sembilan,0,0,0,2006
2006-03-07,Negeri Sembilan,0,0,0,2006
2006-03-08,Negeri Sembilan,0,0,0,2006
2006-03-09,Negeri Sembilan,0,0,0,2006
2006-03-10,Negeri Sembilan,0,0,0,2006
2006-03-11,Negeri Sembilan,0,0,0,2006
2006-03-12,Negeri Sembilan,0,0,0,2006
2006-03-13,Negeri Sembilan,0,0,0,2006
2006-03-14,Negeri Sembilan,0,0,0,2006
2006-03-15,Negeri Sembilan,0,0,0,2006
2006-03-16,Negeri Sembilan,0,0,0,2006
2006-03-17,Negeri Sembilan,0,0,0,2006
2006-03-18,Negeri Sembilan,0,0,0,2006
2006-03-19,Negeri Sembilan,0,0,0,2006
2006-03-20,Negeri Sembilan,0,0,0,2006
2006-03-21,Negeri Sembilan,0,0,0,2006
2006-03-22,Negeri Sembilan,0,0,0,2006
2006-03-23,Negeri Sembilan,0,0,0,2006
2006-03-24,Negeri Sembilan,0,0,0,2006
2006-03-25,Negeri Sembilan,0,0,0,2006
2006-03-26,Negeri Sembilan,0,0,0,2006
2006-03-27,Negeri Sembilan,0,0,0,2006
2006-03-28,Negeri Sembilan,0,0,0,2006
2006-03-29,Negeri Sembilan,0,0,0,2006
2006-03-30,Negeri Sembilan,0,0,0,2006
2006-03-31,Negeri Sembilan,0,0,0,2006
2006-04-01,Negeri Sembilan,0,0,0,2006
2006-04-02,Negeri Sembilan,0,0,0,2006
2006-04-03,Negeri Sembilan,0,0,0,2006
2006-04-04,Negeri Sembilan,0,0,0,2006
2006-04-05,Negeri Sembilan,0,0,0,2006
2006-04-06,Negeri Sembilan,0,0,0,2006
2006-04-07,Negeri Sembilan,0,0,0,2006
2006-04-08,Negeri Sembilan,0,0,0,2006
2006-04-09,Negeri Sembilan,0,0,0,2006
2006-04-10,Negeri Sembilan,0,0,0,2006
2006-04-11,Negeri Sembilan,0,0,0,2006
2006-04-12,Negeri Sembilan,0,0,0,2006
2006-04-13,Negeri Sembilan,0,0,0,2006
2006-04-14,Negeri Sembilan,0,0,0,2006
2006-04-15,Negeri Sembilan,0,0,0,2006
2006-04-16,Negeri Sembilan,0,0,0,2006
2006-04-17,Negeri Sembilan,0,0,0,2006
2006-04-18,Negeri Sembilan,0,0,0,2006
2006-04-19,Negeri Sembilan,1,1,0,2006
2006-04-20,Negeri Sembilan,0,0,0,2006
2006-04-21,Negeri Sembilan,0,0,0,2006
2006-04-22,Negeri Sembilan,0,0,0,2006
2006-04-23,Negeri Sembilan,0,0,0,2006
2006-04-24,Negeri Sembilan,0,0,0,2006
2006-04-25,Negeri Sembilan,0,0,0,2006
2006-04-26,Negeri Sembilan,0,0,0,2006
2006-04-27,Negeri Sembilan,0,0,0,2006
2006-04-28,Negeri Sembilan,0,0,0,2006
2006-04-29,Negeri Sembilan,0,0,0,2006
2006-04-30,Negeri Sembilan,0,0,0,2006
2006-05-01,Negeri Sembilan,0,0,0,2006
2006-05-02,Negeri Sembilan,0,0,0,2006
2006-05-03,Negeri Sembilan,0,0,0,2006
2006-05-04,Negeri Sembilan,0,0,0,2006
2006-05-05,Negeri Sembilan,0,0,0,2006
2006-05-06,Negeri Sembilan,0,0,0,2006
2006-05-07,Negeri Sembilan,0,0,0,2006
2006-05-08,Negeri Sembilan,0,0,0,2006
2006-05-09,Negeri Sembilan,0,0,0,2006
2006-05-10,Negeri Sembilan,0,0,0,2006
2006-05-11,Negeri Sembilan,0,0,0,2006
2006-05-12,Negeri Sembilan,0,0,0,2006
2006-05-13,Negeri Sembilan,0,0,0,2006
2006-05-14,Negeri Sembilan,0,0,0,2006
2006-05-15,Negeri Sembilan,0,0,0,2006
2006-05-16,Negeri Sembilan,0,0,0,2006
2006-05-17,Negeri Sembilan,0,0,0,2006
2006-05-18,Negeri Sembilan,0,0,0,2006
2006-05-19,Negeri Sembilan,0,0,0,2006
2006-05-20,Negeri Sembilan,0,0,0,2006
2006-05-21,Negeri Sembilan,0,0,0,2006
2006-05-22,Negeri Sembilan,0,0,0,2006
2006-05-23,Negeri Sembilan,0,0,0,2006
2006-05-24,Negeri Sembilan,0,0,0,2006
2006-05-25,Negeri Sembilan,0,0,0,2006
2006-05-26,Negeri Sembilan,0,0,0,2006
2006-05-27,Negeri Sembilan,0,0,0,2006
2006-05-28,Negeri Sembilan,0,0,0,2006
2006-05-29,Negeri Sembilan,0,0,0,2006
2006-05-30,Negeri Sembilan,0,0,0,2006
2006-05-31,Negeri Sembilan,0,0,0,2006
2006-06-01,Negeri Sembilan,0,0,0,2006
2006-06-02,Negeri Sembilan,0,0,0,2006
2006-06-03,Negeri Sembilan,0,0,0,2006
2006-06-04,Negeri Sembilan,0,0,0,2006
2006-06-05,Negeri Sembilan,0,0,0,2006
2006-06-06,Negeri Sembilan,0,0,0,2006
2006-06-07,Negeri Sembilan,0,0,0,2006
2006-06-08,Negeri Sembilan,0,0,0,2006
2006-06-09,Negeri Sembilan,0,0,0,2006
2006-06-10,Negeri Sembilan,0,0,0,2006
2006-06-11,Negeri Sembilan,0,0,0,2006
2006-06-12,Negeri Sembilan,0,0,0,2006
2006-06-13,Negeri Sembilan,0,0,0,2006
2006-06-14,Negeri Sembilan,0,0,0,2006
2006-06-15,Negeri Sembilan,0,0,0,2006
2006-06-16,Negeri Sembilan,0,0,0,2006
2006-06-17,Negeri Sembilan,0,0,0,2006
2006-06-18,Negeri Sembilan,0,0,0,2006
2006-06-19,Negeri Sembilan,0,0,0,2006
2006-06-20,Negeri Sembilan,0,0,0,2006
2006-06-21,Negeri Sembilan,0,0,0,2006
2006-06-22,Negeri Sembilan,0,0,0,2006
2006-06-23,Negeri Sembilan,0,0,0,2006
2006-06-24,Negeri Sembilan,0,0,0,2006
2006-06-25,Negeri Sembilan,0,0,0,2006
2006-06-26,Negeri Sembilan,0,0,0,2006
2006-06-27,Negeri Sembilan,0,0,0,2006
2006-06-28,Negeri Sembilan,0,0,0,2006
2006-06-29,Negeri Sembilan,0,0,0,2006
2006-06-30,Negeri Sembilan,0,0,0,2006
2006-07-01,Negeri Sembilan,0,0,0,2006
2006-07-02,Negeri Sembilan,0,0,0,2006
2006-07-03,Negeri Sembilan,0,0,0,2006
2006-07-04,Negeri Sembilan,0,0,0,2006
2006-07-05,Negeri Sembilan,0,0,0,2006
2006-07-06,Negeri Sembilan,0,0,0,2006
2006-07-07,Negeri Sembilan,0,0,0,2006
2006-07-08,Negeri Sembilan,0,0,0,2006
2006-07-09,Negeri Sembilan,1,0,1,2006
2006-07-10,Negeri Sembilan,0,0,0,2006
2006-07-11,Negeri Sembilan,0,0,0,2006
2006-07-12,Negeri Sembilan,0,0,0,2006
2006-07-13,Negeri Sembilan,0,0,0,2006
2006-07-14,Negeri Sembilan,0,0,0,2006
2006-07-15,Negeri Sembilan,0,0,0,2006
2006-07-16,Negeri Sembilan,0,0,0,2006
2006-07-17,Negeri Sembilan,0,0,0,2006
2006-07-18,Negeri Sembilan,0,0,0,2006
2006-07-19,Negeri Sembilan,0,0,0,2006
2006-07-20,Negeri Sembilan,0,0,0,2006
2006-07-21,Negeri Sembilan,0,0,0,2006
2006-07-22,Negeri Sembilan,0,0,0,2006
2006-07-23,Negeri Sembilan,0,0,0,2006
2006-07-24,Negeri Sembilan,0,0,0,2006
2006-07-25,Negeri Sembilan,0,0,0,2006
2006-07-26,Negeri Sembilan,0,0,0,2006
2006-07-27,Negeri Sembilan,0,0,0,2006
2006-07-28,Negeri Sembilan,0,0,0,2006
2006-07-29,Negeri Sembilan,0,0,0,2006
2006-07-30,Negeri Sembilan,0,0,0,2006
2006-07-31,Negeri Sembilan,0,0,0,2006
2006-08-01,Negeri Sembilan,0,0,0,2006
2006-08-02,Negeri Sembilan,0,0,0,2006
2006-08-03,Negeri Sembilan,0,0,0,2006
2006-08-04,Negeri Sembilan,0,0,0,2006
2006-08-05,Negeri Sembilan,0,0,0,2006
2006-08-06,Negeri Sembilan,0,0,0,2006
2006-08-07,Negeri Sembilan,0,0,0,2006
2006-08-08,Negeri Sembilan,0,0,0,2006
2006-08-09,Negeri Sembilan,0,0,0,2006
2006-08-10,Negeri Sembilan,0,0,0,2006
2006-08-11,Negeri Sembilan,0,0,0,2006
2006-08-12,Negeri Sembilan,0,0,0,2006
2006-08-13,Negeri Sembilan,0,0,0,2006
2006-08-14,Negeri Sembilan,0,0,0,2006
2006-08-15,Negeri Sembilan,0,0,0,2006
2006-08-16,Negeri Sembilan,0,0,0,2006
2006-08-17,Negeri Sembilan,0,0,0,2006
2006-08-18,Negeri Sembilan,0,0,0,2006
2006-08-19,Negeri Sembilan,0,0,0,2006
2006-08-20,Negeri Sembilan,0,0,0,2006
2006-08-21,Negeri Sembilan,0,0,0,2006
2006-08-22,Negeri Sembilan,0,0,0,2006
2006-08-23,Negeri Sembilan,0,0,0,2006
2006-08-24,Negeri Sembilan,0,0,0,2006
2006-08-25,Negeri Sembilan,0,0,0,2006
2006-08-26,Negeri Sembilan,0,0,0,2006
2006-08-27,Negeri Sembilan,0,0,0,2006
2006-08-28,Negeri Sembilan,0,0,0,2006
2006-08-29,Negeri Sembilan,0,0,0,2006
2006-08-30,Negeri Sembilan,0,0,0,2006
2006-08-31,Negeri Sembilan,0,0,0,2006
2006-09-01,Negeri Sembilan,12,6,6,2006
2006-09-02,Negeri Sembilan,204,202,2,2006
2006-09-03,Negeri Sembilan,272,265,7,2006
2006-09-04,Negeri Sembilan,10,10,0,2006
2006-09-05,Negeri Sembilan,60,46,14,2006
2006-09-06,Negeri Sembilan,15,15,0,2006
2006-09-07,Negeri Sembilan,7,7,0,2006
2006-09-08,Negeri Sembilan,96,96,0,2006
2006-09-09,Negeri Sembilan,0,0,0,2006
2006-09-10,Negeri Sembilan,29,24,5,2006
2006-09-11,Negeri Sembilan,10,10,0,2006
2006-09-12,Negeri Sembilan,10,10,0,2006
2006-09-13,Negeri Sembilan,66,65,1,2006
2006-09-14,Negeri Sembilan,7,6,1,2006
2006-09-15,Negeri Sembilan,69,66,3,2006
2006-09-16,Negeri Sembilan,0,0,0,2006
2006-09-17,Negeri Sembilan,16,15,1,2006
2006-09-18,Negeri Sembilan,85,85,0,2006
2006-09-19,Negeri Sembilan,12,11,1,2006
2006-09-20,Negeri Sembilan,18,18,0,2006
2006-09-21,Negeri Sembilan,99,97,2,2006
2006-09-22,Negeri Sembilan,20,19,1,2006
2006-09-23,Negeri Sembilan,34,34,0,2006
2006-09-24,Negeri Sembilan,62,61,1,2006
2006-09-25,Negeri Sembilan,12,12,0,2006
2006-09-26,Negeri Sembilan,2,2,0,2006
2006-09-27,Negeri Sembilan,50,50,0,2006
2006-09-28,Negeri Sembilan,47,46,1,2006
2006-09-29,Negeri Sembilan,4,3,1,2006
2006-09-30,Negeri Sembilan,0,0,0,2006
2006-10-01,Negeri Sembilan,0,0,0,2006
2006-10-02,Negeri Sembilan,154,146,8,2006
2006-10-03,Negeri Sembilan,9,7,2,2006
2006-10-04,Negeri Sembilan,3,2,1,2006
2006-10-05,Negeri Sembilan,5,4,1,2006
2006-10-06,Negeri Sembilan,5,4,1,2006
2006-10-07,Negeri Sembilan,0,0,0,2006
2006-10-08,Negeri Sembilan,31,28,3,2006
2006-10-09,Negeri Sembilan,92,91,1,2006
2006-10-10,Negeri Sembilan,4,4,0,2006
2006-10-11,Negeri Sembilan,2,2,0,2006
2006-10-12,Negeri Sembilan,4,4,0,2006
2006-10-13,Negeri Sembilan,7,7,0,2006
2006-10-14,Negeri Sembilan,53,53,0,2006
2006-10-15,Negeri Sembilan,0,0,0,2006
2006-10-16,Negeri Sembilan,73,72,1,2006
2006-10-17,Negeri Sembilan,5,5,0,2006
2006-10-18,Negeri Sembilan,78,77,1,2006
2006-10-19,Negeri Sembilan,2,2,0,2006
2006-10-20,Negeri Sembilan,16,14,2,2006
2006-10-21,Negeri Sembilan,0,0,0,2006
2006-10-22,Negeri Sembilan,13,10,3,2006
2006-10-23,Negeri Sembilan,0,0,0,2006
2006-10-24,Negeri Sembilan,0,0,0,2006
2006-10-25,Negeri Sembilan,0,0,0,2006
2006-10-26,Negeri Sembilan,15,15,0,2006
2006-10-27,Negeri Sembilan,58,54,4,2006
2006-10-28,Negeri Sembilan,0,0,0,2006
2006-10-29,Negeri Sembilan,56,55,1,2006
2006-10-30,Negeri Sembilan,10,9,1,2006
2006-10-31,Negeri Sembilan,14,13,1,2006
2006-11-01,Negeri Sembilan,12,10,2,2006
2006-11-02,Negeri Sembilan,50,50,0,2006
2006-11-03,Negeri Sembilan,65,61,4,2006
2006-11-04,Negeri Sembilan,27,27,0,2006
2006-11-05,Negeri Sembilan,118,112,6,2006
2006-11-06,Negeri Sembilan,36,33,3,2006
2006-11-07,Negeri Sembilan,17,16,1,2006
2006-11-08,Negeri Sembilan,85,84,1,2006
2006-11-09,Negeri Sembilan,77,76,1,2006
2006-11-10,Negeri Sembilan,13,12,1,2006
2006-11-11,Negeri Sembilan,0,0,0,2006
2006-11-12,Negeri Sembilan,0,0,0,2006
2006-11-13,Negeri Sembilan,26,24,2,2006
2006-11-14,Negeri Sembilan,20,18,2,2006
2006-11-15,Negeri Sembilan,19,18,1,2006
2006-11-16,Negeri Sembilan,27,25,2,2006
2006-11-17,Negeri Sembilan,6,6,0,2006
2006-11-18,Negeri Sembilan,0,0,0,2006
2006-11-19,Negeri Sembilan,0,0,0,2006
2006-11-20,Negeri Sembilan,11,10,1,2006
2006-11-21,Negeri Sembilan,15,15,0,2006
2006-11-22,Negeri Sembilan,7,6,1,2006
2006-11-23,Negeri Sembilan,87,77,10,2006
2006-11-24,Negeri Sembilan,76,74,2,2006
2006-11-25,Negeri Sembilan,54,48,6,2006
2006-11-26,Negeri Sembilan,0,0,0,2006
2006-11-27,Negeri Sembilan,13,13,0,2006
2006-11-28,Negeri Sembilan,5,4,1,2006
2006-11-29,Negeri Sembilan,6,5,1,2006
2006-11-30,Negeri Sembilan,8,7,1,2006
2006-12-01,Negeri Sembilan,9,8,1,2006
2006-12-02,Negeri Sembilan,44,43,1,2006
2006-12-03,Negeri Sembilan,29,28,1,2006
2006-12-04,Negeri Sembilan,10,8,2,2006
2006-12-05,Negeri Sembilan,9,8,1,2006
2006-12-06,Negeri Sembilan,45,39,6,2006
2006-12-07,Negeri Sembilan,11,7,4,2006
2006-12-08,Negeri Sembilan,12,11,1,2006
2006-12-09,Negeri Sembilan,0,0,0,2006
2006-12-10,Negeri Sembilan,56,56,0,2006
2006-12-11,Negeri Sembilan,18,12,6,2006
2006-12-12,Negeri Sembilan,14,12,2,2006
2006-12-13,Negeri Sembilan,37,28,9,2006
2006-12-14,Negeri Sembilan,6,4,2,2006
2006-12-15,Negeri Sembilan,11,7,4,2006
2006-12-16,Negeri Sembilan,0,0,0,2006
2006-12-17,Negeri Sembilan,287,277,10,2006
2006-12-18,Negeri Sembilan,11,10,1,2006
2006-12-19,Negeri Sembilan,7,6,1,2006
2006-12-20,Negeri Sembilan,47,45,2,2006
2006-12-21,Negeri Sembilan,91,84,7,2006
2006-12-22,Negeri Sembilan,12,8,4,2006
2006-12-23,Negeri Sembilan,25,24,1,2006
2006-12-24,Negeri Sembilan,0,0,0,2006
2006-12-25,Negeri Sembilan,0,0,0,2006
2006-12-26,Negeri Sembilan,15,8,7,2006
2006-12-27,Negeri Sembilan,14,9,5,2006
2006-12-28,Negeri Sembilan,45,42,3,2006
2006-12-29,Negeri Sembilan,103,100,3,2006
2006-12-30,Negeri Sembilan,0,0,0,2006
2006-12-31,Negeri Sembilan,0,0,0,2006
2007-01-01,Negeri Sembilan,0,0,0,2007
2007-01-02,Negeri Sembilan,131,96,35,2007
2007-01-03,Negeri Sembilan,20,15,5,2007
2007-01-04,Negeri Sembilan,18,14,4,2007
2007-01-05,Negeri Sembilan,13,12,1,2007
2007-01-06,Negeri Sembilan,56,43,13,2007
2007-01-07,Negeri Sembilan,0,0,0,2007
2007-01-08,Negeri Sembilan,19,13,6,2007
2007-01-09,Negeri Sembilan,9,6,3,2007
2007-01-10,Negeri Sembilan,36,29,7,2007
2007-01-11,Negeri Sembilan,7,4,3,2007
2007-01-12,Negeri Sembilan,2,2,0,2007
2007-01-13,Negeri Sembilan,79,70,9,2007
2007-01-14,Negeri Sembilan,0,0,0,2007
2007-01-15,Negeri Sembilan,35,26,9,2007
2007-01-16,Negeri Sembilan,7,6,1,2007
2007-01-17,Negeri Sembilan,47,36,11,2007
2007-01-18,Negeri Sembilan,12,8,4,2007
2007-01-19,Negeri Sembilan,23,20,3,2007
2007-01-20,Negeri Sembilan,69,57,12,2007
2007-01-21,Negeri Sembilan,80,68,12,2007
2007-01-22,Negeri Sembilan,11,9,2,2007
2007-01-23,Negeri Sembilan,12,8,4,2007
2007-01-24,Negeri Sembilan,29,23,6,2007
2007-01-25,Negeri Sembilan,102,71,31,2007
2007-01-26,Negeri Sembilan,8,6,2,2007
2007-01-27,Negeri Sembilan,48,45,3,2007
2007-01-28,Negeri Sembilan,42,33,9,2007
2007-01-29,Negeri Sembilan,9,5,4,2007
2007-01-30,Negeri Sembilan,60,56,4,2007
2007-01-31,Negeri Sembilan,128,116,12,2007
2007-02-01,Negeri Sembilan,0,0,0,2007
2007-02-02,Negeri Sembilan,15,7,8,2007
2007-02-03,Negeri Sembilan,72,71,1,2007
2007-02-04,Negeri Sembilan,0,0,0,2007
2007-02-05,Negeri Sembilan,17,12,5,2007
2007-02-06,Negeri Sembilan,48,23,25,2007
2007-02-07,Negeri Sembilan,50,29,21,2007
2007-02-08,Negeri Sembilan,37,21,16,2007
2007-02-09,Negeri Sembilan,77,47,30,2007
2007-02-10,Negeri Sembilan,98,96,2,2007
2007-02-11,Negeri Sembilan,42,35,7,2007
2007-02-12,Negeri Sembilan,12,6,6,2007
2007-02-13,Negeri Sembilan,87,80,7,2007
2007-02-14,Negeri Sembilan,24,19,5,2007
2007-02-15,Negeri Sembilan,227,213,14,2007
2007-02-16,Negeri Sembilan,13,8,5,2007
2007-02-17,Negeri Sembilan,16,15,1,2007
2007-02-18,Negeri Sembilan,0,0,0,2007
2007-02-19,Negeri Sembilan,0,0,0,2007
2007-02-20,Negeri Sembilan,0,0,0,2007
2007-02-21,Negeri Sembilan,21,13,8,2007
2007-02-22,Negeri Sembilan,20,8,12,2007
2007-02-23,Negeri Sembilan,15,5,10,2007
2007-02-24,Negeri Sembilan,258,250,8,2007
2007-02-25,Negeri Sembilan,0,0,0,2007
2007-02-26,Negeri Sembilan,16,7,9,2007
2007-02-27,Negeri Sembilan,13,10,3,2007
2007-02-28,Negeri Sembilan,75,55,20,2007
2007-03-01,Negeri Sembilan,128,121,7,2007
2007-03-02,Negeri Sembilan,41,35,6,2007
2007-03-03,Negeri Sembilan,16,16,0,2007
2007-03-04,Negeri Sembilan,0,0,0,2007
2007-03-05,Negeri Sembilan,17,7,10,2007
2007-03-06,Negeri Sembilan,176,168,8,2007
2007-03-07,Negeri Sembilan,3,1,2,2007
2007-03-08,Negeri Sembilan,46,26,20,2007
2007-03-09,Negeri Sembilan,79,35,44,2007
2007-03-10,Negeri Sembilan,43,37,6,2007
2007-03-11,Negeri Sembilan,4,4,0,2007
2007-03-12,Negeri Sembilan,97,46,51,2007
2007-03-13,Negeri Sembilan,109,56,53,2007
2007-03-14,Negeri Sembilan,8,5,3,2007
2007-03-15,Negeri Sembilan,8,3,5,2007
2007-03-16,Negeri Sembilan,9,3,6,2007
2007-03-17,Negeri Sembilan,0,0,0,2007
2007-03-18,Negeri Sembilan,93,56,37,2007
2007-03-19,Negeri Sembilan,19,13,6,2007
2007-03-20,Negeri Sembilan,10,5,5,2007
2007-03-21,Negeri Sembilan,8,3,5,2007
2007-03-22,Negeri Sembilan,53,28,25,2007
2007-03-23,Negeri Sembilan,11,3,8,2007
2007-03-24,Negeri Sembilan,0,0,0,2007
2007-03-25,Negeri Sembilan,201,101,100,2007
2007-03-26,Negeri Sembilan,17,4,13,2007
2007-03-27,Negeri Sembilan,9,3,6,2007
2007-03-28,Negeri Sembilan,78,62,16,2007
2007-03-29,Negeri Sembilan,4,2,2,2007
2007-03-30,Negeri Sembilan,11,7,4,2007
2007-03-31,Negeri Sembilan,0,0,0,2007
2007-04-01,Negeri Sembilan,0,0,0,2007
2007-04-02,Negeri Sembilan,13,3,10,2007
2007-04-03,Negeri Sembilan,11,4,7,2007
2007-04-04,Negeri Sembilan,74,55,19,2007
2007-04-05,Negeri Sembilan,15,5,10,2007
2007-04-06,Negeri Sembilan,13,5,8,2007
2007-04-07,Negeri Sembilan,47,33,14,2007
2007-04-08,Negeri Sembilan,36,31,5,2007
2007-04-09,Negeri Sembilan,15,5,10,2007
2007-04-10,Negeri Sembilan,12,3,9,2007
2007-04-11,Negeri Sembilan,8,2,6,2007
2007-04-12,Negeri Sembilan,51,38,13,2007
2007-04-13,Negeri Sembilan,7,3,4,2007
2007-04-14,Negeri Sembilan,53,41,12,2007
2007-04-15,Negeri Sembilan,0,0,0,2007
2007-04-16,Negeri Sembilan,11,4,7,2007
2007-04-17,Negeri Sembilan,4,1,3,2007
2007-04-18,Negeri Sembilan,15,9,6,2007
2007-04-19,Negeri Sembilan,54,45,9,2007
2007-04-20,Negeri Sembilan,36,32,4,2007
2007-04-21,Negeri Sembilan,11,9,2,2007
2007-04-22,Negeri Sembilan,102,54,48,2007
2007-04-23,Negeri Sembilan,18,4,14,2007
2007-04-24,Negeri Sembilan,11,2,9,2007
2007-04-25,Negeri Sembilan,30,23,7,2007
2007-04-26,Negeri Sembilan,0,0,0,2007
2007-04-27,Negeri Sembilan,66,54,12,2007
2007-04-28,Negeri Sembilan,53,46,7,2007
2007-04-29,Negeri Sembilan,93,67,26,2007
2007-04-30,Negeri Sembilan,18,8,10,2007
2007-05-01,Negeri Sembilan,70,40,30,2007
2007-05-02,Negeri Sembilan,0,0,0,2007
2007-05-03,Negeri Sembilan,9,3,6,2007
2007-05-04,Negeri Sembilan,8,4,4,2007
2007-05-05,Negeri Sembilan,64,60,4,2007
2007-05-06,Negeri Sembilan,52,45,7,2007
2007-05-07,Negeri Sembilan,13,5,8,2007
2007-05-08,Negeri Sembilan,12,0,12,2007
2007-05-09,Negeri Sembilan,7,4,3,2007
2007-05-10,Negeri Sembilan,71,51,20,2007
2007-05-11,Negeri Sembilan,5,1,4,2007
2007-05-12,Negeri Sembilan,58,50,8,2007
2007-05-13,Negeri Sembilan,54,43,11,2007
2007-05-14,Negeri Sembilan,5,1,4,2007
2007-05-15,Negeri Sembilan,8,0,8,2007
2007-05-16,Negeri Sembilan,46,16,30,2007
2007-05-17,Negeri Sembilan,87,49,38,2007
2007-05-18,Negeri Sembilan,10,3,7,2007
2007-05-19,Negeri Sembilan,25,21,4,2007
2007-05-20,Negeri Sembilan,14,13,1,2007
2007-05-21,Negeri Sembilan,16,4,12,2007
2007-05-22,Negeri Sembilan,11,2,9,2007
2007-05-23,Negeri Sembilan,62,52,10,2007
2007-05-24,Negeri Sembilan,22,16,6,2007
2007-05-25,Negeri Sembilan,7,0,7,2007
2007-05-26,Negeri Sembilan,169,166,3,2007
2007-05-27,Negeri Sembilan,0,0,0,2007
2007-05-28,Negeri Sembilan,16,6,10,2007
2007-05-29,Negeri Sembilan,7,2,5,2007
2007-05-30,Negeri Sembilan,37,34,3,2007
2007-05-31,Negeri Sembilan,39,32,7,2007
2007-06-01,Negeri Sembilan,14,5,9,2007
2007-06-02,Negeri Sembilan,48,37,11,2007
2007-06-03,Negeri Sembilan,76,31,45,2007
2007-06-04,Negeri Sembilan,22,9,13,2007
2007-06-05,Negeri Sembilan,16,6,10,2007
2007-06-06,Negeri Sembilan,46,33,13,2007
2007-06-07,Negeri Sembilan,8,3,5,2007
2007-06-08,Negeri Sembilan,7,1,6,2007
2007-06-09,Negeri Sembilan,0,0,0,2007
2007-06-10,Negeri Sembilan,261,113,148,2007
2007-06-11,Negeri Sembilan,67,45,22,2007
2007-06-12,Negeri Sembilan,9,2,7,2007
2007-06-13,Negeri Sembilan,59,43,16,2007
2007-06-14,Negeri Sembilan,93,59,34,2007
2007-06-15,Negeri Sembilan,8,3,5,2007
2007-06-16,Negeri Sembilan,0,0,0,2007
2007-06-17,Negeri Sembilan,37,26,11,2007
2007-06-18,Negeri Sembilan,16,6,10,2007
2007-06-19,Negeri Sembilan,14,6,8,2007
2007-06-20,Negeri Sembilan,58,35,23,2007
2007-06-21,Negeri Sembilan,43,37,6,2007
2007-06-22,Negeri Sembilan,11,1,10,2007
2007-06-23,Negeri Sembilan,0,0,0,2007
2007-06-24,Negeri Sembilan,184,65,119,2007
2007-06-25,Negeri Sembilan,12,3,9,2007
2007-06-26,Negeri Sembilan,6,2,4,2007
2007-06-27,Negeri Sembilan,45,16,29,2007
2007-06-28,Negeri Sembilan,11,3,8,2007
2007-06-29,Negeri Sembilan,76,39,37,2007
2007-06-30,Negeri Sembilan,0,0,0,2007
2007-07-01,Negeri Sembilan,0,0,0,2007
2007-07-02,Negeri Sembilan,14,5,9,2007
2007-07-03,Negeri Sembilan,21,13,8,2007
2007-07-04,Negeri Sembilan,45,35,10,2007
2007-07-05,Negeri Sembilan,10,5,5,2007
2007-07-06,Negeri Sembilan,69,48,21,2007
2007-07-07,Negeri Sembilan,108,78,30,2007
2007-07-08,Negeri Sembilan,127,87,40,2007
2007-07-09,Negeri Sembilan,11,4,7,2007
2007-07-10,Negeri Sembilan,11,5,6,2007
2007-07-11,Negeri Sembilan,101,84,17,2007
2007-07-12,Negeri Sembilan,92,82,10,2007
2007-07-13,Negeri Sembilan,7,1,6,2007
2007-07-14,Negeri Sembilan,47,41,6,2007
2007-07-15,Negeri Sembilan,84,68,16,2007
2007-07-16,Negeri Sembilan,7,2,5,2007
2007-07-17,Negeri Sembilan,94,77,17,2007
2007-07-18,Negeri Sembilan,88,65,23,2007
2007-07-19,Negeri Sembilan,0,0,0,2007
2007-07-20,Negeri Sembilan,4,0,4,2007
2007-07-21,Negeri Sembilan,0,0,0,2007
2007-07-22,Negeri Sembilan,79,39,40,2007
2007-07-23,Negeri Sembilan,8,2,6,2007
2007-07-24,Negeri Sembilan,5,2,3,2007
2007-07-25,Negeri Sembilan,25,17,8,2007
2007-07-26,Negeri Sembilan,45,36,9,2007
2007-07-27,Negeri Sembilan,12,4,8,2007
2007-07-28,Negeri Sembilan,75,59,16,2007
2007-07-29,Negeri Sembilan,0,0,0,2007
2007-07-30,Negeri Sembilan,12,5,7,2007
2007-07-31,Negeri Sembilan,11,3,8,2007
2007-08-01,Negeri Sembilan,109,80,29,2007
2007-08-02,Negeri Sembilan,83,64,19,2007
2007-08-03,Negeri Sembilan,15,1,14,2007
2007-08-04,Negeri Sembilan,0,0,0,2007
2007-08-05,Negeri Sembilan,36,29,7,2007
2007-08-06,Negeri Sembilan,19,4,15,2007
2007-08-07,Negeri Sembilan,40,19,21,2007
2007-08-08,Negeri Sembilan,67,26,41,2007
2007-08-09,Negeri Sembilan,67,53,14,2007
2007-08-10,Negeri Sembilan,11,3,8,2007
2007-08-11,Negeri Sembilan,33,28,5,2007
2007-08-12,Negeri Sembilan,36,24,12,2007
2007-08-13,Negeri Sembilan,76,58,18,2007
2007-08-14,Negeri Sembilan,11,5,6,2007
2007-08-15,Negeri Sembilan,13,2,11,2007
2007-08-16,Negeri Sembilan,39,30,9,2007
2007-08-17,Negeri Sembilan,8,4,4,2007
2007-08-18,Negeri Sembilan,62,53,9,2007
2007-08-19,Negeri Sembilan,0,0,0,2007
2007-08-20,Negeri Sembilan,9,2,7,2007
2007-08-21,Negeri Sembilan,9,2,7,2007
2007-08-22,Negeri Sembilan,26,13,13,2007
2007-08-23,Negeri Sembilan,12,5,7,2007
2007-08-24,Negeri Sembilan,5,1,4,2007
2007-08-25,Negeri Sembilan,102,98,4,2007
2007-08-26,Negeri Sembilan,31,27,4,2007
2007-08-27,Negeri Sembilan,7,3,4,2007
2007-08-28,Negeri Sembilan,7,2,5,2007
2007-08-29,Negeri Sembilan,53,40,13,2007
2007-08-30,Negeri Sembilan,8,3,5,2007
2007-08-31,Negeri Sembilan,95,86,9,2007
2007-09-01,Negeri Sembilan,20,16,4,2007
2007-09-02,Negeri Sembilan,114,39,75,2007
2007-09-03,Negeri Sembilan,10,2,8,2007
2007-09-04,Negeri Sembilan,18,7,11,2007
2007-09-05,Negeri Sembilan,45,15,30,2007
2007-09-06,Negeri Sembilan,44,37,7,2007
2007-09-07,Negeri Sembilan,6,3,3,2007
2007-09-08,Negeri Sembilan,70,56,14,2007
2007-09-09,Negeri Sembilan,87,55,32,2007
2007-09-10,Negeri Sembilan,105,80,25,2007
2007-09-11,Negeri Sembilan,51,24,27,2007
2007-09-12,Negeri Sembilan,73,35,38,2007
2007-09-13,Negeri Sembilan,1,0,1,2007
2007-09-14,Negeri Sembilan,3,2,1,2007
2007-09-15,Negeri Sembilan,30,17,13,2007
2007-09-16,Negeri Sembilan,27,19,8,2007
2007-09-17,Negeri Sembilan,4,0,4,2007
2007-09-18,Negeri Sembilan,5,0,5,2007
2007-09-19,Negeri Sembilan,7,2,5,2007
2007-09-20,Negeri Sembilan,6,2,4,2007
2007-09-21,Negeri Sembilan,9,2,7,2007
2007-09-22,Negeri Sembilan,0,0,0,2007
2007-09-23,Negeri Sembilan,159,41,118,2007
2007-09-24,Negeri Sembilan,10,2,8,2007
2007-09-25,Negeri Sembilan,7,1,6,2007
2007-09-26,Negeri Sembilan,5,3,2,2007
2007-09-27,Negeri Sembilan,58,31,27,2007
2007-09-28,Negeri Sembilan,40,23,17,2007
2007-09-29,Negeri Sembilan,0,0,0,2007
2007-09-30,Negeri Sembilan,76,25,51,2007
2007-10-01,Negeri Sembilan,6,3,3,2007
2007-10-02,Negeri Sembilan,2,0,2,2007
2007-10-03,Negeri Sembilan,26,17,9,2007
2007-10-04,Negeri Sembilan,1,0,1,2007
2007-10-05,Negeri Sembilan,2,1,1,2007
2007-10-06,Negeri Sembilan,42,37,5,2007
2007-10-07,Negeri Sembilan,86,45,41,2007
2007-10-08,Negeri Sembilan,10,3,7,2007
2007-10-09,Negeri Sembilan,8,2,6,2007
2007-10-10,Negeri Sembilan,39,22,17,2007
2007-10-11,Negeri Sembilan,36,19,17,2007
2007-10-12,Negeri Sembilan,5,0,5,2007
2007-10-13,Negeri Sembilan,0,0,0,2007
2007-10-14,Negeri Sembilan,0,0,0,2007
2007-10-15,Negeri Sembilan,0,0,0,2007
2007-10-16,Negeri Sembilan,21,11,10,2007
2007-10-17,Negeri Sembilan,11,3,8,2007
2007-10-18,Negeri Sembilan,56,33,23,2007
2007-10-19,Negeri Sembilan,23,10,13,2007
2007-10-20,Negeri Sembilan,34,25,9,2007
2007-10-21,Negeri Sembilan,28,19,9,2007
2007-10-22,Negeri Sembilan,20,5,15,2007
2007-10-23,Negeri Sembilan,15,2,13,2007
2007-10-24,Negeri Sembilan,25,13,12,2007
2007-10-25,Negeri Sembilan,127,102,25,2007
2007-10-26,Negeri Sembilan,77,64,13,2007
2007-10-27,Negeri Sembilan,0,0,0,2007
2007-10-28,Negeri Sembilan,52,36,16,2007
2007-10-29,Negeri Sembilan,16,5,11,2007
2007-10-30,Negeri Sembilan,24,9,15,2007
2007-10-31,Negeri Sembilan,58,31,27,2007
2007-11-01,Negeri Sembilan,93,24,69,2007
2007-11-02,Negeri Sembilan,79,47,32,2007
2007-11-03,Negeri Sembilan,0,0,0,2007
2007-11-04,Negeri Sembilan,46,34,12,2007
2007-11-05,Negeri Sembilan,131,80,51,2007
2007-11-06,Negeri Sembilan,46,24,22,2007
2007-11-07,Negeri Sembilan,64,51,13,2007
2007-11-08,Negeri Sembilan,0,0,0,2007
2007-11-09,Negeri Sembilan,18,5,13,2007
2007-11-10,Negeri Sembilan,0,0,0,2007
2007-11-11,Negeri Sembilan,63,44,19,2007
2007-11-12,Negeri Sembilan,14,2,12,2007
2007-11-13,Negeri Sembilan,64,30,34,2007
2007-11-14,Negeri Sembilan,70,34,36,2007
2007-11-15,Negeri Sembilan,12,2,10,2007
2007-11-16,Negeri Sembilan,11,6,5,2007
2007-11-17,Negeri Sembilan,0,0,0,2007
2007-11-18,Negeri Sembilan,0,0,0,2007
2007-11-19,Negeri Sembilan,41,11,30,2007
2007-11-20,Negeri Sembilan,53,23,30,2007
2007-11-21,Negeri Sembilan,19,10,9,2007
2007-11-22,Negeri Sembilan,11,2,9,2007
2007-11-23,Negeri Sembilan,12,2,10,2007
2007-11-24,Negeri Sembilan,53,42,11,2007
2007-11-25,Negeri Sembilan,83,38,45,2007
2007-11-26,Negeri Sembilan,12,4,8,2007
2007-11-27,Negeri Sembilan,9,4,5,2007
2007-11-28,Negeri Sembilan,25,16,9,2007
2007-11-29,Negeri Sembilan,15,7,8,2007
2007-11-30,Negeri Sembilan,10,4,6,2007
2007-12-01,Negeri Sembilan,0,0,0,2007
2007-12-02,Negeri Sembilan,0,0,0,2007
2007-12-03,Negeri Sembilan,92,76,16,2007
2007-12-04,Negeri Sembilan,100,83,17,2007
2007-12-05,Negeri Sembilan,7,4,3,2007
2007-12-06,Negeri Sembilan,6,3,3,2007
2007-12-07,Negeri Sembilan,69,19,50,2007
2007-12-08,Negeri Sembilan,0,0,0,2007
2007-12-09,Negeri Sembilan,27,20,7,2007
2007-12-10,Negeri Sembilan,17,4,13,2007
2007-12-11,Negeri Sembilan,55,16,39,2007
2007-12-12,Negeri Sembilan,58,26,32,2007
2007-12-13,Negeri Sembilan,104,61,43,2007
2007-12-14,Negeri Sembilan,57,28,29,2007
2007-12-15,Negeri Sembilan,1,1,0,2007
2007-12-16,Negeri Sembilan,116,51,65,2007
2007-12-17,Negeri Sembilan,22,12,10,2007
2007-12-18,Negeri Sembilan,18,4,14,2007
2007-12-19,Negeri Sembilan,18,5,13,2007
2007-12-20,Negeri Sembilan,0,0,0,2007
2007-12-21,Negeri Sembilan,14,4,10,2007
2007-12-22,Negeri Sembilan,86,73,13,2007
2007-12-23,Negeri Sembilan,152,38,114,2007
2007-12-24,Negeri Sembilan,23,3,20,2007
2007-12-25,Negeri Sembilan,0,0,0,2007
2007-12-26,Negeri Sembilan,15,2,13,2007
2007-12-27,Negeri Sembilan,14,2,12,2007
2007-12-28,Negeri Sembilan,18,6,12,2007
2007-12-29,Negeri Sembilan,33,22,11,2007
2007-12-30,Negeri Sembilan,58,37,21,2007
2007-12-31,Negeri Sembilan,18,3,15,2007
2008-01-01,Negeri Sembilan,0,0,0,2008
2008-01-02,Negeri Sembilan,16,2,14,2008
2008-01-03,Negeri Sembilan,20,4,16,2008
2008-01-04,Negeri Sembilan,23,7,16,2008
2008-01-05,Negeri Sembilan,41,28,13,2008
2008-01-06,Negeri Sembilan,0,0,0,2008
2008-01-07,Negeri Sembilan,17,2,15,2008
2008-01-08,Negeri Sembilan,36,8,28,2008
2008-01-09,Negeri Sembilan,72,63,9,2008
2008-01-10,Negeri Sembilan,32,23,9,2008
2008-01-11,Negeri Sembilan,14,4,10,2008
2008-01-12,Negeri Sembilan,63,50,13,2008
2008-01-13,Negeri Sembilan,0,0,0,2008
2008-01-14,Negeri Sembilan,26,17,9,2008
2008-01-15,Negeri Sembilan,28,15,13,2008
2008-01-16,Negeri Sembilan,69,38,31,2008
2008-01-17,Negeri Sembilan,51,39,12,2008
2008-01-18,Negeri Sembilan,14,5,9,2008
2008-01-19,Negeri Sembilan,89,85,4,2008
2008-01-20,Negeri Sembilan,48,36,12,2008
2008-01-21,Negeri Sembilan,49,26,23,2008
2008-01-22,Negeri Sembilan,93,55,38,2008
2008-01-23,Negeri Sembilan,41,27,14,2008
2008-01-24,Negeri Sembilan,18,3,15,2008
2008-01-25,Negeri Sembilan,36,19,17,2008
2008-01-26,Negeri Sembilan,4,2,2,2008
2008-01-27,Negeri Sembilan,0,0,0,2008
2008-01-28,Negeri Sembilan,15,3,12,2008
2008-01-29,Negeri Sembilan,115,61,54,2008
2008-01-30,Negeri Sembilan,108,79,29,2008
2008-01-31,Negeri Sembilan,78,45,33,2008
2008-02-01,Negeri Sembilan,12,2,10,2008
2008-02-02,Negeri Sembilan,25,13,12,2008
2008-02-03,Negeri Sembilan,0,0,0,2008
2008-02-04,Negeri Sembilan,20,6,14,2008
2008-02-05,Negeri Sembilan,17,1,16,2008
2008-02-06,Negeri Sembilan,14,1,13,2008
2008-02-07,Negeri Sembilan,0,0,0,2008
2008-02-08,Negeri Sembilan,0,0,0,2008
2008-02-09,Negeri Sembilan,0,0,0,2008
2008-02-10,Negeri Sembilan,26,19,7,2008
2008-02-11,Negeri Sembilan,26,5,21,2008
2008-02-12,Negeri Sembilan,15,6,9,2008
2008-02-13,Negeri Sembilan,161,91,70,2008
2008-02-14,Negeri Sembilan,40,19,21,2008
2008-02-15,Negeri Sembilan,8,2,6,2008
2008-02-16,Negeri Sembilan,68,59,9,2008
2008-02-17,Negeri Sembilan,0,0,0,2008
2008-02-18,Negeri Sembilan,86,47,39,2008
2008-02-19,Negeri Sembilan,75,45,30,2008
2008-02-20,Negeri Sembilan,58,50,8,2008
2008-02-21,Negeri Sembilan,20,4,16,2008
2008-02-22,Negeri Sembilan,7,4,3,2008
2008-02-23,Negeri Sembilan,145,137,8,2008
2008-02-24,Negeri Sembilan,51,26,25,2008
2008-02-25,Negeri Sembilan,11,2,9,2008
2008-02-26,Negeri Sembilan,7,1,6,2008
2008-02-27,Negeri Sembilan,115,59,56,2008
2008-02-28,Negeri Sembilan,46,27,19,2008
2008-02-29,Negeri Sembilan,109,68,41,2008
2008-03-01,Negeri Sembilan,61,35,26,2008
2008-03-02,Negeri Sembilan,109,53,56,2008
2008-03-03,Negeri Sembilan,17,5,12,2008
2008-03-04,Negeri Sembilan,11,1,10,2008
2008-03-05,Negeri Sembilan,13,3,10,2008
2008-03-06,Negeri Sembilan,22,11,11,2008
2008-03-07,Negeri Sembilan,147,110,37,2008
2008-03-08,Negeri Sembilan,0,0,0,2008
2008-03-09,Negeri Sembilan,0,0,0,2008
2008-03-10,Negeri Sembilan,12,1,11,2008
2008-03-11,Negeri Sembilan,8,1,7,2008
2008-03-12,Negeri Sembilan,51,18,33,2008
2008-03-13,Negeri Sembilan,73,45,28,2008
2008-03-14,Negeri Sembilan,9,3,6,2008
2008-03-15,Negeri Sembilan,56,50,6,2008
2008-03-16,Negeri Sembilan,0,0,0,2008
2008-03-17,Negeri Sembilan,7,1,6,2008
2008-03-18,Negeri Sembilan,13,2,11,2008
2008-03-19,Negeri Sembilan,12,1,11,2008
2008-03-20,Negeri Sembilan,0,0,0,2008
2008-03-21,Negeri Sembilan,70,48,22,2008
2008-03-22,Negeri Sembilan,0,0,0,2008
2008-03-23,Negeri Sembilan,218,65,153,2008
2008-03-24,Negeri Sembilan,19,3,16,2008
2008-03-25,Negeri Sembilan,20,1,19,2008
2008-03-26,Negeri Sembilan,53,32,21,2008
2008-03-27,Negeri Sembilan,43,14,29,2008
2008-03-28,Negeri Sembilan,10,1,9,2008
2008-03-29,Negeri Sembilan,0,0,0,2008
2008-03-30,Negeri Sembilan,37,21,16,2008
2008-03-31,Negeri Sembilan,21,3,18,2008
2008-04-01,Negeri Sembilan,11,1,10,2008
2008-04-02,Negeri Sembilan,104,42,62,2008
2008-04-03,Negeri Sembilan,104,44,60,2008
2008-04-04,Negeri Sembilan,132,101,31,2008
2008-04-05,Negeri Sembilan,0,0,0,2008
2008-04-06,Negeri Sembilan,105,64,41,2008
2008-04-07,Negeri Sembilan,14,3,11,2008
2008-04-08,Negeri Sembilan,6,1,5,2008
2008-04-09,Negeri Sembilan,5,0,5,2008
2008-04-10,Negeri Sembilan,54,24,30,2008
2008-04-11,Negeri Sembilan,63,42,21,2008
2008-04-12,Negeri Sembilan,0,0,0,2008
2008-04-13,Negeri Sembilan,3,2,1,2008
2008-04-14,Negeri Sembilan,141,43,98,2008
2008-04-15,Negeri Sembilan,17,6,11,2008
2008-04-16,Negeri Sembilan,71,65,6,2008
2008-04-17,Negeri Sembilan,6,2,4,2008
2008-04-18,Negeri Sembilan,10,0,10,2008
2008-04-19,Negeri Sembilan,0,0,0,2008
2008-04-20,Negeri Sembilan,0,0,0,2008
2008-04-21,Negeri Sembilan,69,48,21,2008
2008-04-22,Negeri Sembilan,9,1,8,2008
2008-04-23,Negeri Sembilan,80,60,20,2008
2008-04-24,Negeri Sembilan,37,18,19,2008
2008-04-25,Negeri Sembilan,5,0,5,2008
2008-04-26,Negeri Sembilan,48,27,21,2008
2008-04-27,Negeri Sembilan,93,50,43,2008
2008-04-28,Negeri Sembilan,20,2,18,2008
2008-04-29,Negeri Sembilan,13,1,12,2008
2008-04-30,Negeri Sembilan,32,27,5,2008
2008-05-01,Negeri Sembilan,56,14,42,2008
2008-05-02,Negeri Sembilan,10,0,10,2008
2008-05-03,Negeri Sembilan,0,0,0,2008
2008-05-04,Negeri Sembilan,57,27,30,2008
2008-05-05,Negeri Sembilan,20,0,20,2008
2008-05-06,Negeri Sembilan,16,4,12,2008
2008-05-07,Negeri Sembilan,12,3,9,2008
2008-05-08,Negeri Sembilan,11,2,9,2008
2008-05-09,Negeri Sembilan,91,78,13,2008
2008-05-10,Negeri Sembilan,36,18,18,2008
2008-05-11,Negeri Sembilan,71,50,21,2008
2008-05-12,Negeri Sembilan,10,5,5,2008
2008-05-13,Negeri Sembilan,59,33,26,2008
2008-05-14,Negeri Sembilan,11,2,9,2008
2008-05-15,Negeri Sembilan,7,2,5,2008
2008-05-16,Negeri Sembilan,9,0,9,2008
2008-05-17,Negeri Sembilan,103,88,15,2008
2008-05-18,Negeri Sembilan,21,17,4,2008
2008-05-19,Negeri Sembilan,0,0,0,2008
2008-05-20,Negeri Sembilan,17,4,13,2008
2008-05-21,Negeri Sembilan,90,66,24,2008
2008-05-22,Negeri Sembilan,73,65,8,2008
2008-05-23,Negeri Sembilan,14,2,12,2008
2008-05-24,Negeri Sembilan,0,0,0,2008
2008-05-25,Negeri Sembilan,76,46,30,2008
2008-05-26,Negeri Sembilan,52,15,37,2008
2008-05-27,Negeri Sembilan,76,36,40,2008
2008-05-28,Negeri Sembilan,19,5,14,2008
2008-05-29,Negeri Sembilan,10,2,8,2008
2008-05-30,Negeri Sembilan,3,1,2,2008
2008-05-31,Negeri Sembilan,0,0,0,2008
2008-06-01,Negeri Sembilan,35,17,18,2008
2008-06-02,Negeri Sembilan,32,1,31,2008
2008-06-03,Negeri Sembilan,7,1,6,2008
2008-06-04,Negeri Sembilan,20,7,13,2008
2008-06-05,Negeri Sembilan,6,2,4,2008
2008-06-06,Negeri Sembilan,8,3,5,2008
2008-06-07,Negeri Sembilan,0,0,0,2008
2008-06-08,Negeri Sembilan,59,38,21,2008
2008-06-09,Negeri Sembilan,15,3,12,2008
2008-06-10,Negeri Sembilan,13,3,10,2008
2008-06-11,Negeri Sembilan,68,33,35,2008
2008-06-12,Negeri Sembilan,44,38,6,2008
2008-06-13,Negeri Sembilan,53,17,36,2008
2008-06-14,Negeri Sembilan,0,0,0,2008
2008-06-15,Negeri Sembilan,42,7,35,2008
2008-06-16,Negeri Sembilan,19,5,14,2008
2008-06-17,Negeri Sembilan,12,1,11,2008
2008-06-18,Negeri Sembilan,30,22,8,2008
2008-06-19,Negeri Sembilan,46,35,11,2008
2008-06-20,Negeri Sembilan,75,46,29,2008
2008-06-21,Negeri Sembilan,0,0,0,2008
2008-06-22,Negeri Sembilan,188,47,141,2008
2008-06-23,Negeri Sembilan,74,34,40,2008
2008-06-24,Negeri Sembilan,10,1,9,2008
2008-06-25,Negeri Sembilan,35,11,24,2008
2008-06-26,Negeri Sembilan,53,38,15,2008
2008-06-27,Negeri Sembilan,7,0,7,2008
2008-06-28,Negeri Sembilan,41,28,13,2008
2008-06-29,Negeri Sembilan,0,0,0,2008
2008-06-30,Negeri Sembilan,60,45,15,2008
2008-07-01,Negeri Sembilan,7,2,5,2008
2008-07-02,Negeri Sembilan,9,0,9,2008
2008-07-03,Negeri Sembilan,64,48,16,2008
2008-07-04,Negeri Sembilan,7,2,5,2008
2008-07-05,Negeri Sembilan,0,0,0,2008
2008-07-06,Negeri Sembilan,25,16,9,2008
2008-07-07,Negeri Sembilan,15,3,12,2008
2008-07-08,Negeri Sembilan,12,1,11,2008
2008-07-09,Negeri Sembilan,14,2,12,2008
2008-07-10,Negeri Sembilan,27,15,12,2008
2008-07-11,Negeri Sembilan,21,10,11,2008
2008-07-12,Negeri Sembilan,57,49,8,2008
2008-07-13,Negeri Sembilan,72,30,42,2008
2008-07-14,Negeri Sembilan,8,2,6,2008
2008-07-15,Negeri Sembilan,11,2,9,2008
2008-07-16,Negeri Sembilan,66,55,11,2008
2008-07-17,Negeri Sembilan,7,0,7,2008
2008-07-18,Negeri Sembilan,40,9,31,2008
2008-07-19,Negeri Sembilan,0,0,0,2008
2008-07-20,Negeri Sembilan,59,21,38,2008
2008-07-21,Negeri Sembilan,88,49,39,2008
2008-07-22,Negeri Sembilan,17,1,16,2008
2008-07-23,Negeri Sembilan,42,23,19,2008
2008-07-24,Negeri Sembilan,97,58,39,2008
2008-07-25,Negeri Sembilan,21,3,18,2008
2008-07-26,Negeri Sembilan,71,40,31,2008
2008-07-27,Negeri Sembilan,0,0,0,2008
2008-07-28,Negeri Sembilan,56,35,21,2008
2008-07-29,Negeri Sembilan,8,4,4,2008
2008-07-30,Negeri Sembilan,0,0,0,2008
2008-07-31,Negeri Sembilan,114,44,70,2008
2008-08-01,Negeri Sembilan,6,3,3,2008
2008-08-02,Negeri Sembilan,28,26,2,2008
2008-08-03,Negeri Sembilan,33,21,12,2008
2008-08-04,Negeri Sembilan,12,1,11,2008
2008-08-05,Negeri Sembilan,6,3,3,2008
2008-08-06,Negeri Sembilan,19,8,11,2008
2008-08-07,Negeri Sembilan,38,33,5,2008
2008-08-08,Negeri Sembilan,16,4,12,2008
2008-08-09,Negeri Sembilan,87,53,34,2008
2008-08-10,Negeri Sembilan,99,70,29,2008
2008-08-11,Negeri Sembilan,11,4,7,2008
2008-08-12,Negeri Sembilan,60,15,45,2008
2008-08-13,Negeri Sembilan,23,10,13,2008
2008-08-14,Negeri Sembilan,72,24,48,2008
2008-08-15,Negeri Sembilan,10,4,6,2008
2008-08-16,Negeri Sembilan,0,0,0,2008
2008-08-17,Negeri Sembilan,103,19,84,2008
2008-08-18,Negeri Sembilan,77,26,51,2008
2008-08-19,Negeri Sembilan,34,8,26,2008
2008-08-20,Negeri Sembilan,96,36,60,2008
2008-08-21,Negeri Sembilan,92,65,27,2008
2008-08-22,Negeri Sembilan,6,0,6,2008
2008-08-23,Negeri Sembilan,93,84,9,2008
2008-08-24,Negeri Sembilan,153,58,95,2008
2008-08-25,Negeri Sembilan,16,1,15,2008
2008-08-26,Negeri Sembilan,6,0,6,2008
2008-08-27,Negeri Sembilan,78,45,33,2008
2008-08-28,Negeri Sembilan,65,41,24,2008
2008-08-29,Negeri Sembilan,64,23,41,2008
2008-08-30,Negeri Sembilan,128,78,50,2008
2008-08-31,Negeri Sembilan,142,76,66,2008
2008-09-01,Negeri Sembilan,0,0,0,2008
2008-09-02,Negeri Sembilan,7,0,7,2008
2008-09-03,Negeri Sembilan,4,2,2,2008
2008-09-04,Negeri Sembilan,2,1,1,2008
2008-09-05,Negeri Sembilan,3,1,2,2008
2008-09-06,Negeri Sembilan,0,0,0,2008
2008-09-07,Negeri Sembilan,108,47,61,2008
2008-09-08,Negeri Sembilan,6,0,6,2008
2008-09-09,Negeri Sembilan,47,18,29,2008
2008-09-10,Negeri Sembilan,40,16,24,2008
2008-09-11,Negeri Sembilan,47,18,29,2008
2008-09-12,Negeri Sembilan,8,2,6,2008
2008-09-13,Negeri Sembilan,34,30,4,2008
2008-09-14,Negeri Sembilan,57,52,5,2008
2008-09-15,Negeri Sembilan,6,0,6,2008
2008-09-16,Negeri Sembilan,1,0,1,2008
2008-09-17,Negeri Sembilan,35,21,14,2008
2008-09-18,Negeri Sembilan,47,33,14,2008
2008-09-19,Negeri Sembilan,28,10,18,2008
2008-09-20,Negeri Sembilan,0,0,0,2008
2008-09-21,Negeri Sembilan,87,18,69,2008
2008-09-22,Negeri Sembilan,6,2,4,2008
2008-09-23,Negeri Sembilan,75,40,35,2008
2008-09-24,Negeri Sembilan,64,32,32,2008
2008-09-25,Negeri Sembilan,71,26,45,2008
2008-09-26,Negeri Sembilan,5,0,5,2008
2008-09-27,Negeri Sembilan,31,17,14,2008
2008-09-28,Negeri Sembilan,163,26,137,2008
2008-09-29,Negeri Sembilan,12,2,10,2008
2008-09-30,Negeri Sembilan,6,1,5,2008
2008-10-01,Negeri Sembilan,0,0,0,2008
2008-10-02,Negeri Sembilan,0,0,0,2008
2008-10-03,Negeri Sembilan,4,0,4,2008
2008-10-04,Negeri Sembilan,43,26,17,2008
2008-10-05,Negeri Sembilan,58,47,11,2008
2008-10-06,Negeri Sembilan,11,0,11,2008
2008-10-07,Negeri Sembilan,14,1,13,2008
2008-10-08,Negeri Sembilan,70,16,54,2008
2008-10-09,Negeri Sembilan,76,27,49,2008
2008-10-10,Negeri Sembilan,6,2,4,2008
2008-10-11,Negeri Sembilan,46,18,28,2008
2008-10-12,Negeri Sembilan,16,13,3,2008
2008-10-13,Negeri Sembilan,10,1,9,2008
2008-10-14,Negeri Sembilan,7,0,7,2008
2008-10-15,Negeri Sembilan,35,10,25,2008
2008-10-16,Negeri Sembilan,49,21,28,2008
2008-10-17,Negeri Sembilan,7,3,4,2008
2008-10-18,Negeri Sembilan,0,0,0,2008
2008-10-19,Negeri Sembilan,58,27,31,2008
2008-10-20,Negeri Sembilan,31,15,16,2008
2008-10-21,Negeri Sembilan,12,1,11,2008
2008-10-22,Negeri Sembilan,128,74,54,2008
2008-10-23,Negeri Sembilan,9,3,6,2008
2008-10-24,Negeri Sembilan,6,1,5,2008
2008-10-25,Negeri Sembilan,40,26,14,2008
2008-10-26,Negeri Sembilan,0,0,0,2008
2008-10-27,Negeri Sembilan,0,0,0,2008
2008-10-28,Negeri Sembilan,47,20,27,2008
2008-10-29,Negeri Sembilan,32,9,23,2008
2008-10-30,Negeri Sembilan,59,28,31,2008
2008-10-31,Negeri Sembilan,64,33,31,2008
2008-11-01,Negeri Sembilan,0,0,0,2008
2008-11-02,Negeri Sembilan,21,10,11,2008
2008-11-03,Negeri Sembilan,17,2,15,2008
2008-11-04,Negeri Sembilan,143,106,37,2008
2008-11-05,Negeri Sembilan,158,111,47,2008
2008-11-06,Negeri Sembilan,9,1,8,2008
2008-11-07,Negeri Sembilan,8,1,7,2008
2008-11-08,Negeri Sembilan,106,84,22,2008
2008-11-09,Negeri Sembilan,12,9,3,2008
2008-11-10,Negeri Sembilan,16,2,14,2008
2008-11-11,Negeri Sembilan,17,1,16,2008
2008-11-12,Negeri Sembilan,14,1,13,2008
2008-11-13,Negeri Sembilan,19,9,10,2008
2008-11-14,Negeri Sembilan,45,33,12,2008
2008-11-15,Negeri Sembilan,28,16,12,2008
2008-11-16,Negeri Sembilan,37,26,11,2008
2008-11-17,Negeri Sembilan,40,30,10,2008
2008-11-18,Negeri Sembilan,119,101,18,2008
2008-11-19,Negeri Sembilan,11,1,10,2008
2008-11-20,Negeri Sembilan,60,17,43,2008
2008-11-21,Negeri Sembilan,9,2,7,2008
2008-11-22,Negeri Sembilan,0,0,0,2008
2008-11-23,Negeri Sembilan,72,19,53,2008
2008-11-24,Negeri Sembilan,11,1,10,2008
2008-11-25,Negeri Sembilan,78,40,38,2008
2008-11-26,Negeri Sembilan,10,1,9,2008
2008-11-27,Negeri Sembilan,68,45,23,2008
2008-11-28,Negeri Sembilan,11,2,9,2008
2008-11-29,Negeri Sembilan,0,0,0,2008
2008-11-30,Negeri Sembilan,70,10,60,2008
2008-12-01,Negeri Sembilan,11,2,9,2008
2008-12-02,Negeri Sembilan,4,0,4,2008
2008-12-03,Negeri Sembilan,31,3,28,2008
2008-12-04,Negeri Sembilan,20,4,16,2008
2008-12-05,Negeri Sembilan,22,5,17,2008
2008-12-06,Negeri Sembilan,39,19,20,2008
2008-12-07,Negeri Sembilan,0,0,0,2008
2008-12-08,Negeri Sembilan,0,0,0,2008
2008-12-09,Negeri Sembilan,50,30,20,2008
2008-12-10,Negeri Sembilan,56,27,29,2008
2008-12-11,Negeri Sembilan,61,21,40,2008
2008-12-12,Negeri Sembilan,14,2,12,2008
2008-12-13,Negeri Sembilan,59,25,34,2008
2008-12-14,Negeri Sembilan,0,0,0,2008
2008-12-15,Negeri Sembilan,47,14,33,2008
2008-12-16,Negeri Sembilan,63,25,38,2008
2008-12-17,Negeri Sembilan,68,27,41,2008
2008-12-18,Negeri Sembilan,55,22,33,2008
2008-12-19,Negeri Sembilan,42,29,13,2008
2008-12-20,Negeri Sembilan,0,0,0,2008
2008-12-21,Negeri Sembilan,0,0,0,2008
2008-12-22,Negeri Sembilan,95,42,53,2008
2008-12-23,Negeri Sembilan,37,15,22,2008
2008-12-24,Negeri Sembilan,30,8,22,2008
2008-12-25,Negeri Sembilan,0,0,0,2008
2008-12-26,Negeri Sembilan,26,6,20,2008
2008-12-27,Negeri Sembilan,0,0,0,2008
2008-12-28,Negeri Sembilan,183,29,154,2008
2008-12-29,Negeri Sembilan,0,0,0,2008
2008-12-30,Negeri Sembilan,13,2,11,2008
2008-12-31,Negeri Sembilan,18,2,16,2008
2009-01-01,Negeri Sembilan,40,31,9,2009
2009-01-02,Negeri Sembilan,14,2,12,2009
2009-01-03,Negeri Sembilan,0,0,0,2009
2009-01-04,Negeri Sembilan,14,9,5,2009
2009-01-05,Negeri Sembilan,27,3,24,2009
2009-01-06,Negeri Sembilan,14,1,13,2009
2009-01-07,Negeri Sembilan,9,1,8,2009
2009-01-08,Negeri Sembilan,128,21,107,2009
2009-01-09,Negeri Sembilan,53,37,16,2009
2009-01-10,Negeri Sembilan,33,15,18,2009
2009-01-11,Negeri Sembilan,0,0,0,2009
2009-01-12,Negeri Sembilan,69,39,30,2009
2009-01-13,Negeri Sembilan,49,24,25,2009
2009-01-14,Negeri Sembilan,141,57,84,2009
2009-01-15,Negeri Sembilan,33,18,15,2009
2009-01-16,Negeri Sembilan,82,68,14,2009
2009-01-17,Negeri Sembilan,0,0,0,2009
2009-01-18,Negeri Sembilan,25,23,2,2009
2009-01-19,Negeri Sembilan,17,2,15,2009
2009-01-20,Negeri Sembilan,9,0,9,2009
2009-01-21,Negeri Sembilan,44,24,20,2009
2009-01-22,Negeri Sembilan,117,69,48,2009
2009-01-23,Negeri Sembilan,49,35,14,2009
2009-01-24,Negeri Sembilan,0,0,0,2009
2009-01-25,Negeri Sembilan,45,29,16,2009
2009-01-26,Negeri Sembilan,0,0,0,2009
2009-01-27,Negeri Sembilan,0,0,0,2009
2009-01-28,Negeri Sembilan,78,32,46,2009
2009-01-29,Negeri Sembilan,79,36,43,2009
2009-01-30,Negeri Sembilan,82,28,54,2009
2009-01-31,Negeri Sembilan,0,0,0,2009
2009-02-01,Negeri Sembilan,0,0,0,2009
2009-02-02,Negeri Sembilan,12,1,11,2009
2009-02-03,Negeri Sembilan,44,17,27,2009
2009-02-04,Negeri Sembilan,73,25,48,2009
2009-02-05,Negeri Sembilan,55,20,35,2009
2009-02-06,Negeri Sembilan,49,12,37,2009
2009-02-07,Negeri Sembilan,59,48,11,2009
2009-02-08,Negeri Sembilan,0,0,0,2009
2009-02-09,Negeri Sembilan,0,0,0,2009
2009-02-10,Negeri Sembilan,52,18,34,2009
2009-02-11,Negeri Sembilan,51,33,18,2009
2009-02-12,Negeri Sembilan,12,2,10,2009
2009-02-13,Negeri Sembilan,79,33,46,2009
2009-02-14,Negeri Sembilan,0,0,0,2009
2009-02-15,Negeri Sembilan,0,0,0,2009
2009-02-16,Negeri Sembilan,42,20,22,2009
2009-02-17,Negeri Sembilan,43,23,20,2009
2009-02-18,Negeri Sembilan,8,0,8,2009
2009-02-19,Negeri Sembilan,111,62,49,2009
2009-02-20,Negeri Sembilan,20,2,18,2009
2009-02-21,Negeri Sembilan,83,73,10,2009
2009-02-22,Negeri Sembilan,63,37,26,2009
2009-02-23,Negeri Sembilan,81,38,43,2009
2009-02-24,Negeri Sembilan,80,29,51,2009
2009-02-25,Negeri Sembilan,82,53,29,2009
2009-02-26,Negeri Sembilan,7,1,6,2009
2009-02-27,Negeri Sembilan,12,1,11,2009
2009-02-28,Negeri Sembilan,11,9,2,2009
2009-03-01,Negeri Sembilan,0,0,0,2009
2009-03-02,Negeri Sembilan,13,5,8,2009
2009-03-03,Negeri Sembilan,141,72,69,2009
2009-03-04,Negeri Sembilan,171,103,68,2009
2009-03-05,Negeri Sembilan,88,55,33,2009
2009-03-06,Negeri Sembilan,75,65,10,2009
2009-03-07,Negeri Sembilan,75,28,47,2009
2009-03-08,Negeri Sembilan,0,0,0,2009
2009-03-09,Negeri Sembilan,15,13,2,2009
2009-03-10,Negeri Sembilan,14,0,14,2009
2009-03-11,Negeri Sembilan,11,1,10,2009
2009-03-12,Negeri Sembilan,47,16,31,2009
2009-03-13,Negeri Sembilan,5,1,4,2009
2009-03-14,Negeri Sembilan,0,0,0,2009
2009-03-15,Negeri Sembilan,0,0,0,2009
2009-03-16,Negeri Sembilan,7,0,7,2009
2009-03-17,Negeri Sembilan,15,1,14,2009
2009-03-18,Negeri Sembilan,4,1,3,2009
2009-03-19,Negeri Sembilan,33,12,21,2009
2009-03-20,Negeri Sembilan,10,1,9,2009
2009-03-21,Negeri Sembilan,0,0,0,2009
2009-03-22,Negeri Sembilan,190,32,158,2009
2009-03-23,Negeri Sembilan,20,4,16,2009
2009-03-24,Negeri Sembilan,13,1,12,2009
2009-03-25,Negeri Sembilan,10,0,10,2009
2009-03-26,Negeri Sembilan,48,13,35,2009
2009-03-27,Negeri Sembilan,17,6,11,2009
2009-03-28,Negeri Sembilan,0,0,0,2009
2009-03-29,Negeri Sembilan,0,0,0,2009
2009-03-30,Negeri Sembilan,14,1,13,2009
2009-03-31,Negeri Sembilan,7,0,7,2009
2009-04-01,Negeri Sembilan,95,61,34,2009
2009-04-02,Negeri Sembilan,28,1,27,2009
2009-04-03,Negeri Sembilan,94,70,24,2009
2009-04-04,Negeri Sembilan,0,0,0,2009
2009-04-05,Negeri Sembilan,0,0,0,2009
2009-04-06,Negeri Sembilan,42,17,25,2009
2009-04-07,Negeri Sembilan,12,2,10,2009
2009-04-08,Negeri Sembilan,13,2,11,2009
2009-04-09,Negeri Sembilan,7,1,6,2009
2009-04-10,Negeri Sembilan,7,1,6,2009
2009-04-11,Negeri Sembilan,0,0,0,2009
2009-04-12,Negeri Sembilan,44,19,25,2009
2009-04-13,Negeri Sembilan,16,3,13,2009
2009-04-14,Negeri Sembilan,3,1,2,2009
2009-04-15,Negeri Sembilan,80,23,57,2009
2009-04-16,Negeri Sembilan,93,42,51,2009
2009-04-17,Negeri Sembilan,64,30,34,2009
2009-04-18,Negeri Sembilan,72,43,29,2009
2009-04-19,Negeri Sembilan,107,20,87,2009
2009-04-20,Negeri Sembilan,14,3,11,2009
2009-04-21,Negeri Sembilan,8,1,7,2009
2009-04-22,Negeri Sembilan,10,2,8,2009
2009-04-23,Negeri Sembilan,16,3,13,2009
2009-04-24,Negeri Sembilan,10,2,8,2009
2009-04-25,Negeri Sembilan,31,21,10,2009
2009-04-26,Negeri Sembilan,0,0,0,2009
2009-04-27,Negeri Sembilan,11,0,11,2009
2009-04-28,Negeri Sembilan,8,2,6,2009
2009-04-29,Negeri Sembilan,63,21,42,2009
2009-04-30,Negeri Sembilan,61,25,36,2009
2009-05-01,Negeri Sembilan,39,6,33,2009
2009-05-02,Negeri Sembilan,0,0,0,2009
2009-05-03,Negeri Sembilan,53,17,36,2009
2009-05-04,Negeri Sembilan,9,1,8,2009
2009-05-05,Negeri Sembilan,11,0,11,2009
2009-05-06,Negeri Sembilan,44,17,27,2009
2009-05-07,Negeri Sembilan,9,1,8,2009
2009-05-08,Negeri Sembilan,36,19,17,2009
2009-05-09,Negeri Sembilan,85,44,41,2009
2009-05-10,Negeri Sembilan,0,0,0,2009
2009-05-11,Negeri Sembilan,18,0,18,2009
2009-05-12,Negeri Sembilan,7,1,6,2009
2009-05-13,Negeri Sembilan,112,67,45,2009
2009-05-14,Negeri Sembilan,14,1,13,2009
2009-05-15,Negeri Sembilan,6,1,5,2009
2009-05-16,Negeri Sembilan,0,0,0,2009
2009-05-17,Negeri Sembilan,73,32,41,2009
2009-05-18,Negeri Sembilan,70,25,45,2009
2009-05-19,Negeri Sembilan,13,1,12,2009
2009-05-20,Negeri Sembilan,6,0,6,2009
2009-05-21,Negeri Sembilan,29,19,10,2009
2009-05-22,Negeri Sembilan,9,2,7,2009
2009-05-23,Negeri Sembilan,62,58,4,2009
2009-05-24,Negeri Sembilan,104,56,48,2009
2009-05-25,Negeri Sembilan,12,1,11,2009
2009-05-26,Negeri Sembilan,15,3,12,2009
2009-05-27,Negeri Sembilan,98,41,57,2009
2009-05-28,Negeri Sembilan,46,38,8,2009
2009-05-29,Negeri Sembilan,14,3,11,2009
2009-05-30,Negeri Sembilan,0,0,0,2009
2009-05-31,Negeri Sembilan,63,29,34,2009
2009-06-01,Negeri Sembilan,19,2,17,2009
2009-06-02,Negeri Sembilan,10,2,8,2009
2009-06-03,Negeri Sembilan,7,1,6,2009
2009-06-04,Negeri Sembilan,9,2,7,2009
2009-06-05,Negeri Sembilan,27,15,12,2009
2009-06-06,Negeri Sembilan,0,0,0,2009
2009-06-07,Negeri Sembilan,101,60,41,2009
2009-06-08,Negeri Sembilan,7,0,7,2009
2009-06-09,Negeri Sembilan,3,0,3,2009
2009-06-10,Negeri Sembilan,6,0,6,2009
2009-06-11,Negeri Sembilan,12,0,12,2009
2009-06-12,Negeri Sembilan,52,9,43,2009
2009-06-13,Negeri Sembilan,30,12,18,2009
2009-06-14,Negeri Sembilan,66,17,49,2009
2009-06-15,Negeri Sembilan,25,10,15,2009
2009-06-16,Negeri Sembilan,11,0,11,2009
2009-06-17,Negeri Sembilan,14,1,13,2009
2009-06-18,Negeri Sembilan,67,30,37,2009
2009-06-19,Negeri Sembilan,29,19,10,2009
2009-06-20,Negeri Sembilan,0,0,0,2009
2009-06-21,Negeri Sembilan,25,7,18,2009
2009-06-22,Negeri Sembilan,11,3,8,2009
2009-06-23,Negeri Sembilan,10,2,8,2009
2009-06-24,Negeri Sembilan,46,41,5,2009
2009-06-25,Negeri Sembilan,81,70,11,2009
2009-06-26,Negeri Sembilan,88,31,57,2009
2009-06-27,Negeri Sembilan,27,18,9,2009
2009-06-28,Negeri Sembilan,192,39,153,2009
2009-06-29,Negeri Sembilan,16,2,14,2009
2009-06-30,Negeri Sembilan,67,52,15,2009
2009-07-01,Negeri Sembilan,8,1,7,2009
2009-07-02,Negeri Sembilan,29,8,21,2009
2009-07-03,Negeri Sembilan,28,9,19,2009
2009-07-04,Negeri Sembilan,0,0,0,2009
2009-07-05,Negeri Sembilan,0,0,0,2009
2009-07-06,Negeri Sembilan,10,0,10,2009
2009-07-07,Negeri Sembilan,12,1,11,2009
2009-07-08,Negeri Sembilan,82,66,16,2009
2009-07-09,Negeri Sembilan,10,0,10,2009
2009-07-10,Negeri Sembilan,10,0,10,2009
2009-07-11,Negeri Sembilan,62,43,19,2009
2009-07-12,Negeri Sembilan,0,0,0,2009
2009-07-13,Negeri Sembilan,10,2,8,2009
2009-07-14,Negeri Sembilan,13,3,10,2009
2009-07-15,Negeri Sembilan,91,39,52,2009
2009-07-16,Negeri Sembilan,7,0,7,2009
2009-07-17,Negeri Sembilan,8,0,8,2009
2009-07-18,Negeri Sembilan,0,0,0,2009
2009-07-19,Negeri Sembilan,98,42,56,2009
2009-07-20,Negeri Sembilan,0,0,0,2009
2009-07-21,Negeri Sembilan,11,1,10,2009
2009-07-22,Negeri Sembilan,154,73,81,2009
2009-07-23,Negeri Sembilan,68,34,34,2009
2009-07-24,Negeri Sembilan,3,2,1,2009
2009-07-25,Negeri Sembilan,31,21,10,2009
2009-07-26,Negeri Sembilan,0,0,0,2009
2009-07-27,Negeri Sembilan,17,3,14,2009
2009-07-28,Negeri Sembilan,9,1,8,2009
2009-07-29,Negeri Sembilan,44,27,17,2009
2009-07-30,Negeri Sembilan,40,18,22,2009
2009-07-31,Negeri Sembilan,10,0,10,2009
2009-08-01,Negeri Sembilan,0,0,0,2009
2009-08-02,Negeri Sembilan,0,0,0,2009
2009-08-03,Negeri Sembilan,14,1,13,2009
2009-08-04,Negeri Sembilan,68,31,37,2009
2009-08-05,Negeri Sembilan,61,33,28,2009
2009-08-06,Negeri Sembilan,19,8,11,2009
2009-08-07,Negeri Sembilan,69,42,27,2009
2009-08-08,Negeri Sembilan,198,186,12,2009
2009-08-09,Negeri Sembilan,50,19,31,2009
2009-08-10,Negeri Sembilan,15,2,13,2009
2009-08-11,Negeri Sembilan,14,2,12,2009
2009-08-12,Negeri Sembilan,137,88,49,2009
2009-08-13,Negeri Sembilan,121,69,52,2009
2009-08-14,Negeri Sembilan,96,56,40,2009
2009-08-15,Negeri Sembilan,98,47,51,2009
2009-08-16,Negeri Sembilan,134,63,71,2009
2009-08-17,Negeri Sembilan,9,0,9,2009
2009-08-18,Negeri Sembilan,12,1,11,2009
2009-08-19,Negeri Sembilan,91,77,14,2009
2009-08-20,Negeri Sembilan,12,0,12,2009
2009-08-21,Negeri Sembilan,17,2,15,2009
2009-08-22,Negeri Sembilan,2,0,2,2009
2009-08-23,Negeri Sembilan,82,12,70,2009
2009-08-24,Negeri Sembilan,1,0,1,2009
2009-08-25,Negeri Sembilan,6,1,5,2009
2009-08-26,Negeri Sembilan,4,0,4,2009
2009-08-27,Negeri Sembilan,7,0,7,2009
2009-08-28,Negeri Sembilan,10,3,7,2009
2009-08-29,Negeri Sembilan,2,0,2,2009
2009-08-30,Negeri Sembilan,68,34,34,2009
2009-08-31,Negeri Sembilan,13,6,7,2009
2009-09-01,Negeri Sembilan,3,0,3,2009
2009-09-02,Negeri Sembilan,6,1,5,2009
2009-09-03,Negeri Sembilan,7,0,7,2009
2009-09-04,Negeri Sembilan,35,5,30,2009
2009-09-05,Negeri Sembilan,0,0,0,2009
2009-09-06,Negeri Sembilan,94,20,74,2009
2009-09-07,Negeri Sembilan,30,2,28,2009
2009-09-08,Negeri Sembilan,30,8,22,2009
2009-09-09,Negeri Sembilan,29,10,19,2009
2009-09-10,Negeri Sembilan,68,45,23,2009
2009-09-11,Negeri Sembilan,50,40,10,2009
2009-09-12,Negeri Sembilan,90,68,22,2009
2009-09-13,Negeri Sembilan,53,27,26,2009
2009-09-14,Negeri Sembilan,22,10,12,2009
2009-09-15,Negeri Sembilan,3,0,3,2009
2009-09-16,Negeri Sembilan,19,10,9,2009
2009-09-17,Negeri Sembilan,4,0,4,2009
2009-09-18,Negeri Sembilan,33,11,22,2009
2009-09-19,Negeri Sembilan,0,0,0,2009
2009-09-20,Negeri Sembilan,0,0,0,2009
2009-09-21,Negeri Sembilan,0,0,0,2009
2009-09-22,Negeri Sembilan,0,0,0,2009
2009-09-23,Negeri Sembilan,16,5,11,2009
2009-09-24,Negeri Sembilan,17,0,17,2009
2009-09-25,Negeri Sembilan,49,26,23,2009
2009-09-26,Negeri Sembilan,0,0,0,2009
2009-09-27,Negeri Sembilan,155,26,129,2009
2009-09-28,Negeri Sembilan,67,41,26,2009
2009-09-29,Negeri Sembilan,12,5,7,2009
2009-09-30,Negeri Sembilan,74,29,45,2009
2009-10-01,Negeri Sembilan,107,46,61,2009
2009-10-02,Negeri Sembilan,86,71,15,2009
2009-10-03,Negeri Sembilan,0,0,0,2009
2009-10-04,Negeri Sembilan,0,0,0,2009
2009-10-05,Negeri Sembilan,17,2,15,2009
2009-10-06,Negeri Sembilan,6,1,5,2009
2009-10-07,Negeri Sembilan,67,39,28,2009
2009-10-08,Negeri Sembilan,64,34,30,2009
2009-10-09,Negeri Sembilan,8,0,8,2009
2009-10-10,Negeri Sembilan,49,18,31,2009
2009-10-11,Negeri Sembilan,27,17,10,2009
2009-10-12,Negeri Sembilan,13,2,11,2009
2009-10-13,Negeri Sembilan,12,0,12,2009
2009-10-14,Negeri Sembilan,39,5,34,2009
2009-10-15,Negeri Sembilan,12,1,11,2009
2009-10-16,Negeri Sembilan,15,0,15,2009
2009-10-17,Negeri Sembilan,35,15,20,2009
2009-10-18,Negeri Sembilan,0,0,0,2009
2009-10-19,Negeri Sembilan,32,7,25,2009
2009-10-20,Negeri Sembilan,9,1,8,2009
2009-10-21,Negeri Sembilan,77,24,53,2009
2009-10-22,Negeri Sembilan,10,2,8,2009
2009-10-23,Negeri Sembilan,73,37,36,2009
2009-10-24,Negeri Sembilan,0,0,0,2009
2009-10-25,Negeri Sembilan,73,43,30,2009
2009-10-26,Negeri Sembilan,0,0,0,2009
2009-10-27,Negeri Sembilan,11,0,11,2009
2009-10-28,Negeri Sembilan,99,43,56,2009
2009-10-29,Negeri Sembilan,24,4,20,2009
2009-10-30,Negeri Sembilan,15,2,13,2009
2009-10-31,Negeri Sembilan,0,0,0,2009
2009-11-01,Negeri Sembilan,0,0,0,2009
2009-11-02,Negeri Sembilan,29,2,27,2009
2009-11-03,Negeri Sembilan,10,2,8,2009
2009-11-04,Negeri Sembilan,64,38,26,2009
2009-11-05,Negeri Sembilan,68,33,35,2009
2009-11-06,Negeri Sembilan,9,5,4,2009
2009-11-07,Negeri Sembilan,0,0,0,2009
2009-11-08,Negeri Sembilan,140,30,110,2009
2009-11-09,Negeri Sembilan,12,0,12,2009
2009-11-10,Negeri Sembilan,118,71,47,2009
2009-11-11,Negeri Sembilan,109,65,44,2009
2009-11-12,Negeri Sembilan,122,74,48,2009
2009-11-13,Negeri Sembilan,16,5,11,2009
2009-11-14,Negeri Sembilan,6,2,4,2009
2009-11-15,Negeri Sembilan,0,0,0,2009
2009-11-16,Negeri Sembilan,37,18,19,2009
2009-11-17,Negeri Sembilan,61,23,38,2009
2009-11-18,Negeri Sembilan,43,12,31,2009
2009-11-19,Negeri Sembilan,32,18,14,2009
2009-11-20,Negeri Sembilan,113,50,63,2009
2009-11-21,Negeri Sembilan,46,40,6,2009
2009-11-22,Negeri Sembilan,0,0,0,2009
2009-11-23,Negeri Sembilan,48,27,21,2009
2009-11-24,Negeri Sembilan,5,1,4,2009
2009-11-25,Negeri Sembilan,6,0,6,2009
2009-11-26,Negeri Sembilan,21,9,12,2009
2009-11-27,Negeri Sembilan,0,0,0,2009
2009-11-28,Negeri Sembilan,43,36,7,2009
2009-11-29,Negeri Sembilan,0,0,0,2009
2009-11-30,Negeri Sembilan,54,26,28,2009
2009-12-01,Negeri Sembilan,13,1,12,2009
2009-12-02,Negeri Sembilan,5,2,3,2009
2009-12-03,Negeri Sembilan,58,13,45,2009
2009-12-04,Negeri Sembilan,78,20,58,2009
2009-12-05,Negeri Sembilan,0,0,0,2009
2009-12-06,Negeri Sembilan,66,12,54,2009
2009-12-07,Negeri Sembilan,16,5,11,2009
2009-12-08,Negeri Sembilan,40,13,27,2009
2009-12-09,Negeri Sembilan,10,0,10,2009
2009-12-10,Negeri Sembilan,13,3,10,2009
2009-12-11,Negeri Sembilan,11,1,10,2009
2009-12-12,Negeri Sembilan,48,14,34,2009
2009-12-13,Negeri Sembilan,0,0,0,2009
2009-12-14,Negeri Sembilan,21,5,16,2009
2009-12-15,Negeri Sembilan,20,5,15,2009
2009-12-16,Negeri Sembilan,68,27,41,2009
2009-12-17,Negeri Sembilan,70,19,51,2009
2009-12-18,Negeri Sembilan,0,0,0,2009
2009-12-19,Negeri Sembilan,0,0,0,2009
2009-12-20,Negeri Sembilan,62,46,16,2009
2009-12-21,Negeri Sembilan,32,16,16,2009
2009-12-22,Negeri Sembilan,53,26,27,2009
2009-12-23,Negeri Sembilan,57,24,33,2009
2009-12-24,Negeri Sembilan,14,7,7,2009
2009-12-25,Negeri Sembilan,0,0,0,2009
2009-12-26,Negeri Sembilan,0,0,0,2009
2009-12-27,Negeri Sembilan,162,27,135,2009
2009-12-28,Negeri Sembilan,12,1,11,2009
2009-12-29,Negeri Sembilan,19,5,14,2009
2009-12-30,Negeri Sembilan,36,17,19,2009
2009-12-31,Negeri Sembilan,17,1,16,2009
2010-01-01,Negeri Sembilan,0,0,0,2010
2010-01-02,Negeri Sembilan,0,0,0,2010
2010-01-03,Negeri Sembilan,42,23,19,2010
2010-01-04,Negeri Sembilan,18,3,15,2010
2010-01-05,Negeri Sembilan,33,6,27,2010
2010-01-06,Negeri Sembilan,13,3,10,2010
2010-01-07,Negeri Sembilan,40,23,17,2010
2010-01-08,Negeri Sembilan,84,72,12,2010
2010-01-09,Negeri Sembilan,47,23,24,2010
2010-01-10,Negeri Sembilan,0,0,0,2010
2010-01-11,Negeri Sembilan,148,81,67,2010
2010-01-12,Negeri Sembilan,110,31,79,2010
2010-01-13,Negeri Sembilan,60,17,43,2010
2010-01-14,Negeri Sembilan,0,0,0,2010
2010-01-15,Negeri Sembilan,8,1,7,2010
2010-01-16,Negeri Sembilan,0,0,0,2010
2010-01-17,Negeri Sembilan,0,0,0,2010
2010-01-18,Negeri Sembilan,80,50,30,2010
2010-01-19,Negeri Sembilan,145,54,91,2010
2010-01-20,Negeri Sembilan,127,97,30,2010
2010-01-21,Negeri Sembilan,19,5,14,2010
2010-01-22,Negeri Sembilan,110,52,58,2010
2010-01-23,Negeri Sembilan,0,0,0,2010
2010-01-24,Negeri Sembilan,0,0,0,2010
2010-01-25,Negeri Sembilan,89,47,42,2010
2010-01-26,Negeri Sembilan,60,38,22,2010
2010-01-27,Negeri Sembilan,106,63,43,2010
2010-01-28,Negeri Sembilan,109,58,51,2010
2010-01-29,Negeri Sembilan,5,0,5,2010
2010-01-30,Negeri Sembilan,105,55,50,2010
2010-01-31,Negeri Sembilan,38,16,22,2010
2010-02-01,Negeri Sembilan,15,2,13,2010
2010-02-02,Negeri Sembilan,90,49,41,2010
2010-02-03,Negeri Sembilan,13,0,13,2010
2010-02-04,Negeri Sembilan,13,3,10,2010
2010-02-05,Negeri Sembilan,16,1,15,2010
2010-02-06,Negeri Sembilan,99,56,43,2010
2010-02-07,Negeri Sembilan,66,60,6,2010
2010-02-08,Negeri Sembilan,10,0,10,2010
2010-02-09,Negeri Sembilan,63,16,47,2010
2010-02-10,Negeri Sembilan,104,30,74,2010
2010-02-11,Negeri Sembilan,57,21,36,2010
2010-02-12,Negeri Sembilan,47,18,29,2010
2010-02-13,Negeri Sembilan,258,88,170,2010
2010-02-14,Negeri Sembilan,0,0,0,2010
2010-02-15,Negeri Sembilan,0,0,0,2010
2010-02-16,Negeri Sembilan,0,0,0,2010
2010-02-17,Negeri Sembilan,19,1,18,2010
2010-02-18,Negeri Sembilan,41,21,20,2010
2010-02-19,Negeri Sembilan,16,4,12,2010
2010-02-20,Negeri Sembilan,0,0,0,2010
2010-02-21,Negeri Sembilan,0,0,0,2010
2010-02-22,Negeri Sembilan,16,4,12,2010
2010-02-23,Negeri Sembilan,79,29,50,2010
2010-02-24,Negeri Sembilan,89,27,62,2010
2010-02-25,Negeri Sembilan,11,1,10,2010
2010-02-26,Negeri Sembilan,0,0,0,2010
2010-02-27,Negeri Sembilan,124,116,8,2010
2010-02-28,Negeri Sembilan,0,0,0,2010
2010-03-01,Negeri Sembilan,18,4,14,2010
2010-03-02,Negeri Sembilan,15,3,12,2010
2010-03-03,Negeri Sembilan,18,0,18,2010
2010-03-04,Negeri Sembilan,173,116,57,2010
2010-03-05,Negeri Sembilan,72,20,52,2010
2010-03-06,Negeri Sembilan,0,0,0,2010
2010-03-07,Negeri Sembilan,40,21,19,2010
2010-03-08,Negeri Sembilan,8,0,8,2010
2010-03-09,Negeri Sembilan,7,0,7,2010
2010-03-10,Negeri Sembilan,51,14,37,2010
2010-03-11,Negeri Sembilan,18,1,17,2010
2010-03-12,Negeri Sembilan,78,27,51,2010
2010-03-13,Negeri Sembilan,0,0,0,2010
2010-03-14,Negeri Sembilan,50,34,16,2010
2010-03-15,Negeri Sembilan,14,2,12,2010
2010-03-16,Negeri Sembilan,11,2,9,2010
2010-03-17,Negeri Sembilan,10,3,7,2010
2010-03-18,Negeri Sembilan,10,2,8,2010
2010-03-19,Negeri Sembilan,13,2,11,2010
2010-03-20,Negeri Sembilan,0,0,0,2010
2010-03-21,Negeri Sembilan,91,8,83,2010
2010-03-22,Negeri Sembilan,15,4,11,2010
2010-03-23,Negeri Sembilan,8,0,8,2010
2010-03-24,Negeri Sembilan,17,3,14,2010
2010-03-25,Negeri Sembilan,46,14,32,2010
2010-03-26,Negeri Sembilan,88,18,70,2010
2010-03-27,Negeri Sembilan,0,0,0,2010
2010-03-28,Negeri Sembilan,150,23,127,2010
2010-03-29,Negeri Sembilan,12,0,12,2010
2010-03-30,Negeri Sembilan,13,0,13,2010
2010-03-31,Negeri Sembilan,49,13,36,2010
2010-04-01,Negeri Sembilan,66,28,38,2010
2010-04-02,Negeri Sembilan,10,1,9,2010
2010-04-03,Negeri Sembilan,27,17,10,2010
2010-04-04,Negeri Sembilan,0,0,0,2010
2010-04-05,Negeri Sembilan,12,4,8,2010
2010-04-06,Negeri Sembilan,19,9,10,2010
2010-04-07,Negeri Sembilan,76,42,34,2010
2010-04-08,Negeri Sembilan,95,46,49,2010
2010-04-09,Negeri Sembilan,5,1,4,2010
2010-04-10,Negeri Sembilan,33,27,6,2010
2010-04-11,Negeri Sembilan,0,0,0,2010
2010-04-12,Negeri Sembilan,11,2,9,2010
2010-04-13,Negeri Sembilan,14,2,12,2010
2010-04-14,Negeri Sembilan,117,53,64,2010
2010-04-15,Negeri Sembilan,142,63,79,2010
2010-04-16,Negeri Sembilan,65,33,32,2010
2010-04-17,Negeri Sembilan,71,40,31,2010
2010-04-18,Negeri Sembilan,0,0,0,2010
2010-04-19,Negeri Sembilan,44,17,27,2010
2010-04-20,Negeri Sembilan,13,0,13,2010
2010-04-21,Negeri Sembilan,62,37,25,2010
2010-04-22,Negeri Sembilan,4,0,4,2010
2010-04-23,Negeri Sembilan,45,23,22,2010
2010-04-24,Negeri Sembilan,30,18,12,2010
2010-04-25,Negeri Sembilan,0,0,0,2010
2010-04-26,Negeri Sembilan,15,2,13,2010
2010-04-27,Negeri Sembilan,14,2,12,2010
2010-04-28,Negeri Sembilan,97,35,62,2010
2010-04-29,Negeri Sembilan,64,42,22,2010
2010-04-30,Negeri Sembilan,9,1,8,2010
2010-05-01,Negeri Sembilan,61,25,36,2010
2010-05-02,Negeri Sembilan,51,22,29,2010
2010-05-03,Negeri Sembilan,15,2,13,2010
2010-05-04,Negeri Sembilan,11,1,10,2010
2010-05-05,Negeri Sembilan,101,45,56,2010
2010-05-06,Negeri Sembilan,12,4,8,2010
2010-05-07,Negeri Sembilan,6,0,6,2010
2010-05-08,Negeri Sembilan,105,104,1,2010
2010-05-09,Negeri Sembilan,0,0,0,2010
2010-05-10,Negeri Sembilan,11,0,11,2010
2010-05-11,Negeri Sembilan,6,0,6,2010
2010-05-12,Negeri Sembilan,12,2,10,2010
2010-05-13,Negeri Sembilan,4,0,4,2010
2010-05-14,Negeri Sembilan,17,5,12,2010
2010-05-15,Negeri Sembilan,1,0,1,2010
2010-05-16,Negeri Sembilan,38,12,26,2010
2010-05-17,Negeri Sembilan,16,2,14,2010
2010-05-18,Negeri Sembilan,12,1,11,2010
2010-05-19,Negeri Sembilan,50,33,17,2010
2010-05-20,Negeri Sembilan,46,7,39,2010
2010-05-21,Negeri Sembilan,8,2,6,2010
2010-05-22,Negeri Sembilan,158,149,9,2010
2010-05-23,Negeri Sembilan,0,0,0,2010
2010-05-24,Negeri Sembilan,20,1,19,2010
2010-05-25,Negeri Sembilan,10,1,9,2010
2010-05-26,Negeri Sembilan,11,3,8,2010
2010-05-27,Negeri Sembilan,16,0,16,2010
2010-05-28,Negeri Sembilan,72,30,42,2010
2010-05-29,Negeri Sembilan,0,0,0,2010
2010-05-30,Negeri Sembilan,53,16,37,2010
2010-05-31,Negeri Sembilan,35,8,27,2010
2010-06-01,Negeri Sembilan,7,1,6,2010
2010-06-02,Negeri Sembilan,64,19,45,2010
2010-06-03,Negeri Sembilan,4,1,3,2010
2010-06-04,Negeri Sembilan,7,1,6,2010
2010-06-05,Negeri Sembilan,21,10,11,2010
2010-06-06,Negeri Sembilan,0,0,0,2010
2010-06-07,Negeri Sembilan,13,0,13,2010
2010-06-08,Negeri Sembilan,8,1,7,2010
2010-06-09,Negeri Sembilan,38,16,22,2010
2010-06-10,Negeri Sembilan,10,2,8,2010
2010-06-11,Negeri Sembilan,10,1,9,2010
2010-06-12,Negeri Sembilan,57,26,31,2010
2010-06-13,Negeri Sembilan,20,6,14,2010
2010-06-14,Negeri Sembilan,10,1,9,2010
2010-06-15,Negeri Sembilan,15,3,12,2010
2010-06-16,Negeri Sembilan,46,11,35,2010
2010-06-17,Negeri Sembilan,40,25,15,2010
2010-06-18,Negeri Sembilan,6,1,5,2010
2010-06-19,Negeri Sembilan,21,9,12,2010
2010-06-20,Negeri Sembilan,47,6,41,2010
2010-06-21,Negeri Sembilan,9,0,9,2010
2010-06-22,Negeri Sembilan,11,0,11,2010
2010-06-23,Negeri Sembilan,28,7,21,2010
2010-06-24,Negeri Sembilan,83,24,59,2010
2010-06-25,Negeri Sembilan,79,20,59,2010
2010-06-26,Negeri Sembilan,63,25,38,2010
2010-06-27,Negeri Sembilan,68,18,50,2010
2010-06-28,Negeri Sembilan,3,0,3,2010
2010-06-29,Negeri Sembilan,7,0,7,2010
2010-06-30,Negeri Sembilan,8,1,7,2010
2010-07-01,Negeri Sembilan,58,41,17,2010
2010-07-02,Negeri Sembilan,7,0,7,2010
2010-07-03,Negeri Sembilan,29,26,3,2010
2010-07-04,Negeri Sembilan,14,8,6,2010
2010-07-05,Negeri Sembilan,7,1,6,2010
2010-07-06,Negeri Sembilan,16,1,15,2010
2010-07-07,Negeri Sembilan,103,47,56,2010
2010-07-08,Negeri Sembilan,59,37,22,2010
2010-07-09,Negeri Sembilan,9,2,7,2010
2010-07-10,Negeri Sembilan,0,0,0,2010
2010-07-11,Negeri Sembilan,0,0,0,2010
2010-07-12,Negeri Sembilan,20,6,14,2010
2010-07-13,Negeri Sembilan,63,16,47,2010
2010-07-14,Negeri Sembilan,86,44,42,2010
2010-07-15,Negeri Sembilan,49,7,42,2010
2010-07-16,Negeri Sembilan,79,32,47,2010
2010-07-17,Negeri Sembilan,30,16,14,2010
2010-07-18,Negeri Sembilan,149,43,106,2010
2010-07-19,Negeri Sembilan,18,1,17,2010
2010-07-20,Negeri Sembilan,42,7,35,2010
2010-07-21,Negeri Sembilan,22,5,17,2010
2010-07-22,Negeri Sembilan,96,63,33,2010
2010-07-23,Negeri Sembilan,7,0,7,2010
2010-07-24,Negeri Sembilan,31,25,6,2010
2010-07-25,Negeri Sembilan,21,15,6,2010
2010-07-26,Negeri Sembilan,49,26,23,2010
2010-07-27,Negeri Sembilan,64,42,22,2010
2010-07-28,Negeri Sembilan,83,47,36,2010
2010-07-29,Negeri Sembilan,90,60,30,2010
2010-07-30,Negeri Sembilan,79,41,38,2010
2010-07-31,Negeri Sembilan,63,51,12,2010
2010-08-01,Negeri Sembilan,23,19,4,2010
2010-08-02,Negeri Sembilan,10,1,9,2010
2010-08-03,Negeri Sembilan,11,0,11,2010
2010-08-04,Negeri Sembilan,9,2,7,2010
2010-08-05,Negeri Sembilan,9,1,8,2010
2010-08-06,Negeri Sembilan,102,65,37,2010
2010-08-07,Negeri Sembilan,126,61,65,2010
2010-08-08,Negeri Sembilan,154,80,74,2010
2010-08-09,Negeri Sembilan,18,1,17,2010
2010-08-10,Negeri Sembilan,18,1,17,2010
2010-08-11,Negeri Sembilan,67,38,29,2010
2010-08-12,Negeri Sembilan,1,0,1,2010
2010-08-13,Negeri Sembilan,8,1,7,2010
2010-08-14,Negeri Sembilan,0,0,0,2010
2010-08-15,Negeri Sembilan,74,11,63,2010
2010-08-16,Negeri Sembilan,2,2,0,2010
2010-08-17,Negeri Sembilan,2,0,2,2010
2010-08-18,Negeri Sembilan,5,0,5,2010
2010-08-19,Negeri Sembilan,11,2,9,2010
2010-08-20,Negeri Sembilan,11,6,5,2010
2010-08-21,Negeri Sembilan,0,0,0,2010
2010-08-22,Negeri Sembilan,86,18,68,2010
2010-08-23,Negeri Sembilan,4,1,3,2010
2010-08-24,Negeri Sembilan,4,0,4,2010
2010-08-25,Negeri Sembilan,68,20,48,2010
2010-08-26,Negeri Sembilan,65,55,10,2010
2010-08-27,Negeri Sembilan,75,51,24,2010
2010-08-28,Negeri Sembilan,47,15,32,2010
2010-08-29,Negeri Sembilan,26,10,16,2010
2010-08-30,Negeri Sembilan,13,0,13,2010
2010-08-31,Negeri Sembilan,0,0,0,2010
2010-09-01,Negeri Sembilan,4,1,3,2010
2010-09-02,Negeri Sembilan,8,2,6,2010
2010-09-03,Negeri Sembilan,157,84,73,2010
2010-09-04,Negeri Sembilan,1,0,1,2010
2010-09-05,Negeri Sembilan,38,6,32,2010
2010-09-06,Negeri Sembilan,54,12,42,2010
2010-09-07,Negeri Sembilan,81,31,50,2010
2010-09-08,Negeri Sembilan,72,24,48,2010
2010-09-09,Negeri Sembilan,4,0,4,2010
2010-09-10,Negeri Sembilan,0,0,0,2010
2010-09-11,Negeri Sembilan,0,0,0,2010
2010-09-12,Negeri Sembilan,0,0,0,2010
2010-09-13,Negeri Sembilan,55,23,32,2010
2010-09-14,Negeri Sembilan,10,0,10,2010
2010-09-15,Negeri Sembilan,18,2,16,2010
2010-09-16,Negeri Sembilan,0,0,0,2010
2010-09-17,Negeri Sembilan,46,23,23,2010
2010-09-18,Negeri Sembilan,0,0,0,2010
2010-09-19,Negeri Sembilan,25,16,9,2010
2010-09-20,Negeri Sembilan,34,3,31,2010
2010-09-21,Negeri Sembilan,21,5,16,2010
2010-09-22,Negeri Sembilan,65,28,37,2010
2010-09-23,Negeri Sembilan,53,32,21,2010
2010-09-24,Negeri Sembilan,76,38,38,2010
2010-09-25,Negeri Sembilan,0,0,0,2010
2010-09-26,Negeri Sembilan,123,16,107,2010
2010-09-27,Negeri Sembilan,22,2,20,2010
2010-09-28,Negeri Sembilan,110,48,62,2010
2010-09-29,Negeri Sembilan,13,1,12,2010
2010-09-30,Negeri Sembilan,82,40,42,2010
2010-10-01,Negeri Sembilan,8,0,8,2010
2010-10-02,Negeri Sembilan,176,161,15,2010
2010-10-03,Negeri Sembilan,22,6,16,2010
2010-10-04,Negeri Sembilan,15,3,12,2010
2010-10-05,Negeri Sembilan,10,0,10,2010
2010-10-06,Negeri Sembilan,58,45,13,2010
2010-10-07,Negeri Sembilan,53,18,35,2010
2010-10-08,Negeri Sembilan,73,25,48,2010
2010-10-09,Negeri Sembilan,59,24,35,2010
2010-10-10,Negeri Sembilan,27,16,11,2010
2010-10-11,Negeri Sembilan,17,0,17,2010
2010-10-12,Negeri Sembilan,60,8,52,2010
2010-10-13,Negeri Sembilan,85,43,42,2010
2010-10-14,Negeri Sembilan,115,55,60,2010
2010-10-15,Negeri Sembilan,14,1,13,2010
2010-10-16,Negeri Sembilan,50,33,17,2010
2010-10-17,Negeri Sembilan,64,23,41,2010
2010-10-18,Negeri Sembilan,21,1,20,2010
2010-10-19,Negeri Sembilan,12,2,10,2010
2010-10-20,Negeri Sembilan,58,44,14,2010
2010-10-21,Negeri Sembilan,11,2,9,2010
2010-10-22,Negeri Sembilan,61,53,8,2010
2010-10-23,Negeri Sembilan,0,0,0,2010
2010-10-24,Negeri Sembilan,0,0,0,2010
2010-10-25,Negeri Sembilan,32,15,17,2010
2010-10-26,Negeri Sembilan,7,0,7,2010
2010-10-27,Negeri Sembilan,43,19,24,2010
2010-10-28,Negeri Sembilan,12,3,9,2010
2010-10-29,Negeri Sembilan,6,2,4,2010
2010-10-30,Negeri Sembilan,0,0,0,2010
2010-10-31,Negeri Sembilan,0,0,0,2010
2010-11-01,Negeri Sembilan,44,12,32,2010
2010-11-02,Negeri Sembilan,64,41,23,2010
2010-11-03,Negeri Sembilan,52,18,34,2010
2010-11-04,Negeri Sembilan,8,2,6,2010
2010-11-05,Negeri Sembilan,0,0,0,2010
2010-11-06,Negeri Sembilan,0,0,0,2010
2010-11-07,Negeri Sembilan,44,26,18,2010
2010-11-08,Negeri Sembilan,14,5,9,2010
2010-11-09,Negeri Sembilan,64,19,45,2010
2010-11-10,Negeri Sembilan,80,31,49,2010
2010-11-11,Negeri Sembilan,68,32,36,2010
2010-11-12,Negeri Sembilan,8,1,7,2010
2010-11-13,Negeri Sembilan,23,10,13,2010
2010-11-14,Negeri Sembilan,43,4,39,2010
2010-11-15,Negeri Sembilan,52,18,34,2010
2010-11-16,Negeri Sembilan,64,42,22,2010
2010-11-17,Negeri Sembilan,0,0,0,2010
2010-11-18,Negeri Sembilan,11,4,7,2010
2010-11-19,Negeri Sembilan,8,2,6,2010
2010-11-20,Negeri Sembilan,78,33,45,2010
2010-11-21,Negeri Sembilan,48,28,20,2010
2010-11-22,Negeri Sembilan,9,4,5,2010
2010-11-23,Negeri Sembilan,52,17,35,2010
2010-11-24,Negeri Sembilan,90,51,39,2010
2010-11-25,Negeri Sembilan,49,30,19,2010
2010-11-26,Negeri Sembilan,9,3,6,2010
2010-11-27,Negeri Sembilan,38,31,7,2010
2010-11-28,Negeri Sembilan,35,25,10,2010
2010-11-29,Negeri Sembilan,11,1,10,2010
2010-11-30,Negeri Sembilan,11,2,9,2010
2010-12-01,Negeri Sembilan,11,3,8,2010
2010-12-02,Negeri Sembilan,11,1,10,2010
2010-12-03,Negeri Sembilan,117,58,59,2010
2010-12-04,Negeri Sembilan,0,0,0,2010
2010-12-05,Negeri Sembilan,45,20,25,2010
2010-12-06,Negeri Sembilan,20,1,19,2010
2010-12-07,Negeri Sembilan,0,0,0,2010
2010-12-08,Negeri Sembilan,12,3,9,2010
2010-12-09,Negeri Sembilan,36,19,17,2010
2010-12-10,Negeri Sembilan,117,65,52,2010
2010-12-11,Negeri Sembilan,28,18,10,2010
2010-12-12,Negeri Sembilan,10,3,7,2010
2010-12-13,Negeri Sembilan,18,1,17,2010
2010-12-14,Negeri Sembilan,18,1,17,2010
2010-12-15,Negeri Sembilan,104,57,47,2010
2010-12-16,Negeri Sembilan,99,51,48,2010
2010-12-17,Negeri Sembilan,59,35,24,2010
2010-12-18,Negeri Sembilan,0,0,0,2010
2010-12-19,Negeri Sembilan,0,0,0,2010
2010-12-20,Negeri Sembilan,65,14,51,2010
2010-12-21,Negeri Sembilan,106,38,68,2010
2010-12-22,Negeri Sembilan,45,6,39,2010
2010-12-23,Negeri Sembilan,19,5,14,2010
2010-12-24,Negeri Sembilan,15,2,13,2010
2010-12-25,Negeri Sembilan,0,0,0,2010
2010-12-26,Negeri Sembilan,84,13,71,2010
2010-12-27,Negeri Sembilan,18,4,14,2010
2010-12-28,Negeri Sembilan,77,22,55,2010
2010-12-29,Negeri Sembilan,109,48,61,2010
2010-12-30,Negeri Sembilan,100,38,62,2010
2010-12-31,Negeri Sembilan,0,0,0,2010
2011-01-01,Negeri Sembilan,0,0,0,2011
2011-01-02,Negeri Sembilan,0,0,0,2011
2011-01-03,Negeri Sembilan,5,1,4,2011
2011-01-04,Negeri Sembilan,33,16,17,2011
2011-01-05,Negeri Sembilan,14,1,13,2011
2011-01-06,Negeri Sembilan,82,61,21,2011
2011-01-07,Negeri Sembilan,4,0,4,2011
2011-01-08,Negeri Sembilan,45,20,25,2011
2011-01-09,Negeri Sembilan,48,28,20,2011
2011-01-10,Negeri Sembilan,102,40,62,2011
2011-01-11,Negeri Sembilan,84,64,20,2011
2011-01-12,Negeri Sembilan,105,85,20,2011
2011-01-13,Negeri Sembilan,84,61,23,2011
2011-01-14,Negeri Sembilan,0,0,0,2011
2011-01-15,Negeri Sembilan,25,16,9,2011
2011-01-16,Negeri Sembilan,26,13,13,2011
2011-01-17,Negeri Sembilan,40,20,20,2011
2011-01-18,Negeri Sembilan,75,37,38,2011
2011-01-19,Negeri Sembilan,11,1,10,2011
2011-01-20,Negeri Sembilan,0,0,0,2011
2011-01-21,Negeri Sembilan,85,29,56,2011
2011-01-22,Negeri Sembilan,0,0,0,2011
2011-01-23,Negeri Sembilan,12,7,5,2011
2011-01-24,Negeri Sembilan,29,14,15,2011
2011-01-25,Negeri Sembilan,11,4,7,2011
2011-01-26,Negeri Sembilan,118,63,55,2011
2011-01-27,Negeri Sembilan,7,0,7,2011
2011-01-28,Negeri Sembilan,20,4,16,2011
2011-01-29,Negeri Sembilan,256,248,8,2011
2011-01-30,Negeri Sembilan,0,0,0,2011
2011-01-31,Negeri Sembilan,58,15,43,2011
2011-02-01,Negeri Sembilan,72,41,31,2011
2011-02-02,Negeri Sembilan,15,2,13,2011
2011-02-03,Negeri Sembilan,0,0,0,2011
2011-02-04,Negeri Sembilan,0,0,0,2011
2011-02-05,Negeri Sembilan,31,20,11,2011
2011-02-06,Negeri Sembilan,39,22,17,2011
2011-02-07,Negeri Sembilan,30,16,14,2011
2011-02-08,Negeri Sembilan,18,1,17,2011
2011-02-09,Negeri Sembilan,140,87,53,2011
2011-02-10,Negeri Sembilan,9,1,8,2011
2011-02-11,Negeri Sembilan,17,1,16,2011
2011-02-12,Negeri Sembilan,45,26,19,2011
2011-02-13,Negeri Sembilan,56,25,31,2011
2011-02-14,Negeri Sembilan,22,5,17,2011
2011-02-15,Negeri Sembilan,0,0,0,2011
2011-02-16,Negeri Sembilan,61,14,47,2011
2011-02-17,Negeri Sembilan,91,66,25,2011
2011-02-18,Negeri Sembilan,12,4,8,2011
2011-02-19,Negeri Sembilan,0,0,0,2011
2011-02-20,Negeri Sembilan,44,21,23,2011
2011-02-21,Negeri Sembilan,20,2,18,2011
2011-02-22,Negeri Sembilan,40,22,18,2011
2011-02-23,Negeri Sembilan,99,31,68,2011
2011-02-24,Negeri Sembilan,49,23,26,2011
2011-02-25,Negeri Sembilan,15,0,15,2011
2011-02-26,Negeri Sembilan,59,54,5,2011
2011-02-27,Negeri Sembilan,0,0,0,2011
2011-02-28,Negeri Sembilan,119,51,68,2011
2011-03-01,Negeri Sembilan,64,25,39,2011
2011-03-02,Negeri Sembilan,57,12,45,2011
2011-03-03,Negeri Sembilan,66,31,35,2011
2011-03-04,Negeri Sembilan,38,16,22,2011
2011-03-05,Negeri Sembilan,96,66,30,2011
2011-03-06,Negeri Sembilan,102,33,69,2011
2011-03-07,Negeri Sembilan,77,30,47,2011
2011-03-08,Negeri Sembilan,68,19,49,2011
2011-03-09,Negeri Sembilan,69,28,41,2011
2011-03-10,Negeri Sembilan,69,29,40,2011
2011-03-11,Negeri Sembilan,77,47,30,2011
2011-03-12,Negeri Sembilan,69,27,42,2011
2011-03-13,Negeri Sembilan,65,23,42,2011
2011-03-14,Negeri Sembilan,21,3,18,2011
2011-03-15,Negeri Sembilan,9,3,6,2011
2011-03-16,Negeri Sembilan,14,1,13,2011
2011-03-17,Negeri Sembilan,125,26,99,2011
2011-03-18,Negeri Sembilan,125,53,72,2011
2011-03-19,Negeri Sembilan,0,0,0,2011
2011-03-20,Negeri Sembilan,51,13,38,2011
2011-03-21,Negeri Sembilan,6,0,6,2011
2011-03-22,Negeri Sembilan,54,9,45,2011
2011-03-23,Negeri Sembilan,11,2,9,2011
2011-03-24,Negeri Sembilan,10,2,8,2011
2011-03-25,Negeri Sembilan,11,1,10,2011
2011-03-26,Negeri Sembilan,47,28,19,2011
2011-03-27,Negeri Sembilan,37,25,12,2011
2011-03-28,Negeri Sembilan,18,3,15,2011
2011-03-29,Negeri Sembilan,66,36,30,2011
2011-03-30,Negeri Sembilan,13,3,10,2011
2011-03-31,Negeri Sembilan,65,25,40,2011
2011-04-01,Negeri Sembilan,12,0,12,2011
2011-04-02,Negeri Sembilan,26,12,14,2011
2011-04-03,Negeri Sembilan,84,30,54,2011
2011-04-04,Negeri Sembilan,81,30,51,2011
2011-04-05,Negeri Sembilan,5,1,4,2011
2011-04-06,Negeri Sembilan,26,6,20,2011
2011-04-07,Negeri Sembilan,8,1,7,2011
2011-04-08,Negeri Sembilan,13,3,10,2011
2011-04-09,Negeri Sembilan,0,0,0,2011
2011-04-10,Negeri Sembilan,95,15,80,2011
2011-04-11,Negeri Sembilan,12,2,10,2011
2011-04-12,Negeri Sembilan,11,1,10,2011
2011-04-13,Negeri Sembilan,83,47,36,2011
2011-04-14,Negeri Sembilan,73,38,35,2011
2011-04-15,Negeri Sembilan,6,1,5,2011
2011-04-16,Negeri Sembilan,222,72,150,2011
2011-04-17,Negeri Sembilan,0,0,0,2011
2011-04-18,Negeri Sembilan,16,1,15,2011
2011-04-19,Negeri Sembilan,12,1,11,2011
2011-04-20,Negeri Sembilan,11,0,11,2011
2011-04-21,Negeri Sembilan,4,0,4,2011
2011-04-22,Negeri Sembilan,94,16,78,2011
2011-04-23,Negeri Sembilan,37,27,10,2011
2011-04-24,Negeri Sembilan,113,18,95,2011
2011-04-25,Negeri Sembilan,13,2,11,2011
2011-04-26,Negeri Sembilan,16,1,15,2011
2011-04-27,Negeri Sembilan,14,0,14,2011
2011-04-28,Negeri Sembilan,52,19,33,2011
2011-04-29,Negeri Sembilan,9,2,7,2011
2011-04-30,Negeri Sembilan,69,46,23,2011
2011-05-01,Negeri Sembilan,61,13,48,2011
2011-05-02,Negeri Sembilan,0,0,0,2011
2011-05-03,Negeri Sembilan,10,0,10,2011
2011-05-04,Negeri Sembilan,17,0,17,2011
2011-05-05,Negeri Sembilan,80,15,65,2011
2011-05-06,Negeri Sembilan,6,0,6,2011
2011-05-07,Negeri Sembilan,76,34,42,2011
2011-05-08,Negeri Sembilan,15,10,5,2011
2011-05-09,Negeri Sembilan,61,16,45,2011
2011-05-10,Negeri Sembilan,22,1,21,2011
2011-05-11,Negeri Sembilan,9,1,8,2011
2011-05-12,Negeri Sembilan,10,0,10,2011
2011-05-13,Negeri Sembilan,6,1,5,2011
2011-05-14,Negeri Sembilan,31,15,16,2011
2011-05-15,Negeri Sembilan,121,52,69,2011
2011-05-16,Negeri Sembilan,15,0,15,2011
2011-05-17,Negeri Sembilan,82,24,58,2011
2011-05-18,Negeri Sembilan,13,1,12,2011
2011-05-19,Negeri Sembilan,36,14,22,2011
2011-05-20,Negeri Sembilan,8,1,7,2011
2011-05-21,Negeri Sembilan,16,10,6,2011
2011-05-22,Negeri Sembilan,0,0,0,2011
2011-05-23,Negeri Sembilan,15,2,13,2011
2011-05-24,Negeri Sembilan,3,0,3,2011
2011-05-25,Negeri Sembilan,36,10,26,2011
2011-05-26,Negeri Sembilan,8,0,8,2011
2011-05-27,Negeri Sembilan,11,3,8,2011
2011-05-28,Negeri Sembilan,0,0,0,2011
2011-05-29,Negeri Sembilan,51,14,37,2011
2011-05-30,Negeri Sembilan,11,0,11,2011
2011-05-31,Negeri Sembilan,8,1,7,2011
2011-06-01,Negeri Sembilan,10,2,8,2011
2011-06-02,Negeri Sembilan,52,19,33,2011
2011-06-03,Negeri Sembilan,12,2,10,2011
2011-06-04,Negeri Sembilan,0,0,0,2011
2011-06-05,Negeri Sembilan,20,6,14,2011
2011-06-06,Negeri Sembilan,13,1,12,2011
2011-06-07,Negeri Sembilan,7,2,5,2011
2011-06-08,Negeri Sembilan,16,4,12,2011
2011-06-09,Negeri Sembilan,18,3,15,2011
2011-06-10,Negeri Sembilan,46,20,26,2011
2011-06-11,Negeri Sembilan,60,25,35,2011
2011-06-12,Negeri Sembilan,64,26,38,2011
2011-06-13,Negeri Sembilan,13,2,11,2011
2011-06-14,Negeri Sembilan,46,20,26,2011
2011-06-15,Negeri Sembilan,54,25,29,2011
2011-06-16,Negeri Sembilan,43,20,23,2011
2011-06-17,Negeri Sembilan,26,13,13,2011
2011-06-18,Negeri Sembilan,22,9,13,2011
2011-06-19,Negeri Sembilan,47,14,33,2011
2011-06-20,Negeri Sembilan,52,23,29,2011
2011-06-21,Negeri Sembilan,71,43,28,2011
2011-06-22,Negeri Sembilan,34,22,12,2011
2011-06-23,Negeri Sembilan,10,1,9,2011
2011-06-24,Negeri Sembilan,49,25,24,2011
2011-06-25,Negeri Sembilan,19,9,10,2011
2011-06-26,Negeri Sembilan,56,15,41,2011
2011-06-27,Negeri Sembilan,15,2,13,2011
2011-06-28,Negeri Sembilan,49,20,29,2011
2011-06-29,Negeri Sembilan,0,0,0,2011
2011-06-30,Negeri Sembilan,47,19,28,2011
2011-07-01,Negeri Sembilan,9,3,6,2011
2011-07-02,Negeri Sembilan,31,21,10,2011
2011-07-03,Negeri Sembilan,31,19,12,2011
2011-07-04,Negeri Sembilan,15,2,13,2011
2011-07-05,Negeri Sembilan,16,1,15,2011
2011-07-06,Negeri Sembilan,85,59,26,2011
2011-07-07,Negeri Sembilan,42,26,16,2011
2011-07-08,Negeri Sembilan,47,21,26,2011
2011-07-09,Negeri Sembilan,29,14,15,2011
2011-07-10,Negeri Sembilan,22,12,10,2011
2011-07-11,Negeri Sembilan,59,41,18,2011
2011-07-12,Negeri Sembilan,69,31,38,2011
2011-07-13,Negeri Sembilan,79,37,42,2011
2011-07-14,Negeri Sembilan,49,12,37,2011
2011-07-15,Negeri Sembilan,6,0,6,2011
2011-07-16,Negeri Sembilan,33,16,17,2011
2011-07-17,Negeri Sembilan,197,48,149,2011
2011-07-18,Negeri Sembilan,50,19,31,2011
2011-07-19,Negeri Sembilan,85,30,55,2011
2011-07-20,Negeri Sembilan,64,17,47,2011
2011-07-21,Negeri Sembilan,48,14,34,2011
2011-07-22,Negeri Sembilan,9,0,9,2011
2011-07-23,Negeri Sembilan,37,24,13,2011
2011-07-24,Negeri Sembilan,25,6,19,2011
2011-07-25,Negeri Sembilan,11,1,10,2011
2011-07-26,Negeri Sembilan,44,21,23,2011
2011-07-27,Negeri Sembilan,17,1,16,2011
2011-07-28,Negeri Sembilan,61,21,40,2011
2011-07-29,Negeri Sembilan,69,28,41,2011
2011-07-30,Negeri Sembilan,108,49,59,2011
2011-07-31,Negeri Sembilan,132,57,75,2011
2011-08-01,Negeri Sembilan,9,3,6,2011
2011-08-02,Negeri Sembilan,10,1,9,2011
2011-08-03,Negeri Sembilan,6,0,6,2011
2011-08-04,Negeri Sembilan,4,0,4,2011
2011-08-05,Negeri Sembilan,3,0,3,2011
2011-08-06,Negeri Sembilan,0,0,0,2011
2011-08-07,Negeri Sembilan,15,10,5,2011
2011-08-08,Negeri Sembilan,16,1,15,2011
2011-08-09,Negeri Sembilan,5,0,5,2011
2011-08-10,Negeri Sembilan,52,37,15,2011
2011-08-11,Negeri Sembilan,6,0,6,2011
2011-08-12,Negeri Sembilan,6,1,5,2011
2011-08-13,Negeri Sembilan,9,7,2,2011
2011-08-14,Negeri Sembilan,0,0,0,2011
2011-08-15,Negeri Sembilan,4,2,2,2011
2011-08-16,Negeri Sembilan,99,51,48,2011
2011-08-17,Negeri Sembilan,72,53,19,2011
2011-08-18,Negeri Sembilan,5,0,5,2011
2011-08-19,Negeri Sembilan,10,0,10,2011
2011-08-20,Negeri Sembilan,30,15,15,2011
2011-08-21,Negeri Sembilan,0,0,0,2011
2011-08-22,Negeri Sembilan,15,3,12,2011
2011-08-23,Negeri Sembilan,16,1,15,2011
2011-08-24,Negeri Sembilan,84,39,45,2011
2011-08-25,Negeri Sembilan,167,66,101,2011
2011-08-26,Negeri Sembilan,1,0,1,2011
2011-08-27,Negeri Sembilan,8,2,6,2011
2011-08-28,Negeri Sembilan,30,11,19,2011
2011-08-29,Negeri Sembilan,21,1,20,2011
2011-08-30,Negeri Sembilan,0,0,0,2011
2011-08-31,Negeri Sembilan,0,0,0,2011
2011-09-01,Negeri Sembilan,0,0,0,2011
2011-09-02,Negeri Sembilan,11,0,11,2011
2011-09-03,Negeri Sembilan,0,0,0,2011
2011-09-04,Negeri Sembilan,30,15,15,2011
2011-09-05,Negeri Sembilan,24,1,23,2011
2011-09-06,Negeri Sembilan,18,0,18,2011
2011-09-07,Negeri Sembilan,76,18,58,2011
2011-09-08,Negeri Sembilan,94,20,74,2011
2011-09-09,Negeri Sembilan,16,4,12,2011
2011-09-10,Negeri Sembilan,0,0,0,2011
2011-09-11,Negeri Sembilan,0,0,0,2011
2011-09-12,Negeri Sembilan,42,7,35,2011
2011-09-13,Negeri Sembilan,79,21,58,2011
2011-09-14,Negeri Sembilan,50,36,14,2011
2011-09-15,Negeri Sembilan,33,8,25,2011
2011-09-16,Negeri Sembilan,0,0,0,2011
2011-09-17,Negeri Sembilan,0,0,0,2011
2011-09-18,Negeri Sembilan,101,22,79,2011
2011-09-19,Negeri Sembilan,35,7,28,2011
2011-09-20,Negeri Sembilan,130,94,36,2011
2011-09-21,Negeri Sembilan,132,71,61,2011
2011-09-22,Negeri Sembilan,16,0,16,2011
2011-09-23,Negeri Sembilan,68,12,56,2011
2011-09-24,Negeri Sembilan,42,10,32,2011
2011-09-25,Negeri Sembilan,92,12,80,2011
2011-09-26,Negeri Sembilan,12,1,11,2011
2011-09-27,Negeri Sembilan,41,2,39,2011
2011-09-28,Negeri Sembilan,7,0,7,2011
2011-09-29,Negeri Sembilan,91,42,49,2011
2011-09-30,Negeri Sembilan,10,1,9,2011
2011-10-01,Negeri Sembilan,0,0,0,2011
2011-10-02,Negeri Sembilan,0,0,0,2011
2011-10-03,Negeri Sembilan,8,0,8,2011
2011-10-04,Negeri Sembilan,15,2,13,2011
2011-10-05,Negeri Sembilan,105,44,61,2011
2011-10-06,Negeri Sembilan,118,61,57,2011
2011-10-07,Negeri Sembilan,257,144,113,2011
2011-10-08,Negeri Sembilan,28,14,14,2011
2011-10-09,Negeri Sembilan,42,15,27,2011
2011-10-10,Negeri Sembilan,18,2,16,2011
2011-10-11,Negeri Sembilan,65,25,40,2011
2011-10-12,Negeri Sembilan,56,20,36,2011
2011-10-13,Negeri Sembilan,62,19,43,2011
2011-10-14,Negeri Sembilan,119,56,63,2011
2011-10-15,Negeri Sembilan,0,0,0,2011
2011-10-16,Negeri Sembilan,23,12,11,2011
2011-10-17,Negeri Sembilan,11,0,11,2011
2011-10-18,Negeri Sembilan,10,1,9,2011
2011-10-19,Negeri Sembilan,165,96,69,2011
2011-10-20,Negeri Sembilan,144,78,66,2011
2011-10-21,Negeri Sembilan,16,1,15,2011
2011-10-22,Negeri Sembilan,17,11,6,2011
2011-10-23,Negeri Sembilan,29,8,21,2011
2011-10-24,Negeri Sembilan,44,16,28,2011
2011-10-25,Negeri Sembilan,17,4,13,2011
2011-10-26,Negeri Sembilan,0,0,0,2011
2011-10-27,Negeri Sembilan,48,9,39,2011
2011-10-28,Negeri Sembilan,9,3,6,2011
2011-10-29,Negeri Sembilan,28,15,13,2011
2011-10-30,Negeri Sembilan,84,16,68,2011
2011-10-31,Negeri Sembilan,28,3,25,2011
2011-11-01,Negeri Sembilan,48,12,36,2011
2011-11-02,Negeri Sembilan,71,21,50,2011
2011-11-03,Negeri Sembilan,72,25,47,2011
2011-11-04,Negeri Sembilan,67,32,35,2011
2011-11-05,Negeri Sembilan,0,0,0,2011
2011-11-06,Negeri Sembilan,0,0,0,2011
2011-11-07,Negeri Sembilan,1,0,1,2011
2011-11-08,Negeri Sembilan,18,4,14,2011
2011-11-09,Negeri Sembilan,16,0,16,2011
2011-11-10,Negeri Sembilan,54,34,20,2011
2011-11-11,Negeri Sembilan,11,3,8,2011
2011-11-12,Negeri Sembilan,69,65,4,2011
2011-11-13,Negeri Sembilan,0,0,0,2011
2011-11-14,Negeri Sembilan,50,17,33,2011
2011-11-15,Negeri Sembilan,97,33,64,2011
2011-11-16,Negeri Sembilan,41,16,25,2011
2011-11-17,Negeri Sembilan,96,31,65,2011
2011-11-18,Negeri Sembilan,63,41,22,2011
2011-11-19,Negeri Sembilan,0,0,0,2011
2011-11-20,Negeri Sembilan,22,7,15,2011
2011-11-21,Negeri Sembilan,18,1,17,2011
2011-11-22,Negeri Sembilan,47,14,33,2011
2011-11-23,Negeri Sembilan,78,44,34,2011
2011-11-24,Negeri Sembilan,10,4,6,2011
2011-11-25,Negeri Sembilan,4,0,4,2011
2011-11-26,Negeri Sembilan,0,0,0,2011
2011-11-27,Negeri Sembilan,69,10,59,2011
2011-11-28,Negeri Sembilan,0,0,0,2011
2011-11-29,Negeri Sembilan,70,29,41,2011
2011-11-30,Negeri Sembilan,64,22,42,2011
2011-12-01,Negeri Sembilan,13,0,13,2011
2011-12-02,Negeri Sembilan,7,1,6,2011
2011-12-03,Negeri Sembilan,0,0,0,2011
2011-12-04,Negeri Sembilan,34,14,20,2011
2011-12-05,Negeri Sembilan,12,0,12,2011
2011-12-06,Negeri Sembilan,8,0,8,2011
2011-12-07,Negeri Sembilan,9,2,7,2011
2011-12-08,Negeri Sembilan,84,13,71,2011
2011-12-09,Negeri Sembilan,78,14,64,2011
2011-12-10,Negeri Sembilan,0,0,0,2011
2011-12-11,Negeri Sembilan,22,7,15,2011
2011-12-12,Negeri Sembilan,31,14,17,2011
2011-12-13,Negeri Sembilan,57,21,36,2011
2011-12-14,Negeri Sembilan,62,15,47,2011
2011-12-15,Negeri Sembilan,57,24,33,2011
2011-12-16,Negeri Sembilan,34,9,25,2011
2011-12-17,Negeri Sembilan,21,12,9,2011
2011-12-18,Negeri Sembilan,0,0,0,2011
2011-12-19,Negeri Sembilan,21,3,18,2011
2011-12-20,Negeri Sembilan,87,59,28,2011
2011-12-21,Negeri Sembilan,112,73,39,2011
2011-12-22,Negeri Sembilan,74,51,23,2011
2011-12-23,Negeri Sembilan,117,37,80,2011
2011-12-24,Negeri Sembilan,15,2,13,2011
2011-12-25,Negeri Sembilan,0,0,0,2011
2011-12-26,Negeri Sembilan,0,0,0,2011
2011-12-27,Negeri Sembilan,10,2,8,2011
2011-12-28,Negeri Sembilan,62,23,39,2011
2011-12-29,Negeri Sembilan,9,2,7,2011
2011-12-30,Negeri Sembilan,32,12,20,2011
2011-12-31,Negeri Sembilan,68,23,45,2011
2012-01-01,Negeri Sembilan,82,39,43,2012
2012-01-02,Negeri Sembilan,41,13,28,2012
2012-01-03,Negeri Sembilan,21,3,18,2012
2012-01-04,Negeri Sembilan,9,0,9,2012
2012-01-05,Negeri Sembilan,41,24,17,2012
2012-01-06,Negeri Sembilan,21,10,11,2012
2012-01-07,Negeri Sembilan,54,36,18,2012
2012-01-08,Negeri Sembilan,17,14,3,2012
2012-01-09,Negeri Sembilan,9,0,9,2012
2012-01-10,Negeri Sembilan,59,29,30,2012
2012-01-11,Negeri Sembilan,106,60,46,2012
2012-01-12,Negeri Sembilan,130,46,84,2012
2012-01-13,Negeri Sembilan,93,29,64,2012
2012-01-14,Negeri Sembilan,0,0,0,2012
2012-01-15,Negeri Sembilan,20,9,11,2012
2012-01-16,Negeri Sembilan,11,0,11,2012
2012-01-17,Negeri Sembilan,8,0,8,2012
2012-01-18,Negeri Sembilan,118,52,66,2012
2012-01-19,Negeri Sembilan,61,12,49,2012
2012-01-20,Negeri Sembilan,11,2,9,2012
2012-01-21,Negeri Sembilan,77,66,11,2012
2012-01-22,Negeri Sembilan,0,0,0,2012
2012-01-23,Negeri Sembilan,0,0,0,2012
2012-01-24,Negeri Sembilan,1,0,1,2012
2012-01-25,Negeri Sembilan,23,1,22,2012
2012-01-26,Negeri Sembilan,63,18,45,2012
2012-01-27,Negeri Sembilan,14,1,13,2012
2012-01-28,Negeri Sembilan,62,51,11,2012
2012-01-29,Negeri Sembilan,25,7,18,2012
2012-01-30,Negeri Sembilan,17,0,17,2012
2012-01-31,Negeri Sembilan,112,38,74,2012
2012-02-01,Negeri Sembilan,70,27,43,2012
2012-02-02,Negeri Sembilan,86,60,26,2012
2012-02-03,Negeri Sembilan,89,59,30,2012
2012-02-04,Negeri Sembilan,41,19,22,2012
2012-02-05,Negeri Sembilan,78,26,52,2012
2012-02-06,Negeri Sembilan,59,26,33,2012
2012-02-07,Negeri Sembilan,0,0,0,2012
2012-02-08,Negeri Sembilan,151,90,61,2012
2012-02-09,Negeri Sembilan,17,2,15,2012
2012-02-10,Negeri Sembilan,16,5,11,2012
2012-02-11,Negeri Sembilan,0,0,0,2012
2012-02-12,Negeri Sembilan,28,22,6,2012
2012-02-13,Negeri Sembilan,50,16,34,2012
2012-02-14,Negeri Sembilan,19,1,18,2012
2012-02-15,Negeri Sembilan,12,2,10,2012
2012-02-16,Negeri Sembilan,87,45,42,2012
2012-02-17,Negeri Sembilan,9,1,8,2012
2012-02-18,Negeri Sembilan,43,19,24,2012
2012-02-19,Negeri Sembilan,96,33,63,2012
2012-02-20,Negeri Sembilan,63,17,46,2012
2012-02-21,Negeri Sembilan,94,41,53,2012
2012-02-22,Negeri Sembilan,22,4,18,2012
2012-02-23,Negeri Sembilan,52,25,27,2012
2012-02-24,Negeri Sembilan,18,1,17,2012
2012-02-25,Negeri Sembilan,71,67,4,2012
2012-02-26,Negeri Sembilan,0,0,0,2012
2012-02-27,Negeri Sembilan,21,3,18,2012
2012-02-28,Negeri Sembilan,68,28,40,2012
2012-02-29,Negeri Sembilan,65,24,41,2012
2012-03-01,Negeri Sembilan,62,7,55,2012
2012-03-02,Negeri Sembilan,15,1,14,2012
2012-03-03,Negeri Sembilan,66,29,37,2012
2012-03-04,Negeri Sembilan,66,35,31,2012
2012-03-05,Negeri Sembilan,16,1,15,2012
2012-03-06,Negeri Sembilan,68,25,43,2012
2012-03-07,Negeri Sembilan,90,32,58,2012
2012-03-08,Negeri Sembilan,77,26,51,2012
2012-03-09,Negeri Sembilan,48,27,21,2012
2012-03-10,Negeri Sembilan,0,0,0,2012
2012-03-11,Negeri Sembilan,39,18,21,2012
2012-03-12,Negeri Sembilan,74,18,56,2012
2012-03-13,Negeri Sembilan,16,0,16,2012
2012-03-14,Negeri Sembilan,15,3,12,2012
2012-03-15,Negeri Sembilan,214,182,32,2012
2012-03-16,Negeri Sembilan,39,14,25,2012
2012-03-17,Negeri Sembilan,0,0,0,2012
2012-03-18,Negeri Sembilan,123,15,108,2012
2012-03-19,Negeri Sembilan,15,3,12,2012
2012-03-20,Negeri Sembilan,11,0,11,2012
2012-03-21,Negeri Sembilan,93,26,67,2012
2012-03-22,Negeri Sembilan,10,0,10,2012
2012-03-23,Negeri Sembilan,10,0,10,2012
2012-03-24,Negeri Sembilan,0,0,0,2012
2012-03-25,Negeri Sembilan,19,13,6,2012
2012-03-26,Negeri Sembilan,10,3,7,2012
2012-03-27,Negeri Sembilan,16,3,13,2012
2012-03-28,Negeri Sembilan,28,1,27,2012
2012-03-29,Negeri Sembilan,38,12,26,2012
2012-03-30,Negeri Sembilan,22,8,14,2012
2012-03-31,Negeri Sembilan,0,0,0,2012
2012-04-01,Negeri Sembilan,27,11,16,2012
2012-04-02,Negeri Sembilan,39,17,22,2012
2012-04-03,Negeri Sembilan,17,3,14,2012
2012-04-04,Negeri Sembilan,21,4,17,2012
2012-04-05,Negeri Sembilan,9,1,8,2012
2012-04-06,Negeri Sembilan,61,17,44,2012
2012-04-07,Negeri Sembilan,45,21,24,2012
2012-04-08,Negeri Sembilan,0,0,0,2012
2012-04-09,Negeri Sembilan,13,2,11,2012
2012-04-10,Negeri Sembilan,94,35,59,2012
2012-04-11,Negeri Sembilan,0,0,0,2012
2012-04-12,Negeri Sembilan,128,33,95,2012
2012-04-13,Negeri Sembilan,12,1,11,2012
2012-04-14,Negeri Sembilan,0,0,0,2012
2012-04-15,Negeri Sembilan,141,56,85,2012
2012-04-16,Negeri Sembilan,77,21,56,2012
2012-04-17,Negeri Sembilan,60,40,20,2012
2012-04-18,Negeri Sembilan,15,1,14,2012
2012-04-19,Negeri Sembilan,10,3,7,2012
2012-04-20,Negeri Sembilan,8,0,8,2012
2012-04-21,Negeri Sembilan,45,22,23,2012
2012-04-22,Negeri Sembilan,89,87,2,2012
2012-04-23,Negeri Sembilan,13,2,11,2012
2012-04-24,Negeri Sembilan,40,32,8,2012
2012-04-25,Negeri Sembilan,8,2,6,2012
2012-04-26,Negeri Sembilan,10,0,10,2012
2012-04-27,Negeri Sembilan,9,3,6,2012
2012-04-28,Negeri Sembilan,0,0,0,2012
2012-04-29,Negeri Sembilan,86,9,77,2012
2012-04-30,Negeri Sembilan,16,1,15,2012
2012-05-01,Negeri Sembilan,37,4,33,2012
2012-05-02,Negeri Sembilan,10,0,10,2012
2012-05-03,Negeri Sembilan,6,1,5,2012
2012-05-04,Negeri Sembilan,11,2,9,2012
2012-05-05,Negeri Sembilan,47,17,30,2012
2012-05-06,Negeri Sembilan,62,19,43,2012
2012-05-07,Negeri Sembilan,10,1,9,2012
2012-05-08,Negeri Sembilan,7,1,6,2012
2012-05-09,Negeri Sembilan,80,16,64,2012
2012-05-10,Negeri Sembilan,13,2,11,2012
2012-05-11,Negeri Sembilan,82,20,62,2012
2012-05-12,Negeri Sembilan,0,0,0,2012
2012-05-13,Negeri Sembilan,56,20,36,2012
2012-05-14,Negeri Sembilan,72,28,44,2012
2012-05-15,Negeri Sembilan,109,54,55,2012
2012-05-16,Negeri Sembilan,112,37,75,2012
2012-05-17,Negeri Sembilan,38,12,26,2012
2012-05-18,Negeri Sembilan,11,1,10,2012
2012-05-19,Negeri Sembilan,81,43,38,2012
2012-05-20,Negeri Sembilan,0,0,0,2012
2012-05-21,Negeri Sembilan,24,4,20,2012
2012-05-22,Negeri Sembilan,31,14,17,2012
2012-05-23,Negeri Sembilan,7,0,7,2012
2012-05-24,Negeri Sembilan,12,2,10,2012
2012-05-25,Negeri Sembilan,7,1,6,2012
2012-05-26,Negeri Sembilan,41,23,18,2012
2012-05-27,Negeri Sembilan,71,16,55,2012
2012-05-28,Negeri Sembilan,17,5,12,2012
2012-05-29,Negeri Sembilan,48,21,27,2012
2012-05-30,Negeri Sembilan,13,4,9,2012
2012-05-31,Negeri Sembilan,5,1,4,2012
2012-06-01,Negeri Sembilan,5,1,4,2012
2012-06-02,Negeri Sembilan,0,0,0,2012
2012-06-03,Negeri Sembilan,17,5,12,2012
2012-06-04,Negeri Sembilan,17,2,15,2012
2012-06-05,Negeri Sembilan,8,0,8,2012
2012-06-06,Negeri Sembilan,108,32,76,2012
2012-06-07,Negeri Sembilan,103,26,77,2012
2012-06-08,Negeri Sembilan,6,1,5,2012
2012-06-09,Negeri Sembilan,0,0,0,2012
2012-06-10,Negeri Sembilan,14,4,10,2012
2012-06-11,Negeri Sembilan,18,3,15,2012
2012-06-12,Negeri Sembilan,10,2,8,2012
2012-06-13,Negeri Sembilan,9,2,7,2012
2012-06-14,Negeri Sembilan,94,15,79,2012
2012-06-15,Negeri Sembilan,51,12,39,2012
2012-06-16,Negeri Sembilan,100,92,8,2012
2012-06-17,Negeri Sembilan,35,14,21,2012
2012-06-18,Negeri Sembilan,0,0,0,2012
2012-06-19,Negeri Sembilan,8,0,8,2012
2012-06-20,Negeri Sembilan,68,39,29,2012
2012-06-21,Negeri Sembilan,40,16,24,2012
2012-06-22,Negeri Sembilan,63,8,55,2012
2012-06-23,Negeri Sembilan,49,44,5,2012
2012-06-24,Negeri Sembilan,56,10,46,2012
2012-06-25,Negeri Sembilan,19,4,15,2012
2012-06-26,Negeri Sembilan,14,1,13,2012
2012-06-27,Negeri Sembilan,58,42,16,2012
2012-06-28,Negeri Sembilan,10,0,10,2012
2012-06-29,Negeri Sembilan,10,1,9,2012
2012-06-30,Negeri Sembilan,68,44,24,2012
2012-07-01,Negeri Sembilan,34,16,18,2012
2012-07-02,Negeri Sembilan,11,1,10,2012
2012-07-03,Negeri Sembilan,43,19,24,2012
2012-07-04,Negeri Sembilan,55,5,50,2012
2012-07-05,Negeri Sembilan,73,65,8,2012
2012-07-06,Negeri Sembilan,9,1,8,2012
2012-07-07,Negeri Sembilan,0,0,0,2012
2012-07-08,Negeri Sembilan,51,22,29,2012
2012-07-09,Negeri Sembilan,19,0,19,2012
2012-07-10,Negeri Sembilan,18,1,17,2012
2012-07-11,Negeri Sembilan,95,78,17,2012
2012-07-12,Negeri Sembilan,83,28,55,2012
2012-07-13,Negeri Sembilan,60,36,24,2012
2012-07-14,Negeri Sembilan,115,50,65,2012
2012-07-15,Negeri Sembilan,152,68,84,2012
2012-07-16,Negeri Sembilan,14,3,11,2012
2012-07-17,Negeri Sembilan,129,88,41,2012
2012-07-18,Negeri Sembilan,154,130,24,2012
2012-07-19,Negeri Sembilan,118,98,20,2012
2012-07-20,Negeri Sembilan,18,1,17,2012
2012-07-21,Negeri Sembilan,0,0,0,2012
2012-07-22,Negeri Sembilan,142,27,115,2012
2012-07-23,Negeri Sembilan,6,0,6,2012
2012-07-24,Negeri Sembilan,11,1,10,2012
2012-07-25,Negeri Sembilan,102,85,17,2012
2012-07-26,Negeri Sembilan,6,1,5,2012
2012-07-27,Negeri Sembilan,7,0,7,2012
2012-07-28,Negeri Sembilan,18,7,11,2012
2012-07-29,Negeri Sembilan,118,30,88,2012
2012-07-30,Negeri Sembilan,10,0,10,2012
2012-07-31,Negeri Sembilan,4,0,4,2012
2012-08-01,Negeri Sembilan,61,32,29,2012
2012-08-02,Negeri Sembilan,10,1,9,2012
2012-08-03,Negeri Sembilan,3,0,3,2012
2012-08-04,Negeri Sembilan,22,9,13,2012
2012-08-05,Negeri Sembilan,32,8,24,2012
2012-08-06,Negeri Sembilan,10,1,9,2012
2012-08-07,Negeri Sembilan,2,0,2,2012
2012-08-08,Negeri Sembilan,66,37,29,2012
2012-08-09,Negeri Sembilan,5,0,5,2012
2012-08-10,Negeri Sembilan,2,1,1,2012
2012-08-11,Negeri Sembilan,0,0,0,2012
2012-08-12,Negeri Sembilan,73,6,67,2012
2012-08-13,Negeri Sembilan,7,2,5,2012
2012-08-14,Negeri Sembilan,9,1,8,2012
2012-08-15,Negeri Sembilan,37,13,24,2012
2012-08-16,Negeri Sembilan,3,1,2,2012
2012-08-17,Negeri Sembilan,14,5,9,2012
2012-08-18,Negeri Sembilan,0,0,0,2012
2012-08-19,Negeri Sembilan,0,0,0,2012
2012-08-20,Negeri Sembilan,0,0,0,2012
2012-08-21,Negeri Sembilan,2,0,2,2012
2012-08-22,Negeri Sembilan,23,1,22,2012
2012-08-23,Negeri Sembilan,18,1,17,2012
2012-08-24,Negeri Sembilan,26,7,19,2012
2012-08-25,Negeri Sembilan,0,0,0,2012
2012-08-26,Negeri Sembilan,34,4,30,2012
2012-08-27,Negeri Sembilan,20,6,14,2012
2012-08-28,Negeri Sembilan,40,14,26,2012
2012-08-29,Negeri Sembilan,111,43,68,2012
2012-08-30,Negeri Sembilan,29,10,19,2012
2012-08-31,Negeri Sembilan,57,33,24,2012
2012-09-01,Negeri Sembilan,0,0,0,2012
2012-09-02,Negeri Sembilan,41,6,35,2012
2012-09-03,Negeri Sembilan,37,9,28,2012
2012-09-04,Negeri Sembilan,11,3,8,2012
2012-09-05,Negeri Sembilan,58,19,39,2012
2012-09-06,Negeri Sembilan,289,141,148,2012
2012-09-07,Negeri Sembilan,28,6,22,2012
2012-09-08,Negeri Sembilan,32,13,19,2012
2012-09-09,Negeri Sembilan,0,0,0,2012
2012-09-10,Negeri Sembilan,23,3,20,2012
2012-09-11,Negeri Sembilan,278,192,86,2012
2012-09-12,Negeri Sembilan,15,3,12,2012
2012-09-13,Negeri Sembilan,8,0,8,2012
2012-09-14,Negeri Sembilan,28,10,18,2012
2012-09-15,Negeri Sembilan,25,6,19,2012
2012-09-16,Negeri Sembilan,0,0,0,2012
2012-09-17,Negeri Sembilan,0,0,0,2012
2012-09-18,Negeri Sembilan,25,2,23,2012
2012-09-19,Negeri Sembilan,67,14,53,2012
2012-09-20,Negeri Sembilan,43,27,16,2012
2012-09-21,Negeri Sembilan,12,2,10,2012
2012-09-22,Negeri Sembilan,0,0,0,2012
2012-09-23,Negeri Sembilan,102,12,90,2012
2012-09-24,Negeri Sembilan,51,38,13,2012
2012-09-25,Negeri Sembilan,12,1,11,2012
2012-09-26,Negeri Sembilan,24,2,22,2012
2012-09-27,Negeri Sembilan,62,17,45,2012
2012-09-28,Negeri Sembilan,36,8,28,2012
2012-09-29,Negeri Sembilan,0,0,0,2012
2012-09-30,Negeri Sembilan,61,17,44,2012
2012-10-01,Negeri Sembilan,15,2,13,2012
2012-10-02,Negeri Sembilan,14,2,12,2012
2012-10-03,Negeri Sembilan,101,19,82,2012
2012-10-04,Negeri Sembilan,88,20,68,2012
2012-10-05,Negeri Sembilan,7,1,6,2012
2012-10-06,Negeri Sembilan,0,0,0,2012
2012-10-07,Negeri Sembilan,0,0,0,2012
2012-10-08,Negeri Sembilan,80,32,48,2012
2012-10-09,Negeri Sembilan,111,43,68,2012
2012-10-10,Negeri Sembilan,60,10,50,2012
2012-10-11,Negeri Sembilan,13,3,10,2012
2012-10-12,Negeri Sembilan,75,10,65,2012
2012-10-13,Negeri Sembilan,0,0,0,2012
2012-10-14,Negeri Sembilan,65,27,38,2012
2012-10-15,Negeri Sembilan,13,1,12,2012
2012-10-16,Negeri Sembilan,105,48,57,2012
2012-10-17,Negeri Sembilan,10,1,9,2012
2012-10-18,Negeri Sembilan,91,21,70,2012
2012-10-19,Negeri Sembilan,5,0,5,2012
2012-10-20,Negeri Sembilan,25,9,16,2012
2012-10-21,Negeri Sembilan,53,20,33,2012
2012-10-22,Negeri Sembilan,83,66,17,2012
2012-10-23,Negeri Sembilan,29,8,21,2012
2012-10-24,Negeri Sembilan,50,16,34,2012
2012-10-25,Negeri Sembilan,15,3,12,2012
2012-10-26,Negeri Sembilan,0,0,0,2012
2012-10-27,Negeri Sembilan,0,0,0,2012
2012-10-28,Negeri Sembilan,37,13,24,2012
2012-10-29,Negeri Sembilan,48,19,29,2012
2012-10-30,Negeri Sembilan,80,28,52,2012
2012-10-31,Negeri Sembilan,60,20,40,2012
2012-11-01,Negeri Sembilan,31,2,29,2012
2012-11-02,Negeri Sembilan,26,7,19,2012
2012-11-03,Negeri Sembilan,0,0,0,2012
2012-11-04,Negeri Sembilan,0,0,0,2012
2012-11-05,Negeri Sembilan,41,10,31,2012
2012-11-06,Negeri Sembilan,56,36,20,2012
2012-11-07,Negeri Sembilan,5,0,5,2012
2012-11-08,Negeri Sembilan,41,10,31,2012
2012-11-09,Negeri Sembilan,8,2,6,2012
2012-11-10,Negeri Sembilan,52,33,19,2012
2012-11-11,Negeri Sembilan,48,16,32,2012
2012-11-12,Negeri Sembilan,18,2,16,2012
2012-11-13,Negeri Sembilan,0,0,0,2012
2012-11-14,Negeri Sembilan,12,1,11,2012
2012-11-15,Negeri Sembilan,0,0,0,2012
2012-11-16,Negeri Sembilan,11,1,10,2012
2012-11-17,Negeri Sembilan,32,11,21,2012
2012-11-18,Negeri Sembilan,15,5,10,2012
2012-11-19,Negeri Sembilan,21,2,19,2012
2012-11-20,Negeri Sembilan,112,51,61,2012
2012-11-21,Negeri Sembilan,133,68,65,2012
2012-11-22,Negeri Sembilan,66,16,50,2012
2012-11-23,Negeri Sembilan,9,0,9,2012
2012-11-24,Negeri Sembilan,0,0,0,2012
2012-11-25,Negeri Sembilan,53,7,46,2012
2012-11-26,Negeri Sembilan,12,0,12,2012
2012-11-27,Negeri Sembilan,17,1,16,2012
2012-11-28,Negeri Sembilan,73,24,49,2012
2012-11-29,Negeri Sembilan,110,38,72,2012
2012-11-30,Negeri Sembilan,58,19,39,2012
2012-12-01,Negeri Sembilan,37,21,16,2012
2012-12-02,Negeri Sembilan,82,25,57,2012
2012-12-03,Negeri Sembilan,10,4,6,2012
2012-12-04,Negeri Sembilan,16,2,14,2012
2012-12-05,Negeri Sembilan,11,0,11,2012
2012-12-06,Negeri Sembilan,9,0,9,2012
2012-12-07,Negeri Sembilan,75,27,48,2012
2012-12-08,Negeri Sembilan,30,15,15,2012
2012-12-09,Negeri Sembilan,21,7,14,2012
2012-12-10,Negeri Sembilan,9,0,9,2012
2012-12-11,Negeri Sembilan,14,2,12,2012
2012-12-12,Negeri Sembilan,9,0,9,2012
2012-12-13,Negeri Sembilan,41,18,23,2012
2012-12-14,Negeri Sembilan,9,1,8,2012
2012-12-15,Negeri Sembilan,81,31,50,2012
2012-12-16,Negeri Sembilan,31,5,26,2012
2012-12-17,Negeri Sembilan,16,0,16,2012
2012-12-18,Negeri Sembilan,36,9,27,2012
2012-12-19,Negeri Sembilan,16,3,13,2012
2012-12-20,Negeri Sembilan,61,20,41,2012
2012-12-21,Negeri Sembilan,12,0,12,2012
2012-12-22,Negeri Sembilan,0,0,0,2012
2012-12-23,Negeri Sembilan,20,9,11,2012
2012-12-24,Negeri Sembilan,15,1,14,2012
2012-12-25,Negeri Sembilan,0,0,0,2012
2012-12-26,Negeri Sembilan,20,1,19,2012
2012-12-27,Negeri Sembilan,65,25,40,2012
2012-12-28,Negeri Sembilan,16,1,15,2012
2012-12-29,Negeri Sembilan,28,18,10,2012
2012-12-30,Negeri Sembilan,33,15,18,2012
2012-12-31,Negeri Sembilan,22,6,16,2012
2013-01-01,Negeri Sembilan,0,0,0,2013
2013-01-02,Negeri Sembilan,26,4,22,2013
2013-01-03,Negeri Sembilan,88,22,66,2013
2013-01-04,Negeri Sembilan,6,0,6,2013
2013-01-05,Negeri Sembilan,31,10,21,2013
2013-01-06,Negeri Sembilan,39,15,24,2013
2013-01-07,Negeri Sembilan,49,10,39,2013
2013-01-08,Negeri Sembilan,16,2,14,2013
2013-01-09,Negeri Sembilan,133,85,48,2013
2013-01-10,Negeri Sembilan,16,3,13,2013
2013-01-11,Negeri Sembilan,31,10,21,2013
2013-01-12,Negeri Sembilan,14,7,7,2013
2013-01-13,Negeri Sembilan,0,0,0,2013
2013-01-14,Negeri Sembilan,0,0,0,2013
2013-01-15,Negeri Sembilan,17,4,13,2013
2013-01-16,Negeri Sembilan,65,13,52,2013
2013-01-17,Negeri Sembilan,113,43,70,2013
2013-01-18,Negeri Sembilan,103,25,78,2013
2013-01-19,Negeri Sembilan,26,11,15,2013
2013-01-20,Negeri Sembilan,40,17,23,2013
2013-01-21,Negeri Sembilan,133,69,64,2013
2013-01-22,Negeri Sembilan,82,55,27,2013
2013-01-23,Negeri Sembilan,67,20,47,2013
2013-01-24,Negeri Sembilan,0,0,0,2013
2013-01-25,Negeri Sembilan,16,2,14,2013
2013-01-26,Negeri Sembilan,103,42,61,2013
2013-01-27,Negeri Sembilan,96,40,56,2013
2013-01-28,Negeri Sembilan,70,23,47,2013
2013-01-29,Negeri Sembilan,124,36,88,2013
2013-01-30,Negeri Sembilan,56,29,27,2013
2013-01-31,Negeri Sembilan,12,2,10,2013
2013-02-01,Negeri Sembilan,92,21,71,2013
2013-02-02,Negeri Sembilan,0,0,0,2013
2013-02-03,Negeri Sembilan,0,0,0,2013
2013-02-04,Negeri Sembilan,7,2,5,2013
2013-02-05,Negeri Sembilan,96,79,17,2013
2013-02-06,Negeri Sembilan,14,2,12,2013
2013-02-07,Negeri Sembilan,94,69,25,2013
2013-02-08,Negeri Sembilan,122,51,71,2013
2013-02-09,Negeri Sembilan,174,144,30,2013
2013-02-10,Negeri Sembilan,0,0,0,2013
2013-02-11,Negeri Sembilan,0,0,0,2013
2013-02-12,Negeri Sembilan,0,0,0,2013
2013-02-13,Negeri Sembilan,24,6,18,2013
2013-02-14,Negeri Sembilan,42,18,24,2013
2013-02-15,Negeri Sembilan,11,2,9,2013
2013-02-16,Negeri Sembilan,0,0,0,2013
2013-02-17,Negeri Sembilan,32,13,19,2013
2013-02-18,Negeri Sembilan,18,3,15,2013
2013-02-19,Negeri Sembilan,78,31,47,2013
2013-02-20,Negeri Sembilan,86,30,56,2013
2013-02-21,Negeri Sembilan,70,26,44,2013
2013-02-22,Negeri Sembilan,12,1,11,2013
2013-02-23,Negeri Sembilan,43,41,2,2013
2013-02-24,Negeri Sembilan,0,0,0,2013
2013-02-25,Negeri Sembilan,138,80,58,2013
2013-02-26,Negeri Sembilan,62,16,46,2013
2013-02-27,Negeri Sembilan,13,3,10,2013
2013-02-28,Negeri Sembilan,15,2,13,2013
2013-03-01,Negeri Sembilan,16,2,14,2013
2013-03-02,Negeri Sembilan,73,68,5,2013
2013-03-03,Negeri Sembilan,54,27,27,2013
2013-03-04,Negeri Sembilan,7,0,7,2013
2013-03-05,Negeri Sembilan,68,19,49,2013
2013-03-06,Negeri Sembilan,67,29,38,2013
2013-03-07,Negeri Sembilan,72,29,43,2013
2013-03-08,Negeri Sembilan,8,1,7,2013
2013-03-09,Negeri Sembilan,0,0,0,2013
2013-03-10,Negeri Sembilan,37,24,13,2013
2013-03-11,Negeri Sembilan,93,40,53,2013
2013-03-12,Negeri Sembilan,61,36,25,2013
2013-03-13,Negeri Sembilan,90,40,50,2013
2013-03-14,Negeri Sembilan,15,4,11,2013
2013-03-15,Negeri Sembilan,15,1,14,2013
2013-03-16,Negeri Sembilan,31,14,17,2013
2013-03-17,Negeri Sembilan,0,0,0,2013
2013-03-18,Negeri Sembilan,47,11,36,2013
2013-03-19,Negeri Sembilan,68,28,40,2013
2013-03-20,Negeri Sembilan,12,0,12,2013
2013-03-21,Negeri Sembilan,49,7,42,2013
2013-03-22,Negeri Sembilan,8,1,7,2013
2013-03-23,Negeri Sembilan,0,0,0,2013
2013-03-24,Negeri Sembilan,103,19,84,2013
2013-03-25,Negeri Sembilan,15,1,14,2013
2013-03-26,Negeri Sembilan,38,11,27,2013
2013-03-27,Negeri Sembilan,30,15,15,2013
2013-03-28,Negeri Sembilan,36,21,15,2013
2013-03-29,Negeri Sembilan,114,29,85,2013
2013-03-30,Negeri Sembilan,8,6,2,2013
2013-03-31,Negeri Sembilan,101,16,85,2013
2013-04-01,Negeri Sembilan,43,15,28,2013
2013-04-02,Negeri Sembilan,18,5,13,2013
2013-04-03,Negeri Sembilan,43,19,24,2013
2013-04-04,Negeri Sembilan,46,18,28,2013
2013-04-05,Negeri Sembilan,9,0,9,2013
2013-04-06,Negeri Sembilan,0,0,0,2013
2013-04-07,Negeri Sembilan,62,24,38,2013
2013-04-08,Negeri Sembilan,23,4,19,2013
2013-04-09,Negeri Sembilan,12,2,10,2013
2013-04-10,Negeri Sembilan,69,17,52,2013
2013-04-11,Negeri Sembilan,45,26,19,2013
2013-04-12,Negeri Sembilan,51,30,21,2013
2013-04-13,Negeri Sembilan,0,0,0,2013
2013-04-14,Negeri Sembilan,0,0,0,2013
2013-04-15,Negeri Sembilan,11,0,11,2013
2013-04-16,Negeri Sembilan,156,77,79,2013
2013-04-17,Negeri Sembilan,121,76,45,2013
2013-04-18,Negeri Sembilan,68,29,39,2013
2013-04-19,Negeri Sembilan,19,3,16,2013
2013-04-20,Negeri Sembilan,84,33,51,2013
2013-04-21,Negeri Sembilan,0,0,0,2013
2013-04-22,Negeri Sembilan,9,2,7,2013
2013-04-23,Negeri Sembilan,39,14,25,2013
2013-04-24,Negeri Sembilan,13,5,8,2013
2013-04-25,Negeri Sembilan,9,3,6,2013
2013-04-26,Negeri Sembilan,10,1,9,2013
2013-04-27,Negeri Sembilan,0,0,0,2013
2013-04-28,Negeri Sembilan,27,13,14,2013
2013-04-29,Negeri Sembilan,50,15,35,2013
2013-04-30,Negeri Sembilan,47,21,26,2013
2013-05-01,Negeri Sembilan,38,4,34,2013
2013-05-02,Negeri Sembilan,9,1,8,2013
2013-05-03,Negeri Sembilan,9,2,7,2013
2013-05-04,Negeri Sembilan,0,0,0,2013
2013-05-05,Negeri Sembilan,0,0,0,2013
2013-05-06,Negeri Sembilan,12,2,10,2013
2013-05-07,Negeri Sembilan,26,9,17,2013
2013-05-08,Negeri Sembilan,67,14,53,2013
2013-05-09,Negeri Sembilan,45,33,12,2013
2013-05-10,Negeri Sembilan,20,6,14,2013
2013-05-11,Negeri Sembilan,70,36,34,2013
2013-05-12,Negeri Sembilan,21,10,11,2013
2013-05-13,Negeri Sembilan,38,7,31,2013
2013-05-14,Negeri Sembilan,45,24,21,2013
2013-05-15,Negeri Sembilan,57,29,28,2013
2013-05-16,Negeri Sembilan,42,21,21,2013
2013-05-17,Negeri Sembilan,80,20,60,2013
2013-05-18,Negeri Sembilan,0,0,0,2013
2013-05-19,Negeri Sembilan,50,12,38,2013
2013-05-20,Negeri Sembilan,17,1,16,2013
2013-05-21,Negeri Sembilan,61,10,51,2013
2013-05-22,Negeri Sembilan,74,27,47,2013
2013-05-23,Negeri Sembilan,66,30,36,2013
2013-05-24,Negeri Sembilan,53,14,39,2013
2013-05-25,Negeri Sembilan,0,0,0,2013
2013-05-26,Negeri Sembilan,21,4,17,2013
2013-05-27,Negeri Sembilan,11,0,11,2013
2013-05-28,Negeri Sembilan,14,0,14,2013
2013-05-29,Negeri Sembilan,7,0,7,2013
2013-05-30,Negeri Sembilan,43,27,16,2013
2013-05-31,Negeri Sembilan,38,15,23,2013
2013-06-01,Negeri Sembilan,18,5,13,2013
2013-06-02,Negeri Sembilan,80,14,66,2013
2013-06-03,Negeri Sembilan,67,22,45,2013
2013-06-04,Negeri Sembilan,55,13,42,2013
2013-06-05,Negeri Sembilan,17,5,12,2013
2013-06-06,Negeri Sembilan,0,0,0,2013
2013-06-07,Negeri Sembilan,8,0,8,2013
2013-06-08,Negeri Sembilan,32,10,22,2013
2013-06-09,Negeri Sembilan,0,0,0,2013
2013-06-10,Negeri Sembilan,21,4,17,2013
2013-06-11,Negeri Sembilan,62,23,39,2013
2013-06-12,Negeri Sembilan,125,96,29,2013
2013-06-13,Negeri Sembilan,14,1,13,2013
2013-06-14,Negeri Sembilan,6,0,6,2013
2013-06-15,Negeri Sembilan,8,5,3,2013
2013-06-16,Negeri Sembilan,73,7,66,2013
2013-06-17,Negeri Sembilan,168,55,113,2013
2013-06-18,Negeri Sembilan,54,6,48,2013
2013-06-19,Negeri Sembilan,131,78,53,2013
2013-06-20,Negeri Sembilan,39,31,8,2013
2013-06-21,Negeri Sembilan,8,1,7,2013
2013-06-22,Negeri Sembilan,0,0,0,2013
2013-06-23,Negeri Sembilan,100,27,73,2013
2013-06-24,Negeri Sembilan,58,12,46,2013
2013-06-25,Negeri Sembilan,67,12,55,2013
2013-06-26,Negeri Sembilan,26,10,16,2013
2013-06-27,Negeri Sembilan,14,1,13,2013
2013-06-28,Negeri Sembilan,11,1,10,2013
2013-06-29,Negeri Sembilan,0,0,0,2013
2013-06-30,Negeri Sembilan,0,0,0,2013
2013-07-01,Negeri Sembilan,49,27,22,2013
2013-07-02,Negeri Sembilan,26,9,17,2013
2013-07-03,Negeri Sembilan,44,20,24,2013
2013-07-04,Negeri Sembilan,45,28,17,2013
2013-07-05,Negeri Sembilan,19,1,18,2013
2013-07-06,Negeri Sembilan,128,44,84,2013
2013-07-07,Negeri Sembilan,185,92,93,2013
2013-07-08,Negeri Sembilan,19,1,18,2013
2013-07-09,Negeri Sembilan,77,25,52,2013
2013-07-10,Negeri Sembilan,56,16,40,2013
2013-07-11,Negeri Sembilan,45,15,30,2013
2013-07-12,Negeri Sembilan,28,9,19,2013
2013-07-13,Negeri Sembilan,0,0,0,2013
2013-07-14,Negeri Sembilan,0,0,0,2013
2013-07-15,Negeri Sembilan,6,1,5,2013
2013-07-16,Negeri Sembilan,6,0,6,2013
2013-07-17,Negeri Sembilan,110,54,56,2013
2013-07-18,Negeri Sembilan,98,24,74,2013
2013-07-19,Negeri Sembilan,8,1,7,2013
2013-07-20,Negeri Sembilan,0,0,0,2013
2013-07-21,Negeri Sembilan,192,46,146,2013
2013-07-22,Negeri Sembilan,11,1,10,2013
2013-07-23,Negeri Sembilan,7,0,7,2013
2013-07-24,Negeri Sembilan,66,40,26,2013
2013-07-25,Negeri Sembilan,5,0,5,2013
2013-07-26,Negeri Sembilan,12,2,10,2013
2013-07-27,Negeri Sembilan,121,107,14,2013
2013-07-28,Negeri Sembilan,0,0,0,2013
2013-07-29,Negeri Sembilan,8,3,5,2013
2013-07-30,Negeri Sembilan,4,0,4,2013
2013-07-31,Negeri Sembilan,110,41,69,2013
2013-08-01,Negeri Sembilan,8,0,8,2013
2013-08-02,Negeri Sembilan,9,1,8,2013
2013-08-03,Negeri Sembilan,6,1,5,2013
2013-08-04,Negeri Sembilan,109,14,95,2013
2013-08-05,Negeri Sembilan,5,0,5,2013
2013-08-06,Negeri Sembilan,13,1,12,2013
2013-08-07,Negeri Sembilan,7,1,6,2013
2013-08-08,Negeri Sembilan,0,0,0,2013
2013-08-09,Negeri Sembilan,0,0,0,2013
2013-08-10,Negeri Sembilan,70,21,49,2013
2013-08-11,Negeri Sembilan,36,3,33,2013
2013-08-12,Negeri Sembilan,22,0,22,2013
2013-08-13,Negeri Sembilan,28,2,26,2013
2013-08-14,Negeri Sembilan,97,38,59,2013
2013-08-15,Negeri Sembilan,79,30,49,2013
2013-08-16,Negeri Sembilan,44,10,34,2013
2013-08-17,Negeri Sembilan,109,46,63,2013
2013-08-18,Negeri Sembilan,0,0,0,2013
2013-08-19,Negeri Sembilan,44,2,42,2013
2013-08-20,Negeri Sembilan,120,20,100,2013
2013-08-21,Negeri Sembilan,67,26,41,2013
2013-08-22,Negeri Sembilan,87,47,40,2013
2013-08-23,Negeri Sembilan,72,29,43,2013
2013-08-24,Negeri Sembilan,0,0,0,2013
2013-08-25,Negeri Sembilan,0,0,0,2013
2013-08-26,Negeri Sembilan,15,1,14,2013
2013-08-27,Negeri Sembilan,132,62,70,2013
2013-08-28,Negeri Sembilan,84,36,48,2013
2013-08-29,Negeri Sembilan,67,13,54,2013
2013-08-30,Negeri Sembilan,15,1,14,2013
2013-08-31,Negeri Sembilan,70,21,49,2013
2013-09-01,Negeri Sembilan,62,22,40,2013
2013-09-02,Negeri Sembilan,10,0,10,2013
2013-09-03,Negeri Sembilan,89,20,69,2013
2013-09-04,Negeri Sembilan,167,74,93,2013
2013-09-05,Negeri Sembilan,14,1,13,2013
2013-09-06,Negeri Sembilan,50,14,36,2013
2013-09-07,Negeri Sembilan,19,12,7,2013
2013-09-08,Negeri Sembilan,72,23,49,2013
2013-09-09,Negeri Sembilan,102,42,60,2013
2013-09-10,Negeri Sembilan,177,109,68,2013
2013-09-11,Negeri Sembilan,98,76,22,2013
2013-09-12,Negeri Sembilan,116,75,41,2013
2013-09-13,Negeri Sembilan,16,2,14,2013
2013-09-14,Negeri Sembilan,90,43,47,2013
2013-09-15,Negeri Sembilan,144,62,82,2013
2013-09-16,Negeri Sembilan,0,0,0,2013
2013-09-17,Negeri Sembilan,57,37,20,2013
2013-09-18,Negeri Sembilan,65,34,31,2013
2013-09-19,Negeri Sembilan,72,51,21,2013
2013-09-20,Negeri Sembilan,10,0,10,2013
2013-09-21,Negeri Sembilan,37,12,25,2013
2013-09-22,Negeri Sembilan,110,18,92,2013
2013-09-23,Negeri Sembilan,13,2,11,2013
2013-09-24,Negeri Sembilan,48,9,39,2013
2013-09-25,Negeri Sembilan,8,0,8,2013
2013-09-26,Negeri Sembilan,30,13,17,2013
2013-09-27,Negeri Sembilan,10,2,8,2013
2013-09-28,Negeri Sembilan,0,0,0,2013
2013-09-29,Negeri Sembilan,115,38,77,2013
2013-09-30,Negeri Sembilan,8,2,6,2013
2013-10-01,Negeri Sembilan,8,1,7,2013
2013-10-02,Negeri Sembilan,5,0,5,2013
2013-10-03,Negeri Sembilan,11,3,8,2013
2013-10-04,Negeri Sembilan,7,0,7,2013
2013-10-05,Negeri Sembilan,55,29,26,2013
2013-10-06,Negeri Sembilan,26,6,20,2013
2013-10-07,Negeri Sembilan,9,0,9,2013
2013-10-08,Negeri Sembilan,66,27,39,2013
2013-10-09,Negeri Sembilan,9,1,8,2013
2013-10-10,Negeri Sembilan,41,9,32,2013
2013-10-11,Negeri Sembilan,9,2,7,2013
2013-10-12,Negeri Sembilan,19,18,1,2013
2013-10-13,Negeri Sembilan,35,14,21,2013
2013-10-14,Negeri Sembilan,14,1,13,2013
2013-10-15,Negeri Sembilan,0,0,0,2013
2013-10-16,Negeri Sembilan,13,2,11,2013
2013-10-17,Negeri Sembilan,11,1,10,2013
2013-10-18,Negeri Sembilan,15,1,14,2013
2013-10-19,Negeri Sembilan,34,7,27,2013
2013-10-20,Negeri Sembilan,0,0,0,2013
2013-10-21,Negeri Sembilan,18,0,18,2013
2013-10-22,Negeri Sembilan,6,0,6,2013
2013-10-23,Negeri Sembilan,40,13,27,2013
2013-10-24,Negeri Sembilan,13,1,12,2013
2013-10-25,Negeri Sembilan,79,35,44,2013
2013-10-26,Negeri Sembilan,0,0,0,2013
2013-10-27,Negeri Sembilan,0,0,0,2013
2013-10-28,Negeri Sembilan,119,56,63,2013
2013-10-29,Negeri Sembilan,93,43,50,2013
2013-10-30,Negeri Sembilan,107,56,51,2013
2013-10-31,Negeri Sembilan,9,1,8,2013
2013-11-01,Negeri Sembilan,55,18,37,2013
2013-11-02,Negeri Sembilan,134,101,33,2013
2013-11-03,Negeri Sembilan,18,9,9,2013
2013-11-04,Negeri Sembilan,21,0,21,2013
2013-11-05,Negeri Sembilan,0,0,0,2013
2013-11-06,Negeri Sembilan,11,0,11,2013
2013-11-07,Negeri Sembilan,80,56,24,2013
2013-11-08,Negeri Sembilan,36,11,25,2013
2013-11-09,Negeri Sembilan,84,42,42,2013
2013-11-10,Negeri Sembilan,0,0,0,2013
2013-11-11,Negeri Sembilan,62,25,37,2013
2013-11-12,Negeri Sembilan,61,19,42,2013
2013-11-13,Negeri Sembilan,63,15,48,2013
2013-11-14,Negeri Sembilan,54,19,35,2013
2013-11-15,Negeri Sembilan,65,24,41,2013
2013-11-16,Negeri Sembilan,0,0,0,2013
2013-11-17,Negeri Sembilan,18,8,10,2013
2013-11-18,Negeri Sembilan,11,0,11,2013
2013-11-19,Negeri Sembilan,12,3,9,2013
2013-11-20,Negeri Sembilan,119,56,63,2013
2013-11-21,Negeri Sembilan,9,0,9,2013
2013-11-22,Negeri Sembilan,129,29,100,2013
2013-11-23,Negeri Sembilan,17,7,10,2013
2013-11-24,Negeri Sembilan,41,14,27,2013
2013-11-25,Negeri Sembilan,11,0,11,2013
2013-11-26,Negeri Sembilan,75,25,50,2013
2013-11-27,Negeri Sembilan,54,21,33,2013
2013-11-28,Negeri Sembilan,32,10,22,2013
2013-11-29,Negeri Sembilan,8,0,8,2013
2013-11-30,Negeri Sembilan,58,28,30,2013
2013-12-01,Negeri Sembilan,0,0,0,2013
2013-12-02,Negeri Sembilan,9,0,9,2013
2013-12-03,Negeri Sembilan,105,53,52,2013
2013-12-04,Negeri Sembilan,61,4,57,2013
2013-12-05,Negeri Sembilan,11,2,9,2013
2013-12-06,Negeri Sembilan,6,1,5,2013
2013-12-07,Negeri Sembilan,0,0,0,2013
2013-12-08,Negeri Sembilan,11,4,7,2013
2013-12-09,Negeri Sembilan,50,30,20,2013
2013-12-10,Negeri Sembilan,14,3,11,2013
2013-12-11,Negeri Sembilan,44,6,38,2013
2013-12-12,Negeri Sembilan,54,32,22,2013
2013-12-13,Negeri Sembilan,10,0,10,2013
2013-12-14,Negeri Sembilan,15,7,8,2013
2013-12-15,Negeri Sembilan,86,4,82,2013
2013-12-16,Negeri Sembilan,62,26,36,2013
2013-12-17,Negeri Sembilan,88,44,44,2013
2013-12-18,Negeri Sembilan,56,34,22,2013
2013-12-19,Negeri Sembilan,60,14,46,2013
2013-12-20,Negeri Sembilan,31,8,23,2013
2013-12-21,Negeri Sembilan,379,355,24,2013
2013-12-22,Negeri Sembilan,0,0,0,2013
2013-12-23,Negeri Sembilan,11,0,11,2013
2013-12-24,Negeri Sembilan,52,12,40,2013
2013-12-25,Negeri Sembilan,0,0,0,2013
2013-12-26,Negeri Sembilan,11,1,10,2013
2013-12-27,Negeri Sembilan,7,1,6,2013
2013-12-28,Negeri Sembilan,40,22,18,2013
2013-12-29,Negeri Sembilan,83,16,67,2013
2013-12-30,Negeri Sembilan,18,0,18,2013
2013-12-31,Negeri Sembilan,11,0,11,2013
2014-01-01,Negeri Sembilan,0,0,0,2014
2014-01-02,Negeri Sembilan,18,1,17,2014
2014-01-03,Negeri Sembilan,12,0,12,2014
2014-01-04,Negeri Sembilan,30,14,16,2014
2014-01-05,Negeri Sembilan,0,0,0,2014
2014-01-06,Negeri Sembilan,20,4,16,2014
2014-01-07,Negeri Sembilan,71,14,57,2014
2014-01-08,Negeri Sembilan,75,11,64,2014
2014-01-09,Negeri Sembilan,96,31,65,2014
2014-01-10,Negeri Sembilan,97,31,66,2014
2014-01-11,Negeri Sembilan,151,50,101,2014
2014-01-12,Negeri Sembilan,180,56,124,2014
2014-01-13,Negeri Sembilan,14,1,13,2014
2014-01-14,Negeri Sembilan,0,0,0,2014
2014-01-15,Negeri Sembilan,0,0,0,2014
2014-01-16,Negeri Sembilan,75,9,66,2014
2014-01-17,Negeri Sembilan,0,0,0,2014
2014-01-18,Negeri Sembilan,0,0,0,2014
2014-01-19,Negeri Sembilan,44,29,15,2014
2014-01-20,Negeri Sembilan,206,69,137,2014
2014-01-21,Negeri Sembilan,8,0,8,2014
2014-01-22,Negeri Sembilan,91,19,72,2014
2014-01-23,Negeri Sembilan,14,3,11,2014
2014-01-24,Negeri Sembilan,69,8,61,2014
2014-01-25,Negeri Sembilan,46,24,22,2014
2014-01-26,Negeri Sembilan,0,0,0,2014
2014-01-27,Negeri Sembilan,68,27,41,2014
2014-01-28,Negeri Sembilan,17,3,14,2014
2014-01-29,Negeri Sembilan,67,46,21,2014
2014-01-30,Negeri Sembilan,42,22,20,2014
2014-01-31,Negeri Sembilan,0,0,0,2014
2014-02-01,Negeri Sembilan,33,12,21,2014
2014-02-02,Negeri Sembilan,0,0,0,2014
2014-02-03,Negeri Sembilan,20,1,19,2014
2014-02-04,Negeri Sembilan,14,2,12,2014
2014-02-05,Negeri Sembilan,15,2,13,2014
2014-02-06,Negeri Sembilan,38,10,28,2014
2014-02-07,Negeri Sembilan,40,2,38,2014
2014-02-08,Negeri Sembilan,0,0,0,2014
2014-02-09,Negeri Sembilan,0,0,0,2014
2014-02-10,Negeri Sembilan,14,5,9,2014
2014-02-11,Negeri Sembilan,43,5,38,2014
2014-02-12,Negeri Sembilan,48,20,28,2014
2014-02-13,Negeri Sembilan,66,14,52,2014
2014-02-14,Negeri Sembilan,14,1,13,2014
2014-02-15,Negeri Sembilan,102,86,16,2014
2014-02-16,Negeri Sembilan,70,34,36,2014
2014-02-17,Negeri Sembilan,16,2,14,2014
2014-02-18,Negeri Sembilan,52,27,25,2014
2014-02-19,Negeri Sembilan,132,70,62,2014
2014-02-20,Negeri Sembilan,50,9,41,2014
2014-02-21,Negeri Sembilan,64,9,55,2014
2014-02-22,Negeri Sembilan,24,9,15,2014
2014-02-23,Negeri Sembilan,0,0,0,2014
2014-02-24,Negeri Sembilan,17,2,15,2014
2014-02-25,Negeri Sembilan,33,8,25,2014
2014-02-26,Negeri Sembilan,84,38,46,2014
2014-02-27,Negeri Sembilan,56,28,28,2014
2014-02-28,Negeri Sembilan,4,1,3,2014
2014-03-01,Negeri Sembilan,0,0,0,2014
2014-03-02,Negeri Sembilan,39,17,22,2014
2014-03-03,Negeri Sembilan,18,1,17,2014
2014-03-04,Negeri Sembilan,14,3,11,2014
2014-03-05,Negeri Sembilan,47,12,35,2014
2014-03-06,Negeri Sembilan,9,1,8,2014
2014-03-07,Negeri Sembilan,10,2,8,2014
2014-03-08,Negeri Sembilan,39,13,26,2014
2014-03-09,Negeri Sembilan,0,0,0,2014
2014-03-10,Negeri Sembilan,91,42,49,2014
2014-03-11,Negeri Sembilan,86,37,49,2014
2014-03-12,Negeri Sembilan,64,12,52,2014
2014-03-13,Negeri Sembilan,49,11,38,2014
2014-03-14,Negeri Sembilan,11,0,11,2014
2014-03-15,Negeri Sembilan,62,20,42,2014
2014-03-16,Negeri Sembilan,46,0,46,2014
2014-03-17,Negeri Sembilan,87,33,54,2014
2014-03-18,Negeri Sembilan,94,41,53,2014
2014-03-19,Negeri Sembilan,11,1,10,2014
2014-03-20,Negeri Sembilan,57,12,45,2014
2014-03-21,Negeri Sembilan,13,2,11,2014
2014-03-22,Negeri Sembilan,31,11,20,2014
2014-03-23,Negeri Sembilan,120,13,107,2014
2014-03-24,Negeri Sembilan,93,33,60,2014
2014-03-25,Negeri Sembilan,16,4,12,2014
2014-03-26,Negeri Sembilan,25,1,24,2014
2014-03-27,Negeri Sembilan,33,6,27,2014
2014-03-28,Negeri Sembilan,35,8,27,2014
2014-03-29,Negeri Sembilan,10,4,6,2014
2014-03-30,Negeri Sembilan,13,10,3,2014
2014-03-31,Negeri Sembilan,21,0,21,2014
2014-04-01,Negeri Sembilan,49,8,41,2014
2014-04-02,Negeri Sembilan,40,7,33,2014
2014-04-03,Negeri Sembilan,47,10,37,2014
2014-04-04,Negeri Sembilan,7,0,7,2014
2014-04-05,Negeri Sembilan,33,18,15,2014
2014-04-06,Negeri Sembilan,38,13,25,2014
2014-04-07,Negeri Sembilan,87,21,66,2014
2014-04-08,Negeri Sembilan,38,12,26,2014
2014-04-09,Negeri Sembilan,89,40,49,2014
2014-04-10,Negeri Sembilan,11,2,9,2014
2014-04-11,Negeri Sembilan,15,1,14,2014
2014-04-12,Negeri Sembilan,41,13,28,2014
2014-04-13,Negeri Sembilan,0,0,0,2014
2014-04-14,Negeri Sembilan,21,0,21,2014
2014-04-15,Negeri Sembilan,66,22,44,2014
2014-04-16,Negeri Sembilan,75,33,42,2014
2014-04-17,Negeri Sembilan,11,1,10,2014
2014-04-18,Negeri Sembilan,50,32,18,2014
2014-04-19,Negeri Sembilan,28,15,13,2014
2014-04-20,Negeri Sembilan,18,8,10,2014
2014-04-21,Negeri Sembilan,11,0,11,2014
2014-04-22,Negeri Sembilan,147,34,113,2014
2014-04-23,Negeri Sembilan,74,23,51,2014
2014-04-24,Negeri Sembilan,11,1,10,2014
2014-04-25,Negeri Sembilan,10,1,9,2014
2014-04-26,Negeri Sembilan,13,5,8,2014
2014-04-27,Negeri Sembilan,0,0,0,2014
2014-04-28,Negeri Sembilan,16,1,15,2014
2014-04-29,Negeri Sembilan,6,0,6,2014
2014-04-30,Negeri Sembilan,61,18,43,2014
2014-05-01,Negeri Sembilan,18,7,11,2014
2014-05-02,Negeri Sembilan,18,0,18,2014
2014-05-03,Negeri Sembilan,17,4,13,2014
2014-05-04,Negeri Sembilan,0,0,0,2014
2014-05-05,Negeri Sembilan,16,2,14,2014
2014-05-06,Negeri Sembilan,12,1,11,2014
2014-05-07,Negeri Sembilan,13,2,11,2014
2014-05-08,Negeri Sembilan,78,27,51,2014
2014-05-09,Negeri Sembilan,8,1,7,2014
2014-05-10,Negeri Sembilan,33,11,22,2014
2014-05-11,Negeri Sembilan,67,19,48,2014
2014-05-12,Negeri Sembilan,11,2,9,2014
2014-05-13,Negeri Sembilan,114,46,68,2014
2014-05-14,Negeri Sembilan,7,2,5,2014
2014-05-15,Negeri Sembilan,9,1,8,2014
2014-05-16,Negeri Sembilan,13,2,11,2014
2014-05-17,Negeri Sembilan,32,19,13,2014
2014-05-18,Negeri Sembilan,62,17,45,2014
2014-05-19,Negeri Sembilan,55,32,23,2014
2014-05-20,Negeri Sembilan,41,4,37,2014
2014-05-21,Negeri Sembilan,64,10,54,2014
2014-05-22,Negeri Sembilan,46,8,38,2014
2014-05-23,Negeri Sembilan,15,0,15,2014
2014-05-24,Negeri Sembilan,36,31,5,2014
2014-05-25,Negeri Sembilan,28,13,15,2014
2014-05-26,Negeri Sembilan,11,0,11,2014
2014-05-27,Negeri Sembilan,0,0,0,2014
2014-05-28,Negeri Sembilan,51,13,38,2014
2014-05-29,Negeri Sembilan,7,0,7,2014
2014-05-30,Negeri Sembilan,57,25,32,2014
2014-05-31,Negeri Sembilan,29,15,14,2014
2014-06-01,Negeri Sembilan,12,5,7,2014
2014-06-02,Negeri Sembilan,17,2,15,2014
2014-06-03,Negeri Sembilan,18,5,13,2014
2014-06-04,Negeri Sembilan,12,0,12,2014
2014-06-05,Negeri Sembilan,33,15,18,2014
2014-06-06,Negeri Sembilan,16,0,16,2014
2014-06-07,Negeri Sembilan,155,68,87,2014
2014-06-08,Negeri Sembilan,134,46,88,2014
2014-06-09,Negeri Sembilan,67,55,12,2014
2014-06-10,Negeri Sembilan,12,0,12,2014
2014-06-11,Negeri Sembilan,65,21,44,2014
2014-06-12,Negeri Sembilan,67,14,53,2014
2014-06-13,Negeri Sembilan,45,9,36,2014
2014-06-14,Negeri Sembilan,96,56,40,2014
2014-06-15,Negeri Sembilan,67,6,61,2014
2014-06-16,Negeri Sembilan,80,46,34,2014
2014-06-17,Negeri Sembilan,76,35,41,2014
2014-06-18,Negeri Sembilan,40,8,32,2014
2014-06-19,Negeri Sembilan,13,1,12,2014
2014-06-20,Negeri Sembilan,44,26,18,2014
2014-06-21,Negeri Sembilan,94,37,57,2014
2014-06-22,Negeri Sembilan,154,63,91,2014
2014-06-23,Negeri Sembilan,21,1,20,2014
2014-06-24,Negeri Sembilan,9,1,8,2014
2014-06-25,Negeri Sembilan,44,18,26,2014
2014-06-26,Negeri Sembilan,17,3,14,2014
2014-06-27,Negeri Sembilan,63,19,44,2014
2014-06-28,Negeri Sembilan,12,4,8,2014
2014-06-29,Negeri Sembilan,102,22,80,2014
2014-06-30,Negeri Sembilan,7,0,7,2014
2014-07-01,Negeri Sembilan,7,1,6,2014
2014-07-02,Negeri Sembilan,5,1,4,2014
2014-07-03,Negeri Sembilan,6,1,5,2014
2014-07-04,Negeri Sembilan,7,0,7,2014
2014-07-05,Negeri Sembilan,33,13,20,2014
2014-07-06,Negeri Sembilan,30,15,15,2014
2014-07-07,Negeri Sembilan,9,2,7,2014
2014-07-08,Negeri Sembilan,58,54,4,2014
2014-07-09,Negeri Sembilan,4,0,4,2014
2014-07-10,Negeri Sembilan,4,1,3,2014
2014-07-11,Negeri Sembilan,7,0,7,2014
2014-07-12,Negeri Sembilan,0,0,0,2014
2014-07-13,Negeri Sembilan,45,16,29,2014
2014-07-14,Negeri Sembilan,3,0,3,2014
2014-07-15,Negeri Sembilan,16,1,15,2014
2014-07-16,Negeri Sembilan,90,51,39,2014
2014-07-17,Negeri Sembilan,45,26,19,2014
2014-07-18,Negeri Sembilan,11,2,9,2014
2014-07-19,Negeri Sembilan,20,9,11,2014
2014-07-20,Negeri Sembilan,159,40,119,2014
2014-07-21,Negeri Sembilan,47,15,32,2014
2014-07-22,Negeri Sembilan,64,36,28,2014
2014-07-23,Negeri Sembilan,28,9,19,2014
2014-07-24,Negeri Sembilan,32,11,21,2014
2014-07-25,Negeri Sembilan,7,1,6,2014
2014-07-26,Negeri Sembilan,0,0,0,2014
2014-07-27,Negeri Sembilan,34,27,7,2014
2014-07-28,Negeri Sembilan,0,0,0,2014
2014-07-29,Negeri Sembilan,0,0,0,2014
2014-07-30,Negeri Sembilan,0,0,0,2014
2014-07-31,Negeri Sembilan,17,1,16,2014
2014-08-01,Negeri Sembilan,13,0,13,2014
2014-08-02,Negeri Sembilan,1,0,1,2014
2014-08-03,Negeri Sembilan,14,5,9,2014
2014-08-04,Negeri Sembilan,21,2,19,2014
2014-08-05,Negeri Sembilan,17,2,15,2014
2014-08-06,Negeri Sembilan,38,9,29,2014
2014-08-07,Negeri Sembilan,33,8,25,2014
2014-08-08,Negeri Sembilan,11,1,10,2014
2014-08-09,Negeri Sembilan,23,11,12,2014
2014-08-10,Negeri Sembilan,75,35,40,2014
2014-08-11,Negeri Sembilan,24,6,18,2014
2014-08-12,Negeri Sembilan,113,61,52,2014
2014-08-13,Negeri Sembilan,105,31,74,2014
2014-08-14,Negeri Sembilan,84,51,33,2014
2014-08-15,Negeri Sembilan,33,0,33,2014
2014-08-16,Negeri Sembilan,0,0,0,2014
2014-08-17,Negeri Sembilan,98,12,86,2014
2014-08-18,Negeri Sembilan,47,4,43,2014
2014-08-19,Negeri Sembilan,85,6,79,2014
2014-08-20,Negeri Sembilan,45,22,23,2014
2014-08-21,Negeri Sembilan,23,4,19,2014
2014-08-22,Negeri Sembilan,19,4,15,2014
2014-08-23,Negeri Sembilan,60,16,44,2014
2014-08-24,Negeri Sembilan,0,0,0,2014
2014-08-25,Negeri Sembilan,17,3,14,2014
2014-08-26,Negeri Sembilan,53,18,35,2014
2014-08-27,Negeri Sembilan,61,20,41,2014
2014-08-28,Negeri Sembilan,65,14,51,2014
2014-08-29,Negeri Sembilan,19,4,15,2014
2014-08-30,Negeri Sembilan,35,23,12,2014
2014-08-31,Negeri Sembilan,0,0,0,2014
2014-09-01,Negeri Sembilan,55,19,36,2014
2014-09-02,Negeri Sembilan,28,4,24,2014
2014-09-03,Negeri Sembilan,108,41,67,2014
2014-09-04,Negeri Sembilan,114,19,95,2014
2014-09-05,Negeri Sembilan,16,0,16,2014
2014-09-06,Negeri Sembilan,9,4,5,2014
2014-09-07,Negeri Sembilan,49,24,25,2014
2014-09-08,Negeri Sembilan,74,31,43,2014
2014-09-09,Negeri Sembilan,56,21,35,2014
2014-09-10,Negeri Sembilan,34,16,18,2014
2014-09-11,Negeri Sembilan,34,1,33,2014
2014-09-12,Negeri Sembilan,109,45,64,2014
2014-09-13,Negeri Sembilan,0,0,0,2014
2014-09-14,Negeri Sembilan,14,8,6,2014
2014-09-15,Negeri Sembilan,30,9,21,2014
2014-09-16,Negeri Sembilan,0,0,0,2014
2014-09-17,Negeri Sembilan,83,37,46,2014
2014-09-18,Negeri Sembilan,78,29,49,2014
2014-09-19,Negeri Sembilan,73,19,54,2014
2014-09-20,Negeri Sembilan,79,29,50,2014
2014-09-21,Negeri Sembilan,92,10,82,2014
2014-09-22,Negeri Sembilan,18,0,18,2014
2014-09-23,Negeri Sembilan,20,5,15,2014
2014-09-24,Negeri Sembilan,182,74,108,2014
2014-09-25,Negeri Sembilan,134,78,56,2014
2014-09-26,Negeri Sembilan,142,81,61,2014
2014-09-27,Negeri Sembilan,63,39,24,2014
2014-09-28,Negeri Sembilan,89,51,38,2014
2014-09-29,Negeri Sembilan,14,4,10,2014
2014-09-30,Negeri Sembilan,107,45,62,2014
2014-10-01,Negeri Sembilan,27,8,19,2014
2014-10-02,Negeri Sembilan,11,1,10,2014
2014-10-03,Negeri Sembilan,8,0,8,2014
2014-10-04,Negeri Sembilan,0,0,0,2014
2014-10-05,Negeri Sembilan,0,0,0,2014
2014-10-06,Negeri Sembilan,0,0,0,2014
2014-10-07,Negeri Sembilan,74,26,48,2014
2014-10-08,Negeri Sembilan,73,24,49,2014
2014-10-09,Negeri Sembilan,81,23,58,2014
2014-10-10,Negeri Sembilan,15,3,12,2014
2014-10-11,Negeri Sembilan,41,25,16,2014
2014-10-12,Negeri Sembilan,45,26,19,2014
2014-10-13,Negeri Sembilan,9,0,9,2014
2014-10-14,Negeri Sembilan,146,45,101,2014
2014-10-15,Negeri Sembilan,55,23,32,2014
2014-10-16,Negeri Sembilan,45,17,28,2014
2014-10-17,Negeri Sembilan,55,18,37,2014
2014-10-18,Negeri Sembilan,15,3,12,2014
2014-10-19,Negeri Sembilan,32,7,25,2014
2014-10-20,Negeri Sembilan,22,0,22,2014
2014-10-21,Negeri Sembilan,53,30,23,2014
2014-10-22,Negeri Sembilan,0,0,0,2014
2014-10-23,Negeri Sembilan,18,2,16,2014
2014-10-24,Negeri Sembilan,10,1,9,2014
2014-10-25,Negeri Sembilan,14,5,9,2014
2014-10-26,Negeri Sembilan,0,0,0,2014
2014-10-27,Negeri Sembilan,20,2,18,2014
2014-10-28,Negeri Sembilan,94,26,68,2014
2014-10-29,Negeri Sembilan,55,9,46,2014
2014-10-30,Negeri Sembilan,11,0,11,2014
2014-10-31,Negeri Sembilan,46,13,33,2014
2014-11-01,Negeri Sembilan,20,8,12,2014
2014-11-02,Negeri Sembilan,0,0,0,2014
2014-11-03,Negeri Sembilan,11,0,11,2014
2014-11-04,Negeri Sembilan,16,0,16,2014
2014-11-05,Negeri Sembilan,14,0,14,2014
2014-11-06,Negeri Sembilan,20,2,18,2014
2014-11-07,Negeri Sembilan,9,5,4,2014
2014-11-08,Negeri Sembilan,12,6,6,2014
2014-11-09,Negeri Sembilan,89,17,72,2014
2014-11-10,Negeri Sembilan,32,12,20,2014
2014-11-11,Negeri Sembilan,15,2,13,2014
2014-11-12,Negeri Sembilan,90,29,61,2014
2014-11-13,Negeri Sembilan,41,20,21,2014
2014-11-14,Negeri Sembilan,69,33,36,2014
2014-11-15,Negeri Sembilan,25,15,10,2014
2014-11-16,Negeri Sembilan,0,0,0,2014
2014-11-17,Negeri Sembilan,67,27,40,2014
2014-11-18,Negeri Sembilan,79,36,43,2014
2014-11-19,Negeri Sembilan,71,32,39,2014
2014-11-20,Negeri Sembilan,14,2,12,2014
2014-11-21,Negeri Sembilan,11,4,7,2014
2014-11-22,Negeri Sembilan,0,0,0,2014
2014-11-23,Negeri Sembilan,45,17,28,2014
2014-11-24,Negeri Sembilan,11,0,11,2014
2014-11-25,Negeri Sembilan,9,0,9,2014
2014-11-26,Negeri Sembilan,50,6,44,2014
2014-11-27,Negeri Sembilan,37,13,24,2014
2014-11-28,Negeri Sembilan,17,1,16,2014
2014-11-29,Negeri Sembilan,40,18,22,2014
2014-11-30,Negeri Sembilan,68,12,56,2014
2014-12-01,Negeri Sembilan,13,1,12,2014
2014-12-02,Negeri Sembilan,59,13,46,2014
2014-12-03,Negeri Sembilan,13,1,12,2014
2014-12-04,Negeri Sembilan,11,4,7,2014
2014-12-05,Negeri Sembilan,13,1,12,2014
2014-12-06,Negeri Sembilan,48,22,26,2014
2014-12-07,Negeri Sembilan,41,5,36,2014
2014-12-08,Negeri Sembilan,22,7,15,2014
2014-12-09,Negeri Sembilan,71,27,44,2014
2014-12-10,Negeri Sembilan,65,41,24,2014
2014-12-11,Negeri Sembilan,78,35,43,2014
2014-12-12,Negeri Sembilan,21,4,17,2014
2014-12-13,Negeri Sembilan,64,28,36,2014
2014-12-14,Negeri Sembilan,0,0,0,2014
2014-12-15,Negeri Sembilan,16,2,14,2014
2014-12-16,Negeri Sembilan,73,39,34,2014
2014-12-17,Negeri Sembilan,101,35,66,2014
2014-12-18,Negeri Sembilan,145,94,51,2014
2014-12-19,Negeri Sembilan,15,0,15,2014
2014-12-20,Negeri Sembilan,217,202,15,2014
2014-12-21,Negeri Sembilan,0,0,0,2014
2014-12-22,Negeri Sembilan,45,9,36,2014
2014-12-23,Negeri Sembilan,68,7,61,2014
2014-12-24,Negeri Sembilan,27,5,22,2014
2014-12-25,Negeri Sembilan,0,0,0,2014
2014-12-26,Negeri Sembilan,15,3,12,2014
2014-12-27,Negeri Sembilan,28,10,18,2014
2014-12-28,Negeri Sembilan,0,0,0,2014
2014-12-29,Negeri Sembilan,13,4,9,2014
2014-12-30,Negeri Sembilan,16,1,15,2014
2014-12-31,Negeri Sembilan,29,1,28,2014
2015-01-01,Negeri Sembilan,16,6,10,2015
2015-01-02,Negeri Sembilan,44,7,37,2015
2015-01-03,Negeri Sembilan,47,15,32,2015
2015-01-04,Negeri Sembilan,32,19,13,2015
2015-01-05,Negeri Sembilan,17,1,16,2015
2015-01-06,Negeri Sembilan,57,30,27,2015
2015-01-07,Negeri Sembilan,27,3,24,2015
2015-01-08,Negeri Sembilan,20,2,18,2015
2015-01-09,Negeri Sembilan,103,50,53,2015
2015-01-10,Negeri Sembilan,133,45,88,2015
2015-01-11,Negeri Sembilan,154,58,96,2015
2015-01-12,Negeri Sembilan,24,3,21,2015
2015-01-13,Negeri Sembilan,102,11,91,2015
2015-01-14,Negeri Sembilan,0,0,0,2015
2015-01-15,Negeri Sembilan,11,1,10,2015
2015-01-16,Negeri Sembilan,13,1,12,2015
2015-01-17,Negeri Sembilan,0,0,0,2015
2015-01-18,Negeri Sembilan,15,7,8,2015
2015-01-19,Negeri Sembilan,18,1,17,2015
2015-01-20,Negeri Sembilan,139,34,105,2015
2015-01-21,Negeri Sembilan,13,1,12,2015
2015-01-22,Negeri Sembilan,28,15,13,2015
2015-01-23,Negeri Sembilan,7,0,7,2015
2015-01-24,Negeri Sembilan,44,37,7,2015
2015-01-25,Negeri Sembilan,30,21,9,2015
2015-01-26,Negeri Sembilan,10,1,9,2015
2015-01-27,Negeri Sembilan,10,1,9,2015
2015-01-28,Negeri Sembilan,57,45,12,2015
2015-01-29,Negeri Sembilan,86,51,35,2015
2015-01-30,Negeri Sembilan,7,1,6,2015
2015-01-31,Negeri Sembilan,74,20,54,2015
2015-02-01,Negeri Sembilan,0,0,0,2015
2015-02-02,Negeri Sembilan,10,2,8,2015
2015-02-03,Negeri Sembilan,0,0,0,2015
2015-02-04,Negeri Sembilan,83,40,43,2015
2015-02-05,Negeri Sembilan,149,86,63,2015
2015-02-06,Negeri Sembilan,121,66,55,2015
2015-02-07,Negeri Sembilan,8,1,7,2015
2015-02-08,Negeri Sembilan,67,20,47,2015
2015-02-09,Negeri Sembilan,10,0,10,2015
2015-02-10,Negeri Sembilan,14,1,13,2015
2015-02-11,Negeri Sembilan,5,1,4,2015
2015-02-12,Negeri Sembilan,47,34,13,2015
2015-02-13,Negeri Sembilan,33,0,33,2015
2015-02-14,Negeri Sembilan,0,0,0,2015
2015-02-15,Negeri Sembilan,0,0,0,2015
2015-02-16,Negeri Sembilan,19,1,18,2015
2015-02-17,Negeri Sembilan,38,2,36,2015
2015-02-18,Negeri Sembilan,101,35,66,2015
2015-02-19,Negeri Sembilan,0,0,0,2015
2015-02-20,Negeri Sembilan,0,0,0,2015
2015-02-21,Negeri Sembilan,36,13,23,2015
2015-02-22,Negeri Sembilan,0,0,0,2015
2015-02-23,Negeri Sembilan,16,0,16,2015
2015-02-24,Negeri Sembilan,40,8,32,2015
2015-02-25,Negeri Sembilan,45,14,31,2015
2015-02-26,Negeri Sembilan,74,28,46,2015
2015-02-27,Negeri Sembilan,53,15,38,2015
2015-02-28,Negeri Sembilan,48,26,22,2015
2015-03-01,Negeri Sembilan,40,21,19,2015
2015-03-02,Negeri Sembilan,33,4,29,2015
2015-03-03,Negeri Sembilan,68,10,58,2015
2015-03-04,Negeri Sembilan,42,7,35,2015
2015-03-05,Negeri Sembilan,23,4,19,2015
2015-03-06,Negeri Sembilan,32,13,19,2015
2015-03-07,Negeri Sembilan,130,58,72,2015
2015-03-08,Negeri Sembilan,0,0,0,2015
2015-03-09,Negeri Sembilan,18,5,13,2015
2015-03-10,Negeri Sembilan,22,3,19,2015
2015-03-11,Negeri Sembilan,18,2,16,2015
2015-03-12,Negeri Sembilan,55,11,44,2015
2015-03-13,Negeri Sembilan,8,0,8,2015
2015-03-14,Negeri Sembilan,86,45,41,2015
2015-03-15,Negeri Sembilan,107,54,53,2015
2015-03-16,Negeri Sembilan,21,2,19,2015
2015-03-17,Negeri Sembilan,74,40,34,2015
2015-03-18,Negeri Sembilan,102,51,51,2015
2015-03-19,Negeri Sembilan,93,47,46,2015
2015-03-20,Negeri Sembilan,94,24,70,2015
2015-03-21,Negeri Sembilan,22,14,8,2015
2015-03-22,Negeri Sembilan,121,9,112,2015
2015-03-23,Negeri Sembilan,90,34,56,2015
2015-03-24,Negeri Sembilan,91,34,57,2015
2015-03-25,Negeri Sembilan,64,16,48,2015
2015-03-26,Negeri Sembilan,74,39,35,2015
2015-03-27,Negeri Sembilan,13,0,13,2015
2015-03-28,Negeri Sembilan,89,37,52,2015
2015-03-29,Negeri Sembilan,60,22,38,2015
2015-03-30,Negeri Sembilan,51,26,25,2015
2015-03-31,Negeri Sembilan,73,39,34,2015
2015-04-01,Negeri Sembilan,53,15,38,2015
2015-04-02,Negeri Sembilan,12,0,12,2015
2015-04-03,Negeri Sembilan,45,24,21,2015
2015-04-04,Negeri Sembilan,37,23,14,2015
2015-04-05,Negeri Sembilan,31,21,10,2015
2015-04-06,Negeri Sembilan,16,1,15,2015
2015-04-07,Negeri Sembilan,60,34,26,2015
2015-04-08,Negeri Sembilan,47,8,39,2015
2015-04-09,Negeri Sembilan,13,0,13,2015
2015-04-10,Negeri Sembilan,11,1,10,2015
2015-04-11,Negeri Sembilan,53,14,39,2015
2015-04-12,Negeri Sembilan,76,28,48,2015
2015-04-13,Negeri Sembilan,18,2,16,2015
2015-04-14,Negeri Sembilan,19,2,17,2015
2015-04-15,Negeri Sembilan,34,9,25,2015
2015-04-16,Negeri Sembilan,42,28,14,2015
2015-04-17,Negeri Sembilan,55,32,23,2015
2015-04-18,Negeri Sembilan,89,24,65,2015
2015-04-19,Negeri Sembilan,130,51,79,2015
2015-04-20,Negeri Sembilan,9,0,9,2015
2015-04-21,Negeri Sembilan,15,1,14,2015
2015-04-22,Negeri Sembilan,20,4,16,2015
2015-04-23,Negeri Sembilan,79,29,50,2015
2015-04-24,Negeri Sembilan,48,7,41,2015
2015-04-25,Negeri Sembilan,40,25,15,2015
2015-04-26,Negeri Sembilan,72,19,53,2015
2015-04-27,Negeri Sembilan,101,38,63,2015
2015-04-28,Negeri Sembilan,67,13,54,2015
2015-04-29,Negeri Sembilan,71,27,44,2015
2015-04-30,Negeri Sembilan,49,20,29,2015
2015-05-01,Negeri Sembilan,68,14,54,2015
2015-05-02,Negeri Sembilan,56,22,34,2015
2015-05-03,Negeri Sembilan,83,28,55,2015
2015-05-04,Negeri Sembilan,0,0,0,2015
2015-05-05,Negeri Sembilan,16,1,15,2015
2015-05-06,Negeri Sembilan,73,22,51,2015
2015-05-07,Negeri Sembilan,145,61,84,2015
2015-05-08,Negeri Sembilan,72,19,53,2015
2015-05-09,Negeri Sembilan,19,9,10,2015
2015-05-10,Negeri Sembilan,74,20,54,2015
2015-05-11,Negeri Sembilan,17,1,16,2015
2015-05-12,Negeri Sembilan,72,23,49,2015
2015-05-13,Negeri Sembilan,48,21,27,2015
2015-05-14,Negeri Sembilan,58,26,32,2015
2015-05-15,Negeri Sembilan,21,4,17,2015
2015-05-16,Negeri Sembilan,0,0,0,2015
2015-05-17,Negeri Sembilan,38,5,33,2015
2015-05-18,Negeri Sembilan,21,0,21,2015
2015-05-19,Negeri Sembilan,15,3,12,2015
2015-05-20,Negeri Sembilan,61,29,32,2015
2015-05-21,Negeri Sembilan,106,33,73,2015
2015-05-22,Negeri Sembilan,9,3,6,2015
2015-05-23,Negeri Sembilan,18,16,2,2015
2015-05-24,Negeri Sembilan,0,0,0,2015
2015-05-25,Negeri Sembilan,16,0,16,2015
2015-05-26,Negeri Sembilan,62,37,25,2015
2015-05-27,Negeri Sembilan,127,58,69,2015
2015-05-28,Negeri Sembilan,96,39,57,2015
2015-05-29,Negeri Sembilan,30,10,20,2015
2015-05-30,Negeri Sembilan,0,0,0,2015
2015-05-31,Negeri Sembilan,81,16,65,2015
2015-06-01,Negeri Sembilan,12,0,12,2015
2015-06-02,Negeri Sembilan,14,2,12,2015
2015-06-03,Negeri Sembilan,94,42,52,2015
2015-06-04,Negeri Sembilan,15,0,15,2015
2015-06-05,Negeri Sembilan,54,30,24,2015
2015-06-06,Negeri Sembilan,7,2,5,2015
2015-06-07,Negeri Sembilan,52,35,17,2015
2015-06-08,Negeri Sembilan,44,20,24,2015
2015-06-09,Negeri Sembilan,24,5,19,2015
2015-06-10,Negeri Sembilan,43,12,31,2015
2015-06-11,Negeri Sembilan,75,24,51,2015
2015-06-12,Negeri Sembilan,34,10,24,2015
2015-06-13,Negeri Sembilan,94,35,59,2015
2015-06-14,Negeri Sembilan,128,60,68,2015
2015-06-15,Negeri Sembilan,46,15,31,2015
2015-06-16,Negeri Sembilan,62,15,47,2015
2015-06-17,Negeri Sembilan,26,8,18,2015
2015-06-18,Negeri Sembilan,19,5,14,2015
2015-06-19,Negeri Sembilan,6,1,5,2015
2015-06-20,Negeri Sembilan,94,24,70,2015
2015-06-21,Negeri Sembilan,91,25,66,2015
2015-06-22,Negeri Sembilan,3,1,2,2015
2015-06-23,Negeri Sembilan,12,1,11,2015
2015-06-24,Negeri Sembilan,7,0,7,2015
2015-06-25,Negeri Sembilan,35,12,23,2015
2015-06-26,Negeri Sembilan,12,2,10,2015
2015-06-27,Negeri Sembilan,15,8,7,2015
2015-06-28,Negeri Sembilan,41,19,22,2015
2015-06-29,Negeri Sembilan,13,2,11,2015
2015-06-30,Negeri Sembilan,5,1,4,2015
2015-07-01,Negeri Sembilan,2,0,2,2015
2015-07-02,Negeri Sembilan,43,17,26,2015
2015-07-03,Negeri Sembilan,5,1,4,2015
2015-07-04,Negeri Sembilan,30,15,15,2015
2015-07-05,Negeri Sembilan,186,69,117,2015
2015-07-06,Negeri Sembilan,12,1,11,2015
2015-07-07,Negeri Sembilan,79,64,15,2015
2015-07-08,Negeri Sembilan,38,23,15,2015
2015-07-09,Negeri Sembilan,59,29,30,2015
2015-07-10,Negeri Sembilan,6,1,5,2015
2015-07-11,Negeri Sembilan,85,26,59,2015
2015-07-12,Negeri Sembilan,73,23,50,2015
2015-07-13,Negeri Sembilan,7,1,6,2015
2015-07-14,Negeri Sembilan,68,20,48,2015
2015-07-15,Negeri Sembilan,23,6,17,2015
2015-07-16,Negeri Sembilan,9,0,9,2015
2015-07-17,Negeri Sembilan,0,0,0,2015
2015-07-18,Negeri Sembilan,0,0,0,2015
2015-07-19,Negeri Sembilan,9,5,4,2015
2015-07-20,Negeri Sembilan,21,3,18,2015
2015-07-21,Negeri Sembilan,50,9,41,2015
2015-07-22,Negeri Sembilan,57,7,50,2015
2015-07-23,Negeri Sembilan,15,3,12,2015
2015-07-24,Negeri Sembilan,72,24,48,2015
2015-07-25,Negeri Sembilan,0,0,0,2015
2015-07-26,Negeri Sembilan,99,75,24,2015
2015-07-27,Negeri Sembilan,99,55,44,2015
2015-07-28,Negeri Sembilan,19,0,19,2015
2015-07-29,Negeri Sembilan,105,30,75,2015
2015-07-30,Negeri Sembilan,13,0,13,2015
2015-07-31,Negeri Sembilan,15,1,14,2015
2015-08-01,Negeri Sembilan,30,4,26,2015
2015-08-02,Negeri Sembilan,0,0,0,2015
2015-08-03,Negeri Sembilan,16,4,12,2015
2015-08-04,Negeri Sembilan,100,48,52,2015
2015-08-05,Negeri Sembilan,87,56,31,2015
2015-08-06,Negeri Sembilan,41,15,26,2015
2015-08-07,Negeri Sembilan,23,4,19,2015
2015-08-08,Negeri Sembilan,1,1,0,2015
2015-08-09,Negeri Sembilan,68,17,51,2015
2015-08-10,Negeri Sembilan,41,13,28,2015
2015-08-11,Negeri Sembilan,18,1,17,2015
2015-08-12,Negeri Sembilan,155,117,38,2015
2015-08-13,Negeri Sembilan,50,23,27,2015
2015-08-14,Negeri Sembilan,10,0,10,2015
2015-08-15,Negeri Sembilan,0,0,0,2015
2015-08-16,Negeri Sembilan,101,45,56,2015
2015-08-17,Negeri Sembilan,19,4,15,2015
2015-08-18,Negeri Sembilan,85,27,58,2015
2015-08-19,Negeri Sembilan,12,1,11,2015
2015-08-20,Negeri Sembilan,20,3,17,2015
2015-08-21,Negeri Sembilan,44,5,39,2015
2015-08-22,Negeri Sembilan,56,25,31,2015
2015-08-23,Negeri Sembilan,120,23,97,2015
2015-08-24,Negeri Sembilan,10,0,10,2015
2015-08-25,Negeri Sembilan,14,0,14,2015
2015-08-26,Negeri Sembilan,130,79,51,2015
2015-08-27,Negeri Sembilan,17,3,14,2015
2015-08-28,Negeri Sembilan,15,2,13,2015
2015-08-29,Negeri Sembilan,0,0,0,2015
2015-08-30,Negeri Sembilan,23,12,11,2015
2015-08-31,Negeri Sembilan,84,29,55,2015
2015-09-01,Negeri Sembilan,11,1,10,2015
2015-09-02,Negeri Sembilan,70,45,25,2015
2015-09-03,Negeri Sembilan,14,0,14,2015
2015-09-04,Negeri Sembilan,20,5,15,2015
2015-09-05,Negeri Sembilan,65,30,35,2015
2015-09-06,Negeri Sembilan,0,0,0,2015
2015-09-07,Negeri Sembilan,105,31,74,2015
2015-09-08,Negeri Sembilan,17,3,14,2015
2015-09-09,Negeri Sembilan,23,3,20,2015
2015-09-10,Negeri Sembilan,54,33,21,2015
2015-09-11,Negeri Sembilan,12,1,11,2015
2015-09-12,Negeri Sembilan,93,38,55,2015
2015-09-13,Negeri Sembilan,88,49,39,2015
2015-09-14,Negeri Sembilan,33,19,14,2015
2015-09-15,Negeri Sembilan,113,37,76,2015
2015-09-16,Negeri Sembilan,133,50,83,2015
2015-09-17,Negeri Sembilan,92,44,48,2015
2015-09-18,Negeri Sembilan,15,2,13,2015
2015-09-19,Negeri Sembilan,53,23,30,2015
2015-09-20,Negeri Sembilan,138,20,118,2015
2015-09-21,Negeri Sembilan,88,34,54,2015
2015-09-22,Negeri Sembilan,16,3,13,2015
2015-09-23,Negeri Sembilan,11,1,10,2015
2015-09-24,Negeri Sembilan,0,0,0,2015
2015-09-25,Negeri Sembilan,18,2,16,2015
2015-09-26,Negeri Sembilan,59,32,27,2015
2015-09-27,Negeri Sembilan,25,12,13,2015
2015-09-28,Negeri Sembilan,8,1,7,2015
2015-09-29,Negeri Sembilan,104,35,69,2015
2015-09-30,Negeri Sembilan,62,19,43,2015
2015-10-01,Negeri Sembilan,78,28,50,2015
2015-10-02,Negeri Sembilan,11,2,9,2015
2015-10-03,Negeri Sembilan,10,1,9,2015
2015-10-04,Negeri Sembilan,104,43,61,2015
2015-10-05,Negeri Sembilan,16,0,16,2015
2015-10-06,Negeri Sembilan,9,0,9,2015
2015-10-07,Negeri Sembilan,109,50,59,2015
2015-10-08,Negeri Sembilan,39,17,22,2015
2015-10-09,Negeri Sembilan,176,80,96,2015
2015-10-10,Negeri Sembilan,0,0,0,2015
2015-10-11,Negeri Sembilan,60,40,20,2015
2015-10-12,Negeri Sembilan,58,23,35,2015
2015-10-13,Negeri Sembilan,15,2,13,2015
2015-10-14,Negeri Sembilan,0,0,0,2015
2015-10-15,Negeri Sembilan,18,5,13,2015
2015-10-16,Negeri Sembilan,70,54,16,2015
2015-10-17,Negeri Sembilan,31,7,24,2015
2015-10-18,Negeri Sembilan,115,42,73,2015
2015-10-19,Negeri Sembilan,19,2,17,2015
2015-10-20,Negeri Sembilan,100,43,57,2015
2015-10-21,Negeri Sembilan,50,11,39,2015
2015-10-22,Negeri Sembilan,51,22,29,2015
2015-10-23,Negeri Sembilan,10,1,9,2015
2015-10-24,Negeri Sembilan,74,25,49,2015
2015-10-25,Negeri Sembilan,0,0,0,2015
2015-10-26,Negeri Sembilan,23,5,18,2015
2015-10-27,Negeri Sembilan,14,3,11,2015
2015-10-28,Negeri Sembilan,62,20,42,2015
2015-10-29,Negeri Sembilan,69,7,62,2015
2015-10-30,Negeri Sembilan,71,13,58,2015
2015-10-31,Negeri Sembilan,119,37,82,2015
2015-11-01,Negeri Sembilan,96,33,63,2015
2015-11-02,Negeri Sembilan,35,12,23,2015
2015-11-03,Negeri Sembilan,57,17,40,2015
2015-11-04,Negeri Sembilan,71,24,47,2015
2015-11-05,Negeri Sembilan,35,10,25,2015
2015-11-06,Negeri Sembilan,50,27,23,2015
2015-11-07,Negeri Sembilan,21,2,19,2015
2015-11-08,Negeri Sembilan,52,15,37,2015
2015-11-09,Negeri Sembilan,22,1,21,2015
2015-11-10,Negeri Sembilan,0,0,0,2015
2015-11-11,Negeri Sembilan,77,30,47,2015
2015-11-12,Negeri Sembilan,92,46,46,2015
2015-11-13,Negeri Sembilan,94,47,47,2015
2015-11-14,Negeri Sembilan,46,22,24,2015
2015-11-15,Negeri Sembilan,0,0,0,2015
2015-11-16,Negeri Sembilan,13,1,12,2015
2015-11-17,Negeri Sembilan,120,27,93,2015
2015-11-18,Negeri Sembilan,26,3,23,2015
2015-11-19,Negeri Sembilan,26,11,15,2015
2015-11-20,Negeri Sembilan,29,8,21,2015
2015-11-21,Negeri Sembilan,0,0,0,2015
2015-11-22,Negeri Sembilan,34,19,15,2015
2015-11-23,Negeri Sembilan,24,3,21,2015
2015-11-24,Negeri Sembilan,16,0,16,2015
2015-11-25,Negeri Sembilan,70,28,42,2015
2015-11-26,Negeri Sembilan,31,14,17,2015
2015-11-27,Negeri Sembilan,18,7,11,2015
2015-11-28,Negeri Sembilan,78,31,47,2015
2015-11-29,Negeri Sembilan,131,36,95,2015
2015-11-30,Negeri Sembilan,13,0,13,2015
2015-12-01,Negeri Sembilan,61,28,33,2015
2015-12-02,Negeri Sembilan,89,19,70,2015
2015-12-03,Negeri Sembilan,11,2,9,2015
2015-12-04,Negeri Sembilan,15,2,13,2015
2015-12-05,Negeri Sembilan,13,3,10,2015
2015-12-06,Negeri Sembilan,54,25,29,2015
2015-12-07,Negeri Sembilan,11,0,11,2015
2015-12-08,Negeri Sembilan,92,47,45,2015
2015-12-09,Negeri Sembilan,60,24,36,2015
2015-12-10,Negeri Sembilan,91,27,64,2015
2015-12-11,Negeri Sembilan,65,19,46,2015
2015-12-12,Negeri Sembilan,150,60,90,2015
2015-12-13,Negeri Sembilan,115,29,86,2015
2015-12-14,Negeri Sembilan,16,0,16,2015
2015-12-15,Negeri Sembilan,62,23,39,2015
2015-12-16,Negeri Sembilan,47,17,30,2015
2015-12-17,Negeri Sembilan,55,17,38,2015
2015-12-18,Negeri Sembilan,16,0,16,2015
2015-12-19,Negeri Sembilan,259,250,9,2015
2015-12-20,Negeri Sembilan,0,0,0,2015
2015-12-21,Negeri Sembilan,30,5,25,2015
2015-12-22,Negeri Sembilan,54,6,48,2015
2015-12-23,Negeri Sembilan,56,4,52,2015
2015-12-24,Negeri Sembilan,0,0,0,2015
2015-12-25,Negeri Sembilan,0,0,0,2015
2015-12-26,Negeri Sembilan,0,0,0,2015
2015-12-27,Negeri Sembilan,25,8,17,2015
2015-12-28,Negeri Sembilan,38,6,32,2015
2015-12-29,Negeri Sembilan,10,2,8,2015
2015-12-30,Negeri Sembilan,21,3,18,2015
2015-12-31,Negeri Sembilan,48,14,34,2015
2016-01-01,Negeri Sembilan,0,0,0,2016
2016-01-02,Negeri Sembilan,13,4,9,2016
2016-01-03,Negeri Sembilan,0,0,0,2016
2016-01-04,Negeri Sembilan,102,15,87,2016
2016-01-05,Negeri Sembilan,15,2,13,2016
2016-01-06,Negeri Sembilan,26,3,23,2016
2016-01-07,Negeri Sembilan,7,0,7,2016
2016-01-08,Negeri Sembilan,34,9,25,2016
2016-01-09,Negeri Sembilan,29,5,24,2016
2016-01-10,Negeri Sembilan,176,57,119,2016
2016-01-11,Negeri Sembilan,14,1,13,2016
2016-01-12,Negeri Sembilan,14,0,14,2016
2016-01-13,Negeri Sembilan,73,17,56,2016
2016-01-14,Negeri Sembilan,0,0,0,2016
2016-01-15,Negeri Sembilan,12,0,12,2016
2016-01-16,Negeri Sembilan,77,44,33,2016
2016-01-17,Negeri Sembilan,62,27,35,2016
2016-01-18,Negeri Sembilan,24,8,16,2016
2016-01-19,Negeri Sembilan,111,24,87,2016
2016-01-20,Negeri Sembilan,16,1,15,2016
2016-01-21,Negeri Sembilan,37,12,25,2016
2016-01-22,Negeri Sembilan,38,13,25,2016
2016-01-23,Negeri Sembilan,49,22,27,2016
2016-01-24,Negeri Sembilan,27,11,16,2016
2016-01-25,Negeri Sembilan,0,0,0,2016
2016-01-26,Negeri Sembilan,11,1,10,2016
2016-01-27,Negeri Sembilan,85,38,47,2016
2016-01-28,Negeri Sembilan,22,2,20,2016
2016-01-29,Negeri Sembilan,23,5,18,2016
2016-01-30,Negeri Sembilan,54,19,35,2016
2016-01-31,Negeri Sembilan,73,22,51,2016
2016-02-01,Negeri Sembilan,16,0,16,2016
2016-02-02,Negeri Sembilan,68,16,52,2016
2016-02-03,Negeri Sembilan,62,28,34,2016
2016-02-04,Negeri Sembilan,61,32,29,2016
2016-02-05,Negeri Sembilan,21,6,15,2016
2016-02-06,Negeri Sembilan,17,5,12,2016
2016-02-07,Negeri Sembilan,0,0,0,2016
2016-02-08,Negeri Sembilan,0,0,0,2016
2016-02-09,Negeri Sembilan,0,0,0,2016
2016-02-10,Negeri Sembilan,91,30,61,2016
2016-02-11,Negeri Sembilan,56,21,35,2016
2016-02-12,Negeri Sembilan,51,7,44,2016
2016-02-13,Negeri Sembilan,93,68,25,2016
2016-02-14,Negeri Sembilan,0,0,0,2016
2016-02-15,Negeri Sembilan,15,2,13,2016
2016-02-16,Negeri Sembilan,87,16,71,2016
2016-02-17,Negeri Sembilan,85,34,51,2016
2016-02-18,Negeri Sembilan,50,22,28,2016
2016-02-19,Negeri Sembilan,15,2,13,2016
2016-02-20,Negeri Sembilan,26,3,23,2016
2016-02-21,Negeri Sembilan,92,29,63,2016
2016-02-22,Negeri Sembilan,179,103,76,2016
2016-02-23,Negeri Sembilan,131,86,45,2016
2016-02-24,Negeri Sembilan,137,65,72,2016
2016-02-25,Negeri Sembilan,98,18,80,2016
2016-02-26,Negeri Sembilan,9,0,9,2016
2016-02-27,Negeri Sembilan,54,18,36,2016
2016-02-28,Negeri Sembilan,0,0,0,2016
2016-02-29,Negeri Sembilan,57,28,29,2016
2016-03-01,Negeri Sembilan,16,1,15,2016
2016-03-02,Negeri Sembilan,105,67,38,2016
2016-03-03,Negeri Sembilan,20,1,19,2016
2016-03-04,Negeri Sembilan,42,17,25,2016
2016-03-05,Negeri Sembilan,34,6,28,2016
2016-03-06,Negeri Sembilan,95,17,78,2016
2016-03-07,Negeri Sembilan,14,1,13,2016
2016-03-08,Negeri Sembilan,67,19,48,2016
2016-03-09,Negeri Sembilan,27,3,24,2016
2016-03-10,Negeri Sembilan,20,3,17,2016
2016-03-11,Negeri Sembilan,97,26,71,2016
2016-03-12,Negeri Sembilan,0,0,0,2016
2016-03-13,Negeri Sembilan,130,57,73,2016
2016-03-14,Negeri Sembilan,83,42,41,2016
2016-03-15,Negeri Sembilan,22,0,22,2016
2016-03-16,Negeri Sembilan,18,4,14,2016
2016-03-17,Negeri Sembilan,119,51,68,2016
2016-03-18,Negeri Sembilan,34,6,28,2016
2016-03-19,Negeri Sembilan,64,20,44,2016
2016-03-20,Negeri Sembilan,157,27,130,2016
2016-03-21,Negeri Sembilan,132,39,93,2016
2016-03-22,Negeri Sembilan,10,1,9,2016
2016-03-23,Negeri Sembilan,19,2,17,2016
2016-03-24,Negeri Sembilan,20,0,20,2016
2016-03-25,Negeri Sembilan,17,2,15,2016
2016-03-26,Negeri Sembilan,105,52,53,2016
2016-03-27,Negeri Sembilan,57,22,35,2016
2016-03-28,Negeri Sembilan,83,33,50,2016
2016-03-29,Negeri Sembilan,83,34,49,2016
2016-03-30,Negeri Sembilan,125,73,52,2016
2016-03-31,Negeri Sembilan,91,67,24,2016
2016-04-01,Negeri Sembilan,34,13,21,2016
2016-04-02,Negeri Sembilan,107,44,63,2016
2016-04-03,Negeri Sembilan,0,0,0,2016
2016-04-04,Negeri Sembilan,59,14,45,2016
2016-04-05,Negeri Sembilan,84,23,61,2016
2016-04-06,Negeri Sembilan,108,29,79,2016
2016-04-07,Negeri Sembilan,104,28,76,2016
2016-04-08,Negeri Sembilan,8,0,8,2016
2016-04-09,Negeri Sembilan,0,0,0,2016
2016-04-10,Negeri Sembilan,195,37,158,2016
2016-04-11,Negeri Sembilan,16,2,14,2016
2016-04-12,Negeri Sembilan,14,1,13,2016
2016-04-13,Negeri Sembilan,126,58,68,2016
2016-04-14,Negeri Sembilan,84,31,53,2016
2016-04-15,Negeri Sembilan,22,4,18,2016
2016-04-16,Negeri Sembilan,45,20,25,2016
2016-04-17,Negeri Sembilan,0,0,0,2016
2016-04-18,Negeri Sembilan,107,53,54,2016
2016-04-19,Negeri Sembilan,73,22,51,2016
2016-04-20,Negeri Sembilan,50,9,41,2016
2016-04-21,Negeri Sembilan,99,40,59,2016
2016-04-22,Negeri Sembilan,28,3,25,2016
2016-04-23,Negeri Sembilan,46,21,25,2016
2016-04-24,Negeri Sembilan,94,26,68,2016
2016-04-25,Negeri Sembilan,103,34,69,2016
2016-04-26,Negeri Sembilan,41,6,35,2016
2016-04-27,Negeri Sembilan,55,20,35,2016
2016-04-28,Negeri Sembilan,59,17,42,2016
2016-04-29,Negeri Sembilan,18,0,18,2016
2016-04-30,Negeri Sembilan,0,0,0,2016
2016-05-01,Negeri Sembilan,168,50,118,2016
2016-05-02,Negeri Sembilan,0,0,0,2016
2016-05-03,Negeri Sembilan,18,7,11,2016
2016-05-04,Negeri Sembilan,12,1,11,2016
2016-05-05,Negeri Sembilan,0,0,0,2016
2016-05-06,Negeri Sembilan,26,7,19,2016
2016-05-07,Negeri Sembilan,59,21,38,2016
2016-05-08,Negeri Sembilan,31,29,2,2016
2016-05-09,Negeri Sembilan,21,3,18,2016
2016-05-10,Negeri Sembilan,68,9,59,2016
2016-05-11,Negeri Sembilan,86,48,38,2016
2016-05-12,Negeri Sembilan,57,16,41,2016
2016-05-13,Negeri Sembilan,47,16,31,2016
2016-05-14,Negeri Sembilan,0,0,0,2016
2016-05-15,Negeri Sembilan,61,17,44,2016
2016-05-16,Negeri Sembilan,132,43,89,2016
2016-05-17,Negeri Sembilan,123,51,72,2016
2016-05-18,Negeri Sembilan,41,7,34,2016
2016-05-19,Negeri Sembilan,16,3,13,2016
2016-05-20,Negeri Sembilan,16,2,14,2016
2016-05-21,Negeri Sembilan,30,21,9,2016
2016-05-22,Negeri Sembilan,79,19,60,2016
2016-05-23,Negeri Sembilan,98,42,56,2016
2016-05-24,Negeri Sembilan,57,18,39,2016
2016-05-25,Negeri Sembilan,14,1,13,2016
2016-05-26,Negeri Sembilan,16,1,15,2016
2016-05-27,Negeri Sembilan,65,34,31,2016
2016-05-28,Negeri Sembilan,103,32,71,2016
2016-05-29,Negeri Sembilan,0,0,0,2016
2016-05-30,Negeri Sembilan,21,3,18,2016
2016-05-31,Negeri Sembilan,54,20,34,2016
2016-06-01,Negeri Sembilan,11,2,9,2016
2016-06-02,Negeri Sembilan,54,28,26,2016
2016-06-03,Negeri Sembilan,26,8,18,2016
2016-06-04,Negeri Sembilan,151,60,91,2016
2016-06-05,Negeri Sembilan,170,69,101,2016
2016-06-06,Negeri Sembilan,15,3,12,2016
2016-06-07,Negeri Sembilan,15,4,11,2016
2016-06-08,Negeri Sembilan,26,8,18,2016
2016-06-09,Negeri Sembilan,9,0,9,2016
2016-06-10,Negeri Sembilan,16,3,13,2016
2016-06-11,Negeri Sembilan,0,0,0,2016
2016-06-12,Negeri Sembilan,32,8,24,2016
2016-06-13,Negeri Sembilan,5,0,5,2016
2016-06-14,Negeri Sembilan,14,3,11,2016
2016-06-15,Negeri Sembilan,7,2,5,2016
2016-06-16,Negeri Sembilan,6,0,6,2016
2016-06-17,Negeri Sembilan,2,0,2,2016
2016-06-18,Negeri Sembilan,90,26,64,2016
2016-06-19,Negeri Sembilan,0,0,0,2016
2016-06-20,Negeri Sembilan,16,2,14,2016
2016-06-21,Negeri Sembilan,5,0,5,2016
2016-06-22,Negeri Sembilan,35,12,23,2016
2016-06-23,Negeri Sembilan,7,2,5,2016
2016-06-24,Negeri Sembilan,7,0,7,2016
2016-06-25,Negeri Sembilan,20,10,10,2016
2016-06-26,Negeri Sembilan,58,13,45,2016
2016-06-27,Negeri Sembilan,21,6,15,2016
2016-06-28,Negeri Sembilan,19,6,13,2016
2016-06-29,Negeri Sembilan,14,4,10,2016
2016-06-30,Negeri Sembilan,58,30,28,2016
2016-07-01,Negeri Sembilan,15,3,12,2016
2016-07-02,Negeri Sembilan,5,1,4,2016
2016-07-03,Negeri Sembilan,49,2,47,2016
2016-07-04,Negeri Sembilan,30,12,18,2016
2016-07-05,Negeri Sembilan,20,14,6,2016
2016-07-06,Negeri Sembilan,0,0,0,2016
2016-07-07,Negeri Sembilan,0,0,0,2016
2016-07-08,Negeri Sembilan,0,0,0,2016
2016-07-09,Negeri Sembilan,67,31,36,2016
2016-07-10,Negeri Sembilan,155,30,125,2016
2016-07-11,Negeri Sembilan,23,3,20,2016
2016-07-12,Negeri Sembilan,84,32,52,2016
2016-07-13,Negeri Sembilan,80,44,36,2016
2016-07-14,Negeri Sembilan,20,2,18,2016
2016-07-15,Negeri Sembilan,78,31,47,2016
2016-07-16,Negeri Sembilan,40,18,22,2016
2016-07-17,Negeri Sembilan,124,20,104,2016
2016-07-18,Negeri Sembilan,53,21,32,2016
2016-07-19,Negeri Sembilan,43,11,32,2016
2016-07-20,Negeri Sembilan,47,8,39,2016
2016-07-21,Negeri Sembilan,76,46,30,2016
2016-07-22,Negeri Sembilan,22,1,21,2016
2016-07-23,Negeri Sembilan,116,43,73,2016
2016-07-24,Negeri Sembilan,6,3,3,2016
2016-07-25,Negeri Sembilan,114,35,79,2016
2016-07-26,Negeri Sembilan,143,62,81,2016
2016-07-27,Negeri Sembilan,20,1,19,2016
2016-07-28,Negeri Sembilan,19,1,18,2016
2016-07-29,Negeri Sembilan,35,14,21,2016
2016-07-30,Negeri Sembilan,32,20,12,2016
2016-07-31,Negeri Sembilan,77,15,62,2016
2016-08-01,Negeri Sembilan,12,2,10,2016
2016-08-02,Negeri Sembilan,23,3,20,2016
2016-08-03,Negeri Sembilan,109,31,78,2016
2016-08-04,Negeri Sembilan,24,2,22,2016
2016-08-05,Negeri Sembilan,20,2,18,2016
2016-08-06,Negeri Sembilan,113,18,95,2016
2016-08-07,Negeri Sembilan,94,15,79,2016
2016-08-08,Negeri Sembilan,73,23,50,2016
2016-08-09,Negeri Sembilan,70,34,36,2016
2016-08-10,Negeri Sembilan,57,19,38,2016
2016-08-11,Negeri Sembilan,11,0,11,2016
2016-08-12,Negeri Sembilan,15,1,14,2016
2016-08-13,Negeri Sembilan,58,19,39,2016
2016-08-14,Negeri Sembilan,50,21,29,2016
2016-08-15,Negeri Sembilan,21,3,18,2016
2016-08-16,Negeri Sembilan,67,20,47,2016
2016-08-17,Negeri Sembilan,53,16,37,2016
2016-08-18,Negeri Sembilan,38,9,29,2016
2016-08-19,Negeri Sembilan,15,2,13,2016
2016-08-20,Negeri Sembilan,119,49,70,2016
2016-08-21,Negeri Sembilan,140,20,120,2016
2016-08-22,Negeri Sembilan,23,3,20,2016
2016-08-23,Negeri Sembilan,22,4,18,2016
2016-08-24,Negeri Sembilan,128,48,80,2016
2016-08-25,Negeri Sembilan,90,32,58,2016
2016-08-26,Negeri Sembilan,70,23,47,2016
2016-08-27,Negeri Sembilan,118,52,66,2016
2016-08-28,Negeri Sembilan,0,0,0,2016
2016-08-29,Negeri Sembilan,53,12,41,2016
2016-08-30,Negeri Sembilan,29,9,20,2016
2016-08-31,Negeri Sembilan,41,32,9,2016
2016-09-01,Negeri Sembilan,82,26,56,2016
2016-09-02,Negeri Sembilan,16,1,15,2016
2016-09-03,Negeri Sembilan,107,78,29,2016
2016-09-04,Negeri Sembilan,118,34,84,2016
2016-09-05,Negeri Sembilan,36,5,31,2016
2016-09-06,Negeri Sembilan,70,9,61,2016
2016-09-07,Negeri Sembilan,71,50,21,2016
2016-09-08,Negeri Sembilan,66,29,37,2016
2016-09-09,Negeri Sembilan,88,50,38,2016
2016-09-10,Negeri Sembilan,0,0,0,2016
2016-09-11,Negeri Sembilan,124,16,108,2016
2016-09-12,Negeri Sembilan,0,0,0,2016
2016-09-13,Negeri Sembilan,19,3,16,2016
2016-09-14,Negeri Sembilan,22,1,21,2016
2016-09-15,Negeri Sembilan,110,30,80,2016
2016-09-16,Negeri Sembilan,40,23,17,2016
2016-09-17,Negeri Sembilan,0,0,0,2016
2016-09-18,Negeri Sembilan,29,17,12,2016
2016-09-19,Negeri Sembilan,47,12,35,2016
2016-09-20,Negeri Sembilan,67,34,33,2016
2016-09-21,Negeri Sembilan,76,21,55,2016
2016-09-22,Negeri Sembilan,46,10,36,2016
2016-09-23,Negeri Sembilan,56,19,37,2016
2016-09-24,Negeri Sembilan,32,8,24,2016
2016-09-25,Negeri Sembilan,0,0,0,2016
2016-09-26,Negeri Sembilan,17,0,17,2016
2016-09-27,Negeri Sembilan,41,20,21,2016
2016-09-28,Negeri Sembilan,50,21,29,2016
2016-09-29,Negeri Sembilan,96,58,38,2016
2016-09-30,Negeri Sembilan,16,2,14,2016
2016-10-01,Negeri Sembilan,45,20,25,2016
2016-10-02,Negeri Sembilan,118,44,74,2016
2016-10-03,Negeri Sembilan,0,0,0,2016
2016-10-04,Negeri Sembilan,47,8,39,2016
2016-10-05,Negeri Sembilan,87,44,43,2016
2016-10-06,Negeri Sembilan,24,4,20,2016
2016-10-07,Negeri Sembilan,9,1,8,2016
2016-10-08,Negeri Sembilan,58,24,34,2016
2016-10-09,Negeri Sembilan,109,26,83,2016
2016-10-10,Negeri Sembilan,17,0,17,2016
2016-10-11,Negeri Sembilan,14,0,14,2016
2016-10-12,Negeri Sembilan,72,23,49,2016
2016-10-13,Negeri Sembilan,87,31,56,2016
2016-10-14,Negeri Sembilan,16,3,13,2016
2016-10-15,Negeri Sembilan,0,0,0,2016
2016-10-16,Negeri Sembilan,142,20,122,2016
2016-10-17,Negeri Sembilan,15,2,13,2016
2016-10-18,Negeri Sembilan,16,3,13,2016
2016-10-19,Negeri Sembilan,90,44,46,2016
2016-10-20,Negeri Sembilan,12,2,10,2016
2016-10-21,Negeri Sembilan,21,2,19,2016
2016-10-22,Negeri Sembilan,88,28,60,2016
2016-10-23,Negeri Sembilan,141,62,79,2016
2016-10-24,Negeri Sembilan,20,0,20,2016
2016-10-25,Negeri Sembilan,35,9,26,2016
2016-10-26,Negeri Sembilan,12,0,12,2016
2016-10-27,Negeri Sembilan,8,1,7,2016
2016-10-28,Negeri Sembilan,17,3,14,2016
2016-10-29,Negeri Sembilan,0,0,0,2016
2016-10-30,Negeri Sembilan,80,8,72,2016
2016-10-31,Negeri Sembilan,10,1,9,2016
2016-11-01,Negeri Sembilan,15,2,13,2016
2016-11-02,Negeri Sembilan,9,1,8,2016
2016-11-03,Negeri Sembilan,54,14,40,2016
2016-11-04,Negeri Sembilan,45,12,33,2016
2016-11-05,Negeri Sembilan,0,0,0,2016
2016-11-06,Negeri Sembilan,0,0,0,2016
2016-11-07,Negeri Sembilan,79,21,58,2016
2016-11-08,Negeri Sembilan,97,25,72,2016
2016-11-09,Negeri Sembilan,39,8,31,2016
2016-11-10,Negeri Sembilan,46,9,37,2016
2016-11-11,Negeri Sembilan,91,65,26,2016
2016-11-12,Negeri Sembilan,81,39,42,2016
2016-11-13,Negeri Sembilan,141,33,108,2016
2016-11-14,Negeri Sembilan,20,1,19,2016
2016-11-15,Negeri Sembilan,78,29,49,2016
2016-11-16,Negeri Sembilan,68,19,49,2016
2016-11-17,Negeri Sembilan,14,0,14,2016
2016-11-18,Negeri Sembilan,21,2,19,2016
2016-11-19,Negeri Sembilan,0,0,0,2016
2016-11-20,Negeri Sembilan,114,44,70,2016
2016-11-21,Negeri Sembilan,16,1,15,2016
2016-11-22,Negeri Sembilan,31,4,27,2016
2016-11-23,Negeri Sembilan,64,19,45,2016
2016-11-24,Negeri Sembilan,58,20,38,2016
2016-11-25,Negeri Sembilan,11,0,11,2016
2016-11-26,Negeri Sembilan,69,36,33,2016
2016-11-27,Negeri Sembilan,59,6,53,2016
2016-11-28,Negeri Sembilan,15,2,13,2016
2016-11-29,Negeri Sembilan,88,46,42,2016
2016-11-30,Negeri Sembilan,84,35,49,2016
2016-12-01,Negeri Sembilan,70,21,49,2016
2016-12-02,Negeri Sembilan,18,0,18,2016
2016-12-03,Negeri Sembilan,77,26,51,2016
2016-12-04,Negeri Sembilan,0,0,0,2016
2016-12-05,Negeri Sembilan,21,4,17,2016
2016-12-06,Negeri Sembilan,96,23,73,2016
2016-12-07,Negeri Sembilan,151,47,104,2016
2016-12-08,Negeri Sembilan,100,38,62,2016
2016-12-09,Negeri Sembilan,11,2,9,2016
2016-12-10,Negeri Sembilan,31,9,22,2016
2016-12-11,Negeri Sembilan,0,0,0,2016
2016-12-12,Negeri Sembilan,54,20,34,2016
2016-12-13,Negeri Sembilan,37,9,28,2016
2016-12-14,Negeri Sembilan,12,1,11,2016
2016-12-15,Negeri Sembilan,15,0,15,2016
2016-12-16,Negeri Sembilan,16,1,15,2016
2016-12-17,Negeri Sembilan,155,37,118,2016
2016-12-18,Negeri Sembilan,0,0,0,2016
2016-12-19,Negeri Sembilan,39,6,33,2016
2016-12-20,Negeri Sembilan,64,7,57,2016
2016-12-21,Negeri Sembilan,23,3,20,2016
2016-12-22,Negeri Sembilan,9,1,8,2016
2016-12-23,Negeri Sembilan,32,8,24,2016
2016-12-24,Negeri Sembilan,37,16,21,2016
2016-12-25,Negeri Sembilan,64,20,44,2016
2016-12-26,Negeri Sembilan,0,0,0,2016
2016-12-27,Negeri Sembilan,31,12,19,2016
2016-12-28,Negeri Sembilan,22,3,19,2016
2016-12-29,Negeri Sembilan,25,3,22,2016
2016-12-30,Negeri Sembilan,19,5,14,2016
2016-12-31,Negeri Sembilan,10,5,5,2016
2017-01-01,Negeri Sembilan,0,0,0,2017
2017-01-02,Negeri Sembilan,0,0,0,2017
2017-01-03,Negeri Sembilan,24,1,23,2017
2017-01-04,Negeri Sembilan,30,4,26,2017
2017-01-05,Negeri Sembilan,44,6,38,2017
2017-01-06,Negeri Sembilan,82,17,65,2017
2017-01-07,Negeri Sembilan,36,13,23,2017
2017-01-08,Negeri Sembilan,120,25,95,2017
2017-01-09,Negeri Sembilan,47,11,36,2017
2017-01-10,Negeri Sembilan,51,21,30,2017
2017-01-11,Negeri Sembilan,12,0,12,2017
2017-01-12,Negeri Sembilan,53,17,36,2017
2017-01-13,Negeri Sembilan,15,2,13,2017
2017-01-14,Negeri Sembilan,172,159,13,2017
2017-01-15,Negeri Sembilan,64,21,43,2017
2017-01-16,Negeri Sembilan,19,2,17,2017
2017-01-17,Negeri Sembilan,43,12,31,2017
2017-01-18,Negeri Sembilan,75,28,47,2017
2017-01-19,Negeri Sembilan,69,8,61,2017
2017-01-20,Negeri Sembilan,21,3,18,2017
2017-01-21,Negeri Sembilan,153,50,103,2017
2017-01-22,Negeri Sembilan,107,45,62,2017
2017-01-23,Negeri Sembilan,130,50,80,2017
2017-01-24,Negeri Sembilan,63,39,24,2017
2017-01-25,Negeri Sembilan,59,21,38,2017
2017-01-26,Negeri Sembilan,22,1,21,2017
2017-01-27,Negeri Sembilan,8,0,8,2017
2017-01-28,Negeri Sembilan,61,26,35,2017
2017-01-29,Negeri Sembilan,69,28,41,2017
2017-01-30,Negeri Sembilan,0,0,0,2017
2017-01-31,Negeri Sembilan,18,2,16,2017
2017-02-01,Negeri Sembilan,43,11,32,2017
2017-02-02,Negeri Sembilan,66,27,39,2017
2017-02-03,Negeri Sembilan,26,7,19,2017
2017-02-04,Negeri Sembilan,50,30,20,2017
2017-02-05,Negeri Sembilan,72,24,48,2017
2017-02-06,Negeri Sembilan,21,1,20,2017
2017-02-07,Negeri Sembilan,24,6,18,2017
2017-02-08,Negeri Sembilan,64,15,49,2017
2017-02-09,Negeri Sembilan,48,16,32,2017
2017-02-10,Negeri Sembilan,25,7,18,2017
2017-02-11,Negeri Sembilan,45,14,31,2017
2017-02-12,Negeri Sembilan,0,0,0,2017
2017-02-13,Negeri Sembilan,88,38,50,2017
2017-02-14,Negeri Sembilan,61,14,47,2017
2017-02-15,Negeri Sembilan,111,36,75,2017
2017-02-16,Negeri Sembilan,70,24,46,2017
2017-02-17,Negeri Sembilan,6,1,5,2017
2017-02-18,Negeri Sembilan,79,32,47,2017
2017-02-19,Negeri Sembilan,155,29,126,2017
2017-02-20,Negeri Sembilan,51,9,42,2017
2017-02-21,Negeri Sembilan,10,2,8,2017
2017-02-22,Negeri Sembilan,112,44,68,2017
2017-02-23,Negeri Sembilan,200,131,69,2017
2017-02-24,Negeri Sembilan,11,0,11,2017
2017-02-25,Negeri Sembilan,0,0,0,2017
2017-02-26,Negeri Sembilan,52,23,29,2017
2017-02-27,Negeri Sembilan,12,2,10,2017
2017-02-28,Negeri Sembilan,47,16,31,2017
2017-03-01,Negeri Sembilan,14,1,13,2017
2017-03-02,Negeri Sembilan,12,2,10,2017
2017-03-03,Negeri Sembilan,16,2,14,2017
2017-03-04,Negeri Sembilan,59,9,50,2017
2017-03-05,Negeri Sembilan,77,22,55,2017
2017-03-06,Negeri Sembilan,14,0,14,2017
2017-03-07,Negeri Sembilan,44,14,30,2017
2017-03-08,Negeri Sembilan,34,4,30,2017
2017-03-09,Negeri Sembilan,13,5,8,2017
2017-03-10,Negeri Sembilan,19,1,18,2017
2017-03-11,Negeri Sembilan,82,22,60,2017
2017-03-12,Negeri Sembilan,103,31,72,2017
2017-03-13,Negeri Sembilan,16,1,15,2017
2017-03-14,Negeri Sembilan,26,9,17,2017
2017-03-15,Negeri Sembilan,71,32,39,2017
2017-03-16,Negeri Sembilan,97,48,49,2017
2017-03-17,Negeri Sembilan,26,3,23,2017
2017-03-18,Negeri Sembilan,42,18,24,2017
2017-03-19,Negeri Sembilan,109,9,100,2017
2017-03-20,Negeri Sembilan,14,1,13,2017
2017-03-21,Negeri Sembilan,38,5,33,2017
2017-03-22,Negeri Sembilan,88,51,37,2017
2017-03-23,Negeri Sembilan,56,22,34,2017
2017-03-24,Negeri Sembilan,17,3,14,2017
2017-03-25,Negeri Sembilan,0,0,0,2017
2017-03-26,Negeri Sembilan,55,19,36,2017
2017-03-27,Negeri Sembilan,70,25,45,2017
2017-03-28,Negeri Sembilan,13,2,11,2017
2017-03-29,Negeri Sembilan,79,49,30,2017
2017-03-30,Negeri Sembilan,50,18,32,2017
2017-03-31,Negeri Sembilan,13,2,11,2017
2017-04-01,Negeri Sembilan,53,15,38,2017
2017-04-02,Negeri Sembilan,150,49,101,2017
2017-04-03,Negeri Sembilan,24,0,24,2017
2017-04-04,Negeri Sembilan,17,2,15,2017
2017-04-05,Negeri Sembilan,59,22,37,2017
2017-04-06,Negeri Sembilan,19,1,18,2017
2017-04-07,Negeri Sembilan,22,5,17,2017
2017-04-08,Negeri Sembilan,14,4,10,2017
2017-04-09,Negeri Sembilan,74,27,47,2017
2017-04-10,Negeri Sembilan,21,2,19,2017
2017-04-11,Negeri Sembilan,92,34,58,2017
2017-04-12,Negeri Sembilan,75,38,37,2017
2017-04-13,Negeri Sembilan,12,2,10,2017
2017-04-14,Negeri Sembilan,75,13,62,2017
2017-04-15,Negeri Sembilan,0,0,0,2017
2017-04-16,Negeri Sembilan,87,29,58,2017
2017-04-17,Negeri Sembilan,32,14,18,2017
2017-04-18,Negeri Sembilan,21,3,18,2017
2017-04-19,Negeri Sembilan,132,118,14,2017
2017-04-20,Negeri Sembilan,11,1,10,2017
2017-04-21,Negeri Sembilan,20,4,16,2017
2017-04-22,Negeri Sembilan,106,32,74,2017
2017-04-23,Negeri Sembilan,104,28,76,2017
2017-04-24,Negeri Sembilan,0,0,0,2017
2017-04-25,Negeri Sembilan,0,0,0,2017
2017-04-26,Negeri Sembilan,32,9,23,2017
2017-04-27,Negeri Sembilan,10,0,10,2017
2017-04-28,Negeri Sembilan,18,1,17,2017
2017-04-29,Negeri Sembilan,0,0,0,2017
2017-04-30,Negeri Sembilan,0,0,0,2017
2017-05-01,Negeri Sembilan,106,38,68,2017
2017-05-02,Negeri Sembilan,126,49,77,2017
2017-05-03,Negeri Sembilan,53,16,37,2017
2017-05-04,Negeri Sembilan,50,18,32,2017
2017-05-05,Negeri Sembilan,18,2,16,2017
2017-05-06,Negeri Sembilan,43,24,19,2017
2017-05-07,Negeri Sembilan,62,23,39,2017
2017-05-08,Negeri Sembilan,81,29,52,2017
2017-05-09,Negeri Sembilan,90,44,46,2017
2017-05-10,Negeri Sembilan,0,0,0,2017
2017-05-11,Negeri Sembilan,129,54,75,2017
2017-05-12,Negeri Sembilan,9,2,7,2017
2017-05-13,Negeri Sembilan,80,16,64,2017
2017-05-14,Negeri Sembilan,173,48,125,2017
2017-05-15,Negeri Sembilan,104,35,69,2017
2017-05-16,Negeri Sembilan,68,17,51,2017
2017-05-17,Negeri Sembilan,112,64,48,2017
2017-05-18,Negeri Sembilan,17,4,13,2017
2017-05-19,Negeri Sembilan,91,20,71,2017
2017-05-20,Negeri Sembilan,119,45,74,2017
2017-05-21,Negeri Sembilan,122,45,77,2017
2017-05-22,Negeri Sembilan,30,6,24,2017
2017-05-23,Negeri Sembilan,15,3,12,2017
2017-05-24,Negeri Sembilan,22,3,19,2017
2017-05-25,Negeri Sembilan,17,1,16,2017
2017-05-26,Negeri Sembilan,27,2,25,2017
2017-05-27,Negeri Sembilan,0,0,0,2017
2017-05-28,Negeri Sembilan,116,25,91,2017
2017-05-29,Negeri Sembilan,11,1,10,2017
2017-05-30,Negeri Sembilan,11,2,9,2017
2017-05-31,Negeri Sembilan,9,1,8,2017
2017-06-01,Negeri Sembilan,44,9,35,2017
2017-06-02,Negeri Sembilan,8,1,7,2017
2017-06-03,Negeri Sembilan,9,3,6,2017
2017-06-04,Negeri Sembilan,39,14,25,2017
2017-06-05,Negeri Sembilan,7,0,7,2017
2017-06-06,Negeri Sembilan,15,1,14,2017
2017-06-07,Negeri Sembilan,20,11,9,2017
2017-06-08,Negeri Sembilan,14,1,13,2017
2017-06-09,Negeri Sembilan,10,1,9,2017
2017-06-10,Negeri Sembilan,2,0,2,2017
2017-06-11,Negeri Sembilan,88,18,70,2017
2017-06-12,Negeri Sembilan,18,2,16,2017
2017-06-13,Negeri Sembilan,10,3,7,2017
2017-06-14,Negeri Sembilan,72,59,13,2017
2017-06-15,Negeri Sembilan,9,1,8,2017
2017-06-16,Negeri Sembilan,3,1,2,2017
2017-06-17,Negeri Sembilan,46,15,31,2017
2017-06-18,Negeri Sembilan,99,19,80,2017
2017-06-19,Negeri Sembilan,12,1,11,2017
2017-06-20,Negeri Sembilan,45,14,31,2017
2017-06-21,Negeri Sembilan,23,6,17,2017
2017-06-22,Negeri Sembilan,46,11,35,2017
2017-06-23,Negeri Sembilan,6,1,5,2017
2017-06-24,Negeri Sembilan,0,0,0,2017
2017-06-25,Negeri Sembilan,0,0,0,2017
2017-06-26,Negeri Sembilan,0,0,0,2017
2017-06-27,Negeri Sembilan,0,0,0,2017
2017-06-28,Negeri Sembilan,45,12,33,2017
2017-06-29,Negeri Sembilan,14,2,12,2017
2017-06-30,Negeri Sembilan,16,3,13,2017
2017-07-01,Negeri Sembilan,0,0,0,2017
2017-07-02,Negeri Sembilan,69,23,46,2017
2017-07-03,Negeri Sembilan,62,22,40,2017
2017-07-04,Negeri Sembilan,117,19,98,2017
2017-07-05,Negeri Sembilan,147,13,134,2017
2017-07-06,Negeri Sembilan,24,4,20,2017
2017-07-07,Negeri Sembilan,18,0,18,2017
2017-07-08,Negeri Sembilan,0,0,0,2017
2017-07-09,Negeri Sembilan,29,15,14,2017
2017-07-10,Negeri Sembilan,43,13,30,2017
2017-07-11,Negeri Sembilan,57,12,45,2017
2017-07-12,Negeri Sembilan,23,4,19,2017
2017-07-13,Negeri Sembilan,132,29,103,2017
2017-07-14,Negeri Sembilan,56,22,34,2017
2017-07-15,Negeri Sembilan,79,27,52,2017
2017-07-16,Negeri Sembilan,164,34,130,2017
2017-07-17,Negeri Sembilan,63,15,48,2017
2017-07-18,Negeri Sembilan,21,2,19,2017
2017-07-19,Negeri Sembilan,81,14,67,2017
2017-07-20,Negeri Sembilan,66,20,46,2017
2017-07-21,Negeri Sembilan,19,3,16,2017
2017-07-22,Negeri Sembilan,49,18,31,2017
2017-07-23,Negeri Sembilan,66,34,32,2017
2017-07-24,Negeri Sembilan,23,5,18,2017
2017-07-25,Negeri Sembilan,60,4,56,2017
2017-07-26,Negeri Sembilan,20,1,19,2017
2017-07-27,Negeri Sembilan,22,5,17,2017
2017-07-28,Negeri Sembilan,19,4,15,2017
2017-07-29,Negeri Sembilan,0,0,0,2017
2017-07-30,Negeri Sembilan,96,19,77,2017
2017-07-31,Negeri Sembilan,23,0,23,2017
2017-08-01,Negeri Sembilan,19,0,19,2017
2017-08-02,Negeri Sembilan,23,3,20,2017
2017-08-03,Negeri Sembilan,5,0,5,2017
2017-08-04,Negeri Sembilan,15,0,15,2017
2017-08-05,Negeri Sembilan,114,41,73,2017
2017-08-06,Negeri Sembilan,139,37,102,2017
2017-08-07,Negeri Sembilan,15,1,14,2017
2017-08-08,Negeri Sembilan,16,1,15,2017
2017-08-09,Negeri Sembilan,78,57,21,2017
2017-08-10,Negeri Sembilan,92,48,44,2017
2017-08-11,Negeri Sembilan,15,2,13,2017
2017-08-12,Negeri Sembilan,40,19,21,2017
2017-08-13,Negeri Sembilan,137,35,102,2017
2017-08-14,Negeri Sembilan,32,7,25,2017
2017-08-15,Negeri Sembilan,103,25,78,2017
2017-08-16,Negeri Sembilan,23,6,17,2017
2017-08-17,Negeri Sembilan,9,1,8,2017
2017-08-18,Negeri Sembilan,12,1,11,2017
2017-08-19,Negeri Sembilan,65,18,47,2017
2017-08-20,Negeri Sembilan,88,26,62,2017
2017-08-21,Negeri Sembilan,44,26,18,2017
2017-08-22,Negeri Sembilan,23,4,19,2017
2017-08-23,Negeri Sembilan,18,2,16,2017
2017-08-24,Negeri Sembilan,60,36,24,2017
2017-08-25,Negeri Sembilan,8,0,8,2017
2017-08-26,Negeri Sembilan,23,8,15,2017
2017-08-27,Negeri Sembilan,121,39,82,2017
2017-08-28,Negeri Sembilan,14,3,11,2017
2017-08-29,Negeri Sembilan,23,4,19,2017
2017-08-30,Negeri Sembilan,14,1,13,2017
2017-08-31,Negeri Sembilan,0,0,0,2017
2017-09-01,Negeri Sembilan,0,0,0,2017
2017-09-02,Negeri Sembilan,18,7,11,2017
2017-09-03,Negeri Sembilan,19,9,10,2017
2017-09-04,Negeri Sembilan,1,0,1,2017
2017-09-05,Negeri Sembilan,12,0,12,2017
2017-09-06,Negeri Sembilan,107,47,60,2017
2017-09-07,Negeri Sembilan,29,7,22,2017
2017-09-08,Negeri Sembilan,26,1,25,2017
2017-09-09,Negeri Sembilan,0,0,0,2017
2017-09-10,Negeri Sembilan,144,25,119,2017
2017-09-11,Negeri Sembilan,33,4,29,2017
2017-09-12,Negeri Sembilan,11,2,9,2017
2017-09-13,Negeri Sembilan,19,1,18,2017
2017-09-14,Negeri Sembilan,56,28,28,2017
2017-09-15,Negeri Sembilan,26,7,19,2017
2017-09-16,Negeri Sembilan,127,69,58,2017
2017-09-17,Negeri Sembilan,0,0,0,2017
2017-09-18,Negeri Sembilan,32,5,27,2017
2017-09-19,Negeri Sembilan,68,20,48,2017
2017-09-20,Negeri Sembilan,103,17,86,2017
2017-09-21,Negeri Sembilan,54,14,40,2017
2017-09-22,Negeri Sembilan,0,0,0,2017
2017-09-23,Negeri Sembilan,0,0,0,2017
2017-09-24,Negeri Sembilan,115,8,107,2017
2017-09-25,Negeri Sembilan,122,27,95,2017
2017-09-26,Negeri Sembilan,51,15,36,2017
2017-09-27,Negeri Sembilan,82,39,43,2017
2017-09-28,Negeri Sembilan,108,59,49,2017
2017-09-29,Negeri Sembilan,14,1,13,2017
2017-09-30,Negeri Sembilan,72,34,38,2017
2017-10-01,Negeri Sembilan,122,25,97,2017
2017-10-02,Negeri Sembilan,19,2,17,2017
2017-10-03,Negeri Sembilan,67,15,52,2017
2017-10-04,Negeri Sembilan,64,21,43,2017
2017-10-05,Negeri Sembilan,22,1,21,2017
2017-10-06,Negeri Sembilan,46,10,36,2017
2017-10-07,Negeri Sembilan,70,43,27,2017
2017-10-08,Negeri Sembilan,125,11,114,2017
2017-10-09,Negeri Sembilan,12,0,12,2017
2017-10-10,Negeri Sembilan,45,20,25,2017
2017-10-11,Negeri Sembilan,56,13,43,2017
2017-10-12,Negeri Sembilan,19,2,17,2017
2017-10-13,Negeri Sembilan,46,11,35,2017
2017-10-14,Negeri Sembilan,77,36,41,2017
2017-10-15,Negeri Sembilan,65,14,51,2017
2017-10-16,Negeri Sembilan,26,4,22,2017
2017-10-17,Negeri Sembilan,26,4,22,2017
2017-10-18,Negeri Sembilan,0,0,0,2017
2017-10-19,Negeri Sembilan,13,0,13,2017
2017-10-20,Negeri Sembilan,18,4,14,2017
2017-10-21,Negeri Sembilan,91,31,60,2017
2017-10-22,Negeri Sembilan,81,33,48,2017
2017-10-23,Negeri Sembilan,21,1,20,2017
2017-10-24,Negeri Sembilan,16,0,16,2017
2017-10-25,Negeri Sembilan,13,0,13,2017
2017-10-26,Negeri Sembilan,80,16,64,2017
2017-10-27,Negeri Sembilan,9,2,7,2017
2017-10-28,Negeri Sembilan,0,0,0,2017
2017-10-29,Negeri Sembilan,78,11,67,2017
2017-10-30,Negeri Sembilan,24,3,21,2017
2017-10-31,Negeri Sembilan,21,2,19,2017
2017-11-01,Negeri Sembilan,16,4,12,2017
2017-11-02,Negeri Sembilan,104,43,61,2017
2017-11-03,Negeri Sembilan,14,0,14,2017
2017-11-04,Negeri Sembilan,36,13,23,2017
2017-11-05,Negeri Sembilan,115,58,57,2017
2017-11-06,Negeri Sembilan,62,8,54,2017
2017-11-07,Negeri Sembilan,21,1,20,2017
2017-11-08,Negeri Sembilan,68,37,31,2017
2017-11-09,Negeri Sembilan,18,2,16,2017
2017-11-10,Negeri Sembilan,12,1,11,2017
2017-11-11,Negeri Sembilan,54,16,38,2017
2017-11-12,Negeri Sembilan,65,23,42,2017
2017-11-13,Negeri Sembilan,14,0,14,2017
2017-11-14,Negeri Sembilan,25,10,15,2017
2017-11-15,Negeri Sembilan,49,14,35,2017
2017-11-16,Negeri Sembilan,20,1,19,2017
2017-11-17,Negeri Sembilan,18,4,14,2017
2017-11-18,Negeri Sembilan,50,17,33,2017
2017-11-19,Negeri Sembilan,89,16,73,2017
2017-11-20,Negeri Sembilan,121,45,76,2017
2017-11-21,Negeri Sembilan,7,0,7,2017
2017-11-22,Negeri Sembilan,65,18,47,2017
2017-11-23,Negeri Sembilan,12,0,12,2017
2017-11-24,Negeri Sembilan,12,0,12,2017
2017-11-25,Negeri Sembilan,38,13,25,2017
2017-11-26,Negeri Sembilan,0,0,0,2017
2017-11-27,Negeri Sembilan,18,0,18,2017
2017-11-28,Negeri Sembilan,105,53,52,2017
2017-11-29,Negeri Sembilan,14,0,14,2017
2017-11-30,Negeri Sembilan,17,2,15,2017
2017-12-01,Negeri Sembilan,0,0,0,2017
2017-12-02,Negeri Sembilan,63,13,50,2017
2017-12-03,Negeri Sembilan,19,13,6,2017
2017-12-04,Negeri Sembilan,25,7,18,2017
2017-12-05,Negeri Sembilan,63,17,46,2017
2017-12-06,Negeri Sembilan,121,39,82,2017
2017-12-07,Negeri Sembilan,90,45,45,2017
2017-12-08,Negeri Sembilan,24,3,21,2017
2017-12-09,Negeri Sembilan,0,0,0,2017
2017-12-10,Negeri Sembilan,134,18,116,2017
2017-12-11,Negeri Sembilan,31,1,30,2017
2017-12-12,Negeri Sembilan,13,0,13,2017
2017-12-13,Negeri Sembilan,130,69,61,2017
2017-12-14,Negeri Sembilan,20,2,18,2017
2017-12-15,Negeri Sembilan,32,7,25,2017
2017-12-16,Negeri Sembilan,28,8,20,2017
2017-12-17,Negeri Sembilan,101,42,59,2017
2017-12-18,Negeri Sembilan,62,12,50,2017
2017-12-19,Negeri Sembilan,23,3,20,2017
2017-12-20,Negeri Sembilan,150,39,111,2017
2017-12-21,Negeri Sembilan,63,16,47,2017
2017-12-22,Negeri Sembilan,21,0,21,2017
2017-12-23,Negeri Sembilan,54,15,39,2017
2017-12-24,Negeri Sembilan,10,4,6,2017
2017-12-25,Negeri Sembilan,0,0,0,2017
2017-12-26,Negeri Sembilan,13,0,13,2017
2017-12-27,Negeri Sembilan,40,10,30,2017
2017-12-28,Negeri Sembilan,64,38,26,2017
2017-12-29,Negeri Sembilan,16,1,15,2017
2017-12-30,Negeri Sembilan,91,33,58,2017
2017-12-31,Negeri Sembilan,0,0,0,2017
2018-01-01,Negeri Sembilan,0,0,0,2018
2018-01-02,Negeri Sembilan,42,4,38,2018
2018-01-03,Negeri Sembilan,153,57,96,2018
2018-01-04,Negeri Sembilan,139,14,125,2018
2018-01-05,Negeri Sembilan,15,0,15,2018
2018-01-06,Negeri Sembilan,0,0,0,2018
2018-01-07,Negeri Sembilan,42,15,27,2018
2018-01-08,Negeri Sembilan,16,2,14,2018
2018-01-09,Negeri Sembilan,19,1,18,2018
2018-01-10,Negeri Sembilan,79,39,40,2018
2018-01-11,Negeri Sembilan,48,14,34,2018
2018-01-12,Negeri Sembilan,14,0,14,2018
2018-01-13,Negeri Sembilan,80,33,47,2018
2018-01-14,Negeri Sembilan,80,30,50,2018
2018-01-15,Negeri Sembilan,0,0,0,2018
2018-01-16,Negeri Sembilan,46,9,37,2018
2018-01-17,Negeri Sembilan,36,8,28,2018
2018-01-18,Negeri Sembilan,28,3,25,2018
2018-01-19,Negeri Sembilan,17,1,16,2018
2018-01-20,Negeri Sembilan,86,18,68,2018
2018-01-21,Negeri Sembilan,104,32,72,2018
2018-01-22,Negeri Sembilan,22,4,18,2018
2018-01-23,Negeri Sembilan,21,2,19,2018
2018-01-24,Negeri Sembilan,100,43,57,2018
2018-01-25,Negeri Sembilan,15,3,12,2018
2018-01-26,Negeri Sembilan,34,11,23,2018
2018-01-27,Negeri Sembilan,46,13,33,2018
2018-01-28,Negeri Sembilan,0,0,0,2018
2018-01-29,Negeri Sembilan,22,2,20,2018
2018-01-30,Negeri Sembilan,163,71,92,2018
2018-01-31,Negeri Sembilan,0,0,0,2018
2018-02-01,Negeri Sembilan,135,50,85,2018
2018-02-02,Negeri Sembilan,25,3,22,2018
2018-02-03,Negeri Sembilan,46,36,10,2018
2018-02-04,Negeri Sembilan,68,34,34,2018
2018-02-05,Negeri Sembilan,19,3,16,2018
2018-02-06,Negeri Sembilan,51,13,38,2018
2018-02-07,Negeri Sembilan,23,0,23,2018
2018-02-08,Negeri Sembilan,82,17,65,2018
2018-02-09,Negeri Sembilan,17,0,17,2018
2018-02-10,Negeri Sembilan,92,40,52,2018
2018-02-11,Negeri Sembilan,71,20,51,2018
2018-02-12,Negeri Sembilan,131,82,49,2018
2018-02-13,Negeri Sembilan,35,7,28,2018
2018-02-14,Negeri Sembilan,113,71,42,2018
2018-02-15,Negeri Sembilan,31,4,27,2018
2018-02-16,Negeri Sembilan,0,0,0,2018
2018-02-17,Negeri Sembilan,0,0,0,2018
2018-02-18,Negeri Sembilan,10,2,8,2018
2018-02-19,Negeri Sembilan,27,1,26,2018
2018-02-20,Negeri Sembilan,73,8,65,2018
2018-02-21,Negeri Sembilan,80,21,59,2018
2018-02-22,Negeri Sembilan,25,1,24,2018
2018-02-23,Negeri Sembilan,15,1,14,2018
2018-02-24,Negeri Sembilan,52,15,37,2018
2018-02-25,Negeri Sembilan,41,26,15,2018
2018-02-26,Negeri Sembilan,18,2,16,2018
2018-02-27,Negeri Sembilan,59,8,51,2018
2018-02-28,Negeri Sembilan,86,37,49,2018
2018-03-01,Negeri Sembilan,43,13,30,2018
2018-03-02,Negeri Sembilan,19,2,17,2018
2018-03-03,Negeri Sembilan,0,0,0,2018
2018-03-04,Negeri Sembilan,69,24,45,2018
2018-03-05,Negeri Sembilan,19,2,17,2018
2018-03-06,Negeri Sembilan,105,52,53,2018
2018-03-07,Negeri Sembilan,25,3,22,2018
2018-03-08,Negeri Sembilan,46,6,40,2018
2018-03-09,Negeri Sembilan,9,0,9,2018
2018-03-10,Negeri Sembilan,0,0,0,2018
2018-03-11,Negeri Sembilan,190,33,157,2018
2018-03-12,Negeri Sembilan,20,1,19,2018
2018-03-13,Negeri Sembilan,100,26,74,2018
2018-03-14,Negeri Sembilan,85,46,39,2018
2018-03-15,Negeri Sembilan,20,1,19,2018
2018-03-16,Negeri Sembilan,16,0,16,2018
2018-03-17,Negeri Sembilan,90,30,60,2018
2018-03-18,Negeri Sembilan,102,31,71,2018
2018-03-19,Negeri Sembilan,73,30,43,2018
2018-03-20,Negeri Sembilan,94,46,48,2018
2018-03-21,Negeri Sembilan,26,2,24,2018
2018-03-22,Negeri Sembilan,51,36,15,2018
2018-03-23,Negeri Sembilan,12,3,9,2018
2018-03-24,Negeri Sembilan,23,6,17,2018
2018-03-25,Negeri Sembilan,110,19,91,2018
2018-03-26,Negeri Sembilan,95,34,61,2018
2018-03-27,Negeri Sembilan,20,0,20,2018
2018-03-28,Negeri Sembilan,81,51,30,2018
2018-03-29,Negeri Sembilan,15,2,13,2018
2018-03-30,Negeri Sembilan,20,1,19,2018
2018-03-31,Negeri Sembilan,0,0,0,2018
2018-04-01,Negeri Sembilan,21,10,11,2018
2018-04-02,Negeri Sembilan,25,4,21,2018
2018-04-03,Negeri Sembilan,29,8,21,2018
2018-04-04,Negeri Sembilan,21,2,19,2018
2018-04-05,Negeri Sembilan,110,21,89,2018
2018-04-06,Negeri Sembilan,17,2,15,2018
2018-04-07,Negeri Sembilan,102,35,67,2018
2018-04-08,Negeri Sembilan,145,15,130,2018
2018-04-09,Negeri Sembilan,21,2,19,2018
2018-04-10,Negeri Sembilan,58,15,43,2018
2018-04-11,Negeri Sembilan,65,17,48,2018
2018-04-12,Negeri Sembilan,92,22,70,2018
2018-04-13,Negeri Sembilan,21,2,19,2018
2018-04-14,Negeri Sembilan,0,0,0,2018
2018-04-15,Negeri Sembilan,68,18,50,2018
2018-04-16,Negeri Sembilan,22,1,21,2018
2018-04-17,Negeri Sembilan,17,1,16,2018
2018-04-18,Negeri Sembilan,14,0,14,2018
2018-04-19,Negeri Sembilan,104,32,72,2018
2018-04-20,Negeri Sembilan,51,34,17,2018
2018-04-21,Negeri Sembilan,53,18,35,2018
2018-04-22,Negeri Sembilan,103,48,55,2018
2018-04-23,Negeri Sembilan,17,1,16,2018
2018-04-24,Negeri Sembilan,73,15,58,2018
2018-04-25,Negeri Sembilan,65,21,44,2018
2018-04-26,Negeri Sembilan,17,2,15,2018
2018-04-27,Negeri Sembilan,17,3,14,2018
2018-04-28,Negeri Sembilan,138,42,96,2018
2018-04-29,Negeri Sembilan,86,10,76,2018
2018-04-30,Negeri Sembilan,20,1,19,2018
2018-05-01,Negeri Sembilan,130,40,90,2018
2018-05-02,Negeri Sembilan,40,14,26,2018
2018-05-03,Negeri Sembilan,56,7,49,2018
2018-05-04,Negeri Sembilan,23,2,21,2018
2018-05-05,Negeri Sembilan,0,0,0,2018
2018-05-06,Negeri Sembilan,85,11,74,2018
2018-05-07,Negeri Sembilan,74,26,48,2018
2018-05-08,Negeri Sembilan,51,9,42,2018
2018-05-09,Negeri Sembilan,0,0,0,2018
2018-05-10,Negeri Sembilan,0,0,0,2018
2018-05-11,Negeri Sembilan,0,0,0,2018
2018-05-12,Negeri Sembilan,155,55,100,2018
2018-05-13,Negeri Sembilan,175,43,132,2018
2018-05-14,Negeri Sembilan,61,21,40,2018
2018-05-15,Negeri Sembilan,46,12,34,2018
2018-05-16,Negeri Sembilan,94,22,72,2018
2018-05-17,Negeri Sembilan,38,20,18,2018
2018-05-18,Negeri Sembilan,9,0,9,2018
2018-05-19,Negeri Sembilan,0,0,0,2018
2018-05-20,Negeri Sembilan,66,24,42,2018
2018-05-21,Negeri Sembilan,12,2,10,2018
2018-05-22,Negeri Sembilan,11,0,11,2018
2018-05-23,Negeri Sembilan,108,19,89,2018
2018-05-24,Negeri Sembilan,82,21,61,2018
2018-05-25,Negeri Sembilan,9,0,9,2018
2018-05-26,Negeri Sembilan,31,7,24,2018
2018-05-27,Negeri Sembilan,42,6,36,2018
2018-05-28,Negeri Sembilan,32,2,30,2018
2018-05-29,Negeri Sembilan,0,0,0,2018
2018-05-30,Negeri Sembilan,25,3,22,2018
2018-05-31,Negeri Sembilan,11,0,11,2018
2018-06-01,Negeri Sembilan,11,1,10,2018
2018-06-02,Negeri Sembilan,0,0,0,2018
2018-06-03,Negeri Sembilan,84,24,60,2018
2018-06-04,Negeri Sembilan,16,1,15,2018
2018-06-05,Negeri Sembilan,22,2,20,2018
2018-06-06,Negeri Sembilan,16,5,11,2018
2018-06-07,Negeri Sembilan,55,19,36,2018
2018-06-08,Negeri Sembilan,13,1,12,2018
2018-06-09,Negeri Sembilan,3,0,3,2018
2018-06-10,Negeri Sembilan,86,19,67,2018
2018-06-11,Negeri Sembilan,24,14,10,2018
2018-06-12,Negeri Sembilan,51,21,30,2018
2018-06-13,Negeri Sembilan,39,15,24,2018
2018-06-14,Negeri Sembilan,13,0,13,2018
2018-06-15,Negeri Sembilan,0,0,0,2018
2018-06-16,Negeri Sembilan,0,0,0,2018
2018-06-17,Negeri Sembilan,0,0,0,2018
2018-06-18,Negeri Sembilan,20,0,20,2018
2018-06-19,Negeri Sembilan,45,10,35,2018
2018-06-20,Negeri Sembilan,49,8,41,2018
2018-06-21,Negeri Sembilan,56,11,45,2018
2018-06-22,Negeri Sembilan,16,2,14,2018
2018-06-23,Negeri Sembilan,49,18,31,2018
2018-06-24,Negeri Sembilan,132,15,117,2018
2018-06-25,Negeri Sembilan,70,17,53,2018
2018-06-26,Negeri Sembilan,34,4,30,2018
2018-06-27,Negeri Sembilan,85,45,40,2018
2018-06-28,Negeri Sembilan,78,54,24,2018
2018-06-29,Negeri Sembilan,20,0,20,2018
2018-06-30,Negeri Sembilan,36,7,29,2018
2018-07-01,Negeri Sembilan,40,11,29,2018
2018-07-02,Negeri Sembilan,28,4,24,2018
2018-07-03,Negeri Sembilan,24,4,20,2018
2018-07-04,Negeri Sembilan,38,15,23,2018
2018-07-05,Negeri Sembilan,20,0,20,2018
2018-07-06,Negeri Sembilan,10,1,9,2018
2018-07-07,Negeri Sembilan,32,8,24,2018
2018-07-08,Negeri Sembilan,29,10,19,2018
2018-07-09,Negeri Sembilan,18,2,16,2018
2018-07-10,Negeri Sembilan,86,19,67,2018
2018-07-11,Negeri Sembilan,38,10,28,2018
2018-07-12,Negeri Sembilan,54,14,40,2018
2018-07-13,Negeri Sembilan,20,2,18,2018
2018-07-14,Negeri Sembilan,82,17,65,2018
2018-07-15,Negeri Sembilan,206,38,168,2018
2018-07-16,Negeri Sembilan,20,1,19,2018
2018-07-17,Negeri Sembilan,76,27,49,2018
2018-07-18,Negeri Sembilan,46,5,41,2018
2018-07-19,Negeri Sembilan,43,5,38,2018
2018-07-20,Negeri Sembilan,21,1,20,2018
2018-07-21,Negeri Sembilan,0,0,0,2018
2018-07-22,Negeri Sembilan,150,49,101,2018
2018-07-23,Negeri Sembilan,24,1,23,2018
2018-07-24,Negeri Sembilan,25,1,24,2018
2018-07-25,Negeri Sembilan,44,17,27,2018
2018-07-26,Negeri Sembilan,89,13,76,2018
2018-07-27,Negeri Sembilan,104,27,77,2018
2018-07-28,Negeri Sembilan,0,0,0,2018
2018-07-29,Negeri Sembilan,129,31,98,2018
2018-07-30,Negeri Sembilan,16,2,14,2018
2018-07-31,Negeri Sembilan,19,5,14,2018
2018-08-01,Negeri Sembilan,72,32,40,2018
2018-08-02,Negeri Sembilan,19,4,15,2018
2018-08-03,Negeri Sembilan,102,59,43,2018
2018-08-04,Negeri Sembilan,44,18,26,2018
2018-08-05,Negeri Sembilan,142,41,101,2018
2018-08-06,Negeri Sembilan,17,0,17,2018
2018-08-07,Negeri Sembilan,23,3,20,2018
2018-08-08,Negeri Sembilan,146,31,115,2018
2018-08-09,Negeri Sembilan,90,40,50,2018
2018-08-10,Negeri Sembilan,12,1,11,2018
2018-08-11,Negeri Sembilan,32,6,26,2018
2018-08-12,Negeri Sembilan,115,40,75,2018
2018-08-13,Negeri Sembilan,15,2,13,2018
2018-08-14,Negeri Sembilan,64,9,55,2018
2018-08-15,Negeri Sembilan,111,57,54,2018
2018-08-16,Negeri Sembilan,44,2,42,2018
2018-08-17,Negeri Sembilan,10,0,10,2018
2018-08-18,Negeri Sembilan,124,23,101,2018
2018-08-19,Negeri Sembilan,126,37,89,2018
2018-08-20,Negeri Sembilan,68,23,45,2018
2018-08-21,Negeri Sembilan,15,2,13,2018
2018-08-22,Negeri Sembilan,0,0,0,2018
2018-08-23,Negeri Sembilan,13,2,11,2018
2018-08-24,Negeri Sembilan,26,1,25,2018
2018-08-25,Negeri Sembilan,0,0,0,2018
2018-08-26,Negeri Sembilan,39,4,35,2018
2018-08-27,Negeri Sembilan,137,104,33,2018
2018-08-28,Negeri Sembilan,9,1,8,2018
2018-08-29,Negeri Sembilan,20,2,18,2018
2018-08-30,Negeri Sembilan,17,2,15,2018
2018-08-31,Negeri Sembilan,50,8,42,2018
2018-09-01,Negeri Sembilan,37,13,24,2018
2018-09-02,Negeri Sembilan,97,8,89,2018
2018-09-03,Negeri Sembilan,17,2,15,2018
2018-09-04,Negeri Sembilan,18,1,17,2018
2018-09-05,Negeri Sembilan,19,2,17,2018
2018-09-06,Negeri Sembilan,96,15,81,2018
2018-09-07,Negeri Sembilan,15,1,14,2018
2018-09-08,Negeri Sembilan,23,6,17,2018
2018-09-09,Negeri Sembilan,75,33,42,2018
2018-09-10,Negeri Sembilan,0,0,0,2018
2018-09-11,Negeri Sembilan,0,0,0,2018
2018-09-12,Negeri Sembilan,98,53,45,2018
2018-09-13,Negeri Sembilan,20,3,17,2018
2018-09-14,Negeri Sembilan,19,4,15,2018
2018-09-15,Negeri Sembilan,0,0,0,2018
2018-09-16,Negeri Sembilan,98,20,78,2018
2018-09-17,Negeri Sembilan,28,4,24,2018
2018-09-18,Negeri Sembilan,18,2,16,2018
2018-09-19,Negeri Sembilan,84,24,60,2018
2018-09-20,Negeri Sembilan,16,1,15,2018
2018-09-21,Negeri Sembilan,60,13,47,2018
2018-09-22,Negeri Sembilan,0,0,0,2018
2018-09-23,Negeri Sembilan,61,7,54,2018
2018-09-24,Negeri Sembilan,24,2,22,2018
2018-09-25,Negeri Sembilan,15,2,13,2018
2018-09-26,Negeri Sembilan,100,45,55,2018
2018-09-27,Negeri Sembilan,88,57,31,2018
2018-09-28,Negeri Sembilan,22,1,21,2018
2018-09-29,Negeri Sembilan,48,8,40,2018
2018-09-30,Negeri Sembilan,83,13,70,2018
2018-10-01,Negeri Sembilan,24,4,20,2018
2018-10-02,Negeri Sembilan,15,1,14,2018
2018-10-03,Negeri Sembilan,50,9,41,2018
2018-10-04,Negeri Sembilan,18,4,14,2018
2018-10-05,Negeri Sembilan,21,2,19,2018
2018-10-06,Negeri Sembilan,28,9,19,2018
2018-10-07,Negeri Sembilan,0,0,0,2018
2018-10-08,Negeri Sembilan,39,12,27,2018
2018-10-09,Negeri Sembilan,18,4,14,2018
2018-10-10,Negeri Sembilan,36,8,28,2018
2018-10-11,Negeri Sembilan,38,4,34,2018
2018-10-12,Negeri Sembilan,19,1,18,2018
2018-10-13,Negeri Sembilan,57,20,37,2018
2018-10-14,Negeri Sembilan,101,15,86,2018
2018-10-15,Negeri Sembilan,77,24,53,2018
2018-10-16,Negeri Sembilan,24,4,20,2018
2018-10-17,Negeri Sembilan,34,7,27,2018
2018-10-18,Negeri Sembilan,14,2,12,2018
2018-10-19,Negeri Sembilan,22,3,19,2018
2018-10-20,Negeri Sembilan,0,0,0,2018
2018-10-21,Negeri Sembilan,62,4,58,2018
2018-10-22,Negeri Sembilan,27,3,24,2018
2018-10-23,Negeri Sembilan,35,14,21,2018
2018-10-24,Negeri Sembilan,68,37,31,2018
2018-10-25,Negeri Sembilan,32,11,21,2018
2018-10-26,Negeri Sembilan,10,2,8,2018
2018-10-27,Negeri Sembilan,55,24,31,2018
2018-10-28,Negeri Sembilan,41,17,24,2018
2018-10-29,Negeri Sembilan,17,1,16,2018
2018-10-30,Negeri Sembilan,14,3,11,2018
2018-10-31,Negeri Sembilan,60,17,43,2018
2018-11-01,Negeri Sembilan,108,34,74,2018
2018-11-02,Negeri Sembilan,6,0,6,2018
2018-11-03,Negeri Sembilan,56,19,37,2018
2018-11-04,Negeri Sembilan,104,26,78,2018
2018-11-05,Negeri Sembilan,32,3,29,2018
2018-11-06,Negeri Sembilan,0,0,0,2018
2018-11-07,Negeri Sembilan,53,15,38,2018
2018-11-08,Negeri Sembilan,46,6,40,2018
2018-11-09,Negeri Sembilan,17,1,16,2018
2018-11-10,Negeri Sembilan,57,14,43,2018
2018-11-11,Negeri Sembilan,57,17,40,2018
2018-11-12,Negeri Sembilan,80,27,53,2018
2018-11-13,Negeri Sembilan,73,25,48,2018
2018-11-14,Negeri Sembilan,58,21,37,2018
2018-11-15,Negeri Sembilan,17,1,16,2018
2018-11-16,Negeri Sembilan,19,2,17,2018
2018-11-17,Negeri Sembilan,0,0,0,2018
2018-11-18,Negeri Sembilan,131,16,115,2018
2018-11-19,Negeri Sembilan,27,2,25,2018
2018-11-20,Negeri Sembilan,0,0,0,2018
2018-11-21,Negeri Sembilan,78,31,47,2018
2018-11-22,Negeri Sembilan,35,9,26,2018
2018-11-23,Negeri Sembilan,57,19,38,2018
2018-11-24,Negeri Sembilan,1,1,0,2018
2018-11-25,Negeri Sembilan,33,3,30,2018
2018-11-26,Negeri Sembilan,61,10,51,2018
2018-11-27,Negeri Sembilan,111,72,39,2018
2018-11-28,Negeri Sembilan,106,41,65,2018
2018-11-29,Negeri Sembilan,54,13,41,2018
2018-11-30,Negeri Sembilan,16,3,13,2018
2018-12-01,Negeri Sembilan,0,0,0,2018
2018-12-02,Negeri Sembilan,46,12,34,2018
2018-12-03,Negeri Sembilan,52,11,41,2018
2018-12-04,Negeri Sembilan,81,14,67,2018
2018-12-05,Negeri Sembilan,46,5,41,2018
2018-12-06,Negeri Sembilan,17,1,16,2018
2018-12-07,Negeri Sembilan,22,1,21,2018
2018-12-08,Negeri Sembilan,245,234,11,2018
2018-12-09,Negeri Sembilan,126,22,104,2018
2018-12-10,Negeri Sembilan,21,3,18,2018
2018-12-11,Negeri Sembilan,22,2,20,2018
2018-12-12,Negeri Sembilan,55,13,42,2018
2018-12-13,Negeri Sembilan,27,6,21,2018
2018-12-14,Negeri Sembilan,16,1,15,2018
2018-12-15,Negeri Sembilan,36,12,24,2018
2018-12-16,Negeri Sembilan,50,14,36,2018
2018-12-17,Negeri Sembilan,12,0,12,2018
2018-12-18,Negeri Sembilan,40,4,36,2018
2018-12-19,Negeri Sembilan,45,3,42,2018
2018-12-20,Negeri Sembilan,14,0,14,2018
2018-12-21,Negeri Sembilan,18,0,18,2018
2018-12-22,Negeri Sembilan,69,36,33,2018
2018-12-23,Negeri Sembilan,0,0,0,2018
2018-12-24,Negeri Sembilan,20,2,18,2018
2018-12-25,Negeri Sembilan,0,0,0,2018
2018-12-26,Negeri Sembilan,33,3,30,2018
2018-12-27,Negeri Sembilan,23,4,19,2018
2018-12-28,Negeri Sembilan,25,4,21,2018
2018-12-29,Negeri Sembilan,0,0,0,2018
2018-12-30,Negeri Sembilan,73,9,64,2018
2018-12-31,Negeri Sembilan,30,5,25,2018
2019-01-01,Negeri Sembilan,0,0,0,2019
2019-01-02,Negeri Sembilan,76,15,61,2019
2019-01-03,Negeri Sembilan,86,11,75,2019
2019-01-04,Negeri Sembilan,26,2,24,2019
2019-01-05,Negeri Sembilan,71,16,55,2019
2019-01-06,Negeri Sembilan,99,30,69,2019
2019-01-07,Negeri Sembilan,24,2,22,2019
2019-01-08,Negeri Sembilan,133,72,61,2019
2019-01-09,Negeri Sembilan,49,14,35,2019
2019-01-10,Negeri Sembilan,23,3,20,2019
2019-01-11,Negeri Sembilan,11,2,9,2019
2019-01-12,Negeri Sembilan,17,5,12,2019
2019-01-13,Negeri Sembilan,62,10,52,2019
2019-01-14,Negeri Sembilan,0,0,0,2019
2019-01-15,Negeri Sembilan,54,3,51,2019
2019-01-16,Negeri Sembilan,48,8,40,2019
2019-01-17,Negeri Sembilan,16,1,15,2019
2019-01-18,Negeri Sembilan,18,2,16,2019
2019-01-19,Negeri Sembilan,79,23,56,2019
2019-01-20,Negeri Sembilan,0,0,0,2019
2019-01-21,Negeri Sembilan,0,0,0,2019
2019-01-22,Negeri Sembilan,46,13,33,2019
2019-01-23,Negeri Sembilan,88,39,49,2019
2019-01-24,Negeri Sembilan,27,5,22,2019
2019-01-25,Negeri Sembilan,34,7,27,2019
2019-01-26,Negeri Sembilan,33,8,25,2019
2019-01-27,Negeri Sembilan,69,16,53,2019
2019-01-28,Negeri Sembilan,67,18,49,2019
2019-01-29,Negeri Sembilan,68,13,55,2019
2019-01-30,Negeri Sembilan,74,23,51,2019
2019-01-31,Negeri Sembilan,46,6,40,2019
2019-02-01,Negeri Sembilan,23,2,21,2019
2019-02-02,Negeri Sembilan,50,17,33,2019
2019-02-03,Negeri Sembilan,52,16,36,2019
2019-02-04,Negeri Sembilan,58,6,52,2019
2019-02-05,Negeri Sembilan,0,0,0,2019
2019-02-06,Negeri Sembilan,0,0,0,2019
2019-02-07,Negeri Sembilan,50,11,39,2019
2019-02-08,Negeri Sembilan,41,6,35,2019
2019-02-09,Negeri Sembilan,84,31,53,2019
2019-02-10,Negeri Sembilan,100,41,59,2019
2019-02-11,Negeri Sembilan,34,4,30,2019
2019-02-12,Negeri Sembilan,32,6,26,2019
2019-02-13,Negeri Sembilan,41,25,16,2019
2019-02-14,Negeri Sembilan,78,19,59,2019
2019-02-15,Negeri Sembilan,27,2,25,2019
2019-02-16,Negeri Sembilan,66,30,36,2019
2019-02-17,Negeri Sembilan,58,12,46,2019
2019-02-18,Negeri Sembilan,48,8,40,2019
2019-02-19,Negeri Sembilan,72,32,40,2019
2019-02-20,Negeri Sembilan,113,31,82,2019
2019-02-21,Negeri Sembilan,21,4,17,2019
2019-02-22,Negeri Sembilan,13,0,13,2019
2019-02-23,Negeri Sembilan,51,14,37,2019
2019-02-24,Negeri Sembilan,45,16,29,2019
2019-02-25,Negeri Sembilan,202,134,68,2019
2019-02-26,Negeri Sembilan,23,2,21,2019
2019-02-27,Negeri Sembilan,105,51,54,2019
2019-02-28,Negeri Sembilan,76,26,50,2019
2019-03-01,Negeri Sembilan,26,2,24,2019
2019-03-02,Negeri Sembilan,167,131,36,2019
2019-03-03,Negeri Sembilan,0,0,0,2019
2019-03-04,Negeri Sembilan,33,4,29,2019
2019-03-05,Negeri Sembilan,71,21,50,2019
2019-03-06,Negeri Sembilan,21,4,17,2019
2019-03-07,Negeri Sembilan,21,4,17,2019
2019-03-08,Negeri Sembilan,94,35,59,2019
2019-03-09,Negeri Sembilan,87,22,65,2019
2019-03-10,Negeri Sembilan,167,24,143,2019
2019-03-11,Negeri Sembilan,24,3,21,2019
2019-03-12,Negeri Sembilan,65,14,51,2019
2019-03-13,Negeri Sembilan,66,13,53,2019
2019-03-14,Negeri Sembilan,42,24,18,2019
2019-03-15,Negeri Sembilan,21,7,14,2019
2019-03-16,Negeri Sembilan,0,0,0,2019
2019-03-17,Negeri Sembilan,54,5,49,2019
2019-03-18,Negeri Sembilan,102,30,72,2019
2019-03-19,Negeri Sembilan,12,1,11,2019
2019-03-20,Negeri Sembilan,16,1,15,2019
2019-03-21,Negeri Sembilan,63,12,51,2019
2019-03-22,Negeri Sembilan,15,1,14,2019
2019-03-23,Negeri Sembilan,32,13,19,2019
2019-03-24,Negeri Sembilan,130,11,119,2019
2019-03-25,Negeri Sembilan,21,3,18,2019
2019-03-26,Negeri Sembilan,101,15,86,2019
2019-03-27,Negeri Sembilan,78,36,42,2019
2019-03-28,Negeri Sembilan,89,58,31,2019
2019-03-29,Negeri Sembilan,25,5,20,2019
2019-03-30,Negeri Sembilan,43,31,12,2019
2019-03-31,Negeri Sembilan,108,24,84,2019
2019-04-01,Negeri Sembilan,13,2,11,2019
2019-04-02,Negeri Sembilan,92,22,70,2019
2019-04-03,Negeri Sembilan,0,0,0,2019
2019-04-04,Negeri Sembilan,87,54,33,2019
2019-04-05,Negeri Sembilan,19,2,17,2019
2019-04-06,Negeri Sembilan,0,0,0,2019
2019-04-07,Negeri Sembilan,95,15,80,2019
2019-04-08,Negeri Sembilan,19,2,17,2019
2019-04-09,Negeri Sembilan,99,24,75,2019
2019-04-10,Negeri Sembilan,23,1,22,2019
2019-04-11,Negeri Sembilan,114,17,97,2019
2019-04-12,Negeri Sembilan,18,2,16,2019
2019-04-13,Negeri Sembilan,0,0,0,2019
2019-04-14,Negeri Sembilan,73,18,55,2019
2019-04-15,Negeri Sembilan,65,27,38,2019
2019-04-16,Negeri Sembilan,144,48,96,2019
2019-04-17,Negeri Sembilan,52,33,19,2019
2019-04-18,Negeri Sembilan,68,38,30,2019
2019-04-19,Negeri Sembilan,31,5,26,2019
2019-04-20,Negeri Sembilan,64,15,49,2019
2019-04-21,Negeri Sembilan,81,27,54,2019
2019-04-22,Negeri Sembilan,32,2,30,2019
2019-04-23,Negeri Sembilan,47,12,35,2019
2019-04-24,Negeri Sembilan,65,10,55,2019
2019-04-25,Negeri Sembilan,76,32,44,2019
2019-04-26,Negeri Sembilan,8,0,8,2019
2019-04-27,Negeri Sembilan,93,24,69,2019
2019-04-28,Negeri Sembilan,141,37,104,2019
2019-04-29,Negeri Sembilan,59,12,47,2019
2019-04-30,Negeri Sembilan,58,15,43,2019
2019-05-01,Negeri Sembilan,97,24,73,2019
2019-05-02,Negeri Sembilan,98,35,63,2019
2019-05-03,Negeri Sembilan,82,29,53,2019
2019-05-04,Negeri Sembilan,117,36,81,2019
2019-05-05,Negeri Sembilan,87,31,56,2019
2019-05-06,Negeri Sembilan,7,1,6,2019
2019-05-07,Negeri Sembilan,10,2,8,2019
2019-05-08,Negeri Sembilan,9,0,9,2019
2019-05-09,Negeri Sembilan,7,1,6,2019
2019-05-10,Negeri Sembilan,9,0,9,2019
2019-05-11,Negeri Sembilan,0,0,0,2019
2019-05-12,Negeri Sembilan,0,0,0,2019
2019-05-13,Negeri Sembilan,13,1,12,2019
2019-05-14,Negeri Sembilan,11,0,11,2019
2019-05-15,Negeri Sembilan,22,3,19,2019
2019-05-16,Negeri Sembilan,26,8,18,2019
2019-05-17,Negeri Sembilan,8,0,8,2019
2019-05-18,Negeri Sembilan,20,4,16,2019
2019-05-19,Negeri Sembilan,44,13,31,2019
2019-05-20,Negeri Sembilan,0,0,0,2019
2019-05-21,Negeri Sembilan,53,16,37,2019
2019-05-22,Negeri Sembilan,43,18,25,2019
2019-05-23,Negeri Sembilan,47,6,41,2019
2019-05-24,Negeri Sembilan,4,0,4,2019
2019-05-25,Negeri Sembilan,0,0,0,2019
2019-05-26,Negeri Sembilan,51,23,28,2019
2019-05-27,Negeri Sembilan,8,2,6,2019
2019-05-28,Negeri Sembilan,9,1,8,2019
2019-05-29,Negeri Sembilan,31,8,23,2019
2019-05-30,Negeri Sembilan,20,0,20,2019
2019-05-31,Negeri Sembilan,8,0,8,2019
2019-06-01,Negeri Sembilan,27,6,21,2019
2019-06-02,Negeri Sembilan,70,36,34,2019
2019-06-03,Negeri Sembilan,26,4,22,2019
2019-06-04,Negeri Sembilan,28,3,25,2019
2019-06-05,Negeri Sembilan,0,0,0,2019
2019-06-06,Negeri Sembilan,0,0,0,2019
2019-06-07,Negeri Sembilan,35,3,32,2019
2019-06-08,Negeri Sembilan,75,23,52,2019
2019-06-09,Negeri Sembilan,68,18,50,2019
2019-06-10,Negeri Sembilan,51,7,44,2019
2019-06-11,Negeri Sembilan,69,22,47,2019
2019-06-12,Negeri Sembilan,75,23,52,2019
2019-06-13,Negeri Sembilan,73,17,56,2019
2019-06-14,Negeri Sembilan,33,6,27,2019
2019-06-15,Negeri Sembilan,0,0,0,2019
2019-06-16,Negeri Sembilan,166,19,147,2019
2019-06-17,Negeri Sembilan,28,2,26,2019
2019-06-18,Negeri Sembilan,46,13,33,2019
2019-06-19,Negeri Sembilan,39,13,26,2019
2019-06-20,Negeri Sembilan,53,10,43,2019
2019-06-21,Negeri Sembilan,38,12,26,2019
2019-06-22,Negeri Sembilan,47,6,41,2019
2019-06-23,Negeri Sembilan,94,11,83,2019
2019-06-24,Negeri Sembilan,38,5,33,2019
2019-06-25,Negeri Sembilan,27,3,24,2019
2019-06-26,Negeri Sembilan,61,9,52,2019
2019-06-27,Negeri Sembilan,47,14,33,2019
2019-06-28,Negeri Sembilan,21,1,20,2019
2019-06-29,Negeri Sembilan,65,26,39,2019
2019-06-30,Negeri Sembilan,91,28,63,2019
2019-07-01,Negeri Sembilan,39,4,35,2019
2019-07-02,Negeri Sembilan,50,19,31,2019
2019-07-03,Negeri Sembilan,76,42,34,2019
2019-07-04,Negeri Sembilan,30,2,28,2019
2019-07-05,Negeri Sembilan,28,1,27,2019
2019-07-06,Negeri Sembilan,29,12,17,2019
2019-07-07,Negeri Sembilan,62,16,46,2019
2019-07-08,Negeri Sembilan,30,7,23,2019
2019-07-09,Negeri Sembilan,34,2,32,2019
2019-07-10,Negeri Sembilan,70,42,28,2019
2019-07-11,Negeri Sembilan,15,3,12,2019
2019-07-12,Negeri Sembilan,22,1,21,2019
2019-07-13,Negeri Sembilan,90,26,64,2019
2019-07-14,Negeri Sembilan,244,43,201,2019
2019-07-15,Negeri Sembilan,77,13,64,2019
2019-07-16,Negeri Sembilan,93,29,64,2019
2019-07-17,Negeri Sembilan,92,30,62,2019
2019-07-18,Negeri Sembilan,86,68,18,2019
2019-07-19,Negeri Sembilan,15,3,12,2019
2019-07-20,Negeri Sembilan,0,0,0,2019
2019-07-21,Negeri Sembilan,27,11,16,2019
2019-07-22,Negeri Sembilan,68,19,49,2019
2019-07-23,Negeri Sembilan,75,17,58,2019
2019-07-24,Negeri Sembilan,20,0,20,2019
2019-07-25,Negeri Sembilan,79,31,48,2019
2019-07-26,Negeri Sembilan,18,2,16,2019
2019-07-27,Negeri Sembilan,0,0,0,2019
2019-07-28,Negeri Sembilan,86,14,72,2019
2019-07-29,Negeri Sembilan,33,3,30,2019
2019-07-30,Negeri Sembilan,0,0,0,2019
2019-07-31,Negeri Sembilan,69,32,37,2019
2019-08-01,Negeri Sembilan,30,4,26,2019
2019-08-02,Negeri Sembilan,18,3,15,2019
2019-08-03,Negeri Sembilan,53,10,43,2019
2019-08-04,Negeri Sembilan,80,25,55,2019
2019-08-05,Negeri Sembilan,99,23,76,2019
2019-08-06,Negeri Sembilan,99,36,63,2019
2019-08-07,Negeri Sembilan,53,8,45,2019
2019-08-08,Negeri Sembilan,70,44,26,2019
2019-08-09,Negeri Sembilan,17,3,14,2019
2019-08-10,Negeri Sembilan,60,13,47,2019
2019-08-11,Negeri Sembilan,0,0,0,2019
2019-08-12,Negeri Sembilan,0,0,0,2019
2019-08-13,Negeri Sembilan,27,3,24,2019
2019-08-14,Negeri Sembilan,39,5,34,2019
2019-08-15,Negeri Sembilan,88,21,67,2019
2019-08-16,Negeri Sembilan,13,2,11,2019
2019-08-17,Negeri Sembilan,69,26,43,2019
2019-08-18,Negeri Sembilan,89,39,50,2019
2019-08-19,Negeri Sembilan,20,2,18,2019
2019-08-20,Negeri Sembilan,150,29,121,2019
2019-08-21,Negeri Sembilan,84,34,50,2019
2019-08-22,Negeri Sembilan,57,23,34,2019
2019-08-23,Negeri Sembilan,16,3,13,2019
2019-08-24,Negeri Sembilan,158,32,126,2019
2019-08-25,Negeri Sembilan,156,29,127,2019
2019-08-26,Negeri Sembilan,14,1,13,2019
2019-08-27,Negeri Sembilan,21,2,19,2019
2019-08-28,Negeri Sembilan,81,31,50,2019
2019-08-29,Negeri Sembilan,16,0,16,2019
2019-08-30,Negeri Sembilan,76,47,29,2019
2019-08-31,Negeri Sembilan,73,21,52,2019
2019-09-01,Negeri Sembilan,51,18,33,2019
2019-09-02,Negeri Sembilan,0,0,0,2019
2019-09-03,Negeri Sembilan,17,3,14,2019
2019-09-04,Negeri Sembilan,88,28,60,2019
2019-09-05,Negeri Sembilan,81,47,34,2019
2019-09-06,Negeri Sembilan,20,2,18,2019
2019-09-07,Negeri Sembilan,30,9,21,2019
2019-09-08,Negeri Sembilan,127,20,107,2019
2019-09-09,Negeri Sembilan,0,0,0,2019
2019-09-10,Negeri Sembilan,18,3,15,2019
2019-09-11,Negeri Sembilan,20,3,17,2019
2019-09-12,Negeri Sembilan,142,29,113,2019
2019-09-13,Negeri Sembilan,29,3,26,2019
2019-09-14,Negeri Sembilan,0,0,0,2019
2019-09-15,Negeri Sembilan,125,14,111,2019
2019-09-16,Negeri Sembilan,50,14,36,2019
2019-09-17,Negeri Sembilan,27,3,24,2019
2019-09-18,Negeri Sembilan,16,0,16,2019
2019-09-19,Negeri Sembilan,52,15,37,2019
2019-09-20,Negeri Sembilan,24,1,23,2019
2019-09-21,Negeri Sembilan,0,0,0,2019
2019-09-22,Negeri Sembilan,93,11,82,2019
2019-09-23,Negeri Sembilan,30,4,26,2019
2019-09-24,Negeri Sembilan,17,0,17,2019
2019-09-25,Negeri Sembilan,93,54,39,2019
2019-09-26,Negeri Sembilan,62,14,48,2019
2019-09-27,Negeri Sembilan,24,4,20,2019
2019-09-28,Negeri Sembilan,72,18,54,2019
2019-09-29,Negeri Sembilan,80,7,73,2019
2019-09-30,Negeri Sembilan,15,1,14,2019
2019-10-01,Negeri Sembilan,27,1,26,2019
2019-10-02,Negeri Sembilan,19,3,16,2019
2019-10-03,Negeri Sembilan,26,1,25,2019
2019-10-04,Negeri Sembilan,77,20,57,2019
2019-10-05,Negeri Sembilan,17,9,8,2019
2019-10-06,Negeri Sembilan,85,20,65,2019
2019-10-07,Negeri Sembilan,27,2,25,2019
2019-10-08,Negeri Sembilan,23,3,20,2019
2019-10-09,Negeri Sembilan,126,35,91,2019
2019-10-10,Negeri Sembilan,94,61,33,2019
2019-10-11,Negeri Sembilan,60,33,27,2019
2019-10-12,Negeri Sembilan,0,0,0,2019
2019-10-13,Negeri Sembilan,0,0,0,2019
2019-10-14,Negeri Sembilan,77,29,48,2019
2019-10-15,Negeri Sembilan,32,3,29,2019
2019-10-16,Negeri Sembilan,14,0,14,2019
2019-10-17,Negeri Sembilan,54,15,39,2019
2019-10-18,Negeri Sembilan,33,8,25,2019
2019-10-19,Negeri Sembilan,40,14,26,2019
2019-10-20,Negeri Sembilan,81,12,69,2019
2019-10-21,Negeri Sembilan,25,5,20,2019
2019-10-22,Negeri Sembilan,14,1,13,2019
2019-10-23,Negeri Sembilan,65,22,43,2019
2019-10-24,Negeri Sembilan,85,29,56,2019
2019-10-25,Negeri Sembilan,18,4,14,2019
2019-10-26,Negeri Sembilan,9,5,4,2019
2019-10-27,Negeri Sembilan,110,21,89,2019
2019-10-28,Negeri Sembilan,0,0,0,2019
2019-10-29,Negeri Sembilan,21,1,20,2019
2019-10-30,Negeri Sembilan,89,16,73,2019
2019-10-31,Negeri Sembilan,17,1,16,2019
2019-11-01,Negeri Sembilan,30,2,28,2019
2019-11-02,Negeri Sembilan,59,14,45,2019
2019-11-03,Negeri Sembilan,140,36,104,2019
2019-11-04,Negeri Sembilan,25,4,21,2019
2019-11-05,Negeri Sembilan,15,1,14,2019
2019-11-06,Negeri Sembilan,104,22,82,2019
2019-11-07,Negeri Sembilan,114,38,76,2019
2019-11-08,Negeri Sembilan,80,24,56,2019
2019-11-09,Negeri Sembilan,28,14,14,2019
2019-11-10,Negeri Sembilan,29,3,26,2019
2019-11-11,Negeri Sembilan,28,4,24,2019
2019-11-12,Negeri Sembilan,42,12,30,2019
2019-11-13,Negeri Sembilan,62,24,38,2019
2019-11-14,Negeri Sembilan,47,23,24,2019
2019-11-15,Negeri Sembilan,10,0,10,2019
2019-11-16,Negeri Sembilan,0,0,0,2019
2019-11-17,Negeri Sembilan,100,20,80,2019
2019-11-18,Negeri Sembilan,12,3,9,2019
2019-11-19,Negeri Sembilan,83,34,49,2019
2019-11-20,Negeri Sembilan,84,27,57,2019
2019-11-21,Negeri Sembilan,74,27,47,2019
2019-11-22,Negeri Sembilan,8,1,7,2019
2019-11-23,Negeri Sembilan,78,19,59,2019
2019-11-24,Negeri Sembilan,79,7,72,2019
2019-11-25,Negeri Sembilan,14,1,13,2019
2019-11-26,Negeri Sembilan,46,12,34,2019
2019-11-27,Negeri Sembilan,65,24,41,2019
2019-11-28,Negeri Sembilan,17,0,17,2019
2019-11-29,Negeri Sembilan,20,1,19,2019
2019-11-30,Negeri Sembilan,28,10,18,2019
2019-12-01,Negeri Sembilan,0,0,0,2019
2019-12-02,Negeri Sembilan,59,3,56,2019
2019-12-03,Negeri Sembilan,59,13,46,2019
2019-12-04,Negeri Sembilan,44,5,39,2019
2019-12-05,Negeri Sembilan,39,17,22,2019
2019-12-06,Negeri Sembilan,70,34,36,2019
2019-12-07,Negeri Sembilan,14,3,11,2019
2019-12-08,Negeri Sembilan,0,0,0,2019
2019-12-09,Negeri Sembilan,52,12,40,2019
2019-12-10,Negeri Sembilan,48,23,25,2019
2019-12-11,Negeri Sembilan,48,9,39,2019
2019-12-12,Negeri Sembilan,57,13,44,2019
2019-12-13,Negeri Sembilan,16,3,13,2019
2019-12-14,Negeri Sembilan,49,17,32,2019
2019-12-15,Negeri Sembilan,144,14,130,2019
2019-12-16,Negeri Sembilan,29,4,25,2019
2019-12-17,Negeri Sembilan,75,20,55,2019
2019-12-18,Negeri Sembilan,55,23,32,2019
2019-12-19,Negeri Sembilan,59,22,37,2019
2019-12-20,Negeri Sembilan,97,55,42,2019
2019-12-21,Negeri Sembilan,0,0,0,2019
2019-12-22,Negeri Sembilan,83,7,76,2019
2019-12-23,Negeri Sembilan,53,20,33,2019
2019-12-24,Negeri Sembilan,18,1,17,2019
2019-12-25,Negeri Sembilan,0,0,0,2019
2019-12-26,Negeri Sembilan,42,5,37,2019
2019-12-27,Negeri Sembilan,46,6,40,2019
2019-12-28,Negeri Sembilan,95,25,70,2019
2019-12-29,Negeri Sembilan,135,30,105,2019
2019-12-30,Negeri Sembilan,43,4,39,2019
2019-12-31,Negeri Sembilan,36,1,35,2019
2020-01-01,Negeri Sembilan,109,33,76,2020
2020-01-02,Negeri Sembilan,26,2,24,2020
2020-01-03,Negeri Sembilan,40,6,34,2020
2020-01-04,Negeri Sembilan,48,15,33,2020
2020-01-05,Negeri Sembilan,48,17,31,2020
2020-01-06,Negeri Sembilan,21,2,19,2020
2020-01-07,Negeri Sembilan,106,26,80,2020
2020-01-08,Negeri Sembilan,79,18,61,2020
2020-01-09,Negeri Sembilan,104,56,48,2020
2020-01-10,Negeri Sembilan,21,0,21,2020
2020-01-11,Negeri Sembilan,36,12,24,2020
2020-01-12,Negeri Sembilan,55,12,43,2020
2020-01-13,Negeri Sembilan,25,3,22,2020
2020-01-14,Negeri Sembilan,0,0,0,2020
2020-01-15,Negeri Sembilan,50,16,34,2020
2020-01-16,Negeri Sembilan,63,20,43,2020
2020-01-17,Negeri Sembilan,12,1,11,2020
2020-01-18,Negeri Sembilan,86,23,63,2020
2020-01-19,Negeri Sembilan,125,37,88,2020
2020-01-20,Negeri Sembilan,18,5,13,2020
2020-01-21,Negeri Sembilan,60,9,51,2020
2020-01-22,Negeri Sembilan,50,12,38,2020
2020-01-23,Negeri Sembilan,48,17,31,2020
2020-01-24,Negeri Sembilan,18,0,18,2020
2020-01-25,Negeri Sembilan,0,0,0,2020
2020-01-26,Negeri Sembilan,40,15,25,2020
2020-01-27,Negeri Sembilan,0,0,0,2020
2020-01-28,Negeri Sembilan,40,9,31,2020
2020-01-29,Negeri Sembilan,44,9,35,2020
2020-01-30,Negeri Sembilan,63,32,31,2020
2020-01-31,Negeri Sembilan,28,2,26,2020
2020-02-01,Negeri Sembilan,71,27,44,2020
2020-02-02,Negeri Sembilan,0,0,0,2020
2020-02-03,Negeri Sembilan,50,13,37,2020
2020-02-04,Negeri Sembilan,24,1,23,2020
2020-02-05,Negeri Sembilan,49,6,43,2020
2020-02-06,Negeri Sembilan,93,16,77,2020
2020-02-07,Negeri Sembilan,12,1,11,2020
2020-02-08,Negeri Sembilan,79,35,44,2020
2020-02-09,Negeri Sembilan,69,24,45,2020
2020-02-10,Negeri Sembilan,18,0,18,2020
2020-02-11,Negeri Sembilan,66,12,54,2020
2020-02-12,Negeri Sembilan,69,16,53,2020
2020-02-13,Negeri Sembilan,33,9,24,2020
2020-02-14,Negeri Sembilan,16,2,14,2020
2020-02-15,Negeri Sembilan,172,140,32,2020
2020-02-16,Negeri Sembilan,0,0,0,2020
2020-02-17,Negeri Sembilan,54,26,28,2020
2020-02-18,Negeri Sembilan,69,20,49,2020
2020-02-19,Negeri Sembilan,43,15,28,2020
2020-02-20,Negeri Sembilan,30,3,27,2020
2020-02-21,Negeri Sembilan,21,1,20,2020
2020-02-22,Negeri Sembilan,106,45,61,2020
2020-02-23,Negeri Sembilan,27,7,20,2020
2020-02-24,Negeri Sembilan,16,0,16,2020
2020-02-25,Negeri Sembilan,72,6,66,2020
2020-02-26,Negeri Sembilan,82,33,49,2020
2020-02-27,Negeri Sembilan,165,33,132,2020
2020-02-28,Negeri Sembilan,28,3,25,2020
2020-02-29,Negeri Sembilan,88,17,71,2020
2020-03-01,Negeri Sembilan,96,30,66,2020
2020-03-02,Negeri Sembilan,35,6,29,2020
2020-03-03,Negeri Sembilan,60,14,46,2020
2020-03-04,Negeri Sembilan,98,37,61,2020
2020-03-05,Negeri Sembilan,102,32,70,2020
2020-03-06,Negeri Sembilan,13,2,11,2020
2020-03-07,Negeri Sembilan,132,37,95,2020
2020-03-08,Negeri Sembilan,153,41,112,2020
2020-03-09,Negeri Sembilan,22,2,20,2020
2020-03-10,Negeri Sembilan,70,24,46,2020
2020-03-11,Negeri Sembilan,39,10,29,2020
2020-03-12,Negeri Sembilan,36,5,31,2020
2020-03-13,Negeri Sembilan,68,28,40,2020
2020-03-14,Negeri Sembilan,72,19,53,2020
2020-03-15,Negeri Sembilan,101,18,83,2020
2020-03-16,Negeri Sembilan,24,1,23,2020
2020-03-17,Negeri Sembilan,17,2,15,2020
2020-03-18,Negeri Sembilan,21,2,19,2020
2020-03-19,Negeri Sembilan,33,5,28,2020
2020-03-20,Negeri Sembilan,34,5,29,2020
2020-03-21,Negeri Sembilan,17,4,13,2020
2020-03-22,Negeri Sembilan,2,0,2,2020
2020-03-23,Negeri Sembilan,0,0,0,2020
2020-03-24,Negeri Sembilan,24,5,19,2020
2020-03-25,Negeri Sembilan,37,2,35,2020
2020-03-26,Negeri Sembilan,33,4,29,2020
2020-03-27,Negeri Sembilan,28,5,23,2020
2020-03-28,Negeri Sembilan,14,1,13,2020
2020-03-29,Negeri Sembilan,13,2,11,2020
2020-03-30,Negeri Sembilan,36,5,31,2020
2020-03-31,Negeri Sembilan,36,8,28,2020
2020-04-01,Negeri Sembilan,17,1,16,2020
2020-04-02,Negeri Sembilan,11,3,8,2020
2020-04-03,Negeri Sembilan,18,1,17,2020
2020-04-04,Negeri Sembilan,10,1,9,2020
2020-04-05,Negeri Sembilan,7,1,6,2020
2020-04-06,Negeri Sembilan,15,2,13,2020
2020-04-07,Negeri Sembilan,20,2,18,2020
2020-04-08,Negeri Sembilan,11,1,10,2020
2020-04-09,Negeri Sembilan,6,0,6,2020
2020-04-10,Negeri Sembilan,28,4,24,2020
2020-04-11,Negeri Sembilan,12,0,12,2020
2020-04-12,Negeri Sembilan,11,1,10,2020
2020-04-13,Negeri Sembilan,29,2,27,2020
2020-04-14,Negeri Sembilan,34,4,30,2020
2020-04-15,Negeri Sembilan,20,0,20,2020
2020-04-16,Negeri Sembilan,21,2,19,2020
2020-04-17,Negeri Sembilan,31,9,22,2020
2020-04-18,Negeri Sembilan,10,3,7,2020
2020-04-19,Negeri Sembilan,8,2,6,2020
2020-04-20,Negeri Sembilan,58,29,29,2020
2020-04-21,Negeri Sembilan,43,7,36,2020
2020-04-22,Negeri Sembilan,43,10,33,2020
2020-04-23,Negeri Sembilan,114,45,69,2020
2020-04-24,Negeri Sembilan,12,1,11,2020
2020-04-25,Negeri Sembilan,2,0,2,2020
2020-04-26,Negeri Sembilan,5,1,4,2020
2020-04-27,Negeri Sembilan,23,3,20,2020
2020-04-28,Negeri Sembilan,38,7,31,2020
2020-04-29,Negeri Sembilan,43,10,33,2020
2020-04-30,Negeri Sembilan,22,0,22,2020
2020-05-01,Negeri Sembilan,0,0,0,2020
2020-05-02,Negeri Sembilan,14,1,13,2020
2020-05-03,Negeri Sembilan,3,0,3,2020
2020-05-04,Negeri Sembilan,30,4,26,2020
2020-05-05,Negeri Sembilan,55,5,50,2020
2020-05-06,Negeri Sembilan,23,3,20,2020
2020-05-07,Negeri Sembilan,0,0,0,2020
2020-05-08,Negeri Sembilan,29,4,25,2020
2020-05-09,Negeri Sembilan,20,5,15,2020
2020-05-10,Negeri Sembilan,16,2,14,2020
2020-05-11,Negeri Sembilan,34,4,30,2020
2020-05-12,Negeri Sembilan,42,6,36,2020
2020-05-13,Negeri Sembilan,19,4,15,2020
2020-05-14,Negeri Sembilan,23,1,22,2020
2020-05-15,Negeri Sembilan,13,2,11,2020
2020-05-16,Negeri Sembilan,65,11,54,2020
2020-05-17,Negeri Sembilan,13,1,12,2020
2020-05-18,Negeri Sembilan,75,15,60,2020
2020-05-19,Negeri Sembilan,47,16,31,2020
2020-05-20,Negeri Sembilan,75,20,55,2020
2020-05-21,Negeri Sembilan,126,54,72,2020
2020-05-22,Negeri Sembilan,95,42,53,2020
2020-05-23,Negeri Sembilan,0,0,0,2020
2020-05-24,Negeri Sembilan,0,0,0,2020
2020-05-25,Negeri Sembilan,0,0,0,2020
2020-05-26,Negeri Sembilan,70,10,60,2020
2020-05-27,Negeri Sembilan,55,12,43,2020
2020-05-28,Negeri Sembilan,97,32,65,2020
2020-05-29,Negeri Sembilan,36,3,33,2020
2020-05-30,Negeri Sembilan,121,27,94,2020
2020-05-31,Negeri Sembilan,172,43,129,2020
2020-06-01,Negeri Sembilan,99,20,79,2020
2020-06-02,Negeri Sembilan,98,29,69,2020
2020-06-03,Negeri Sembilan,29,2,27,2020
2020-06-04,Negeri Sembilan,121,45,76,2020
2020-06-05,Negeri Sembilan,21,4,17,2020
2020-06-06,Negeri Sembilan,0,0,0,2020
2020-06-07,Negeri Sembilan,0,0,0,2020
2020-06-08,Negeri Sembilan,0,0,0,2020
2020-06-09,Negeri Sembilan,30,2,28,2020
2020-06-10,Negeri Sembilan,24,2,22,2020
2020-06-11,Negeri Sembilan,94,31,63,2020
2020-06-12,Negeri Sembilan,19,3,16,2020
2020-06-13,Negeri Sembilan,0,0,0,2020
2020-06-14,Negeri Sembilan,0,0,0,2020
2020-06-15,Negeri Sembilan,32,6,26,2020
2020-06-16,Negeri Sembilan,32,3,29,2020
2020-06-17,Negeri Sembilan,70,29,41,2020
2020-06-18,Negeri Sembilan,19,4,15,2020
2020-06-19,Negeri Sembilan,121,45,76,2020
2020-06-20,Negeri Sembilan,50,23,27,2020
2020-06-21,Negeri Sembilan,52,23,29,2020
2020-06-22,Negeri Sembilan,35,6,29,2020
2020-06-23,Negeri Sembilan,25,3,22,2020
2020-06-24,Negeri Sembilan,11,0,11,2020
2020-06-25,Negeri Sembilan,113,42,71,2020
2020-06-26,Negeri Sembilan,23,4,19,2020
2020-06-27,Negeri Sembilan,193,64,129,2020
2020-06-28,Negeri Sembilan,241,66,175,2020
2020-06-29,Negeri Sembilan,33,3,30,2020
2020-06-30,Negeri Sembilan,26,2,24,2020
2020-07-01,Negeri Sembilan,69,6,63,2020
2020-07-02,Negeri Sembilan,17,4,13,2020
2020-07-03,Negeri Sembilan,22,2,20,2020
2020-07-04,Negeri Sembilan,119,53,66,2020
2020-07-05,Negeri Sembilan,77,24,53,2020
2020-07-06,Negeri Sembilan,23,1,22,2020
2020-07-07,Negeri Sembilan,19,3,16,2020
2020-07-08,Negeri Sembilan,18,3,15,2020
2020-07-09,Negeri Sembilan,117,82,35,2020
2020-07-10,Negeri Sembilan,27,2,25,2020
2020-07-11,Negeri Sembilan,0,0,0,2020
2020-07-12,Negeri Sembilan,46,7,39,2020
2020-07-13,Negeri Sembilan,74,20,54,2020
2020-07-14,Negeri Sembilan,12,0,12,2020
2020-07-15,Negeri Sembilan,99,15,84,2020
2020-07-16,Negeri Sembilan,23,4,19,2020
2020-07-17,Negeri Sembilan,25,3,22,2020
2020-07-18,Negeri Sembilan,0,0,0,2020
2020-07-19,Negeri Sembilan,133,18,115,2020
2020-07-20,Negeri Sembilan,36,6,30,2020
2020-07-21,Negeri Sembilan,24,2,22,2020
2020-07-22,Negeri Sembilan,17,2,15,2020
2020-07-23,Negeri Sembilan,170,113,57,2020
2020-07-24,Negeri Sembilan,11,3,8,2020
2020-07-25,Negeri Sembilan,37,10,27,2020
2020-07-26,Negeri Sembilan,51,10,41,2020
2020-07-27,Negeri Sembilan,28,1,27,2020
2020-07-28,Negeri Sembilan,73,19,54,2020
2020-07-29,Negeri Sembilan,8,2,6,2020
2020-07-30,Negeri Sembilan,21,1,20,2020
2020-07-31,Negeri Sembilan,0,0,0,2020
2020-08-01,Negeri Sembilan,0,0,0,2020
2020-08-02,Negeri Sembilan,0,0,0,2020
2020-08-03,Negeri Sembilan,25,2,23,2020
2020-08-04,Negeri Sembilan,31,4,27,2020
2020-08-05,Negeri Sembilan,50,11,39,2020
2020-08-06,Negeri Sembilan,20,2,18,2020
2020-08-07,Negeri Sembilan,29,5,24,2020
2020-08-08,Negeri Sembilan,37,12,25,2020
2020-08-09,Negeri Sembilan,149,45,104,2020
2020-08-10,Negeri Sembilan,72,13,59,2020
2020-08-11,Negeri Sembilan,26,1,25,2020
2020-08-12,Negeri Sembilan,39,0,39,2020
2020-08-13,Negeri Sembilan,34,6,28,2020
2020-08-14,Negeri Sembilan,31,4,27,2020
2020-08-15,Negeri Sembilan,28,3,25,2020
2020-08-16,Negeri Sembilan,90,17,73,2020
2020-08-17,Negeri Sembilan,32,2,30,2020
2020-08-18,Negeri Sembilan,44,14,30,2020
2020-08-19,Negeri Sembilan,26,4,22,2020
2020-08-20,Negeri Sembilan,0,0,0,2020
2020-08-21,Negeri Sembilan,25,4,21,2020
2020-08-22,Negeri Sembilan,79,18,61,2020
2020-08-23,Negeri Sembilan,136,40,96,2020
2020-08-24,Negeri Sembilan,36,6,30,2020
2020-08-25,Negeri Sembilan,25,2,23,2020
2020-08-26,Negeri Sembilan,32,3,29,2020
2020-08-27,Negeri Sembilan,75,31,44,2020
2020-08-28,Negeri Sembilan,15,2,13,2020
2020-08-29,Negeri Sembilan,0,0,0,2020
2020-08-30,Negeri Sembilan,78,21,57,2020
2020-08-31,Negeri Sembilan,104,19,85,2020
2020-09-01,Negeri Sembilan,91,46,45,2020
2020-09-02,Negeri Sembilan,25,2,23,2020
2020-09-03,Negeri Sembilan,105,27,78,2020
2020-09-04,Negeri Sembilan,75,17,58,2020
2020-09-05,Negeri Sembilan,31,16,15,2020
2020-09-06,Negeri Sembilan,49,20,29,2020
2020-09-07,Negeri Sembilan,27,2,25,2020
2020-09-08,Negeri Sembilan,25,2,23,2020
2020-09-09,Negeri Sembilan,67,45,22,2020
2020-09-10,Negeri Sembilan,31,3,28,2020
2020-09-11,Negeri Sembilan,18,1,17,2020
2020-09-12,Negeri Sembilan,0,0,0,2020
2020-09-13,Negeri Sembilan,138,27,111,2020
2020-09-14,Negeri Sembilan,44,5,39,2020
2020-09-15,Negeri Sembilan,30,0,30,2020
2020-09-16,Negeri Sembilan,0,0,0,2020
2020-09-17,Negeri Sembilan,27,3,24,2020
2020-09-18,Negeri Sembilan,22,2,20,2020
2020-09-19,Negeri Sembilan,0,0,0,2020
2020-09-20,Negeri Sembilan,94,16,78,2020
2020-09-21,Negeri Sembilan,19,1,18,2020
2020-09-22,Negeri Sembilan,27,2,25,2020
2020-09-23,Negeri Sembilan,62,8,54,2020
2020-09-24,Negeri Sembilan,19,2,17,2020
2020-09-25,Negeri Sembilan,16,0,16,2020
2020-09-26,Negeri Sembilan,87,22,65,2020
2020-09-27,Negeri Sembilan,82,12,70,2020
2020-09-28,Negeri Sembilan,30,5,25,2020
2020-09-29,Negeri Sembilan,152,58,94,2020
2020-09-30,Negeri Sembilan,89,22,67,2020
2020-10-01,Negeri Sembilan,44,5,39,2020
2020-10-02,Negeri Sembilan,16,1,15,2020
2020-10-03,Negeri Sembilan,14,1,13,2020
2020-10-04,Negeri Sembilan,20,0,20,2020
2020-10-05,Negeri Sembilan,30,2,28,2020
2020-10-06,Negeri Sembilan,25,1,24,2020
2020-10-07,Negeri Sembilan,14,0,14,2020
2020-10-08,Negeri Sembilan,54,15,39,2020
2020-10-09,Negeri Sembilan,23,2,21,2020
2020-10-10,Negeri Sembilan,48,23,25,2020
2020-10-11,Negeri Sembilan,0,0,0,2020
2020-10-12,Negeri Sembilan,33,4,29,2020
2020-10-13,Negeri Sembilan,21,1,20,2020
2020-10-14,Negeri Sembilan,86,21,65,2020
2020-10-15,Negeri Sembilan,58,17,41,2020
2020-10-16,Negeri Sembilan,35,5,30,2020
2020-10-17,Negeri Sembilan,90,13,77,2020
2020-10-18,Negeri Sembilan,85,17,68,2020
2020-10-19,Negeri Sembilan,55,12,43,2020
2020-10-20,Negeri Sembilan,28,0,28,2020
2020-10-21,Negeri Sembilan,26,2,24,2020
2020-10-22,Negeri Sembilan,45,4,41,2020
2020-10-23,Negeri Sembilan,75,15,60,2020
2020-10-24,Negeri Sembilan,0,0,0,2020
2020-10-25,Negeri Sembilan,100,31,69,2020
2020-10-26,Negeri Sembilan,31,3,28,2020
2020-10-27,Negeri Sembilan,73,11,62,2020
2020-10-28,Negeri Sembilan,25,2,23,2020
2020-10-29,Negeri Sembilan,0,0,0,2020
2020-10-30,Negeri Sembilan,27,3,24,2020
2020-10-31,Negeri Sembilan,0,0,0,2020
2020-11-01,Negeri Sembilan,213,32,181,2020
2020-11-02,Negeri Sembilan,17,0,17,2020
2020-11-03,Negeri Sembilan,18,1,17,2020
2020-11-04,Negeri Sembilan,28,4,24,2020
2020-11-05,Negeri Sembilan,9,1,8,2020
2020-11-06,Negeri Sembilan,12,1,11,2020
2020-11-07,Negeri Sembilan,91,20,71,2020
2020-11-08,Negeri Sembilan,133,40,93,2020
2020-11-09,Negeri Sembilan,53,23,30,2020
2020-11-10,Negeri Sembilan,29,6,23,2020
2020-11-11,Negeri Sembilan,27,1,26,2020
2020-11-12,Negeri Sembilan,18,1,17,2020
2020-11-13,Negeri Sembilan,26,5,21,2020
2020-11-14,Negeri Sembilan,102,38,64,2020
2020-11-15,Negeri Sembilan,115,27,88,2020
2020-11-16,Negeri Sembilan,45,5,40,2020
2020-11-17,Negeri Sembilan,20,1,19,2020
2020-11-18,Negeri Sembilan,24,7,17,2020
2020-11-19,Negeri Sembilan,26,4,22,2020
2020-11-20,Negeri Sembilan,20,2,18,2020
2020-11-21,Negeri Sembilan,62,20,42,2020
2020-11-22,Negeri Sembilan,88,27,61,2020
2020-11-23,Negeri Sembilan,19,2,17,2020
2020-11-24,Negeri Sembilan,31,2,29,2020
2020-11-25,Negeri Sembilan,24,3,21,2020
2020-11-26,Negeri Sembilan,14,1,13,2020
2020-11-27,Negeri Sembilan,24,1,23,2020
2020-11-28,Negeri Sembilan,0,0,0,2020
2020-11-29,Negeri Sembilan,124,16,108,2020
2020-11-30,Negeri Sembilan,23,1,22,2020
2020-12-01,Negeri Sembilan,79,11,68,2020
2020-12-02,Negeri Sembilan,86,20,66,2020
2020-12-03,Negeri Sembilan,62,9,53,2020
2020-12-04,Negeri Sembilan,21,0,21,2020
2020-12-05,Negeri Sembilan,26,8,18,2020
2020-12-06,Negeri Sembilan,0,0,0,2020
2020-12-07,Negeri Sembilan,14,1,13,2020
2020-12-08,Negeri Sembilan,27,1,26,2020
2020-12-09,Negeri Sembilan,14,2,12,2020
2020-12-10,Negeri Sembilan,115,46,69,2020
2020-12-11,Negeri Sembilan,35,2,33,2020
2020-12-12,Negeri Sembilan,0,0,0,2020
2020-12-13,Negeri Sembilan,0,0,0,2020
2020-12-14,Negeri Sembilan,31,2,29,2020
2020-12-15,Negeri Sembilan,23,5,18,2020
2020-12-16,Negeri Sembilan,26,2,24,2020
2020-12-17,Negeri Sembilan,105,28,77,2020
2020-12-18,Negeri Sembilan,30,3,27,2020
2020-12-19,Negeri Sembilan,0,0,0,2020
2020-12-20,Negeri Sembilan,79,13,66,2020
2020-12-21,Negeri Sembilan,24,1,23,2020
2020-12-22,Negeri Sembilan,31,3,28,2020
2020-12-23,Negeri Sembilan,29,2,27,2020
2020-12-24,Negeri Sembilan,41,2,39,2020
2020-12-25,Negeri Sembilan,0,0,0,2020
2020-12-26,Negeri Sembilan,81,15,66,2020
2020-12-27,Negeri Sembilan,101,22,79,2020
2020-12-28,Negeri Sembilan,23,1,22,2020
2020-12-29,Negeri Sembilan,32,3,29,2020
2020-12-30,Negeri Sembilan,126,44,82,2020
2020-12-31,Negeri Sembilan,23,2,21,2020
2021-01-01,Negeri Sembilan,0,0,0,2021
2021-01-02,Negeri Sembilan,89,19,70,2021
2021-01-03,Negeri Sembilan,124,26,98,2021
2021-01-04,Negeri Sembilan,30,4,26,2021
2021-01-05,Negeri Sembilan,19,2,17,2021
2021-01-06,Negeri Sembilan,22,1,21,2021
2021-01-07,Negeri Sembilan,50,11,39,2021
2021-01-08,Negeri Sembilan,26,4,22,2021
2021-01-09,Negeri Sembilan,0,0,0,2021
2021-01-10,Negeri Sembilan,0,0,0,2021
2021-01-11,Negeri Sembilan,67,9,58,2021
2021-01-12,Negeri Sembilan,20,3,17,2021
2021-01-13,Negeri Sembilan,26,4,22,2021
2021-01-14,Negeri Sembilan,102,27,75,2021
2021-01-15,Negeri Sembilan,27,4,23,2021
2021-01-16,Negeri Sembilan,0,0,0,2021
2021-01-17,Negeri Sembilan,146,55,91,2021
2021-01-18,Negeri Sembilan,25,2,23,2021
2021-01-19,Negeri Sembilan,16,1,15,2021
2021-01-20,Negeri Sembilan,14,1,13,2021
2021-01-21,Negeri Sembilan,22,1,21,2021
2021-01-22,Negeri Sembilan,15,2,13,2021
2021-01-23,Negeri Sembilan,21,1,20,2021
2021-01-24,Negeri Sembilan,18,5,13,2021
2021-01-25,Negeri Sembilan,40,2,38,2021
2021-01-26,Negeri Sembilan,21,1,20,2021
2021-01-27,Negeri Sembilan,21,2,19,2021
2021-01-28,Negeri Sembilan,0,0,0,2021
2021-01-29,Negeri Sembilan,40,8,32,2021
2021-01-30,Negeri Sembilan,97,25,72,2021
2021-01-31,Negeri Sembilan,121,35,86,2021
2021-02-01,Negeri Sembilan,30,2,28,2021
2021-02-02,Negeri Sembilan,21,0,21,2021
2021-02-03,Negeri Sembilan,154,74,80,2021
2021-02-04,Negeri Sembilan,19,1,18,2021
2021-02-05,Negeri Sembilan,35,0,35,2021
2021-02-06,Negeri Sembilan,45,8,37,2021
2021-02-07,Negeri Sembilan,107,17,90,2021
2021-02-08,Negeri Sembilan,26,7,19,2021
2021-02-09,Negeri Sembilan,80,18,62,2021
2021-02-10,Negeri Sembilan,27,0,27,2021
2021-02-11,Negeri Sembilan,49,3,46,2021
2021-02-12,Negeri Sembilan,0,0,0,2021
2021-02-13,Negeri Sembilan,109,30,79,2021
2021-02-14,Negeri Sembilan,131,39,92,2021
2021-02-15,Negeri Sembilan,59,7,52,2021
2021-02-16,Negeri Sembilan,36,3,33,2021
2021-02-17,Negeri Sembilan,24,1,23,2021
2021-02-18,Negeri Sembilan,44,5,39,2021
2021-02-19,Negeri Sembilan,19,0,19,2021
2021-02-20,Negeri Sembilan,104,31,73,2021
2021-02-21,Negeri Sembilan,138,23,115,2021
2021-02-22,Negeri Sembilan,28,2,26,2021
2021-02-23,Negeri Sembilan,65,8,57,2021
2021-02-24,Negeri Sembilan,16,3,13,2021
2021-02-25,Negeri Sembilan,68,8,60,2021
2021-02-26,Negeri Sembilan,37,6,31,2021
2021-02-27,Negeri Sembilan,0,0,0,2021
2021-02-28,Negeri Sembilan,107,24,83,2021
2021-03-01,Negeri Sembilan,23,2,21,2021
2021-03-02,Negeri Sembilan,26,3,23,2021
2021-03-03,Negeri Sembilan,20,1,19,2021
2021-03-04,Negeri Sembilan,34,11,23,2021
2021-03-05,Negeri Sembilan,44,7,37,2021
2021-03-06,Negeri Sembilan,87,15,72,2021
2021-03-07,Negeri Sembilan,0,0,0,2021
2021-03-08,Negeri Sembilan,33,2,31,2021
2021-03-09,Negeri Sembilan,33,5,28,2021
2021-03-10,Negeri Sembilan,72,10,62,2021
2021-03-11,Negeri Sembilan,0,0,0,2021
2021-03-12,Negeri Sembilan,24,1,23,2021
2021-03-13,Negeri Sembilan,70,16,54,2021
2021-03-14,Negeri Sembilan,120,37,83,2021
2021-03-15,Negeri Sembilan,28,1,27,2021
2021-03-16,Negeri Sembilan,29,2,27,2021
2021-03-17,Negeri Sembilan,42,7,35,2021
2021-03-18,Negeri Sembilan,38,9,29,2021
2021-03-19,Negeri Sembilan,34,6,28,2021
2021-03-20,Negeri Sembilan,0,0,0,2021
2021-03-21,Negeri Sembilan,122,22,100,2021
2021-03-22,Negeri Sembilan,18,2,16,2021
2021-03-23,Negeri Sembilan,29,3,26,2021
2021-03-24,Negeri Sembilan,17,1,16,2021
2021-03-25,Negeri Sembilan,9,0,9,2021
2021-03-26,Negeri Sembilan,16,0,16,2021
2021-03-27,Negeri Sembilan,0,0,0,2021
2021-03-28,Negeri Sembilan,123,20,103,2021
2021-03-29,Negeri Sembilan,21,0,21,2021
2021-03-30,Negeri Sembilan,18,1,17,2021
2021-03-31,Negeri Sembilan,63,22,41,2021
2021-04-01,Negeri Sembilan,16,0,16,2021
2021-04-02,Negeri Sembilan,22,0,22,2021
2021-04-03,Negeri Sembilan,0,0,0,2021
2021-04-04,Negeri Sembilan,88,23,65,2021
2021-04-05,Negeri Sembilan,74,32,42,2021
2021-04-06,Negeri Sembilan,22,2,20,2021
2021-04-07,Negeri Sembilan,22,6,16,2021
2021-04-08,Negeri Sembilan,68,26,42,2021
2021-04-09,Negeri Sembilan,22,0,22,2021
2021-04-10,Negeri Sembilan,163,63,100,2021
2021-04-11,Negeri Sembilan,215,58,157,2021
2021-04-12,Negeri Sembilan,57,6,51,2021
2021-04-13,Negeri Sembilan,17,2,15,2021
2021-04-14,Negeri Sembilan,11,0,11,2021
2021-04-15,Negeri Sembilan,8,0,8,2021
2021-04-16,Negeri Sembilan,16,1,15,2021
2021-04-17,Negeri Sembilan,24,8,16,2021
2021-04-18,Negeri Sembilan,31,8,23,2021
2021-04-19,Negeri Sembilan,13,0,13,2021
2021-04-20,Negeri Sembilan,21,2,19,2021
2021-04-21,Negeri Sembilan,64,27,37,2021
2021-04-22,Negeri Sembilan,14,1,13,2021
2021-04-23,Negeri Sembilan,12,1,11,2021
2021-04-24,Negeri Sembilan,0,0,0,2021
2021-04-25,Negeri Sembilan,197,35,162,2021
2021-04-26,Negeri Sembilan,18,0,18,2021
2021-04-27,Negeri Sembilan,13,0,13,2021
2021-04-28,Negeri Sembilan,59,1,58,2021
2021-04-29,Negeri Sembilan,25,0,25,2021
2021-04-30,Negeri Sembilan,18,0,18,2021
2021-05-01,Negeri Sembilan,0,0,0,2021
2021-05-02,Negeri Sembilan,41,3,38,2021
2021-05-03,Negeri Sembilan,19,2,17,2021
2021-05-04,Negeri Sembilan,19,2,17,2021
2021-05-05,Negeri Sembilan,124,12,112,2021
2021-05-06,Negeri Sembilan,29,1,28,2021
2021-05-07,Negeri Sembilan,20,5,15,2021
2021-05-08,Negeri Sembilan,126,17,109,2021
2021-05-09,Negeri Sembilan,0,0,0,2021
2021-05-10,Negeri Sembilan,49,3,46,2021
2021-05-11,Negeri Sembilan,107,21,86,2021
2021-05-12,Negeri Sembilan,19,0,19,2021
2021-05-13,Negeri Sembilan,0,0,0,2021
2021-05-14,Negeri Sembilan,0,0,0,2021
2021-05-15,Negeri Sembilan,0,0,0,2021
2021-05-16,Negeri Sembilan,113,11,102,2021
2021-05-17,Negeri Sembilan,50,6,44,2021
2021-05-18,Negeri Sembilan,34,2,32,2021
2021-05-19,Negeri Sembilan,39,8,31,2021
2021-05-20,Negeri Sembilan,32,4,28,2021
2021-05-21,Negeri Sembilan,26,3,23,2021
2021-05-22,Negeri Sembilan,116,20,96,2021
2021-05-23,Negeri Sembilan,152,26,126,2021
2021-05-24,Negeri Sembilan,38,2,36,2021
2021-05-25,Negeri Sembilan,31,0,31,2021
2021-05-26,Negeri Sembilan,0,0,0,2021
2021-05-27,Negeri Sembilan,31,4,27,2021
2021-05-28,Negeri Sembilan,23,1,22,2021
2021-05-29,Negeri Sembilan,58,9,49,2021
2021-05-30,Negeri Sembilan,117,20,97,2021
2021-05-31,Negeri Sembilan,36,3,33,2021
2021-06-01,Negeri Sembilan,14,1,13,2021
2021-06-02,Negeri Sembilan,13,3,10,2021
2021-06-03,Negeri Sembilan,21,2,19,2021
2021-06-04,Negeri Sembilan,20,0,20,2021
2021-06-05,Negeri Sembilan,0,0,0,2021
2021-06-06,Negeri Sembilan,55,14,41,2021
2021-06-07,Negeri Sembilan,0,0,0,2021
2021-06-08,Negeri Sembilan,22,0,22,2021
2021-06-09,Negeri Sembilan,20,0,20,2021
2021-06-10,Negeri Sembilan,25,2,23,2021
2021-06-11,Negeri Sembilan,27,2,25,2021
2021-06-12,Negeri Sembilan,26,5,21,2021
2021-06-13,Negeri Sembilan,30,6,24,2021
2021-06-14,Negeri Sembilan,31,4,27,2021
2021-06-15,Negeri Sembilan,32,6,26,2021
2021-06-16,Negeri Sembilan,20,0,20,2021
2021-06-17,Negeri Sembilan,55,9,46,2021
2021-06-18,Negeri Sembilan,29,6,23,2021
2021-06-19,Negeri Sembilan,49,10,39,2021
2021-06-20,Negeri Sembilan,56,13,43,2021
2021-06-21,Negeri Sembilan,22,5,17,2021
2021-06-22,Negeri Sembilan,27,0,27,2021
2021-06-23,Negeri Sembilan,22,2,20,2021
2021-06-24,Negeri Sembilan,21,4,17,2021
2021-06-25,Negeri Sembilan,27,5,22,2021
2021-06-26,Negeri Sembilan,28,4,24,2021
2021-06-27,Negeri Sembilan,33,6,27,2021
2021-06-28,Negeri Sembilan,28,1,27,2021
2021-06-29,Negeri Sembilan,24,2,22,2021
2021-06-30,Negeri Sembilan,21,4,17,2021
2021-07-01,Negeri Sembilan,26,5,21,2021
2021-07-02,Negeri Sembilan,25,2,23,2021
2021-07-03,Negeri Sembilan,55,11,44,2021
2021-07-04,Negeri Sembilan,106,16,90,2021
2021-07-05,Negeri Sembilan,34,4,30,2021
2021-07-06,Negeri Sembilan,26,3,23,2021
2021-07-07,Negeri Sembilan,33,4,29,2021
2021-07-08,Negeri Sembilan,20,0,20,2021
2021-07-09,Negeri Sembilan,1,0,1,2021
2021-07-10,Negeri Sembilan,0,0,0,2021
2021-07-11,Negeri Sembilan,0,0,0,2021
2021-07-12,Negeri Sembilan,26,2,24,2021
2021-07-13,Negeri Sembilan,25,4,21,2021
2021-07-14,Negeri Sembilan,23,1,22,2021
2021-07-15,Negeri Sembilan,13,2,11,2021
2021-07-16,Negeri Sembilan,14,0,14,2021
2021-07-17,Negeri Sembilan,8,0,8,2021
2021-07-18,Negeri Sembilan,10,3,7,2021
2021-07-19,Negeri Sembilan,16,0,16,2021
2021-07-20,Negeri Sembilan,0,0,0,2021
2021-07-21,Negeri Sembilan,21,4,17,2021
2021-07-22,Negeri Sembilan,70,21,49,2021
2021-07-23,Negeri Sembilan,26,1,25,2021
2021-07-24,Negeri Sembilan,28,9,19,2021
2021-07-25,Negeri Sembilan,16,4,12,2021
2021-07-26,Negeri Sembilan,11,4,7,2021
2021-07-27,Negeri Sembilan,28,2,26,2021
2021-07-28,Negeri Sembilan,44,4,40,2021
2021-07-29,Negeri Sembilan,143,83,60,2021
2021-07-30,Negeri Sembilan,23,7,16,2021
2021-07-31,Negeri Sembilan,17,3,14,2021
2021-08-01,Negeri Sembilan,13,2,11,2021
2021-08-02,Negeri Sembilan,23,2,21,2021
2021-08-03,Negeri Sembilan,11,1,10,2021
2021-08-04,Negeri Sembilan,68,18,50,2021
2021-08-05,Negeri Sembilan,19,1,18,2021
2021-08-06,Negeri Sembilan,28,3,25,2021
2021-08-07,Negeri Sembilan,28,4,24,2021
2021-08-08,Negeri Sembilan,20,2,18,2021
2021-08-09,Negeri Sembilan,25,1,24,2021
2021-08-10,Negeri Sembilan,25,3,22,2021
2021-08-11,Negeri Sembilan,88,26,62,2021
2021-08-12,Negeri Sembilan,78,39,39,2021
2021-08-13,Negeri Sembilan,78,14,64,2021
2021-08-14,Negeri Sembilan,80,25,55,2021
2021-08-15,Negeri Sembilan,86,32,54,2021
2021-08-16,Negeri Sembilan,39,7,32,2021
2021-08-17,Negeri Sembilan,86,18,68,2021
2021-08-18,Negeri Sembilan,106,32,74,2021
2021-08-19,Negeri Sembilan,46,13,33,2021
2021-08-20,Negeri Sembilan,29,2,27,2021
2021-08-21,Negeri Sembilan,155,28,127,2021
2021-08-22,Negeri Sembilan,132,37,95,2021
2021-08-23,Negeri Sembilan,64,15,49,2021
2021-08-24,Negeri Sembilan,35,6,29,2021
2021-08-25,Negeri Sembilan,93,14,79,2021
2021-08-26,Negeri Sembilan,113,11,102,2021
2021-08-27,Negeri Sembilan,40,11,29,2021
2021-08-28,Negeri Sembilan,0,0,0,2021
2021-08-29,Negeri Sembilan,113,25,88,2021
2021-08-30,Negeri Sembilan,44,7,37,2021
2021-08-31,Negeri Sembilan,118,29,89,2021
2021-09-01,Negeri Sembilan,40,7,33,2021
2021-09-02,Negeri Sembilan,159,75,84,2021
2021-09-03,Negeri Sembilan,40,12,28,2021
2021-09-04,Negeri Sembilan,66,27,39,2021
2021-09-05,Negeri Sembilan,0,0,0,2021
2021-09-06,Negeri Sembilan,34,3,31,2021
2021-09-07,Negeri Sembilan,39,6,33,2021
2021-09-08,Negeri Sembilan,166,56,110,2021
2021-09-09,Negeri Sembilan,27,4,23,2021
2021-09-10,Negeri Sembilan,28,2,26,2021
2021-09-11,Negeri Sembilan,0,0,0,2021
2021-09-12,Negeri Sembilan,79,10,69,2021
2021-09-13,Negeri Sembilan,28,6,22,2021
2021-09-14,Negeri Sembilan,20,1,19,2021
2021-09-15,Negeri Sembilan,27,2,25,2021
2021-09-16,Negeri Sembilan,110,20,90,2021
2021-09-17,Negeri Sembilan,23,1,22,2021
2021-09-18,Negeri Sembilan,0,0,0,2021
2021-09-19,Negeri Sembilan,116,27,89,2021
2021-09-20,Negeri Sembilan,28,3,25,2021
2021-09-21,Negeri Sembilan,26,2,24,2021
2021-09-22,Negeri Sembilan,50,17,33,2021
2021-09-23,Negeri Sembilan,33,8,25,2021
2021-09-24,Negeri Sembilan,29,2,27,2021
2021-09-25,Negeri Sembilan,0,0,0,2021
2021-09-26,Negeri Sembilan,81,23,58,2021
2021-09-27,Negeri Sembilan,32,1,31,2021
2021-09-28,Negeri Sembilan,17,2,15,2021
2021-09-29,Negeri Sembilan,28,2,26,2021
2021-09-30,Negeri Sembilan,82,24,58,2021
2021-10-01,Negeri Sembilan,21,1,20,2021
2021-10-02,Negeri Sembilan,0,0,0,2021
2021-10-03,Negeri Sembilan,58,13,45,2021
2021-10-04,Negeri Sembilan,18,1,17,2021
2021-10-05,Negeri Sembilan,15,0,15,2021
2021-10-06,Negeri Sembilan,33,6,27,2021
2021-10-07,Negeri Sembilan,14,1,13,2021
2021-10-08,Negeri Sembilan,25,3,22,2021
2021-10-09,Negeri Sembilan,85,21,64,2021
2021-10-10,Negeri Sembilan,58,8,50,2021
2021-10-11,Negeri Sembilan,14,0,14,2021
2021-10-12,Negeri Sembilan,26,4,22,2021
2021-10-13,Negeri Sembilan,22,1,21,2021
2021-10-14,Negeri Sembilan,60,21,39,2021
2021-10-15,Negeri Sembilan,29,3,26,2021
2021-10-16,Negeri Sembilan,0,0,0,2021
2021-10-17,Negeri Sembilan,65,7,58,2021
2021-10-18,Negeri Sembilan,32,0,32,2021
2021-10-19,Negeri Sembilan,0,0,0,2021
2021-10-20,Negeri Sembilan,63,20,43,2021
2021-10-21,Negeri Sembilan,20,1,19,2021
2021-10-22,Negeri Sembilan,11,0,11,2021
2021-10-23,Negeri Sembilan,0,0,0,2021
2021-10-24,Negeri Sembilan,78,20,58,2021
2021-10-25,Negeri Sembilan,18,0,18,2021
2021-10-26,Negeri Sembilan,27,4,23,2021
2021-10-27,Negeri Sembilan,84,9,75,2021
2021-10-28,Negeri Sembilan,15,1,14,2021
2021-10-29,Negeri Sembilan,21,0,21,2021
2021-10-30,Negeri Sembilan,50,15,35,2021
2021-10-31,Negeri Sembilan,0,0,0,2021
2021-11-01,Negeri Sembilan,32,4,28,2021
2021-11-02,Negeri Sembilan,17,1,16,2021
2021-11-03,Negeri Sembilan,46,15,31,2021
2021-11-04,Negeri Sembilan,0,0,0,2021
2021-11-05,Negeri Sembilan,29,3,26,2021
2021-11-06,Negeri Sembilan,0,0,0,2021
2021-11-07,Negeri Sembilan,42,14,28,2021
2021-11-08,Negeri Sembilan,18,1,17,2021
2021-11-09,Negeri Sembilan,10,0,10,2021
2021-11-10,Negeri Sembilan,42,2,40,2021
2021-11-11,Negeri Sembilan,21,1,20,2021
2021-11-12,Negeri Sembilan,22,2,20,2021
2021-11-13,Negeri Sembilan,102,23,79,2021
2021-11-14,Negeri Sembilan,74,16,58,2021
2021-11-15,Negeri Sembilan,19,2,17,2021
2021-11-16,Negeri Sembilan,16,2,14,2021
2021-11-17,Negeri Sembilan,11,3,8,2021
2021-11-18,Negeri Sembilan,83,25,58,2021
2021-11-19,Negeri Sembilan,32,4,28,2021
2021-11-20,Negeri Sembilan,0,0,0,2021
2021-11-21,Negeri Sembilan,63,13,50,2021
2021-11-22,Negeri Sembilan,29,2,27,2021
2021-11-23,Negeri Sembilan,32,2,30,2021
2021-11-24,Negeri Sembilan,62,24,38,2021
2021-11-25,Negeri Sembilan,21,5,16,2021
2021-11-26,Negeri Sembilan,33,4,29,2021
2021-11-27,Negeri Sembilan,0,0,0,2021
2021-11-28,Negeri Sembilan,66,10,56,2021
2021-11-29,Negeri Sembilan,29,2,27,2021
2021-11-30,Negeri Sembilan,29,3,26,2021
2021-12-01,Negeri Sembilan,146,68,78,2021
2021-12-02,Negeri Sembilan,60,7,53,2021
2021-12-03,Negeri Sembilan,39,5,34,2021
2021-12-04,Negeri Sembilan,0,0,0,2021
2021-12-05,Negeri Sembilan,17,5,12,2021
2021-12-06,Negeri Sembilan,72,11,61,2021
2021-12-07,Negeri Sembilan,23,3,20,2021
2021-12-08,Negeri Sembilan,43,3,40,2021
2021-12-09,Negeri Sembilan,80,20,60,2021
2021-12-10,Negeri Sembilan,43,7,36,2021
2021-12-11,Negeri Sembilan,0,0,0,2021
2021-12-12,Negeri Sembilan,84,8,76,2021
2021-12-13,Negeri Sembilan,31,6,25,2021
2021-12-14,Negeri Sembilan,22,0,22,2021
2021-12-15,Negeri Sembilan,29,4,25,2021
2021-12-16,Negeri Sembilan,26,1,25,2021
2021-12-17,Negeri Sembilan,25,3,22,2021
2021-12-18,Negeri Sembilan,72,36,36,2021
2021-12-19,Negeri Sembilan,77,17,60,2021
2021-12-20,Negeri Sembilan,23,0,23,2021
2021-12-21,Negeri Sembilan,28,0,28,2021
2021-12-22,Negeri Sembilan,42,11,31,2021
2021-12-23,Negeri Sembilan,20,1,19,2021
2021-12-24,Negeri Sembilan,17,0,17,2021
2021-12-25,Negeri Sembilan,0,0,0,2021
2021-12-26,Negeri Sembilan,71,14,57,2021
2021-12-27,Negeri Sembilan,27,3,24,2021
2021-12-28,Negeri Sembilan,24,4,20,2021
2021-12-29,Negeri Sembilan,32,3,29,2021
2021-12-30,Negeri Sembilan,36,3,33,2021
2021-12-31,Negeri Sembilan,38,3,35,2021
2022-01-01,Negeri Sembilan,0,0,0,2022
2022-01-02,Negeri Sembilan,123,27,96,2022
2022-01-03,Negeri Sembilan,22,1,21,2022
2022-01-04,Negeri Sembilan,18,3,15,2022
2022-01-05,Negeri Sembilan,51,19,32,2022
2022-01-06,Negeri Sembilan,52,22,30,2022
2022-01-07,Negeri Sembilan,27,5,22,2022
2022-01-08,Negeri Sembilan,0,0,0,2022
2022-01-09,Negeri Sembilan,0,0,0,2022
2022-01-10,Negeri Sembilan,14,2,12,2022
2022-01-11,Negeri Sembilan,33,6,27,2022
2022-01-12,Negeri Sembilan,33,2,31,2022
2022-01-13,Negeri Sembilan,87,48,39,2022
2022-01-14,Negeri Sembilan,0,0,0,2022
2022-01-15,Negeri Sembilan,57,8,49,2022
2022-01-16,Negeri Sembilan,108,24,84,2022
2022-01-17,Negeri Sembilan,45,6,39,2022
2022-01-18,Negeri Sembilan,60,13,47,2022
2022-01-19,Negeri Sembilan,28,4,24,2022
2022-01-20,Negeri Sembilan,60,17,43,2022
2022-01-21,Negeri Sembilan,37,3,34,2022
2022-01-22,Negeri Sembilan,0,0,0,2022
2022-01-23,Negeri Sembilan,82,20,62,2022
2022-01-24,Negeri Sembilan,23,1,22,2022
2022-01-25,Negeri Sembilan,20,2,18,2022
2022-01-26,Negeri Sembilan,17,3,14,2022
2022-01-27,Negeri Sembilan,119,29,90,2022
2022-01-28,Negeri Sembilan,22,1,21,2022
2022-01-29,Negeri Sembilan,98,31,67,2022
2022-01-30,Negeri Sembilan,0,0,0,2022
2022-01-31,Negeri Sembilan,30,1,29,2022
2022-02-01,Negeri Sembilan,0,0,0,2022
2022-02-02,Negeri Sembilan,0,0,0,2022
2022-02-03,Negeri Sembilan,42,4,38,2022
2022-02-04,Negeri Sembilan,84,20,64,2022
2022-02-05,Negeri Sembilan,114,26,88,2022
2022-02-06,Negeri Sembilan,108,36,72,2022
2022-02-07,Negeri Sembilan,28,0,28,2022
2022-02-08,Negeri Sembilan,50,25,25,2022
2022-02-09,Negeri Sembilan,19,2,17,2022
2022-02-10,Negeri Sembilan,49,4,45,2022
2022-02-11,Negeri Sembilan,19,0,19,2022
2022-02-12,Negeri Sembilan,0,0,0,2022
2022-02-13,Negeri Sembilan,0,0,0,2022
2022-02-14,Negeri Sembilan,21,2,19,2022
2022-02-15,Negeri Sembilan,32,5,27,2022
2022-02-16,Negeri Sembilan,67,6,61,2022
2022-02-17,Negeri Sembilan,23,1,22,2022
2022-02-18,Negeri Sembilan,40,1,39,2022
2022-02-19,Negeri Sembilan,101,16,85,2022
2022-02-20,Negeri Sembilan,137,20,117,2022
2022-02-21,Negeri Sembilan,38,5,33,2022
2022-02-22,Negeri Sembilan,37,3,34,2022
2022-02-23,Negeri Sembilan,14,1,13,2022
2022-02-24,Negeri Sembilan,30,3,27,2022
2022-02-25,Negeri Sembilan,19,0,19,2022
2022-02-26,Negeri Sembilan,0,0,0,2022
2022-02-27,Negeri Sembilan,73,21,52,2022
2022-02-28,Negeri Sembilan,36,2,34,2022
2022-03-01,Negeri Sembilan,0,0,0,2022
2022-03-02,Negeri Sembilan,31,2,29,2022
2022-03-03,Negeri Sembilan,44,5,39,2022
2022-03-04,Negeri Sembilan,18,1,17,2022
2022-03-05,Negeri Sembilan,75,10,65,2022
2022-03-06,Negeri Sembilan,0,0,0,2022
2022-03-07,Negeri Sembilan,19,2,17,2022
2022-03-08,Negeri Sembilan,21,0,21,2022
2022-03-09,Negeri Sembilan,24,3,21,2022
2022-03-10,Negeri Sembilan,55,10,45,2022
2022-03-11,Negeri Sembilan,20,1,19,2022
2022-03-12,Negeri Sembilan,70,18,52,2022
2022-03-13,Negeri Sembilan,0,0,0,2022
2022-03-14,Negeri Sembilan,30,1,29,2022
2022-03-15,Negeri Sembilan,18,3,15,2022
2022-03-16,Negeri Sembilan,49,6,43,2022
2022-03-17,Negeri Sembilan,61,10,51,2022
2022-03-18,Negeri Sembilan,31,1,30,2022
2022-03-19,Negeri Sembilan,72,12,60,2022
2022-03-20,Negeri Sembilan,78,16,62,2022
2022-03-21,Negeri Sembilan,34,4,30,2022
2022-03-22,Negeri Sembilan,24,4,20,2022
2022-03-23,Negeri Sembilan,61,15,46,2022
2022-03-24,Negeri Sembilan,27,2,25,2022
2022-03-25,Negeri Sembilan,77,10,67,2022
2022-03-26,Negeri Sembilan,93,18,75,2022
2022-03-27,Negeri Sembilan,121,20,101,2022
2022-03-28,Negeri Sembilan,34,1,33,2022
2022-03-29,Negeri Sembilan,192,75,117,2022
2022-03-30,Negeri Sembilan,23,1,22,2022
2022-03-31,Negeri Sembilan,90,33,57,2022
2022-04-01,Negeri Sembilan,30,3,27,2022
2022-04-02,Negeri Sembilan,47,14,33,2022
2022-04-03,Negeri Sembilan,62,21,41,2022
2022-04-04,Negeri Sembilan,12,1,11,2022
2022-04-05,Negeri Sembilan,17,1,16,2022
2022-04-06,Negeri Sembilan,18,0,18,2022
2022-04-07,Negeri Sembilan,18,4,14,2022
2022-04-08,Negeri Sembilan,61,9,52,2022
2022-04-09,Negeri Sembilan,0,0,0,2022
2022-04-10,Negeri Sembilan,172,34,138,2022
2022-04-11,Negeri Sembilan,10,0,10,2022
2022-04-12,Negeri Sembilan,13,0,13,2022
2022-04-13,Negeri Sembilan,66,12,54,2022
2022-04-14,Negeri Sembilan,18,0,18,2022
2022-04-15,Negeri Sembilan,18,3,15,2022
2022-04-16,Negeri Sembilan,34,10,24,2022
2022-04-17,Negeri Sembilan,59,19,40,2022
2022-04-18,Negeri Sembilan,12,0,12,2022
2022-04-19,Negeri Sembilan,51,13,38,2022
2022-04-20,Negeri Sembilan,12,2,10,2022
2022-04-21,Negeri Sembilan,11,0,11,2022
2022-04-22,Negeri Sembilan,5,0,5,2022
2022-04-23,Negeri Sembilan,33,5,28,2022
2022-04-24,Negeri Sembilan,81,21,60,2022
2022-04-25,Negeri Sembilan,6,0,6,2022
2022-04-26,Negeri Sembilan,12,0,12,2022
2022-04-27,Negeri Sembilan,40,17,23,2022
2022-04-28,Negeri Sembilan,17,2,15,2022
2022-04-29,Negeri Sembilan,13,1,12,2022
2022-04-30,Negeri Sembilan,4,1,3,2022
2022-05-01,Negeri Sembilan,184,44,140,2022
2022-05-02,Negeri Sembilan,0,0,0,2022
2022-05-03,Negeri Sembilan,0,0,0,2022
2022-05-04,Negeri Sembilan,0,0,0,2022
2022-05-05,Negeri Sembilan,29,2,27,2022
2022-05-06,Negeri Sembilan,74,9,65,2022
2022-05-07,Negeri Sembilan,79,16,63,2022
2022-05-08,Negeri Sembilan,115,28,87,2022
2022-05-09,Negeri Sembilan,25,3,22,2022
2022-05-10,Negeri Sembilan,25,0,25,2022
2022-05-11,Negeri Sembilan,142,59,83,2022
2022-05-12,Negeri Sembilan,14,2,12,2022
2022-05-13,Negeri Sembilan,28,1,27,2022
2022-05-14,Negeri Sembilan,37,19,18,2022
2022-05-15,Negeri Sembilan,120,30,90,2022
2022-05-16,Negeri Sembilan,0,0,0,2022
2022-05-17,Negeri Sembilan,44,7,37,2022
2022-05-18,Negeri Sembilan,22,1,21,2022
2022-05-19,Negeri Sembilan,84,16,68,2022
2022-05-20,Negeri Sembilan,27,2,25,2022
2022-05-21,Negeri Sembilan,107,34,73,2022
2022-05-22,Negeri Sembilan,50,8,42,2022
2022-05-23,Negeri Sembilan,27,2,25,2022
2022-05-24,Negeri Sembilan,18,1,17,2022
2022-05-25,Negeri Sembilan,91,34,57,2022
2022-05-26,Negeri Sembilan,22,2,20,2022
2022-05-27,Negeri Sembilan,24,1,23,2022
2022-05-28,Negeri Sembilan,55,13,42,2022
2022-05-29,Negeri Sembilan,124,24,100,2022
2022-05-30,Negeri Sembilan,30,4,26,2022
2022-05-31,Negeri Sembilan,32,2,30,2022
2022-06-01,Negeri Sembilan,36,6,30,2022
2022-06-02,Negeri Sembilan,23,4,19,2022
2022-06-03,Negeri Sembilan,22,2,20,2022
2022-06-04,Negeri Sembilan,58,10,48,2022
2022-06-05,Negeri Sembilan,61,22,39,2022
2022-06-06,Negeri Sembilan,0,0,0,2022
2022-06-07,Negeri Sembilan,21,1,20,2022
2022-06-08,Negeri Sembilan,26,2,24,2022
2022-06-09,Negeri Sembilan,132,35,97,2022
2022-06-10,Negeri Sembilan,31,4,27,2022
2022-06-11,Negeri Sembilan,51,26,25,2022
2022-06-12,Negeri Sembilan,0,0,0,2022
2022-06-13,Negeri Sembilan,25,3,22,2022
2022-06-14,Negeri Sembilan,102,35,67,2022
2022-06-15,Negeri Sembilan,89,34,55,2022
2022-06-16,Negeri Sembilan,99,23,76,2022
2022-06-17,Negeri Sembilan,85,7,78,2022
2022-06-18,Negeri Sembilan,49,16,33,2022
2022-06-19,Negeri Sembilan,0,0,0,2022
2022-06-20,Negeri Sembilan,85,25,60,2022
2022-06-21,Negeri Sembilan,32,2,30,2022
2022-06-22,Negeri Sembilan,84,10,74,2022
2022-06-23,Negeri Sembilan,94,48,46,2022
2022-06-24,Negeri Sembilan,27,1,26,2022
2022-06-25,Negeri Sembilan,70,10,60,2022
2022-06-26,Negeri Sembilan,82,15,67,2022
2022-06-27,Negeri Sembilan,34,5,29,2022
2022-06-28,Negeri Sembilan,31,2,29,2022
2022-06-29,Negeri Sembilan,44,9,35,2022
2022-06-30,Negeri Sembilan,29,4,25,2022
2022-07-01,Negeri Sembilan,26,2,24,2022
2022-07-02,Negeri Sembilan,72,14,58,2022
2022-07-03,Negeri Sembilan,0,0,0,2022
2022-07-04,Negeri Sembilan,29,5,24,2022
2022-07-05,Negeri Sembilan,71,11,60,2022
2022-07-06,Negeri Sembilan,61,18,43,2022
2022-07-07,Negeri Sembilan,55,12,43,2022
2022-07-08,Negeri Sembilan,25,1,24,2022
2022-07-09,Negeri Sembilan,0,0,0,2022
2022-07-10,Negeri Sembilan,0,0,0,2022
2022-07-11,Negeri Sembilan,0,0,0,2022
2022-07-12,Negeri Sembilan,31,6,25,2022
2022-07-13,Negeri Sembilan,31,3,28,2022
2022-07-14,Negeri Sembilan,17,2,15,2022
2022-07-15,Negeri Sembilan,16,4,12,2022
2022-07-16,Negeri Sembilan,0,0,0,2022
2022-07-17,Negeri Sembilan,110,20,90,2022
2022-07-18,Negeri Sembilan,29,8,21,2022
2022-07-19,Negeri Sembilan,26,2,24,2022
2022-07-20,Negeri Sembilan,26,1,25,2022
2022-07-21,Negeri Sembilan,27,9,18,2022
2022-07-22,Negeri Sembilan,17,1,16,2022
2022-07-23,Negeri Sembilan,156,48,108,2022
2022-07-24,Negeri Sembilan,158,36,122,2022
2022-07-25,Negeri Sembilan,22,3,19,2022
2022-07-26,Negeri Sembilan,12,1,11,2022
2022-07-27,Negeri Sembilan,76,7,69,2022
2022-07-28,Negeri Sembilan,22,3,19,2022
2022-07-29,Negeri Sembilan,22,1,21,2022
2022-07-30,Negeri Sembilan,82,15,67,2022
2022-07-31,Negeri Sembilan,0,0,0,2022
2022-08-01,Negeri Sembilan,24,2,22,2022
2022-08-02,Negeri Sembilan,24,4,20,2022
2022-08-03,Negeri Sembilan,71,9,62,2022
2022-08-04,Negeri Sembilan,47,10,37,2022
2022-08-05,Negeri Sembilan,20,2,18,2022
2022-08-06,Negeri Sembilan,65,10,55,2022
2022-08-07,Negeri Sembilan,99,21,78,2022
2022-08-08,Negeri Sembilan,29,1,28,2022
2022-08-09,Negeri Sembilan,129,41,88,2022
2022-08-10,Negeri Sembilan,17,2,15,2022
2022-08-11,Negeri Sembilan,19,3,16,2022
2022-08-12,Negeri Sembilan,30,2,28,2022
2022-08-13,Negeri Sembilan,0,0,0,2022
2022-08-14,Negeri Sembilan,43,4,39,2022
2022-08-15,Negeri Sembilan,27,0,27,2022
2022-08-16,Negeri Sembilan,104,34,70,2022
2022-08-17,Negeri Sembilan,12,1,11,2022
2022-08-18,Negeri Sembilan,20,3,17,2022
2022-08-19,Negeri Sembilan,23,0,23,2022
2022-08-20,Negeri Sembilan,0,0,0,2022
2022-08-21,Negeri Sembilan,112,12,100,2022
2022-08-22,Negeri Sembilan,22,0,22,2022
2022-08-23,Negeri Sembilan,36,2,34,2022
2022-08-24,Negeri Sembilan,55,20,35,2022
2022-08-25,Negeri Sembilan,17,0,17,2022
2022-08-26,Negeri Sembilan,23,3,20,2022
2022-08-27,Negeri Sembilan,0,0,0,2022
2022-08-28,Negeri Sembilan,149,24,125,2022
2022-08-29,Negeri Sembilan,29,4,25,2022
2022-08-30,Negeri Sembilan,31,3,28,2022
2022-08-31,Negeri Sembilan,84,23,61,2022
2022-09-01,Negeri Sembilan,64,15,49,2022
2022-09-02,Negeri Sembilan,16,1,15,2022
2022-09-03,Negeri Sembilan,0,0,0,2022
2022-09-04,Negeri Sembilan,115,15,100,2022
2022-09-05,Negeri Sembilan,17,5,12,2022
2022-09-06,Negeri Sembilan,22,3,19,2022
2022-09-07,Negeri Sembilan,24,4,20,2022
2022-09-08,Negeri Sembilan,133,53,80,2022
2022-09-09,Negeri Sembilan,20,2,18,2022
2022-09-10,Negeri Sembilan,0,0,0,2022
2022-09-11,Negeri Sembilan,93,27,66,2022
2022-09-12,Negeri Sembilan,26,3,23,2022
2022-09-13,Negeri Sembilan,27,1,26,2022
2022-09-14,Negeri Sembilan,131,92,39,2022
2022-09-15,Negeri Sembilan,22,2,20,2022
2022-09-16,Negeri Sembilan,123,33,90,2022
2022-09-17,Negeri Sembilan,117,28,89,2022
2022-09-18,Negeri Sembilan,0,0,0,2022
2022-09-19,Negeri Sembilan,31,5,26,2022
2022-09-20,Negeri Sembilan,29,5,24,2022
2022-09-21,Negeri Sembilan,60,29,31,2022
2022-09-22,Negeri Sembilan,38,8,30,2022
2022-09-23,Negeri Sembilan,26,1,25,2022
2022-09-24,Negeri Sembilan,0,0,0,2022
2022-09-25,Negeri Sembilan,70,13,57,2022
2022-09-26,Negeri Sembilan,34,5,29,2022
2022-09-27,Negeri Sembilan,17,0,17,2022
2022-09-28,Negeri Sembilan,99,19,80,2022
2022-09-29,Negeri Sembilan,16,0,16,2022
2022-09-30,Negeri Sembilan,14,3,11,2022
2022-10-01,Negeri Sembilan,0,0,0,2022
2022-10-02,Negeri Sembilan,172,163,9,2022
2022-10-03,Negeri Sembilan,22,0,22,2022
2022-10-04,Negeri Sembilan,37,2,35,2022
2022-10-05,Negeri Sembilan,99,55,44,2022
2022-10-06,Negeri Sembilan,27,1,26,2022
2022-10-07,Negeri Sembilan,90,31,59,2022
2022-10-08,Negeri Sembilan,33,12,21,2022
2022-10-09,Negeri Sembilan,0,0,0,2022
2022-10-10,Negeri Sembilan,0,0,0,2022
2022-10-11,Negeri Sembilan,92,54,38,2022
2022-10-12,Negeri Sembilan,27,3,24,2022
2022-10-13,Negeri Sembilan,40,8,32,2022
2022-10-14,Negeri Sembilan,31,3,28,2022
2022-10-15,Negeri Sembilan,61,16,45,2022
2022-10-16,Negeri Sembilan,0,0,0,2022
2022-10-17,Negeri Sembilan,22,2,20,2022
2022-10-18,Negeri Sembilan,26,1,25,2022
2022-10-19,Negeri Sembilan,79,22,57,2022
2022-10-20,Negeri Sembilan,51,12,39,2022
2022-10-21,Negeri Sembilan,19,3,16,2022
2022-10-22,Negeri Sembilan,102,20,82,2022
2022-10-23,Negeri Sembilan,0,0,0,2022
2022-10-24,Negeri Sembilan,0,0,0,2022
2022-10-25,Negeri Sembilan,24,0,24,2022
2022-10-26,Negeri Sembilan,21,1,20,2022
2022-10-27,Negeri Sembilan,55,4,51,2022
2022-10-28,Negeri Sembilan,15,1,14,2022
2022-10-29,Negeri Sembilan,83,16,67,2022
2022-10-30,Negeri Sembilan,0,0,0,2022
2022-10-31,Negeri Sembilan,19,1,18,2022
2022-11-01,Negeri Sembilan,22,3,19,2022
2022-11-02,Negeri Sembilan,12,1,11,2022
2022-11-03,Negeri Sembilan,68,24,44,2022
2022-11-04,Negeri Sembilan,24,6,18,2022
2022-11-05,Negeri Sembilan,0,0,0,2022
2022-11-06,Negeri Sembilan,107,25,82,2022
2022-11-07,Negeri Sembilan,17,1,16,2022
2022-11-08,Negeri Sembilan,22,2,20,2022
2022-11-09,Negeri Sembilan,121,22,99,2022
2022-11-10,Negeri Sembilan,24,2,22,2022
2022-11-11,Negeri Sembilan,27,5,22,2022
2022-11-12,Negeri Sembilan,0,0,0,2022
2022-11-13,Negeri Sembilan,114,16,98,2022
2022-11-14,Negeri Sembilan,18,0,18,2022
2022-11-15,Negeri Sembilan,138,88,50,2022
2022-11-16,Negeri Sembilan,78,7,71,2022
2022-11-17,Negeri Sembilan,16,1,15,2022
2022-11-18,Negeri Sembilan,0,0,0,2022
2022-11-19,Negeri Sembilan,0,0,0,2022
2022-11-20,Negeri Sembilan,125,22,103,2022
2022-11-21,Negeri Sembilan,21,2,19,2022
2022-11-22,Negeri Sembilan,21,3,18,2022
2022-11-23,Negeri Sembilan,50,12,38,2022
2022-11-24,Negeri Sembilan,65,31,34,2022
2022-11-25,Negeri Sembilan,27,4,23,2022
2022-11-26,Negeri Sembilan,58,26,32,2022
2022-11-27,Negeri Sembilan,87,22,65,2022
2022-11-28,Negeri Sembilan,0,0,0,2022
2022-11-29,Negeri Sembilan,66,15,51,2022
2022-11-30,Negeri Sembilan,20,1,19,2022
2022-12-01,Negeri Sembilan,23,5,18,2022
2022-12-02,Negeri Sembilan,44,10,34,2022
2022-12-03,Negeri Sembilan,0,0,0,2022
2022-12-04,Negeri Sembilan,84,15,69,2022
2022-12-05,Negeri Sembilan,28,3,25,2022
2022-12-06,Negeri Sembilan,16,1,15,2022
2022-12-07,Negeri Sembilan,98,14,84,2022
2022-12-08,Negeri Sembilan,85,30,55,2022
2022-12-09,Negeri Sembilan,28,2,26,2022
2022-12-10,Negeri Sembilan,24,11,13,2022
2022-12-11,Negeri Sembilan,0,0,0,2022
2022-12-12,Negeri Sembilan,48,1,47,2022
2022-12-13,Negeri Sembilan,38,2,36,2022
2022-12-14,Negeri Sembilan,88,21,67,2022
2022-12-15,Negeri Sembilan,71,17,54,2022
2022-12-16,Negeri Sembilan,33,4,29,2022
2022-12-17,Negeri Sembilan,0,0,0,2022
2022-12-18,Negeri Sembilan,98,7,91,2022
2022-12-19,Negeri Sembilan,24,5,19,2022
2022-12-20,Negeri Sembilan,28,2,26,2022
2022-12-21,Negeri Sembilan,59,15,44,2022
2022-12-22,Negeri Sembilan,25,2,23,2022
2022-12-23,Negeri Sembilan,30,2,28,2022
2022-12-24,Negeri Sembilan,0,0,0,2022
2022-12-25,Negeri Sembilan,111,22,89,2022
2022-12-26,Negeri Sembilan,0,0,0,2022
2022-12-27,Negeri Sembilan,33,4,29,2022
2022-12-28,Negeri Sembilan,67,12,55,2022
2022-12-29,Negeri Sembilan,50,6,44,2022
2022-12-30,Negeri Sembilan,33,3,30,2022
2022-12-31,Negeri Sembilan,50,4,46,2022
2023-01-01,Negeri Sembilan,0,0,0,2023
2023-01-02,Negeri Sembilan,0,0,0,2023
2023-01-03,Negeri Sembilan,36,1,35,2023
2023-01-04,Negeri Sembilan,62,22,40,2023
2023-01-05,Negeri Sembilan,78,41,37,2023
2023-01-06,Negeri Sembilan,32,3,29,2023
2023-01-07,Negeri Sembilan,0,0,0,2023
2023-01-08,Negeri Sembilan,64,15,49,2023
2023-01-09,Negeri Sembilan,31,3,28,2023
2023-01-10,Negeri Sembilan,25,0,25,2023
2023-01-11,Negeri Sembilan,63,16,47,2023
2023-01-12,Negeri Sembilan,120,64,56,2023
2023-01-13,Negeri Sembilan,23,4,19,2023
2023-01-14,Negeri Sembilan,58,21,37,2023
2023-01-15,Negeri Sembilan,0,0,0,2023
2023-01-16,Negeri Sembilan,21,5,16,2023
2023-01-17,Negeri Sembilan,31,3,28,2023
2023-01-18,Negeri Sembilan,70,28,42,2023
2023-01-19,Negeri Sembilan,109,14,95,2023
2023-01-20,Negeri Sembilan,37,2,35,2023
2023-01-21,Negeri Sembilan,0,0,0,2023
2023-01-22,Negeri Sembilan,100,22,78,2023
2023-01-23,Negeri Sembilan,0,0,0,2023
2023-01-24,Negeri Sembilan,0,0,0,2023
2023-01-25,Negeri Sembilan,31,3,28,2023
2023-01-26,Negeri Sembilan,70,12,58,2023
2023-01-27,Negeri Sembilan,30,3,27,2023
2023-01-28,Negeri Sembilan,100,21,79,2023
2023-01-29,Negeri Sembilan,99,18,81,2023
2023-01-30,Negeri Sembilan,30,4,26,2023
2023-01-31,Negeri Sembilan,27,0,27,2023
2023-02-01,Negeri Sembilan,66,20,46,2023
2023-02-02,Negeri Sembilan,34,5,29,2023
2023-02-03,Negeri Sembilan,21,2,19,2023
2023-02-04,Negeri Sembilan,101,26,75,2023
2023-02-05,Negeri Sembilan,49,4,45,2023
2023-02-06,Negeri Sembilan,0,0,0,2023
2023-02-07,Negeri Sembilan,29,4,25,2023
2023-02-08,Negeri Sembilan,76,9,67,2023
2023-02-09,Negeri Sembilan,88,27,61,2023
2023-02-10,Negeri Sembilan,25,3,22,2023
2023-02-11,Negeri Sembilan,42,12,30,2023
2023-02-12,Negeri Sembilan,0,0,0,2023
2023-02-13,Negeri Sembilan,29,3,26,2023
2023-02-14,Negeri Sembilan,21,2,19,2023
2023-02-15,Negeri Sembilan,87,25,62,2023
2023-02-16,Negeri Sembilan,154,96,58,2023
2023-02-17,Negeri Sembilan,26,1,25,2023
2023-02-18,Negeri Sembilan,0,0,0,2023
2023-02-19,Negeri Sembilan,0,0,0,2023
2023-02-20,Negeri Sembilan,78,7,71,2023
2023-02-21,Negeri Sembilan,20,2,18,2023
2023-02-22,Negeri Sembilan,23,3,20,2023
2023-02-23,Negeri Sembilan,70,22,48,2023
2023-02-24,Negeri Sembilan,14,1,13,2023
2023-02-25,Negeri Sembilan,97,20,77,2023
2023-02-26,Negeri Sembilan,116,25,91,2023
2023-02-27,Negeri Sembilan,29,2,27,2023
2023-02-28,Negeri Sembilan,67,8,59,2023
2023-03-01,Negeri Sembilan,27,1,26,2023
2023-03-02,Negeri Sembilan,27,2,25,2023
2023-03-03,Negeri Sembilan,38,4,34,2023
2023-03-04,Negeri Sembilan,58,14,44,2023
2023-03-05,Negeri Sembilan,78,19,59,2023
2023-03-06,Negeri Sembilan,29,4,25,2023
2023-03-07,Negeri Sembilan,28,2,26,2023
2023-03-08,Negeri Sembilan,28,4,24,2023
2023-03-09,Negeri Sembilan,16,1,15,2023
2023-03-10,Negeri Sembilan,70,10,60,2023
2023-03-11,Negeri Sembilan,74,32,42,2023
2023-03-12,Negeri Sembilan,161,27,134,2023
2023-03-13,Negeri Sembilan,29,0,29,2023
2023-03-14,Negeri Sembilan,31,4,27,2023
2023-03-15,Negeri Sembilan,37,6,31,2023
2023-03-16,Negeri Sembilan,27,1,26,2023
2023-03-17,Negeri Sembilan,67,12,55,2023
2023-03-18,Negeri Sembilan,77,22,55,2023
2023-03-19,Negeri Sembilan,143,32,111,2023
2023-03-20,Negeri Sembilan,44,1,43,2023
2023-03-21,Negeri Sembilan,109,21,88,2023
2023-03-22,Negeri Sembilan,48,1,47,2023
2023-03-23,Negeri Sembilan,11,0,11,2023
2023-03-24,Negeri Sembilan,8,1,7,2023
2023-03-25,Negeri Sembilan,0,0,0,2023
2023-03-26,Negeri Sembilan,41,5,36,2023
2023-03-27,Negeri Sembilan,16,0,16,2023
2023-03-28,Negeri Sembilan,24,3,21,2023
2023-03-29,Negeri Sembilan,20,5,15,2023
2023-03-30,Negeri Sembilan,14,0,14,2023
2023-03-31,Negeri Sembilan,84,19,65,2023
2023-04-01,Negeri Sembilan,24,1,23,2023
2023-04-02,Negeri Sembilan,0,0,0,2023
2023-04-03,Negeri Sembilan,21,3,18,2023
2023-04-04,Negeri Sembilan,21,1,20,2023
2023-04-05,Negeri Sembilan,15,0,15,2023
2023-04-06,Negeri Sembilan,11,2,9,2023
2023-04-07,Negeri Sembilan,14,2,12,2023
2023-04-08,Negeri Sembilan,38,4,34,2023
2023-04-09,Negeri Sembilan,23,7,16,2023
2023-04-10,Negeri Sembilan,17,1,16,2023
2023-04-11,Negeri Sembilan,14,0,14,2023
2023-04-12,Negeri Sembilan,77,6,71,2023
2023-04-13,Negeri Sembilan,10,0,10,2023
2023-04-14,Negeri Sembilan,52,15,37,2023
2023-04-15,Negeri Sembilan,31,5,26,2023
2023-04-16,Negeri Sembilan,67,13,54,2023
2023-04-17,Negeri Sembilan,8,0,8,2023
2023-04-18,Negeri Sembilan,42,23,19,2023
2023-04-19,Negeri Sembilan,33,3,30,2023
2023-04-20,Negeri Sembilan,20,0,20,2023
2023-04-21,Negeri Sembilan,0,0,0,2023
2023-04-22,Negeri Sembilan,0,0,0,2023
2023-04-23,Negeri Sembilan,0,0,0,2023
2023-04-24,Negeri Sembilan,0,0,0,2023
2023-04-25,Negeri Sembilan,26,3,23,2023
2023-04-26,Negeri Sembilan,80,20,60,2023
2023-04-27,Negeri Sembilan,97,21,76,2023
2023-04-28,Negeri Sembilan,27,2,25,2023
2023-04-29,Negeri Sembilan,71,7,64,2023
2023-04-30,Negeri Sembilan,85,13,72,2023
2023-05-01,Negeri Sembilan,168,30,138,2023
2023-05-02,Negeri Sembilan,31,1,30,2023
2023-05-03,Negeri Sembilan,30,3,27,2023
2023-05-04,Negeri Sembilan,0,0,0,2023
2023-05-05,Negeri Sembilan,30,3,27,2023
2023-05-06,Negeri Sembilan,57,9,48,2023
2023-05-07,Negeri Sembilan,63,11,52,2023
2023-05-08,Negeri Sembilan,30,4,26,2023
2023-05-09,Negeri Sembilan,63,22,41,2023
2023-05-10,Negeri Sembilan,147,43,104,2023
2023-05-11,Negeri Sembilan,17,0,17,2023
2023-05-12,Negeri Sembilan,22,1,21,2023
2023-05-13,Negeri Sembilan,0,0,0,2023
2023-05-14,Negeri Sembilan,0,0,0,2023
2023-05-15,Negeri Sembilan,24,1,23,2023
2023-05-16,Negeri Sembilan,15,1,14,2023
2023-05-17,Negeri Sembilan,76,24,52,2023
2023-05-18,Negeri Sembilan,53,7,46,2023
2023-05-19,Negeri Sembilan,24,2,22,2023
2023-05-20,Negeri Sembilan,0,0,0,2023
2023-05-21,Negeri Sembilan,75,5,70,2023
2023-05-22,Negeri Sembilan,106,37,69,2023
2023-05-23,Negeri Sembilan,28,1,27,2023
2023-05-24,Negeri Sembilan,78,9,69,2023
2023-05-25,Negeri Sembilan,30,4,26,2023
2023-05-26,Negeri Sembilan,25,2,23,2023
2023-05-27,Negeri Sembilan,109,27,82,2023
2023-05-28,Negeri Sembilan,146,42,104,2023
2023-05-29,Negeri Sembilan,32,3,29,2023
2023-05-30,Negeri Sembilan,20,1,19,2023
2023-05-31,Negeri Sembilan,70,17,53,2023
2023-06-01,Negeri Sembilan,23,1,22,2023
2023-06-02,Negeri Sembilan,37,1,36,2023
2023-06-03,Negeri Sembilan,68,20,48,2023
2023-06-04,Negeri Sembilan,79,12,67,2023
2023-06-05,Negeri Sembilan,0,0,0,2023
2023-06-06,Negeri Sembilan,143,36,107,2023
2023-06-07,Negeri Sembilan,94,42,52,2023
2023-06-08,Negeri Sembilan,85,46,39,2023
2023-06-09,Negeri Sembilan,88,14,74,2023
2023-06-10,Negeri Sembilan,0,0,0,2023
2023-06-11,Negeri Sembilan,0,0,0,2023
2023-06-12,Negeri Sembilan,29,2,27,2023
2023-06-13,Negeri Sembilan,29,4,25,2023
2023-06-14,Negeri Sembilan,128,17,111,2023
2023-06-15,Negeri Sembilan,18,1,17,2023
2023-06-16,Negeri Sembilan,28,3,25,2023
2023-06-17,Negeri Sembilan,21,6,15,2023
2023-06-18,Negeri Sembilan,32,11,21,2023
2023-06-19,Negeri Sembilan,30,2,28,2023
2023-06-20,Negeri Sembilan,19,1,18,2023
2023-06-21,Negeri Sembilan,86,12,74,2023
2023-06-22,Negeri Sembilan,86,10,76,2023
2023-06-23,Negeri Sembilan,41,3,38,2023
2023-06-24,Negeri Sembilan,74,13,61,2023
2023-06-25,Negeri Sembilan,116,30,86,2023
2023-06-26,Negeri Sembilan,23,2,21,2023
2023-06-27,Negeri Sembilan,65,24,41,2023
2023-06-28,Negeri Sembilan,16,2,14,2023
2023-06-29,Negeri Sembilan,0,0,0,2023
2023-06-30,Negeri Sembilan,24,1,23,2023
2023-07-01,Negeri Sembilan,0,0,0,2023
2023-07-02,Negeri Sembilan,69,13,56,2023
2023-07-03,Negeri Sembilan,22,0,22,2023
2023-07-04,Negeri Sembilan,17,0,17,2023
2023-07-05,Negeri Sembilan,83,34,49,2023
2023-07-06,Negeri Sembilan,19,1,18,2023
2023-07-07,Negeri Sembilan,55,6,49,2023
2023-07-08,Negeri Sembilan,29,4,25,2023
2023-07-09,Negeri Sembilan,121,18,103,2023
2023-07-10,Negeri Sembilan,26,4,22,2023
2023-07-11,Negeri Sembilan,68,18,50,2023
2023-07-12,Negeri Sembilan,15,0,15,2023
2023-07-13,Negeri Sembilan,74,49,25,2023
2023-07-14,Negeri Sembilan,22,1,21,2023
2023-07-15,Negeri Sembilan,0,0,0,2023
2023-07-16,Negeri Sembilan,60,17,43,2023
2023-07-17,Negeri Sembilan,24,2,22,2023
2023-07-18,Negeri Sembilan,23,0,23,2023
2023-07-19,Negeri Sembilan,0,0,0,2023
2023-07-20,Negeri Sembilan,67,4,63,2023
2023-07-21,Negeri Sembilan,21,2,19,2023
2023-07-22,Negeri Sembilan,0,0,0,2023
2023-07-23,Negeri Sembilan,121,25,96,2023
2023-07-24,Negeri Sembilan,23,5,18,2023
2023-07-25,Negeri Sembilan,28,2,26,2023
2023-07-26,Negeri Sembilan,48,8,40,2023
2023-07-27,Negeri Sembilan,55,10,45,2023
2023-07-28,Negeri Sembilan,22,1,21,2023
2023-07-29,Negeri Sembilan,0,0,0,2023
2023-07-30,Negeri Sembilan,76,13,63,2023
2023-07-31,Negeri Sembilan,26,1,25,2023
2023-08-01,Negeri Sembilan,24,3,21,2023
2023-08-02,Negeri Sembilan,25,0,25,2023
2023-08-03,Negeri Sembilan,60,24,36,2023
2023-08-04,Negeri Sembilan,19,0,19,2023
2023-08-05,Negeri Sembilan,78,19,59,2023
2023-08-06,Negeri Sembilan,104,16,88,2023
2023-08-07,Negeri Sembilan,32,7,25,2023
2023-08-08,Negeri Sembilan,114,26,88,2023
2023-08-09,Negeri Sembilan,35,2,33,2023
2023-08-10,Negeri Sembilan,29,5,24,2023
2023-08-11,Negeri Sembilan,29,1,28,2023
2023-08-12,Negeri Sembilan,0,0,0,2023
2023-08-13,Negeri Sembilan,59,17,42,2023
2023-08-14,Negeri Sembilan,0,0,0,2023
2023-08-15,Negeri Sembilan,51,20,31,2023
2023-08-16,Negeri Sembilan,58,17,41,2023
2023-08-17,Negeri Sembilan,25,5,20,2023
2023-08-18,Negeri Sembilan,18,1,17,2023
2023-08-19,Negeri Sembilan,0,0,0,2023
2023-08-20,Negeri Sembilan,125,12,113,2023
2023-08-21,Negeri Sembilan,30,2,28,2023
2023-08-22,Negeri Sembilan,79,13,66,2023
2023-08-23,Negeri Sembilan,89,11,78,2023
2023-08-24,Negeri Sembilan,125,22,103,2023
2023-08-25,Negeri Sembilan,28,0,28,2023
2023-08-26,Negeri Sembilan,68,16,52,2023
2023-08-27,Negeri Sembilan,121,21,100,2023
2023-08-28,Negeri Sembilan,31,2,29,2023
2023-08-29,Negeri Sembilan,31,3,28,2023
2023-08-30,Negeri Sembilan,62,2,60,2023
2023-08-31,Negeri Sembilan,114,29,85,2023
2023-09-01,Negeri Sembilan,31,5,26,2023
2023-09-02,Negeri Sembilan,44,11,33,2023
2023-09-03,Negeri Sembilan,65,14,51,2023
2023-09-04,Negeri Sembilan,30,0,30,2023
2023-09-05,Negeri Sembilan,22,0,22,2023
2023-09-06,Negeri Sembilan,152,81,71,2023
2023-09-07,Negeri Sembilan,59,7,52,2023
2023-09-08,Negeri Sembilan,21,0,21,2023
2023-09-09,Negeri Sembilan,0,0,0,2023
2023-09-10,Negeri Sembilan,0,0,0,2023
2023-09-11,Negeri Sembilan,79,27,52,2023
2023-09-12,Negeri Sembilan,20,3,17,2023
2023-09-13,Negeri Sembilan,51,12,39,2023
2023-09-14,Negeri Sembilan,29,3,26,2023
2023-09-15,Negeri Sembilan,15,1,14,2023
2023-09-16,Negeri Sembilan,47,14,33,2023
2023-09-17,Negeri Sembilan,71,22,49,2023
2023-09-18,Negeri Sembilan,24,1,23,2023
2023-09-19,Negeri Sembilan,33,3,30,2023
2023-09-20,Negeri Sembilan,47,6,41,2023
2023-09-21,Negeri Sembilan,132,42,90,2023
2023-09-22,Negeri Sembilan,14,0,14,2023
2023-09-23,Negeri Sembilan,0,0,0,2023
2023-09-24,Negeri Sembilan,82,19,63,2023
2023-09-25,Negeri Sembilan,16,1,15,2023
2023-09-26,Negeri Sembilan,24,2,22,2023
2023-09-27,Negeri Sembilan,91,16,75,2023
2023-09-28,Negeri Sembilan,0,0,0,2023
2023-09-29,Negeri Sembilan,32,4,28,2023
2023-09-30,Negeri Sembilan,0,0,0,2023
2023-10-01,Negeri Sembilan,96,19,77,2023
2023-10-02,Negeri Sembilan,27,1,26,2023
2023-10-03,Negeri Sembilan,23,0,23,2023
2023-10-04,Negeri Sembilan,50,2,48,2023
2023-10-05,Negeri Sembilan,20,1,19,2023
2023-10-06,Negeri Sembilan,74,15,59,2023
2023-10-07,Negeri Sembilan,34,10,24,2023
2023-10-08,Negeri Sembilan,0,0,0,2023
2023-10-09,Negeri Sembilan,20,1,19,2023
2023-10-10,Negeri Sembilan,27,0,27,2023
2023-10-11,Negeri Sembilan,89,34,55,2023
2023-10-12,Negeri Sembilan,91,49,42,2023
2023-10-13,Negeri Sembilan,15,1,14,2023
2023-10-14,Negeri Sembilan,79,28,51,2023
2023-10-15,Negeri Sembilan,103,23,80,2023
2023-10-16,Negeri Sembilan,25,1,24,2023
2023-10-17,Negeri Sembilan,20,1,19,2023
2023-10-18,Negeri Sembilan,80,44,36,2023
2023-10-19,Negeri Sembilan,50,16,34,2023
2023-10-20,Negeri Sembilan,25,1,24,2023
2023-10-21,Negeri Sembilan,38,13,25,2023
2023-10-22,Negeri Sembilan,59,13,46,2023
2023-10-23,Negeri Sembilan,14,1,13,2023
2023-10-24,Negeri Sembilan,57,4,53,2023
2023-10-25,Negeri Sembilan,57,30,27,2023
2023-10-26,Negeri Sembilan,17,0,17,2023
2023-10-27,Negeri Sembilan,22,0,22,2023
2023-10-28,Negeri Sembilan,84,17,67,2023
2023-10-29,Negeri Sembilan,122,30,92,2023
2023-10-30,Negeri Sembilan,22,0,22,2023
2023-10-31,Negeri Sembilan,15,0,15,2023
2023-11-01,Negeri Sembilan,23,2,21,2023
2023-11-02,Negeri Sembilan,81,14,67,2023
2023-11-03,Negeri Sembilan,18,2,16,2023
2023-11-04,Negeri Sembilan,87,15,72,2023
2023-11-05,Negeri Sembilan,100,25,75,2023
2023-11-06,Negeri Sembilan,26,2,24,2023
2023-11-07,Negeri Sembilan,18,2,16,2023
2023-11-08,Negeri Sembilan,84,16,68,2023
2023-11-09,Negeri Sembilan,20,0,20,2023
2023-11-10,Negeri Sembilan,20,2,18,2023
2023-11-11,Negeri Sembilan,43,22,21,2023
2023-11-12,Negeri Sembilan,0,0,0,2023
2023-11-13,Negeri Sembilan,0,0,0,2023
2023-11-14,Negeri Sembilan,21,0,21,2023
2023-11-15,Negeri Sembilan,90,15,75,2023
2023-11-16,Negeri Sembilan,64,13,51,2023
2023-11-17,Negeri Sembilan,28,3,25,2023
2023-11-18,Negeri Sembilan,87,11,76,2023
2023-11-19,Negeri Sembilan,60,3,57,2023
2023-11-20,Negeri Sembilan,37,3,34,2023
2023-11-21,Negeri Sembilan,17,4,13,2023
2023-11-22,Negeri Sembilan,32,9,23,2023
2023-11-23,Negeri Sembilan,51,10,41,2023
2023-11-24,Negeri Sembilan,23,2,21,2023
2023-11-25,Negeri Sembilan,67,8,59,2023
2023-11-26,Negeri Sembilan,103,12,91,2023
2023-11-27,Negeri Sembilan,19,2,17,2023
2023-11-28,Negeri Sembilan,18,1,17,2023
2023-11-29,Negeri Sembilan,78,31,47,2023
2023-11-30,Negeri Sembilan,65,7,58,2023
2023-12-01,Negeri Sembilan,42,2,40,2023
2023-12-02,Negeri Sembilan,0,0,0,2023
2023-12-03,Negeri Sembilan,98,13,85,2023
2023-12-04,Negeri Sembilan,23,2,21,2023
2023-12-05,Negeri Sembilan,30,0,30,2023
2023-12-06,Negeri Sembilan,111,66,45,2023
2023-12-07,Negeri Sembilan,10,0,10,2023
2023-12-08,Negeri Sembilan,25,2,23,2023
2023-12-09,Negeri Sembilan,71,17,54,2023
2023-12-10,Negeri Sembilan,49,15,34,2023
2023-12-11,Negeri Sembilan,37,5,32,2023
2023-12-12,Negeri Sembilan,48,20,28,2023
2023-12-13,Negeri Sembilan,130,57,73,2023
2023-12-14,Negeri Sembilan,68,13,55,2023
2023-12-15,Negeri Sembilan,20,1,19,2023
2023-12-16,Negeri Sembilan,68,7,61,2023
2023-12-17,Negeri Sembilan,85,14,71,2023
2023-12-18,Negeri Sembilan,23,1,22,2023
2023-12-19,Negeri Sembilan,19,1,18,2023
2023-12-20,Negeri Sembilan,67,6,61,2023
2023-12-21,Negeri Sembilan,17,1,16,2023
2023-12-22,Negeri Sembilan,30,2,28,2023
2023-12-23,Negeri Sembilan,77,17,60,2023
2023-12-24,Negeri Sembilan,0,0,0,2023
2023-12-25,Negeri Sembilan,0,0,0,2023
2023-12-26,Negeri Sembilan,31,0,31,2023
2023-12-27,Negeri Sembilan,60,4,56,2023
2023-12-28,Negeri Sembilan,53,6,47,2023
2023-12-29,Negeri Sembilan,34,0,34,2023
2023-12-30,Negeri Sembilan,0,0,0,2023
2023-12-31,Negeri Sembilan,0,0,0,2023
2024-01-01,Negeri Sembilan,115,12,103,2024
2024-01-02,Negeri Sembilan,23,1,22,2024
2024-01-03,Negeri Sembilan,65,22,43,2024
2024-01-04,Negeri Sembilan,48,15,33,2024
2024-01-05,Negeri Sembilan,20,1,19,2024
2024-01-06,Negeri Sembilan,73,12,61,2024
2024-01-07,Negeri Sembilan,102,21,81,2024
2024-01-08,Negeri Sembilan,15,0,15,2024
2024-01-09,Negeri Sembilan,19,0,19,2024
2024-01-10,Negeri Sembilan,84,46,38,2024
2024-01-11,Negeri Sembilan,70,39,31,2024
2024-01-12,Negeri Sembilan,16,2,14,2024
2024-01-13,Negeri Sembilan,0,0,0,2024
2024-01-14,Negeri Sembilan,128,16,112,2024
2024-01-15,Negeri Sembilan,0,0,0,2024
2024-01-16,Negeri Sembilan,20,5,15,2024
2024-01-17,Negeri Sembilan,77,19,58,2024
2024-01-18,Negeri Sembilan,206,77,129,2024
2024-01-19,Negeri Sembilan,13,0,13,2024
2024-01-20,Negeri Sembilan,0,0,0,2024
2024-01-21,Negeri Sembilan,77,15,62,2024
2024-01-22,Negeri Sembilan,23,1,22,2024
2024-01-23,Negeri Sembilan,23,3,20,2024
2024-01-24,Negeri Sembilan,138,66,72,2024
2024-01-25,Negeri Sembilan,0,0,0,2024
2024-01-26,Negeri Sembilan,37,4,33,2024
2024-01-27,Negeri Sembilan,76,9,67,2024
2024-01-28,Negeri Sembilan,106,14,92,2024
2024-01-29,Negeri Sembilan,27,3,24,2024
2024-01-30,Negeri Sembilan,34,2,32,2024
2024-01-31,Negeri Sembilan,59,16,43,2024
2024-02-01,Negeri Sembilan,62,4,58,2024
2024-02-02,Negeri Sembilan,25,2,23,2024
2006-01-01,Pahang,0,0,0,2006
2006-01-02,Pahang,10,9,1,2006
2006-01-03,Pahang,0,0,0,2006
2006-01-04,Pahang,2,2,0,2006
2006-01-05,Pahang,39,39,0,2006
2006-01-06,Pahang,1,1,0,2006
2006-01-07,Pahang,0,0,0,2006
2006-01-08,Pahang,14,13,1,2006
2006-01-09,Pahang,1,1,0,2006
2006-01-10,Pahang,0,0,0,2006
2006-01-11,Pahang,2,2,0,2006
2006-01-12,Pahang,0,0,0,2006
2006-01-13,Pahang,16,15,1,2006
2006-01-14,Pahang,12,12,0,2006
2006-01-15,Pahang,26,25,1,2006
2006-01-16,Pahang,1,1,0,2006
2006-01-17,Pahang,20,20,0,2006
2006-01-18,Pahang,2,2,0,2006
2006-01-19,Pahang,28,28,0,2006
2006-01-20,Pahang,9,9,0,2006
2006-01-21,Pahang,0,0,0,2006
2006-01-22,Pahang,0,0,0,2006
2006-01-23,Pahang,0,0,0,2006
2006-01-24,Pahang,0,0,0,2006
2006-01-25,Pahang,28,28,0,2006
2006-01-26,Pahang,25,25,0,2006
2006-01-27,Pahang,3,3,0,2006
2006-01-28,Pahang,8,8,0,2006
2006-01-29,Pahang,0,0,0,2006
2006-01-30,Pahang,0,0,0,2006
2006-01-31,Pahang,0,0,0,2006
2006-02-01,Pahang,15,13,2,2006
2006-02-02,Pahang,9,9,0,2006
2006-02-03,Pahang,2,1,1,2006
2006-02-04,Pahang,11,11,0,2006
2006-02-05,Pahang,17,16,1,2006
2006-02-06,Pahang,13,11,2,2006
2006-02-07,Pahang,23,23,0,2006
2006-02-08,Pahang,2,2,0,2006
2006-02-09,Pahang,19,17,2,2006
2006-02-10,Pahang,1,1,0,2006
2006-02-11,Pahang,7,6,1,2006
2006-02-12,Pahang,1,1,0,2006
2006-02-13,Pahang,0,0,0,2006
2006-02-14,Pahang,23,22,1,2006
2006-02-15,Pahang,6,6,0,2006
2006-02-16,Pahang,11,11,0,2006
2006-02-17,Pahang,1,1,0,2006
2006-02-18,Pahang,0,0,0,2006
2006-02-19,Pahang,9,9,0,2006
2006-02-20,Pahang,3,2,1,2006
2006-02-21,Pahang,53,49,4,2006
2006-02-22,Pahang,27,26,1,2006
2006-02-23,Pahang,2,2,0,2006
2006-02-24,Pahang,3,3,0,2006
2006-02-25,Pahang,14,14,0,2006
2006-02-26,Pahang,0,0,0,2006
2006-02-27,Pahang,4,2,2,2006
2006-02-28,Pahang,2,2,0,2006
2006-03-01,Pahang,2,2,0,2006
2006-03-02,Pahang,7,6,1,2006
2006-03-03,Pahang,3,2,1,2006
2006-03-04,Pahang,10,10,0,2006
2006-03-05,Pahang,24,22,2,2006
2006-03-06,Pahang,2,2,0,2006
2006-03-07,Pahang,2,0,2,2006
2006-03-08,Pahang,3,2,1,2006
2006-03-09,Pahang,3,1,2,2006
2006-03-10,Pahang,0,0,0,2006
2006-03-11,Pahang,56,56,0,2006
2006-03-12,Pahang,33,28,5,2006
2006-03-13,Pahang,2,1,1,2006
2006-03-14,Pahang,1,1,0,2006
2006-03-15,Pahang,2,0,2,2006
2006-03-16,Pahang,1,1,0,2006
2006-03-17,Pahang,3,0,3,2006
2006-03-18,Pahang,0,0,0,2006
2006-03-19,Pahang,14,12,2,2006
2006-03-20,Pahang,1,1,0,2006
2006-03-21,Pahang,1,0,1,2006
2006-03-22,Pahang,3,1,2,2006
2006-03-23,Pahang,23,22,1,2006
2006-03-24,Pahang,0,0,0,2006
2006-03-25,Pahang,11,9,2,2006
2006-03-26,Pahang,0,0,0,2006
2006-03-27,Pahang,0,0,0,2006
2006-03-28,Pahang,4,2,2,2006
2006-03-29,Pahang,33,33,0,2006
2006-03-30,Pahang,4,1,3,2006
2006-03-31,Pahang,0,0,0,2006
2006-04-01,Pahang,1,1,0,2006
2006-04-02,Pahang,0,0,0,2006
2006-04-03,Pahang,2,1,1,2006
2006-04-04,Pahang,13,13,0,2006
2006-04-05,Pahang,3,2,1,2006
2006-04-06,Pahang,3,3,0,2006
2006-04-07,Pahang,11,9,2,2006
2006-04-08,Pahang,5,5,0,2006
2006-04-09,Pahang,10,10,0,2006
2006-04-10,Pahang,4,2,2,2006
2006-04-11,Pahang,0,0,0,2006
2006-04-12,Pahang,19,18,1,2006
2006-04-13,Pahang,3,2,1,2006
2006-04-14,Pahang,5,4,1,2006
2006-04-15,Pahang,0,0,0,2006
2006-04-16,Pahang,22,18,4,2006
2006-04-17,Pahang,2,1,1,2006
2006-04-18,Pahang,2,1,1,2006
2006-04-19,Pahang,2,1,1,2006
2006-04-20,Pahang,14,13,1,2006
2006-04-21,Pahang,3,3,0,2006
2006-04-22,Pahang,4,4,0,2006
2006-04-23,Pahang,30,26,4,2006
2006-04-24,Pahang,2,2,0,2006
2006-04-25,Pahang,21,20,1,2006
2006-04-26,Pahang,70,69,1,2006
2006-04-27,Pahang,27,27,0,2006
2006-04-28,Pahang,0,0,0,2006
2006-04-29,Pahang,2,2,0,2006
2006-04-30,Pahang,15,13,2,2006
2006-05-01,Pahang,0,0,0,2006
2006-05-02,Pahang,1,1,0,2006
2006-05-03,Pahang,2,1,1,2006
2006-05-04,Pahang,9,7,2,2006
2006-05-05,Pahang,0,0,0,2006
2006-05-06,Pahang,9,7,2,2006
2006-05-07,Pahang,36,33,3,2006
2006-05-08,Pahang,0,0,0,2006
2006-05-09,Pahang,2,1,1,2006
2006-05-10,Pahang,0,0,0,2006
2006-05-11,Pahang,2,0,2,2006
2006-05-12,Pahang,0,0,0,2006
2006-05-13,Pahang,17,14,3,2006
2006-05-14,Pahang,26,25,1,2006
2006-05-15,Pahang,5,3,2,2006
2006-05-16,Pahang,0,0,0,2006
2006-05-17,Pahang,22,21,1,2006
2006-05-18,Pahang,3,1,2,2006
2006-05-19,Pahang,0,0,0,2006
2006-05-20,Pahang,6,6,0,2006
2006-05-21,Pahang,24,22,2,2006
2006-05-22,Pahang,7,5,2,2006
2006-05-23,Pahang,2,1,1,2006
2006-05-24,Pahang,4,2,2,2006
2006-05-25,Pahang,1,1,0,2006
2006-05-26,Pahang,1,0,1,2006
2006-05-27,Pahang,0,0,0,2006
2006-05-28,Pahang,35,32,3,2006
2006-05-29,Pahang,5,3,2,2006
2006-05-30,Pahang,3,1,2,2006
2006-05-31,Pahang,3,2,1,2006
2006-06-01,Pahang,2,0,2,2006
2006-06-02,Pahang,24,23,1,2006
2006-06-03,Pahang,0,0,0,2006
2006-06-04,Pahang,31,21,10,2006
2006-06-05,Pahang,0,0,0,2006
2006-06-06,Pahang,1,1,0,2006
2006-06-07,Pahang,0,0,0,2006
2006-06-08,Pahang,21,20,1,2006
2006-06-09,Pahang,37,36,1,2006
2006-06-10,Pahang,0,0,0,2006
2006-06-11,Pahang,0,0,0,2006
2006-06-12,Pahang,3,1,2,2006
2006-06-13,Pahang,3,1,2,2006
2006-06-14,Pahang,2,1,1,2006
2006-06-15,Pahang,5,2,3,2006
2006-06-16,Pahang,2,2,0,2006
2006-06-17,Pahang,43,37,6,2006
2006-06-18,Pahang,0,0,0,2006
2006-06-19,Pahang,4,2,2,2006
2006-06-20,Pahang,9,7,2,2006
2006-06-21,Pahang,2,2,0,2006
2006-06-22,Pahang,2,1,1,2006
2006-06-23,Pahang,0,0,0,2006
2006-06-24,Pahang,0,0,0,2006
2006-06-25,Pahang,6,5,1,2006
2006-06-26,Pahang,2,1,1,2006
2006-06-27,Pahang,2,1,1,2006
2006-06-28,Pahang,4,1,3,2006
2006-06-29,Pahang,11,10,1,2006
2006-06-30,Pahang,1,1,0,2006
2006-07-01,Pahang,0,0,0,2006
2006-07-02,Pahang,43,30,13,2006
2006-07-03,Pahang,2,2,0,2006
2006-07-04,Pahang,0,0,0,2006
2006-07-05,Pahang,1,0,1,2006
2006-07-06,Pahang,6,5,1,2006
2006-07-07,Pahang,8,7,1,2006
2006-07-08,Pahang,13,12,1,2006
2006-07-09,Pahang,5,5,0,2006
2006-07-10,Pahang,0,0,0,2006
2006-07-11,Pahang,16,15,1,2006
2006-07-12,Pahang,20,15,5,2006
2006-07-13,Pahang,8,5,3,2006
2006-07-14,Pahang,1,0,1,2006
2006-07-15,Pahang,26,20,6,2006
2006-07-16,Pahang,12,8,4,2006
2006-07-17,Pahang,2,1,1,2006
2006-07-18,Pahang,2,1,1,2006
2006-07-19,Pahang,46,45,1,2006
2006-07-20,Pahang,1,1,0,2006
2006-07-21,Pahang,1,0,1,2006
2006-07-22,Pahang,51,50,1,2006
2006-07-23,Pahang,0,0,0,2006
2006-07-24,Pahang,2,0,2,2006
2006-07-25,Pahang,25,21,4,2006
2006-07-26,Pahang,1,1,0,2006
2006-07-27,Pahang,74,73,1,2006
2006-07-28,Pahang,2,1,1,2006
2006-07-29,Pahang,11,11,0,2006
2006-07-30,Pahang,41,31,10,2006
2006-07-31,Pahang,0,0,0,2006
2006-08-01,Pahang,0,0,0,2006
2006-08-02,Pahang,1,0,1,2006
2006-08-03,Pahang,3,0,3,2006
2006-08-04,Pahang,2,0,2,2006
2006-08-05,Pahang,0,0,0,2006
2006-08-06,Pahang,8,7,1,2006
2006-08-07,Pahang,2,1,1,2006
2006-08-08,Pahang,2,1,1,2006
2006-08-09,Pahang,27,27,0,2006
2006-08-10,Pahang,1,1,0,2006
2006-08-11,Pahang,1,1,0,2006
2006-08-12,Pahang,13,11,2,2006
2006-08-13,Pahang,35,24,11,2006
2006-08-14,Pahang,3,1,2,2006
2006-08-15,Pahang,3,1,2,2006
2006-08-16,Pahang,6,4,2,2006
2006-08-17,Pahang,2,1,1,2006
2006-08-18,Pahang,1,1,0,2006
2006-08-19,Pahang,57,56,1,2006
2006-08-20,Pahang,0,0,0,2006
2006-08-21,Pahang,1,0,1,2006
2006-08-22,Pahang,1,0,1,2006
2006-08-23,Pahang,32,24,8,2006
2006-08-24,Pahang,18,16,2,2006
2006-08-25,Pahang,4,1,3,2006
2006-08-26,Pahang,46,43,3,2006
2006-08-27,Pahang,15,12,3,2006
2006-08-28,Pahang,1,1,0,2006
2006-08-29,Pahang,2,2,0,2006
2006-08-30,Pahang,2,1,1,2006
2006-08-31,Pahang,0,0,0,2006
2006-09-01,Pahang,2,0,2,2006
2006-09-02,Pahang,0,0,0,2006
2006-09-03,Pahang,83,68,15,2006
2006-09-04,Pahang,0,0,0,2006
2006-09-05,Pahang,11,7,4,2006
2006-09-06,Pahang,3,2,1,2006
2006-09-07,Pahang,2,1,1,2006
2006-09-08,Pahang,4,2,2,2006
2006-09-09,Pahang,7,7,0,2006
2006-09-10,Pahang,27,18,9,2006
2006-09-11,Pahang,0,0,0,2006
2006-09-12,Pahang,13,11,2,2006
2006-09-13,Pahang,44,38,6,2006
2006-09-14,Pahang,11,10,1,2006
2006-09-15,Pahang,1,0,1,2006
2006-09-16,Pahang,8,8,0,2006
2006-09-17,Pahang,21,16,5,2006
2006-09-18,Pahang,1,0,1,2006
2006-09-19,Pahang,0,0,0,2006
2006-09-20,Pahang,3,1,2,2006
2006-09-21,Pahang,36,35,1,2006
2006-09-22,Pahang,4,1,3,2006
2006-09-23,Pahang,39,30,9,2006
2006-09-24,Pahang,21,16,5,2006
2006-09-25,Pahang,0,0,0,2006
2006-09-26,Pahang,1,1,0,2006
2006-09-27,Pahang,2,2,0,2006
2006-09-28,Pahang,1,0,1,2006
2006-09-29,Pahang,1,0,1,2006
2006-09-30,Pahang,24,22,2,2006
2006-10-01,Pahang,35,27,8,2006
2006-10-02,Pahang,0,0,0,2006
2006-10-03,Pahang,0,0,0,2006
2006-10-04,Pahang,2,0,2,2006
2006-10-05,Pahang,2,1,1,2006
2006-10-06,Pahang,1,1,0,2006
2006-10-07,Pahang,0,0,0,2006
2006-10-08,Pahang,4,2,2,2006
2006-10-09,Pahang,4,1,3,2006
2006-10-10,Pahang,0,0,0,2006
2006-10-11,Pahang,1,0,1,2006
2006-10-12,Pahang,4,1,3,2006
2006-10-13,Pahang,0,0,0,2006
2006-10-14,Pahang,0,0,0,2006
2006-10-15,Pahang,16,9,7,2006
2006-10-16,Pahang,1,0,1,2006
2006-10-17,Pahang,0,0,0,2006
2006-10-18,Pahang,0,0,0,2006
2006-10-19,Pahang,1,0,1,2006
2006-10-20,Pahang,7,2,5,2006
2006-10-21,Pahang,0,0,0,2006
2006-10-22,Pahang,5,4,1,2006
2006-10-23,Pahang,1,0,1,2006
2006-10-24,Pahang,0,0,0,2006
2006-10-25,Pahang,0,0,0,2006
2006-10-26,Pahang,2,0,2,2006
2006-10-27,Pahang,5,3,2,2006
2006-10-28,Pahang,0,0,0,2006
2006-10-29,Pahang,39,25,14,2006
2006-10-30,Pahang,2,0,2,2006
2006-10-31,Pahang,12,8,4,2006
2006-11-01,Pahang,11,9,2,2006
2006-11-02,Pahang,46,37,9,2006
2006-11-03,Pahang,23,21,2,2006
2006-11-04,Pahang,0,0,0,2006
2006-11-05,Pahang,0,0,0,2006
2006-11-06,Pahang,9,5,4,2006
2006-11-07,Pahang,11,10,1,2006
2006-11-08,Pahang,26,19,7,2006
2006-11-09,Pahang,14,13,1,2006
2006-11-10,Pahang,2,1,1,2006
2006-11-11,Pahang,0,0,0,2006
2006-11-12,Pahang,44,20,24,2006
2006-11-13,Pahang,2,1,1,2006
2006-11-14,Pahang,1,0,1,2006
2006-11-15,Pahang,1,0,1,2006
2006-11-16,Pahang,20,16,4,2006
2006-11-17,Pahang,0,0,0,2006
2006-11-18,Pahang,31,29,2,2006
2006-11-19,Pahang,12,9,3,2006
2006-11-20,Pahang,4,1,3,2006
2006-11-21,Pahang,2,0,2,2006
2006-11-22,Pahang,4,2,2,2006
2006-11-23,Pahang,4,3,1,2006
2006-11-24,Pahang,5,2,3,2006
2006-11-25,Pahang,0,0,0,2006
2006-11-26,Pahang,20,18,2,2006
2006-11-27,Pahang,4,2,2,2006
2006-11-28,Pahang,1,0,1,2006
2006-11-29,Pahang,3,2,1,2006
2006-11-30,Pahang,6,4,2,2006
2006-12-01,Pahang,3,1,2,2006
2006-12-02,Pahang,28,27,1,2006
2006-12-03,Pahang,3,3,0,2006
2006-12-04,Pahang,0,0,0,2006
2006-12-05,Pahang,1,0,1,2006
2006-12-06,Pahang,1,0,1,2006
2006-12-07,Pahang,1,0,1,2006
2006-12-08,Pahang,2,0,2,2006
2006-12-09,Pahang,18,17,1,2006
2006-12-10,Pahang,0,0,0,2006
2006-12-11,Pahang,3,1,2,2006
2006-12-12,Pahang,2,1,1,2006
2006-12-13,Pahang,13,8,5,2006
2006-12-14,Pahang,15,10,5,2006
2006-12-15,Pahang,2,1,1,2006
2006-12-16,Pahang,8,7,1,2006
2006-12-17,Pahang,12,9,3,2006
2006-12-18,Pahang,2,0,2,2006
2006-12-19,Pahang,6,4,2,2006
2006-12-20,Pahang,19,17,2,2006
2006-12-21,Pahang,14,11,3,2006
2006-12-22,Pahang,0,0,0,2006
2006-12-23,Pahang,6,6,0,2006
2006-12-24,Pahang,8,6,2,2006
2006-12-25,Pahang,0,0,0,2006
2006-12-26,Pahang,1,1,0,2006
2006-12-27,Pahang,16,13,3,2006
2006-12-28,Pahang,28,20,8,2006
2006-12-29,Pahang,7,6,1,2006
2006-12-30,Pahang,0,0,0,2006
2006-12-31,Pahang,0,0,0,2006
2007-01-01,Pahang,0,0,0,2007
2007-01-02,Pahang,8,6,2,2007
2007-01-03,Pahang,5,4,1,2007
2007-01-04,Pahang,1,0,1,2007
2007-01-05,Pahang,1,1,0,2007
2007-01-06,Pahang,13,12,1,2007
2007-01-07,Pahang,11,9,2,2007
2007-01-08,Pahang,4,2,2,2007
2007-01-09,Pahang,1,0,1,2007
2007-01-10,Pahang,34,30,4,2007
2007-01-11,Pahang,33,31,2,2007
2007-01-12,Pahang,2,2,0,2007
2007-01-13,Pahang,0,0,0,2007
2007-01-14,Pahang,0,0,0,2007
2007-01-15,Pahang,3,1,2,2007
2007-01-16,Pahang,1,0,1,2007
2007-01-17,Pahang,34,27,7,2007
2007-01-18,Pahang,1,1,0,2007
2007-01-19,Pahang,0,0,0,2007
2007-01-20,Pahang,47,31,16,2007
2007-01-21,Pahang,42,23,19,2007
2007-01-22,Pahang,2,0,2,2007
2007-01-23,Pahang,3,1,2,2007
2007-01-24,Pahang,4,0,4,2007
2007-01-25,Pahang,1,1,0,2007
2007-01-26,Pahang,0,0,0,2007
2007-01-27,Pahang,0,0,0,2007
2007-01-28,Pahang,35,18,17,2007
2007-01-29,Pahang,0,0,0,2007
2007-01-30,Pahang,36,31,5,2007
2007-01-31,Pahang,4,2,2,2007
2007-02-01,Pahang,2,0,2,2007
2007-02-02,Pahang,2,2,0,2007
2007-02-03,Pahang,21,17,4,2007
2007-02-04,Pahang,13,10,3,2007
2007-02-05,Pahang,3,0,3,2007
2007-02-06,Pahang,54,44,10,2007
2007-02-07,Pahang,52,40,12,2007
2007-02-08,Pahang,2,1,1,2007
2007-02-09,Pahang,1,0,1,2007
2007-02-10,Pahang,0,0,0,2007
2007-02-11,Pahang,29,14,15,2007
2007-02-12,Pahang,1,0,1,2007
2007-02-13,Pahang,1,1,0,2007
2007-02-14,Pahang,19,17,2,2007
2007-02-15,Pahang,22,17,5,2007
2007-02-16,Pahang,3,1,2,2007
2007-02-17,Pahang,0,0,0,2007
2007-02-18,Pahang,0,0,0,2007
2007-02-19,Pahang,0,0,0,2007
2007-02-20,Pahang,0,0,0,2007
2007-02-21,Pahang,3,2,1,2007
2007-02-22,Pahang,2,0,2,2007
2007-02-23,Pahang,2,0,2,2007
2007-02-24,Pahang,24,24,0,2007
2007-02-25,Pahang,0,0,0,2007
2007-02-26,Pahang,9,3,6,2007
2007-02-27,Pahang,2,1,1,2007
2007-02-28,Pahang,4,1,3,2007
2007-03-01,Pahang,0,0,0,2007
2007-03-02,Pahang,18,17,1,2007
2007-03-03,Pahang,0,0,0,2007
2007-03-04,Pahang,0,0,0,2007
2007-03-05,Pahang,3,3,0,2007
2007-03-06,Pahang,3,2,1,2007
2007-03-07,Pahang,25,23,2,2007
2007-03-08,Pahang,0,0,0,2007
2007-03-09,Pahang,3,0,3,2007
2007-03-10,Pahang,24,22,2,2007
2007-03-11,Pahang,25,20,5,2007
2007-03-12,Pahang,0,0,0,2007
2007-03-13,Pahang,2,1,1,2007
2007-03-14,Pahang,2,1,1,2007
2007-03-15,Pahang,3,1,2,2007
2007-03-16,Pahang,3,0,3,2007
2007-03-17,Pahang,81,70,11,2007
2007-03-18,Pahang,106,88,18,2007
2007-03-19,Pahang,1,0,1,2007
2007-03-20,Pahang,2,0,2,2007
2007-03-21,Pahang,0,0,0,2007
2007-03-22,Pahang,2,1,1,2007
2007-03-23,Pahang,2,0,2,2007
2007-03-24,Pahang,0,0,0,2007
2007-03-25,Pahang,20,10,10,2007
2007-03-26,Pahang,11,6,5,2007
2007-03-27,Pahang,1,0,1,2007
2007-03-28,Pahang,2,0,2,2007
2007-03-29,Pahang,6,2,4,2007
2007-03-30,Pahang,2,1,1,2007
2007-03-31,Pahang,0,0,0,2007
2007-04-01,Pahang,24,15,9,2007
2007-04-02,Pahang,2,2,0,2007
2007-04-03,Pahang,29,21,8,2007
2007-04-04,Pahang,1,0,1,2007
2007-04-05,Pahang,3,2,1,2007
2007-04-06,Pahang,2,0,2,2007
2007-04-07,Pahang,11,9,2,2007
2007-04-08,Pahang,0,0,0,2007
2007-04-09,Pahang,3,0,3,2007
2007-04-10,Pahang,3,2,1,2007
2007-04-11,Pahang,1,0,1,2007
2007-04-12,Pahang,28,22,6,2007
2007-04-13,Pahang,2,0,2,2007
2007-04-14,Pahang,0,0,0,2007
2007-04-15,Pahang,31,13,18,2007
2007-04-16,Pahang,0,0,0,2007
2007-04-17,Pahang,3,2,1,2007
2007-04-18,Pahang,2,2,0,2007
2007-04-19,Pahang,26,21,5,2007
2007-04-20,Pahang,0,0,0,2007
2007-04-21,Pahang,0,0,0,2007
2007-04-22,Pahang,17,11,6,2007
2007-04-23,Pahang,1,0,1,2007
2007-04-24,Pahang,0,0,0,2007
2007-04-25,Pahang,16,14,2,2007
2007-04-26,Pahang,0,0,0,2007
2007-04-27,Pahang,1,1,0,2007
2007-04-28,Pahang,8,8,0,2007
2007-04-29,Pahang,6,6,0,2007
2007-04-30,Pahang,6,3,3,2007
2007-05-01,Pahang,0,0,0,2007
2007-05-02,Pahang,0,0,0,2007
2007-05-03,Pahang,4,0,4,2007
2007-05-04,Pahang,1,0,1,2007
2007-05-05,Pahang,0,0,0,2007
2007-05-06,Pahang,35,15,20,2007
2007-05-07,Pahang,25,25,0,2007
2007-05-08,Pahang,1,1,0,2007
2007-05-09,Pahang,9,9,0,2007
2007-05-10,Pahang,15,5,10,2007
2007-05-11,Pahang,4,1,3,2007
2007-05-12,Pahang,0,0,0,2007
2007-05-13,Pahang,23,10,13,2007
2007-05-14,Pahang,7,2,5,2007
2007-05-15,Pahang,1,1,0,2007
2007-05-16,Pahang,0,0,0,2007
2007-05-17,Pahang,4,1,3,2007
2007-05-18,Pahang,1,0,1,2007
2007-05-19,Pahang,17,16,1,2007
2007-05-20,Pahang,37,14,23,2007
2007-05-21,Pahang,4,1,3,2007
2007-05-22,Pahang,0,0,0,2007
2007-05-23,Pahang,2,0,2,2007
2007-05-24,Pahang,16,8,8,2007
2007-05-25,Pahang,2,1,1,2007
2007-05-26,Pahang,0,0,0,2007
2007-05-27,Pahang,22,11,11,2007
2007-05-28,Pahang,1,0,1,2007
2007-05-29,Pahang,0,0,0,2007
2007-05-30,Pahang,0,0,0,2007
2007-05-31,Pahang,4,2,2,2007
2007-06-01,Pahang,1,0,1,2007
2007-06-02,Pahang,23,17,6,2007
2007-06-03,Pahang,17,8,9,2007
2007-06-04,Pahang,4,1,3,2007
2007-06-05,Pahang,3,1,2,2007
2007-06-06,Pahang,2,0,2,2007
2007-06-07,Pahang,3,2,1,2007
2007-06-08,Pahang,14,11,3,2007
2007-06-09,Pahang,0,0,0,2007
2007-06-10,Pahang,17,8,9,2007
2007-06-11,Pahang,5,2,3,2007
2007-06-12,Pahang,4,0,4,2007
2007-06-13,Pahang,1,1,0,2007
2007-06-14,Pahang,15,14,1,2007
2007-06-15,Pahang,3,1,2,2007
2007-06-16,Pahang,0,0,0,2007
2007-06-17,Pahang,16,8,8,2007
2007-06-18,Pahang,0,0,0,2007
2007-06-19,Pahang,16,8,8,2007
2007-06-20,Pahang,3,1,2,2007
2007-06-21,Pahang,16,13,3,2007
2007-06-22,Pahang,0,0,0,2007
2007-06-23,Pahang,13,11,2,2007
2007-06-24,Pahang,15,11,4,2007
2007-06-25,Pahang,2,1,1,2007
2007-06-26,Pahang,1,0,1,2007
2007-06-27,Pahang,9,8,1,2007
2007-06-28,Pahang,7,4,3,2007
2007-06-29,Pahang,2,0,2,2007
2007-06-30,Pahang,12,8,4,2007
2007-07-01,Pahang,11,8,3,2007
2007-07-02,Pahang,3,1,2,2007
2007-07-03,Pahang,2,0,2,2007
2007-07-04,Pahang,15,10,5,2007
2007-07-05,Pahang,9,3,6,2007
2007-07-06,Pahang,4,1,3,2007
2007-07-07,Pahang,1,1,0,2007
2007-07-08,Pahang,66,36,30,2007
2007-07-09,Pahang,2,2,0,2007
2007-07-10,Pahang,1,0,1,2007
2007-07-11,Pahang,15,15,0,2007
2007-07-12,Pahang,17,15,2,2007
2007-07-13,Pahang,3,1,2,2007
2007-07-14,Pahang,10,9,1,2007
2007-07-15,Pahang,0,0,0,2007
2007-07-16,Pahang,35,23,12,2007
2007-07-17,Pahang,2,1,1,2007
2007-07-18,Pahang,0,0,0,2007
2007-07-19,Pahang,4,0,4,2007
2007-07-20,Pahang,1,0,1,2007
2007-07-21,Pahang,4,3,1,2007
2007-07-22,Pahang,6,5,1,2007
2007-07-23,Pahang,3,0,3,2007
2007-07-24,Pahang,35,29,6,2007
2007-07-25,Pahang,1,1,0,2007
2007-07-26,Pahang,1,0,1,2007
2007-07-27,Pahang,1,1,0,2007
2007-07-28,Pahang,27,13,14,2007
2007-07-29,Pahang,10,6,4,2007
2007-07-30,Pahang,2,2,0,2007
2007-07-31,Pahang,15,9,6,2007
2007-08-01,Pahang,0,0,0,2007
2007-08-02,Pahang,41,39,2,2007
2007-08-03,Pahang,2,2,0,2007
2007-08-04,Pahang,51,38,13,2007
2007-08-05,Pahang,54,49,5,2007
2007-08-06,Pahang,1,1,0,2007
2007-08-07,Pahang,2,1,1,2007
2007-08-08,Pahang,17,15,2,2007
2007-08-09,Pahang,1,0,1,2007
2007-08-10,Pahang,1,1,0,2007
2007-08-11,Pahang,3,3,0,2007
2007-08-12,Pahang,22,10,12,2007
2007-08-13,Pahang,1,0,1,2007
2007-08-14,Pahang,37,27,10,2007
2007-08-15,Pahang,1,0,1,2007
2007-08-16,Pahang,8,8,0,2007
2007-08-17,Pahang,3,1,2,2007
2007-08-18,Pahang,29,20,9,2007
2007-08-19,Pahang,0,0,0,2007
2007-08-20,Pahang,2,0,2,2007
2007-08-21,Pahang,4,0,4,2007
2007-08-22,Pahang,4,1,3,2007
2007-08-23,Pahang,3,1,2,2007
2007-08-24,Pahang,1,0,1,2007
2007-08-25,Pahang,14,14,0,2007
2007-08-26,Pahang,15,6,9,2007
2007-08-27,Pahang,0,0,0,2007
2007-08-28,Pahang,4,1,3,2007
2007-08-29,Pahang,2,1,1,2007
2007-08-30,Pahang,2,0,2,2007
2007-08-31,Pahang,33,32,1,2007
2007-09-01,Pahang,16,8,8,2007
2007-09-02,Pahang,44,20,24,2007
2007-09-03,Pahang,2,0,2,2007
2007-09-04,Pahang,33,27,6,2007
2007-09-05,Pahang,11,7,4,2007
2007-09-06,Pahang,3,1,2,2007
2007-09-07,Pahang,2,0,2,2007
2007-09-08,Pahang,61,46,15,2007
2007-09-09,Pahang,45,21,24,2007
2007-09-10,Pahang,1,1,0,2007
2007-09-11,Pahang,9,7,2,2007
2007-09-12,Pahang,8,8,0,2007
2007-09-13,Pahang,0,0,0,2007
2007-09-14,Pahang,0,0,0,2007
2007-09-15,Pahang,8,5,3,2007
2007-09-16,Pahang,21,8,13,2007
2007-09-17,Pahang,0,0,0,2007
2007-09-18,Pahang,1,0,1,2007
2007-09-19,Pahang,0,0,0,2007
2007-09-20,Pahang,2,1,1,2007
2007-09-21,Pahang,9,7,2,2007
2007-09-22,Pahang,0,0,0,2007
2007-09-23,Pahang,0,0,0,2007
2007-09-24,Pahang,9,7,2,2007
2007-09-25,Pahang,5,4,1,2007
2007-09-26,Pahang,3,2,1,2007
2007-09-27,Pahang,0,0,0,2007
2007-09-28,Pahang,1,0,1,2007
2007-09-29,Pahang,0,0,0,2007
2007-09-30,Pahang,9,6,3,2007
2007-10-01,Pahang,1,0,1,2007
2007-10-02,Pahang,0,0,0,2007
2007-10-03,Pahang,0,0,0,2007
2007-10-04,Pahang,0,0,0,2007
2007-10-05,Pahang,1,0,1,2007
2007-10-06,Pahang,0,0,0,2007
2007-10-07,Pahang,17,10,7,2007
2007-10-08,Pahang,1,1,0,2007
2007-10-09,Pahang,0,0,0,2007
2007-10-10,Pahang,8,3,5,2007
2007-10-11,Pahang,1,0,1,2007
2007-10-12,Pahang,0,0,0,2007
2007-10-13,Pahang,0,0,0,2007
2007-10-14,Pahang,0,0,0,2007
2007-10-15,Pahang,0,0,0,2007
2007-10-16,Pahang,7,0,7,2007
2007-10-17,Pahang,12,8,4,2007
2007-10-18,Pahang,16,13,3,2007
2007-10-19,Pahang,18,10,8,2007
2007-10-20,Pahang,0,0,0,2007
2007-10-21,Pahang,0,0,0,2007
2007-10-22,Pahang,2,1,1,2007
2007-10-23,Pahang,13,8,5,2007
2007-10-24,Pahang,28,19,9,2007
2007-10-25,Pahang,18,16,2,2007
2007-10-26,Pahang,2,0,2,2007
2007-10-27,Pahang,0,0,0,2007
2007-10-28,Pahang,22,14,8,2007
2007-10-29,Pahang,5,3,2,2007
2007-10-30,Pahang,14,12,2,2007
2007-10-31,Pahang,4,1,3,2007
2007-11-01,Pahang,16,12,4,2007
2007-11-02,Pahang,3,2,1,2007
2007-11-03,Pahang,13,9,4,2007
2007-11-04,Pahang,16,8,8,2007
2007-11-05,Pahang,2,1,1,2007
2007-11-06,Pahang,0,0,0,2007
2007-11-07,Pahang,21,17,4,2007
2007-11-08,Pahang,0,0,0,2007
2007-11-09,Pahang,16,10,6,2007
2007-11-10,Pahang,0,0,0,2007
2007-11-11,Pahang,31,13,18,2007
2007-11-12,Pahang,3,2,1,2007
2007-11-13,Pahang,9,6,3,2007
2007-11-14,Pahang,1,0,1,2007
2007-11-15,Pahang,1,0,1,2007
2007-11-16,Pahang,3,1,2,2007
2007-11-17,Pahang,0,0,0,2007
2007-11-18,Pahang,30,16,14,2007
2007-11-19,Pahang,20,12,8,2007
2007-11-20,Pahang,2,1,1,2007
2007-11-21,Pahang,0,0,0,2007
2007-11-22,Pahang,32,18,14,2007
2007-11-23,Pahang,2,1,1,2007
2007-11-24,Pahang,9,8,1,2007
2007-11-25,Pahang,3,3,0,2007
2007-11-26,Pahang,1,0,1,2007
2007-11-27,Pahang,1,1,0,2007
2007-11-28,Pahang,1,1,0,2007
2007-11-29,Pahang,14,10,4,2007
2007-11-30,Pahang,2,2,0,2007
2007-12-01,Pahang,0,0,0,2007
2007-12-02,Pahang,41,35,6,2007
2007-12-03,Pahang,2,2,0,2007
2007-12-04,Pahang,1,0,1,2007
2007-12-05,Pahang,0,0,0,2007
2007-12-06,Pahang,2,1,1,2007
2007-12-07,Pahang,3,1,2,2007
2007-12-08,Pahang,0,0,0,2007
2007-12-09,Pahang,17,8,9,2007
2007-12-10,Pahang,3,0,3,2007
2007-12-11,Pahang,0,0,0,2007
2007-12-12,Pahang,5,2,3,2007
2007-12-13,Pahang,10,6,4,2007
2007-12-14,Pahang,5,2,3,2007
2007-12-15,Pahang,0,0,0,2007
2007-12-16,Pahang,30,9,21,2007
2007-12-17,Pahang,10,6,4,2007
2007-12-18,Pahang,5,1,4,2007
2007-12-19,Pahang,2,0,2,2007
2007-12-20,Pahang,0,0,0,2007
2007-12-21,Pahang,1,1,0,2007
2007-12-22,Pahang,9,7,2,2007
2007-12-23,Pahang,0,0,0,2007
2007-12-24,Pahang,2,2,0,2007
2007-12-25,Pahang,12,8,4,2007
2007-12-26,Pahang,1,0,1,2007
2007-12-27,Pahang,7,1,6,2007
2007-12-28,Pahang,1,0,1,2007
2007-12-29,Pahang,13,8,5,2007
2007-12-30,Pahang,15,6,9,2007
2007-12-31,Pahang,2,0,2,2007
2008-01-01,Pahang,0,0,0,2008
2008-01-02,Pahang,13,10,3,2008
2008-01-03,Pahang,4,1,3,2008
2008-01-04,Pahang,14,10,4,2008
2008-01-05,Pahang,15,13,2,2008
2008-01-06,Pahang,3,2,1,2008
2008-01-07,Pahang,3,1,2,2008
2008-01-08,Pahang,3,2,1,2008
2008-01-09,Pahang,1,0,1,2008
2008-01-10,Pahang,2,0,2,2008
2008-01-11,Pahang,2,1,1,2008
2008-01-12,Pahang,14,9,5,2008
2008-01-13,Pahang,0,0,0,2008
2008-01-14,Pahang,3,0,3,2008
2008-01-15,Pahang,0,0,0,2008
2008-01-16,Pahang,0,0,0,2008
2008-01-17,Pahang,40,34,6,2008
2008-01-18,Pahang,1,0,1,2008
2008-01-19,Pahang,25,10,15,2008
2008-01-20,Pahang,29,15,14,2008
2008-01-21,Pahang,1,0,1,2008
2008-01-22,Pahang,2,1,1,2008
2008-01-23,Pahang,26,15,11,2008
2008-01-24,Pahang,18,14,4,2008
2008-01-25,Pahang,1,1,0,2008
2008-01-26,Pahang,0,0,0,2008
2008-01-27,Pahang,0,0,0,2008
2008-01-28,Pahang,4,1,3,2008
2008-01-29,Pahang,37,29,8,2008
2008-01-30,Pahang,18,16,2,2008
2008-01-31,Pahang,4,1,3,2008
2008-02-01,Pahang,6,6,0,2008
2008-02-02,Pahang,0,0,0,2008
2008-02-03,Pahang,0,0,0,2008
2008-02-04,Pahang,12,8,4,2008
2008-02-05,Pahang,3,2,1,2008
2008-02-06,Pahang,2,0,2,2008
2008-02-07,Pahang,0,0,0,2008
2008-02-08,Pahang,0,0,0,2008
2008-02-09,Pahang,0,0,0,2008
2008-02-10,Pahang,27,14,13,2008
2008-02-11,Pahang,3,0,3,2008
2008-02-12,Pahang,22,11,11,2008
2008-02-13,Pahang,41,30,11,2008
2008-02-14,Pahang,60,55,5,2008
2008-02-15,Pahang,37,25,12,2008
2008-02-16,Pahang,9,8,1,2008
2008-02-17,Pahang,0,0,0,2008
2008-02-18,Pahang,0,0,0,2008
2008-02-19,Pahang,3,2,1,2008
2008-02-20,Pahang,3,2,1,2008
2008-02-21,Pahang,28,25,3,2008
2008-02-22,Pahang,2,0,2,2008
2008-02-23,Pahang,12,12,0,2008
2008-02-24,Pahang,27,14,13,2008
2008-02-25,Pahang,7,3,4,2008
2008-02-26,Pahang,0,0,0,2008
2008-02-27,Pahang,18,12,6,2008
2008-02-28,Pahang,15,10,5,2008
2008-02-29,Pahang,2,1,1,2008
2008-03-01,Pahang,0,0,0,2008
2008-03-02,Pahang,17,16,1,2008
2008-03-03,Pahang,0,0,0,2008
2008-03-04,Pahang,12,11,1,2008
2008-03-05,Pahang,30,23,7,2008
2008-03-06,Pahang,2,1,1,2008
2008-03-07,Pahang,3,1,2,2008
2008-03-08,Pahang,0,0,0,2008
2008-03-09,Pahang,19,6,13,2008
2008-03-10,Pahang,4,0,4,2008
2008-03-11,Pahang,3,0,3,2008
2008-03-12,Pahang,1,1,0,2008
2008-03-13,Pahang,8,5,3,2008
2008-03-14,Pahang,4,1,3,2008
2008-03-15,Pahang,56,38,18,2008
2008-03-16,Pahang,44,12,32,2008
2008-03-17,Pahang,4,0,4,2008
2008-03-18,Pahang,25,19,6,2008
2008-03-19,Pahang,24,18,6,2008
2008-03-20,Pahang,0,0,0,2008
2008-03-21,Pahang,3,1,2,2008
2008-03-22,Pahang,0,0,0,2008
2008-03-23,Pahang,27,16,11,2008
2008-03-24,Pahang,0,0,0,2008
2008-03-25,Pahang,2,0,2,2008
2008-03-26,Pahang,14,9,5,2008
2008-03-27,Pahang,31,28,3,2008
2008-03-28,Pahang,2,0,2,2008
2008-03-29,Pahang,30,15,15,2008
2008-03-30,Pahang,5,4,1,2008
2008-03-31,Pahang,3,1,2,2008
2008-04-01,Pahang,4,2,2,2008
2008-04-02,Pahang,1,1,0,2008
2008-04-03,Pahang,3,1,2,2008
2008-04-04,Pahang,3,0,3,2008
2008-04-05,Pahang,0,0,0,2008
2008-04-06,Pahang,19,9,10,2008
2008-04-07,Pahang,2,1,1,2008
2008-04-08,Pahang,0,0,0,2008
2008-04-09,Pahang,4,1,3,2008
2008-04-10,Pahang,0,0,0,2008
2008-04-11,Pahang,1,0,1,2008
2008-04-12,Pahang,0,0,0,2008
2008-04-13,Pahang,35,13,22,2008
2008-04-14,Pahang,3,3,0,2008
2008-04-15,Pahang,18,14,4,2008
2008-04-16,Pahang,1,1,0,2008
2008-04-17,Pahang,1,0,1,2008
2008-04-18,Pahang,12,9,3,2008
2008-04-19,Pahang,0,0,0,2008
2008-04-20,Pahang,14,6,8,2008
2008-04-21,Pahang,4,0,4,2008
2008-04-22,Pahang,0,0,0,2008
2008-04-23,Pahang,11,7,4,2008
2008-04-24,Pahang,2,1,1,2008
2008-04-25,Pahang,9,6,3,2008
2008-04-26,Pahang,5,4,1,2008
2008-04-27,Pahang,18,8,10,2008
2008-04-28,Pahang,27,20,7,2008
2008-04-29,Pahang,2,1,1,2008
2008-04-30,Pahang,15,14,1,2008
2008-05-01,Pahang,0,0,0,2008
2008-05-02,Pahang,3,1,2,2008
2008-05-03,Pahang,0,0,0,2008
2008-05-04,Pahang,17,12,5,2008
2008-05-05,Pahang,2,1,1,2008
2008-05-06,Pahang,12,5,7,2008
2008-05-07,Pahang,0,0,0,2008
2008-05-08,Pahang,14,5,9,2008
2008-05-09,Pahang,1,0,1,2008
2008-05-10,Pahang,0,0,0,2008
2008-05-11,Pahang,27,6,21,2008
2008-05-12,Pahang,1,0,1,2008
2008-05-13,Pahang,3,0,3,2008
2008-05-14,Pahang,1,1,0,2008
2008-05-15,Pahang,3,2,1,2008
2008-05-16,Pahang,1,1,0,2008
2008-05-17,Pahang,12,12,0,2008
2008-05-18,Pahang,0,0,0,2008
2008-05-19,Pahang,0,0,0,2008
2008-05-20,Pahang,7,7,0,2008
2008-05-21,Pahang,6,1,5,2008
2008-05-22,Pahang,1,1,0,2008
2008-05-23,Pahang,2,0,2,2008
2008-05-24,Pahang,17,16,1,2008
2008-05-25,Pahang,0,0,0,2008
2008-05-26,Pahang,2,2,0,2008
2008-05-27,Pahang,3,1,2,2008
2008-05-28,Pahang,1,0,1,2008
2008-05-29,Pahang,2,0,2,2008
2008-05-30,Pahang,1,0,1,2008
2008-05-31,Pahang,22,22,0,2008
2008-06-01,Pahang,10,3,7,2008
2008-06-02,Pahang,1,0,1,2008
2008-06-03,Pahang,1,0,1,2008
2008-06-04,Pahang,2,0,2,2008
2008-06-05,Pahang,0,0,0,2008
2008-06-06,Pahang,20,13,7,2008
2008-06-07,Pahang,0,0,0,2008
2008-06-08,Pahang,16,4,12,2008
2008-06-09,Pahang,2,0,2,2008
2008-06-10,Pahang,1,0,1,2008
2008-06-11,Pahang,6,3,3,2008
2008-06-12,Pahang,2,0,2,2008
2008-06-13,Pahang,1,0,1,2008
2008-06-14,Pahang,17,9,8,2008
2008-06-15,Pahang,47,10,37,2008
2008-06-16,Pahang,4,0,4,2008
2008-06-17,Pahang,9,9,0,2008
2008-06-18,Pahang,1,0,1,2008
2008-06-19,Pahang,13,11,2,2008
2008-06-20,Pahang,2,1,1,2008
2008-06-21,Pahang,0,0,0,2008
2008-06-22,Pahang,27,9,18,2008
2008-06-23,Pahang,2,0,2,2008
2008-06-24,Pahang,2,1,1,2008
2008-06-25,Pahang,12,8,4,2008
2008-06-26,Pahang,16,11,5,2008
2008-06-27,Pahang,40,39,1,2008
2008-06-28,Pahang,0,0,0,2008
2008-06-29,Pahang,9,5,4,2008
2008-06-30,Pahang,3,0,3,2008
2008-07-01,Pahang,3,0,3,2008
2008-07-02,Pahang,7,5,2,2008
2008-07-03,Pahang,1,0,1,2008
2008-07-04,Pahang,19,18,1,2008
2008-07-05,Pahang,0,0,0,2008
2008-07-06,Pahang,14,9,5,2008
2008-07-07,Pahang,1,0,1,2008
2008-07-08,Pahang,1,0,1,2008
2008-07-09,Pahang,3,0,3,2008
2008-07-10,Pahang,1,1,0,2008
2008-07-11,Pahang,2,1,1,2008
2008-07-12,Pahang,19,12,7,2008
2008-07-13,Pahang,1,1,0,2008
2008-07-14,Pahang,4,2,2,2008
2008-07-15,Pahang,2,0,2,2008
2008-07-16,Pahang,13,6,7,2008
2008-07-17,Pahang,14,7,7,2008
2008-07-18,Pahang,3,0,3,2008
2008-07-19,Pahang,0,0,0,2008
2008-07-20,Pahang,17,10,7,2008
2008-07-21,Pahang,2,1,1,2008
2008-07-22,Pahang,9,7,2,2008
2008-07-23,Pahang,3,2,1,2008
2008-07-24,Pahang,45,21,24,2008
2008-07-25,Pahang,0,0,0,2008
2008-07-26,Pahang,0,0,0,2008
2008-07-27,Pahang,0,0,0,2008
2008-07-28,Pahang,26,17,9,2008
2008-07-29,Pahang,35,26,9,2008
2008-07-30,Pahang,1,1,0,2008
2008-07-31,Pahang,12,4,8,2008
2008-08-01,Pahang,6,4,2,2008
2008-08-02,Pahang,10,2,8,2008
2008-08-03,Pahang,0,0,0,2008
2008-08-04,Pahang,1,0,1,2008
2008-08-05,Pahang,26,19,7,2008
2008-08-06,Pahang,31,11,20,2008
2008-08-07,Pahang,0,0,0,2008
2008-08-08,Pahang,15,6,9,2008
2008-08-09,Pahang,52,30,22,2008
2008-08-10,Pahang,20,5,15,2008
2008-08-11,Pahang,4,0,4,2008
2008-08-12,Pahang,8,5,3,2008
2008-08-13,Pahang,25,15,10,2008
2008-08-14,Pahang,37,22,15,2008
2008-08-15,Pahang,13,3,10,2008
2008-08-16,Pahang,0,0,0,2008
2008-08-17,Pahang,0,0,0,2008
2008-08-18,Pahang,3,0,3,2008
2008-08-19,Pahang,0,0,0,2008
2008-08-20,Pahang,19,10,9,2008
2008-08-21,Pahang,1,0,1,2008
2008-08-22,Pahang,4,3,1,2008
2008-08-23,Pahang,0,0,0,2008
2008-08-24,Pahang,16,11,5,2008
2008-08-25,Pahang,11,8,3,2008
2008-08-26,Pahang,3,1,2,2008
2008-08-27,Pahang,2,0,2,2008
2008-08-28,Pahang,1,0,1,2008
2008-08-29,Pahang,27,13,14,2008
2008-08-30,Pahang,9,7,2,2008
2008-08-31,Pahang,20,10,10,2008
2008-09-01,Pahang,0,0,0,2008
2008-09-02,Pahang,0,0,0,2008
2008-09-03,Pahang,1,0,1,2008
2008-09-04,Pahang,1,0,1,2008
2008-09-05,Pahang,7,4,3,2008
2008-09-06,Pahang,0,0,0,2008
2008-09-07,Pahang,29,6,23,2008
2008-09-08,Pahang,0,0,0,2008
2008-09-09,Pahang,0,0,0,2008
2008-09-10,Pahang,1,0,1,2008
2008-09-11,Pahang,1,1,0,2008
2008-09-12,Pahang,0,0,0,2008
2008-09-13,Pahang,19,11,8,2008
2008-09-14,Pahang,0,0,0,2008
2008-09-15,Pahang,0,0,0,2008
2008-09-16,Pahang,22,16,6,2008
2008-09-17,Pahang,0,0,0,2008
2008-09-18,Pahang,0,0,0,2008
2008-09-19,Pahang,0,0,0,2008
2008-09-20,Pahang,12,9,3,2008
2008-09-21,Pahang,15,0,15,2008
2008-09-22,Pahang,0,0,0,2008
2008-09-23,Pahang,0,0,0,2008
2008-09-24,Pahang,11,5,6,2008
2008-09-25,Pahang,1,0,1,2008
2008-09-26,Pahang,6,4,2,2008
2008-09-27,Pahang,0,0,0,2008
2008-09-28,Pahang,25,8,17,2008
2008-09-29,Pahang,7,3,4,2008
2008-09-30,Pahang,0,0,0,2008
2008-10-01,Pahang,0,0,0,2008
2008-10-02,Pahang,0,0,0,2008
2008-10-03,Pahang,6,0,6,2008
2008-10-04,Pahang,0,0,0,2008
2008-10-05,Pahang,41,8,33,2008
2008-10-06,Pahang,2,0,2,2008
2008-10-07,Pahang,4,2,2,2008
2008-10-08,Pahang,19,9,10,2008
2008-10-09,Pahang,9,3,6,2008
2008-10-10,Pahang,2,1,1,2008
2008-10-11,Pahang,8,4,4,2008
2008-10-12,Pahang,11,4,7,2008
2008-10-13,Pahang,6,0,6,2008
2008-10-14,Pahang,17,10,7,2008
2008-10-15,Pahang,1,0,1,2008
2008-10-16,Pahang,33,18,15,2008
2008-10-17,Pahang,2,0,2,2008
2008-10-18,Pahang,0,0,0,2008
2008-10-19,Pahang,14,4,10,2008
2008-10-20,Pahang,10,8,2,2008
2008-10-21,Pahang,12,8,4,2008
2008-10-22,Pahang,0,0,0,2008
2008-10-23,Pahang,3,0,3,2008
2008-10-24,Pahang,23,11,12,2008
2008-10-25,Pahang,0,0,0,2008
2008-10-26,Pahang,0,0,0,2008
2008-10-27,Pahang,0,0,0,2008
2008-10-28,Pahang,2,0,2,2008
2008-10-29,Pahang,2,0,2,2008
2008-10-30,Pahang,10,8,2,2008
2008-10-31,Pahang,3,0,3,2008
2008-11-01,Pahang,0,0,0,2008
2008-11-02,Pahang,36,16,20,2008
2008-11-03,Pahang,2,0,2,2008
2008-11-04,Pahang,12,6,6,2008
2008-11-05,Pahang,24,17,7,2008
2008-11-06,Pahang,29,16,13,2008
2008-11-07,Pahang,0,0,0,2008
2008-11-08,Pahang,6,5,1,2008
2008-11-09,Pahang,25,10,15,2008
2008-11-10,Pahang,2,1,1,2008
2008-11-11,Pahang,5,2,3,2008
2008-11-12,Pahang,5,4,1,2008
2008-11-13,Pahang,3,0,3,2008
2008-11-14,Pahang,3,0,3,2008
2008-11-15,Pahang,0,0,0,2008
2008-11-16,Pahang,25,11,14,2008
2008-11-17,Pahang,2,0,2,2008
2008-11-18,Pahang,3,0,3,2008
2008-11-19,Pahang,1,0,1,2008
2008-11-20,Pahang,18,9,9,2008
2008-11-21,Pahang,2,1,1,2008
2008-11-22,Pahang,5,2,3,2008
2008-11-23,Pahang,0,0,0,2008
2008-11-24,Pahang,1,0,1,2008
2008-11-25,Pahang,9,5,4,2008
2008-11-26,Pahang,1,0,1,2008
2008-11-27,Pahang,1,0,1,2008
2008-11-28,Pahang,7,3,4,2008
2008-11-29,Pahang,0,0,0,2008
2008-11-30,Pahang,22,18,4,2008
2008-12-01,Pahang,4,1,3,2008
2008-12-02,Pahang,5,0,5,2008
2008-12-03,Pahang,1,0,1,2008
2008-12-04,Pahang,13,12,1,2008
2008-12-05,Pahang,0,0,0,2008
2008-12-06,Pahang,11,6,5,2008
2008-12-07,Pahang,20,9,11,2008
2008-12-08,Pahang,0,0,0,2008
2008-12-09,Pahang,2,1,1,2008
2008-12-10,Pahang,1,0,1,2008
2008-12-11,Pahang,9,4,5,2008
2008-12-12,Pahang,4,1,3,2008
2008-12-13,Pahang,0,0,0,2008
2008-12-14,Pahang,6,5,1,2008
2008-12-15,Pahang,18,13,5,2008
2008-12-16,Pahang,11,5,6,2008
2008-12-17,Pahang,24,17,7,2008
2008-12-18,Pahang,2,1,1,2008
2008-12-19,Pahang,35,25,10,2008
2008-12-20,Pahang,4,3,1,2008
2008-12-21,Pahang,0,0,0,2008
2008-12-22,Pahang,3,2,1,2008
2008-12-23,Pahang,11,6,5,2008
2008-12-24,Pahang,12,8,4,2008
2008-12-25,Pahang,0,0,0,2008
2008-12-26,Pahang,7,4,3,2008
2008-12-27,Pahang,0,0,0,2008
2008-12-28,Pahang,11,6,5,2008
2008-12-29,Pahang,0,0,0,2008
2008-12-30,Pahang,4,1,3,2008
2008-12-31,Pahang,17,8,9,2008
2009-01-01,Pahang,0,0,0,2009
2009-01-02,Pahang,1,0,1,2009
2009-01-03,Pahang,0,0,0,2009
2009-01-04,Pahang,31,6,25,2009
2009-01-05,Pahang,3,0,3,2009
2009-01-06,Pahang,2,1,1,2009
2009-01-07,Pahang,1,0,1,2009
2009-01-08,Pahang,16,7,9,2009
2009-01-09,Pahang,6,1,5,2009
2009-01-10,Pahang,6,2,4,2009
2009-01-11,Pahang,29,16,13,2009
2009-01-12,Pahang,5,2,3,2009
2009-01-13,Pahang,2,0,2,2009
2009-01-14,Pahang,45,31,14,2009
2009-01-15,Pahang,13,11,2,2009
2009-01-16,Pahang,2,1,1,2009
2009-01-17,Pahang,14,11,3,2009
2009-01-18,Pahang,0,0,0,2009
2009-01-19,Pahang,32,23,9,2009
2009-01-20,Pahang,44,32,12,2009
2009-01-21,Pahang,27,17,10,2009
2009-01-22,Pahang,16,12,4,2009
2009-01-23,Pahang,6,1,5,2009
2009-01-24,Pahang,0,0,0,2009
2009-01-25,Pahang,0,0,0,2009
2009-01-26,Pahang,0,0,0,2009
2009-01-27,Pahang,0,0,0,2009
2009-01-28,Pahang,3,0,3,2009
2009-01-29,Pahang,27,14,13,2009
2009-01-30,Pahang,6,1,5,2009
2009-01-31,Pahang,0,0,0,2009
2009-02-01,Pahang,0,0,0,2009
2009-02-02,Pahang,5,1,4,2009
2009-02-03,Pahang,1,0,1,2009
2009-02-04,Pahang,14,9,5,2009
2009-02-05,Pahang,9,4,5,2009
2009-02-06,Pahang,3,0,3,2009
2009-02-07,Pahang,0,0,0,2009
2009-02-08,Pahang,24,19,5,2009
2009-02-09,Pahang,3,0,3,2009
2009-02-10,Pahang,14,11,3,2009
2009-02-11,Pahang,17,10,7,2009
2009-02-12,Pahang,15,12,3,2009
2009-02-13,Pahang,0,0,0,2009
2009-02-14,Pahang,20,6,14,2009
2009-02-15,Pahang,25,9,16,2009
2009-02-16,Pahang,18,16,2,2009
2009-02-17,Pahang,35,24,11,2009
2009-02-18,Pahang,8,7,1,2009
2009-02-19,Pahang,24,21,3,2009
2009-02-20,Pahang,3,1,2,2009
2009-02-21,Pahang,28,28,0,2009
2009-02-22,Pahang,23,8,15,2009
2009-02-23,Pahang,10,8,2,2009
2009-02-24,Pahang,21,17,4,2009
2009-02-25,Pahang,15,15,0,2009
2009-02-26,Pahang,2,1,1,2009
2009-02-27,Pahang,3,1,2,2009
2009-02-28,Pahang,0,0,0,2009
2009-03-01,Pahang,20,6,14,2009
2009-03-02,Pahang,3,0,3,2009
2009-03-03,Pahang,33,21,12,2009
2009-03-04,Pahang,30,17,13,2009
2009-03-05,Pahang,14,9,5,2009
2009-03-06,Pahang,2,0,2,2009
2009-03-07,Pahang,0,0,0,2009
2009-03-08,Pahang,0,0,0,2009
2009-03-09,Pahang,0,0,0,2009
2009-03-10,Pahang,34,20,14,2009
2009-03-11,Pahang,1,0,1,2009
2009-03-12,Pahang,1,1,0,2009
2009-03-13,Pahang,1,0,1,2009
2009-03-14,Pahang,0,0,0,2009
2009-03-15,Pahang,10,5,5,2009
2009-03-16,Pahang,3,1,2,2009
2009-03-17,Pahang,2,1,1,2009
2009-03-18,Pahang,12,5,7,2009
2009-03-19,Pahang,3,0,3,2009
2009-03-20,Pahang,4,1,3,2009
2009-03-21,Pahang,50,28,22,2009
2009-03-22,Pahang,61,39,22,2009
2009-03-23,Pahang,15,10,5,2009
2009-03-24,Pahang,2,1,1,2009
2009-03-25,Pahang,3,1,2,2009
2009-03-26,Pahang,9,4,5,2009
2009-03-27,Pahang,0,0,0,2009
2009-03-28,Pahang,0,0,0,2009
2009-03-29,Pahang,7,3,4,2009
2009-03-30,Pahang,4,0,4,2009
2009-03-31,Pahang,4,2,2,2009
2009-04-01,Pahang,2,0,2,2009
2009-04-02,Pahang,4,2,2,2009
2009-04-03,Pahang,28,17,11,2009
2009-04-04,Pahang,19,10,9,2009
2009-04-05,Pahang,28,11,17,2009
2009-04-06,Pahang,2,0,2,2009
2009-04-07,Pahang,7,5,2,2009
2009-04-08,Pahang,15,9,6,2009
2009-04-09,Pahang,1,0,1,2009
2009-04-10,Pahang,11,8,3,2009
2009-04-11,Pahang,0,0,0,2009
2009-04-12,Pahang,36,5,31,2009
2009-04-13,Pahang,4,0,4,2009
2009-04-14,Pahang,14,9,5,2009
2009-04-15,Pahang,0,0,0,2009
2009-04-16,Pahang,2,0,2,2009
2009-04-17,Pahang,20,7,13,2009
2009-04-18,Pahang,23,17,6,2009
2009-04-19,Pahang,18,8,10,2009
2009-04-20,Pahang,3,0,3,2009
2009-04-21,Pahang,13,6,7,2009
2009-04-22,Pahang,37,18,19,2009
2009-04-23,Pahang,1,0,1,2009
2009-04-24,Pahang,3,1,2,2009
2009-04-25,Pahang,0,0,0,2009
2009-04-26,Pahang,0,0,0,2009
2009-04-27,Pahang,1,0,1,2009
2009-04-28,Pahang,36,21,15,2009
2009-04-29,Pahang,1,0,1,2009
2009-04-30,Pahang,3,1,2,2009
2009-05-01,Pahang,0,0,0,2009
2009-05-02,Pahang,0,0,0,2009
2009-05-03,Pahang,0,0,0,2009
2009-05-04,Pahang,11,5,6,2009
2009-05-05,Pahang,3,1,2,2009
2009-05-06,Pahang,8,1,7,2009
2009-05-07,Pahang,0,0,0,2009
2009-05-08,Pahang,3,1,2,2009
2009-05-09,Pahang,0,0,0,2009
2009-05-10,Pahang,43,21,22,2009
2009-05-11,Pahang,3,2,1,2009
2009-05-12,Pahang,27,17,10,2009
2009-05-13,Pahang,3,0,3,2009
2009-05-14,Pahang,4,1,3,2009
2009-05-15,Pahang,24,18,6,2009
2009-05-16,Pahang,5,2,3,2009
2009-05-17,Pahang,33,12,21,2009
2009-05-18,Pahang,2,0,2,2009
2009-05-19,Pahang,12,8,4,2009
2009-05-20,Pahang,13,10,3,2009
2009-05-21,Pahang,16,13,3,2009
2009-05-22,Pahang,1,0,1,2009
2009-05-23,Pahang,0,0,0,2009
2009-05-24,Pahang,16,7,9,2009
2009-05-25,Pahang,3,1,2,2009
2009-05-26,Pahang,3,0,3,2009
2009-05-27,Pahang,12,9,3,2009
2009-05-28,Pahang,5,4,1,2009
2009-05-29,Pahang,8,5,3,2009
2009-05-30,Pahang,25,15,10,2009
2009-05-31,Pahang,0,0,0,2009
2009-06-01,Pahang,4,2,2,2009
2009-06-02,Pahang,2,0,2,2009
2009-06-03,Pahang,2,0,2,2009
2009-06-04,Pahang,9,4,5,2009
2009-06-05,Pahang,2,0,2,2009
2009-06-06,Pahang,0,0,0,2009
2009-06-07,Pahang,13,4,9,2009
2009-06-08,Pahang,21,11,10,2009
2009-06-09,Pahang,2,0,2,2009
2009-06-10,Pahang,3,0,3,2009
2009-06-11,Pahang,1,1,0,2009
2009-06-12,Pahang,0,0,0,2009
2009-06-13,Pahang,4,2,2,2009
2009-06-14,Pahang,10,3,7,2009
2009-06-15,Pahang,2,0,2,2009
2009-06-16,Pahang,2,2,0,2009
2009-06-17,Pahang,19,13,6,2009
2009-06-18,Pahang,0,0,0,2009
2009-06-19,Pahang,5,1,4,2009
2009-06-20,Pahang,20,12,8,2009
2009-06-21,Pahang,18,14,4,2009
2009-06-22,Pahang,8,2,6,2009
2009-06-23,Pahang,0,0,0,2009
2009-06-24,Pahang,7,5,2,2009
2009-06-25,Pahang,3,1,2,2009
2009-06-26,Pahang,32,28,4,2009
2009-06-27,Pahang,0,0,0,2009
2009-06-28,Pahang,24,7,17,2009
2009-06-29,Pahang,1,0,1,2009
2009-06-30,Pahang,2,0,2,2009
2009-07-01,Pahang,0,0,0,2009
2009-07-02,Pahang,2,1,1,2009
2009-07-03,Pahang,2,0,2,2009
2009-07-04,Pahang,6,5,1,2009
2009-07-05,Pahang,8,2,6,2009
2009-07-06,Pahang,1,0,1,2009
2009-07-07,Pahang,1,0,1,2009
2009-07-08,Pahang,6,1,5,2009
2009-07-09,Pahang,14,13,1,2009
2009-07-10,Pahang,2,0,2,2009
2009-07-11,Pahang,13,11,2,2009
2009-07-12,Pahang,15,6,9,2009
2009-07-13,Pahang,2,0,2,2009
2009-07-14,Pahang,28,14,14,2009
2009-07-15,Pahang,1,0,1,2009
2009-07-16,Pahang,18,9,9,2009
2009-07-17,Pahang,9,4,5,2009
2009-07-18,Pahang,23,9,14,2009
2009-07-19,Pahang,44,13,31,2009
2009-07-20,Pahang,1,0,1,2009
2009-07-21,Pahang,22,7,15,2009
2009-07-22,Pahang,6,3,3,2009
2009-07-23,Pahang,1,0,1,2009
2009-07-24,Pahang,6,5,1,2009
2009-07-25,Pahang,0,0,0,2009
2009-07-26,Pahang,0,0,0,2009
2009-07-27,Pahang,29,26,3,2009
2009-07-28,Pahang,13,11,2,2009
2009-07-29,Pahang,27,25,2,2009
2009-07-30,Pahang,51,29,22,2009
2009-07-31,Pahang,6,4,2,2009
2009-08-01,Pahang,0,0,0,2009
2009-08-02,Pahang,0,0,0,2009
2009-08-03,Pahang,2,0,2,2009
2009-08-04,Pahang,0,0,0,2009
2009-08-05,Pahang,1,0,1,2009
2009-08-06,Pahang,1,0,1,2009
2009-08-07,Pahang,5,2,3,2009
2009-08-08,Pahang,0,0,0,2009
2009-08-09,Pahang,22,10,12,2009
2009-08-10,Pahang,1,0,1,2009
2009-08-11,Pahang,5,3,2,2009
2009-08-12,Pahang,9,5,4,2009
2009-08-13,Pahang,10,7,3,2009
2009-08-14,Pahang,2,1,1,2009
2009-08-15,Pahang,0,0,0,2009
2009-08-16,Pahang,12,5,7,2009
2009-08-17,Pahang,2,0,2,2009
2009-08-18,Pahang,16,10,6,2009
2009-08-19,Pahang,24,15,9,2009
2009-08-20,Pahang,41,23,18,2009
2009-08-21,Pahang,1,1,0,2009
2009-08-22,Pahang,0,0,0,2009
2009-08-23,Pahang,9,6,3,2009
2009-08-24,Pahang,1,0,1,2009
2009-08-25,Pahang,0,0,0,2009
2009-08-26,Pahang,2,0,2,2009
2009-08-27,Pahang,12,6,6,2009
2009-08-28,Pahang,26,13,13,2009
2009-08-29,Pahang,0,0,0,2009
2009-08-30,Pahang,0,0,0,2009
2009-08-31,Pahang,0,0,0,2009
2009-09-01,Pahang,1,0,1,2009
2009-09-02,Pahang,14,8,6,2009
2009-09-03,Pahang,1,0,1,2009
2009-09-04,Pahang,7,3,4,2009
2009-09-05,Pahang,27,10,17,2009
2009-09-06,Pahang,42,11,31,2009
2009-09-07,Pahang,0,0,0,2009
2009-09-08,Pahang,9,4,5,2009
2009-09-09,Pahang,2,0,2,2009
2009-09-10,Pahang,27,14,13,2009
2009-09-11,Pahang,1,0,1,2009
2009-09-12,Pahang,13,8,5,2009
2009-09-13,Pahang,32,13,19,2009
2009-09-14,Pahang,1,0,1,2009
2009-09-15,Pahang,1,0,1,2009
2009-09-16,Pahang,0,0,0,2009
2009-09-17,Pahang,7,3,4,2009
2009-09-18,Pahang,2,0,2,2009
2009-09-19,Pahang,0,0,0,2009
2009-09-20,Pahang,0,0,0,2009
2009-09-21,Pahang,0,0,0,2009
2009-09-22,Pahang,0,0,0,2009
2009-09-23,Pahang,2,0,2,2009
2009-09-24,Pahang,1,0,1,2009
2009-09-25,Pahang,3,0,3,2009
2009-09-26,Pahang,0,0,0,2009
2009-09-27,Pahang,21,8,13,2009
2009-09-28,Pahang,11,6,5,2009
2009-09-29,Pahang,5,2,3,2009
2009-09-30,Pahang,5,0,5,2009
2009-10-01,Pahang,2,0,2,2009
2009-10-02,Pahang,5,0,5,2009
2009-10-03,Pahang,0,0,0,2009
2009-10-04,Pahang,0,0,0,2009
2009-10-05,Pahang,13,9,4,2009
2009-10-06,Pahang,15,9,6,2009
2009-10-07,Pahang,14,2,12,2009
2009-10-08,Pahang,22,6,16,2009
2009-10-09,Pahang,4,1,3,2009
2009-10-10,Pahang,16,9,7,2009
2009-10-11,Pahang,40,29,11,2009
2009-10-12,Pahang,4,0,4,2009
2009-10-13,Pahang,12,7,5,2009
2009-10-14,Pahang,10,5,5,2009
2009-10-15,Pahang,2,1,1,2009
2009-10-16,Pahang,2,0,2,2009
2009-10-17,Pahang,0,0,0,2009
2009-10-18,Pahang,30,6,24,2009
2009-10-19,Pahang,1,0,1,2009
2009-10-20,Pahang,0,0,0,2009
2009-10-21,Pahang,23,10,13,2009
2009-10-22,Pahang,6,3,3,2009
2009-10-23,Pahang,3,1,2,2009
2009-10-24,Pahang,27,11,16,2009
2009-10-25,Pahang,0,0,0,2009
2009-10-26,Pahang,4,0,4,2009
2009-10-27,Pahang,2,0,2,2009
2009-10-28,Pahang,1,1,0,2009
2009-10-29,Pahang,40,23,17,2009
2009-10-30,Pahang,0,0,0,2009
2009-10-31,Pahang,0,0,0,2009
2009-11-01,Pahang,39,12,27,2009
2009-11-02,Pahang,1,1,0,2009
2009-11-03,Pahang,10,6,4,2009
2009-11-04,Pahang,1,0,1,2009
2009-11-05,Pahang,1,1,0,2009
2009-11-06,Pahang,0,0,0,2009
2009-11-07,Pahang,0,0,0,2009
2009-11-08,Pahang,33,13,20,2009
2009-11-09,Pahang,18,11,7,2009
2009-11-10,Pahang,3,0,3,2009
2009-11-11,Pahang,3,1,2,2009
2009-11-12,Pahang,4,2,2,2009
2009-11-13,Pahang,1,0,1,2009
2009-11-14,Pahang,5,2,3,2009
2009-11-15,Pahang,41,6,35,2009
2009-11-16,Pahang,12,8,4,2009
2009-11-17,Pahang,3,0,3,2009
2009-11-18,Pahang,2,0,2,2009
2009-11-19,Pahang,28,14,14,2009
2009-11-20,Pahang,1,0,1,2009
2009-11-21,Pahang,0,0,0,2009
2009-11-22,Pahang,30,15,15,2009
2009-11-23,Pahang,2,0,2,2009
2009-11-24,Pahang,12,5,7,2009
2009-11-25,Pahang,2,0,2,2009
2009-11-26,Pahang,1,0,1,2009
2009-11-27,Pahang,0,0,0,2009
2009-11-28,Pahang,12,9,3,2009
2009-11-29,Pahang,14,3,11,2009
2009-11-30,Pahang,3,0,3,2009
2009-12-01,Pahang,1,0,1,2009
2009-12-02,Pahang,2,0,2,2009
2009-12-03,Pahang,1,1,0,2009
2009-12-04,Pahang,0,0,0,2009
2009-12-05,Pahang,0,0,0,2009
2009-12-06,Pahang,13,5,8,2009
2009-12-07,Pahang,3,1,2,2009
2009-12-08,Pahang,1,0,1,2009
2009-12-09,Pahang,6,3,3,2009
2009-12-10,Pahang,7,2,5,2009
2009-12-11,Pahang,32,27,5,2009
2009-12-12,Pahang,0,0,0,2009
2009-12-13,Pahang,0,0,0,2009
2009-12-14,Pahang,9,8,1,2009
2009-12-15,Pahang,3,3,0,2009
2009-12-16,Pahang,18,7,11,2009
2009-12-17,Pahang,6,2,4,2009
2009-12-18,Pahang,0,0,0,2009
2009-12-19,Pahang,8,3,5,2009
2009-12-20,Pahang,0,0,0,2009
2009-12-21,Pahang,1,0,1,2009
2009-12-22,Pahang,20,18,2,2009
2009-12-23,Pahang,36,20,16,2009
2009-12-24,Pahang,0,0,0,2009
2009-12-25,Pahang,0,0,0,2009
2009-12-26,Pahang,0,0,0,2009
2009-12-27,Pahang,14,6,8,2009
2009-12-28,Pahang,3,1,2,2009
2009-12-29,Pahang,12,9,3,2009
2009-12-30,Pahang,2,0,2,2009
2009-12-31,Pahang,4,0,4,2009
2010-01-01,Pahang,0,0,0,2010
2010-01-02,Pahang,12,4,8,2010
2010-01-03,Pahang,0,0,0,2010
2010-01-04,Pahang,21,13,8,2010
2010-01-05,Pahang,2,0,2,2010
2010-01-06,Pahang,12,8,4,2010
2010-01-07,Pahang,9,6,3,2010
2010-01-08,Pahang,0,0,0,2010
2010-01-09,Pahang,18,6,12,2010
2010-01-10,Pahang,36,15,21,2010
2010-01-11,Pahang,2,0,2,2010
2010-01-12,Pahang,3,0,3,2010
2010-01-13,Pahang,1,0,1,2010
2010-01-14,Pahang,22,10,12,2010
2010-01-15,Pahang,34,26,8,2010
2010-01-16,Pahang,28,25,3,2010
2010-01-17,Pahang,0,0,0,2010
2010-01-18,Pahang,4,2,2,2010
2010-01-19,Pahang,38,14,24,2010
2010-01-20,Pahang,17,9,8,2010
2010-01-21,Pahang,0,0,0,2010
2010-01-22,Pahang,6,1,5,2010
2010-01-23,Pahang,0,0,0,2010
2010-01-24,Pahang,26,11,15,2010
2010-01-25,Pahang,31,21,10,2010
2010-01-26,Pahang,10,5,5,2010
2010-01-27,Pahang,0,0,0,2010
2010-01-28,Pahang,10,4,6,2010
2010-01-29,Pahang,3,0,3,2010
2010-01-30,Pahang,7,5,2,2010
2010-01-31,Pahang,0,0,0,2010
2010-02-01,Pahang,2,0,2,2010
2010-02-02,Pahang,24,16,8,2010
2010-02-03,Pahang,4,2,2,2010
2010-02-04,Pahang,8,5,3,2010
2010-02-05,Pahang,0,0,0,2010
2010-02-06,Pahang,0,0,0,2010
2010-02-07,Pahang,0,0,0,2010
2010-02-08,Pahang,3,0,3,2010
2010-02-09,Pahang,38,21,17,2010
2010-02-10,Pahang,26,20,6,2010
2010-02-11,Pahang,43,23,20,2010
2010-02-12,Pahang,4,0,4,2010
2010-02-13,Pahang,0,0,0,2010
2010-02-14,Pahang,0,0,0,2010
2010-02-15,Pahang,0,0,0,2010
2010-02-16,Pahang,0,0,0,2010
2010-02-17,Pahang,25,13,12,2010
2010-02-18,Pahang,4,1,3,2010
2010-02-19,Pahang,31,13,18,2010
2010-02-20,Pahang,22,20,2,2010
2010-02-21,Pahang,0,0,0,2010
2010-02-22,Pahang,32,29,3,2010
2010-02-23,Pahang,14,13,1,2010
2010-02-24,Pahang,16,14,2,2010
2010-02-25,Pahang,24,21,3,2010
2010-02-26,Pahang,0,0,0,2010
2010-02-27,Pahang,0,0,0,2010
2010-02-28,Pahang,0,0,0,2010
2010-03-01,Pahang,4,0,4,2010
2010-03-02,Pahang,29,27,2,2010
2010-03-03,Pahang,3,0,3,2010
2010-03-04,Pahang,4,0,4,2010
2010-03-05,Pahang,1,0,1,2010
2010-03-06,Pahang,0,0,0,2010
2010-03-07,Pahang,25,7,18,2010
2010-03-08,Pahang,6,1,5,2010
2010-03-09,Pahang,2,1,1,2010
2010-03-10,Pahang,4,2,2,2010
2010-03-11,Pahang,14,2,12,2010
2010-03-12,Pahang,2,1,1,2010
2010-03-13,Pahang,0,0,0,2010
2010-03-14,Pahang,25,6,19,2010
2010-03-15,Pahang,2,1,1,2010
2010-03-16,Pahang,6,3,3,2010
2010-03-17,Pahang,4,2,2,2010
2010-03-18,Pahang,2,2,0,2010
2010-03-19,Pahang,3,1,2,2010
2010-03-20,Pahang,0,0,0,2010
2010-03-21,Pahang,40,8,32,2010
2010-03-22,Pahang,2,0,2,2010
2010-03-23,Pahang,21,6,15,2010
2010-03-24,Pahang,2,0,2,2010
2010-03-25,Pahang,38,16,22,2010
2010-03-26,Pahang,1,0,1,2010
2010-03-27,Pahang,56,33,23,2010
2010-03-28,Pahang,0,0,0,2010
2010-03-29,Pahang,3,0,3,2010
2010-03-30,Pahang,2,1,1,2010
2010-03-31,Pahang,40,24,16,2010
2010-04-01,Pahang,0,0,0,2010
2010-04-02,Pahang,4,1,3,2010
2010-04-03,Pahang,6,3,3,2010
2010-04-04,Pahang,12,6,6,2010
2010-04-05,Pahang,0,0,0,2010
2010-04-06,Pahang,1,0,1,2010
2010-04-07,Pahang,0,0,0,2010
2010-04-08,Pahang,10,7,3,2010
2010-04-09,Pahang,9,2,7,2010
2010-04-10,Pahang,0,0,0,2010
2010-04-11,Pahang,32,20,12,2010
2010-04-12,Pahang,1,0,1,2010
2010-04-13,Pahang,12,6,6,2010
2010-04-14,Pahang,2,1,1,2010
2010-04-15,Pahang,8,5,3,2010
2010-04-16,Pahang,2,0,2,2010
2010-04-17,Pahang,0,0,0,2010
2010-04-18,Pahang,0,0,0,2010
2010-04-19,Pahang,4,0,4,2010
2010-04-20,Pahang,3,1,2,2010
2010-04-21,Pahang,11,8,3,2010
2010-04-22,Pahang,1,0,1,2010
2010-04-23,Pahang,2,0,2,2010
2010-04-24,Pahang,23,12,11,2010
2010-04-25,Pahang,23,6,17,2010
2010-04-26,Pahang,2,1,1,2010
2010-04-27,Pahang,2,0,2,2010
2010-04-28,Pahang,17,10,7,2010
2010-04-29,Pahang,2,1,1,2010
2010-04-30,Pahang,2,0,2,2010
2010-05-01,Pahang,0,0,0,2010
2010-05-02,Pahang,0,0,0,2010
2010-05-03,Pahang,2,1,1,2010
2010-05-04,Pahang,28,16,12,2010
2010-05-05,Pahang,5,0,5,2010
2010-05-06,Pahang,4,2,2,2010
2010-05-07,Pahang,0,0,0,2010
2010-05-08,Pahang,0,0,0,2010
2010-05-09,Pahang,33,8,25,2010
2010-05-10,Pahang,1,1,0,2010
2010-05-11,Pahang,1,0,1,2010
2010-05-12,Pahang,4,0,4,2010
2010-05-13,Pahang,2,0,2,2010
2010-05-14,Pahang,1,0,1,2010
2010-05-15,Pahang,0,0,0,2010
2010-05-16,Pahang,0,0,0,2010
2010-05-17,Pahang,32,29,3,2010
2010-05-18,Pahang,1,1,0,2010
2010-05-19,Pahang,12,10,2,2010
2010-05-20,Pahang,1,0,1,2010
2010-05-21,Pahang,0,0,0,2010
2010-05-22,Pahang,0,0,0,2010
2010-05-23,Pahang,13,4,9,2010
2010-05-24,Pahang,107,57,50,2010
2010-05-25,Pahang,3,2,1,2010
2010-05-26,Pahang,14,6,8,2010
2010-05-27,Pahang,0,0,0,2010
2010-05-28,Pahang,0,0,0,2010
2010-05-29,Pahang,5,5,0,2010
2010-05-30,Pahang,0,0,0,2010
2010-05-31,Pahang,23,20,3,2010
2010-06-01,Pahang,4,1,3,2010
2010-06-02,Pahang,1,1,0,2010
2010-06-03,Pahang,1,1,0,2010
2010-06-04,Pahang,0,0,0,2010
2010-06-05,Pahang,0,0,0,2010
2010-06-06,Pahang,8,2,6,2010
2010-06-07,Pahang,2,0,2,2010
2010-06-08,Pahang,1,0,1,2010
2010-06-09,Pahang,2,0,2,2010
2010-06-10,Pahang,3,0,3,2010
2010-06-11,Pahang,9,5,4,2010
2010-06-12,Pahang,0,0,0,2010
2010-06-13,Pahang,30,5,25,2010
2010-06-14,Pahang,7,2,5,2010
2010-06-15,Pahang,4,1,3,2010
2010-06-16,Pahang,2,0,2,2010
2010-06-17,Pahang,14,12,2,2010
2010-06-18,Pahang,1,0,1,2010
2010-06-19,Pahang,0,0,0,2010
2010-06-20,Pahang,16,5,11,2010
2010-06-21,Pahang,3,0,3,2010
2010-06-22,Pahang,3,1,2,2010
2010-06-23,Pahang,2,0,2,2010
2010-06-24,Pahang,3,0,3,2010
2010-06-25,Pahang,5,1,4,2010
2010-06-26,Pahang,5,2,3,2010
2010-06-27,Pahang,38,8,30,2010
2010-06-28,Pahang,4,1,3,2010
2010-06-29,Pahang,2,1,1,2010
2010-06-30,Pahang,2,1,1,2010
2010-07-01,Pahang,22,12,10,2010
2010-07-02,Pahang,3,0,3,2010
2010-07-03,Pahang,18,18,0,2010
2010-07-04,Pahang,0,0,0,2010
2010-07-05,Pahang,2,0,2,2010
2010-07-06,Pahang,9,7,2,2010
2010-07-07,Pahang,9,7,2,2010
2010-07-08,Pahang,0,0,0,2010
2010-07-09,Pahang,3,1,2,2010
2010-07-10,Pahang,21,11,10,2010
2010-07-11,Pahang,14,5,9,2010
2010-07-12,Pahang,2,0,2,2010
2010-07-13,Pahang,8,7,1,2010
2010-07-14,Pahang,2,1,1,2010
2010-07-15,Pahang,6,6,0,2010
2010-07-16,Pahang,0,0,0,2010
2010-07-17,Pahang,15,14,1,2010
2010-07-18,Pahang,27,7,20,2010
2010-07-19,Pahang,16,13,3,2010
2010-07-20,Pahang,21,15,6,2010
2010-07-21,Pahang,1,0,1,2010
2010-07-22,Pahang,4,0,4,2010
2010-07-23,Pahang,1,0,1,2010
2010-07-24,Pahang,0,0,0,2010
2010-07-25,Pahang,9,3,6,2010
2010-07-26,Pahang,3,1,2,2010
2010-07-27,Pahang,1,0,1,2010
2010-07-28,Pahang,7,6,1,2010
2010-07-29,Pahang,8,5,3,2010
2010-07-30,Pahang,36,15,21,2010
2010-07-31,Pahang,10,4,6,2010
2010-08-01,Pahang,0,0,0,2010
2010-08-02,Pahang,33,19,14,2010
2010-08-03,Pahang,49,32,17,2010
2010-08-04,Pahang,19,8,11,2010
2010-08-05,Pahang,33,18,15,2010
2010-08-06,Pahang,34,12,22,2010
2010-08-07,Pahang,48,36,12,2010
2010-08-08,Pahang,34,24,10,2010
2010-08-09,Pahang,7,1,6,2010
2010-08-10,Pahang,3,0,3,2010
2010-08-11,Pahang,2,1,1,2010
2010-08-12,Pahang,0,0,0,2010
2010-08-13,Pahang,0,0,0,2010
2010-08-14,Pahang,0,0,0,2010
2010-08-15,Pahang,0,0,0,2010
2010-08-16,Pahang,1,0,1,2010
2010-08-17,Pahang,1,0,1,2010
2010-08-18,Pahang,15,8,7,2010
2010-08-19,Pahang,1,1,0,2010
2010-08-20,Pahang,0,0,0,2010
2010-08-21,Pahang,15,6,9,2010
2010-08-22,Pahang,0,0,0,2010
2010-08-23,Pahang,1,0,1,2010
2010-08-24,Pahang,2,1,1,2010
2010-08-25,Pahang,11,5,6,2010
2010-08-26,Pahang,1,1,0,2010
2010-08-27,Pahang,10,7,3,2010
2010-08-28,Pahang,0,0,0,2010
2010-08-29,Pahang,41,10,31,2010
2010-08-30,Pahang,0,0,0,2010
2010-08-31,Pahang,0,0,0,2010
2010-09-01,Pahang,0,0,0,2010
2010-09-02,Pahang,1,1,0,2010
2010-09-03,Pahang,13,5,8,2010
2010-09-04,Pahang,17,8,9,2010
2010-09-05,Pahang,0,0,0,2010
2010-09-06,Pahang,2,0,2,2010
2010-09-07,Pahang,6,1,5,2010
2010-09-08,Pahang,2,1,1,2010
2010-09-09,Pahang,0,0,0,2010
2010-09-10,Pahang,0,0,0,2010
2010-09-11,Pahang,0,0,0,2010
2010-09-12,Pahang,0,0,0,2010
2010-09-13,Pahang,4,0,4,2010
2010-09-14,Pahang,6,3,3,2010
2010-09-15,Pahang,0,0,0,2010
2010-09-16,Pahang,0,0,0,2010
2010-09-17,Pahang,5,0,5,2010
2010-09-18,Pahang,14,2,12,2010
2010-09-19,Pahang,34,6,28,2010
2010-09-20,Pahang,3,0,3,2010
2010-09-21,Pahang,0,0,0,2010
2010-09-22,Pahang,4,0,4,2010
2010-09-23,Pahang,18,10,8,2010
2010-09-24,Pahang,2,1,1,2010
2010-09-25,Pahang,16,7,9,2010
2010-09-26,Pahang,52,9,43,2010
2010-09-27,Pahang,0,0,0,2010
2010-09-28,Pahang,15,9,6,2010
2010-09-29,Pahang,32,28,4,2010
2010-09-30,Pahang,26,11,15,2010
2010-10-01,Pahang,2,1,1,2010
2010-10-02,Pahang,0,0,0,2010
2010-10-03,Pahang,32,6,26,2010
2010-10-04,Pahang,2,1,1,2010
2010-10-05,Pahang,5,1,4,2010
2010-10-06,Pahang,7,4,3,2010
2010-10-07,Pahang,11,5,6,2010
2010-10-08,Pahang,12,5,7,2010
2010-10-09,Pahang,1,1,0,2010
2010-10-10,Pahang,23,5,18,2010
2010-10-11,Pahang,1,1,0,2010
2010-10-12,Pahang,1,0,1,2010
2010-10-13,Pahang,4,1,3,2010
2010-10-14,Pahang,2,0,2,2010
2010-10-15,Pahang,1,0,1,2010
2010-10-16,Pahang,10,1,9,2010
2010-10-17,Pahang,36,9,27,2010
2010-10-18,Pahang,9,3,6,2010
2010-10-19,Pahang,4,1,3,2010
2010-10-20,Pahang,14,10,4,2010
2010-10-21,Pahang,34,17,17,2010
2010-10-22,Pahang,1,0,1,2010
2010-10-23,Pahang,0,0,0,2010
2010-10-24,Pahang,24,7,17,2010
2010-10-25,Pahang,0,0,0,2010
2010-10-26,Pahang,3,1,2,2010
2010-10-27,Pahang,0,0,0,2010
2010-10-28,Pahang,2,0,2,2010
2010-10-29,Pahang,0,0,0,2010
2010-10-30,Pahang,10,4,6,2010
2010-10-31,Pahang,33,18,15,2010
2010-11-01,Pahang,4,1,3,2010
2010-11-02,Pahang,6,2,4,2010
2010-11-03,Pahang,7,7,0,2010
2010-11-04,Pahang,4,2,2,2010
2010-11-05,Pahang,0,0,0,2010
2010-11-06,Pahang,17,11,6,2010
2010-11-07,Pahang,0,0,0,2010
2010-11-08,Pahang,4,1,3,2010
2010-11-09,Pahang,20,7,13,2010
2010-11-10,Pahang,39,36,3,2010
2010-11-11,Pahang,1,0,1,2010
2010-11-12,Pahang,2,0,2,2010
2010-11-13,Pahang,2,0,2,2010
2010-11-14,Pahang,18,8,10,2010
2010-11-15,Pahang,2,0,2,2010
2010-11-16,Pahang,1,0,1,2010
2010-11-17,Pahang,0,0,0,2010
2010-11-18,Pahang,10,6,4,2010
2010-11-19,Pahang,7,2,5,2010
2010-11-20,Pahang,0,0,0,2010
2010-11-21,Pahang,0,0,0,2010
2010-11-22,Pahang,5,0,5,2010
2010-11-23,Pahang,7,4,3,2010
2010-11-24,Pahang,18,15,3,2010
2010-11-25,Pahang,2,2,0,2010
2010-11-26,Pahang,9,7,2,2010
2010-11-27,Pahang,0,0,0,2010
2010-11-28,Pahang,14,8,6,2010
2010-11-29,Pahang,1,0,1,2010
2010-11-30,Pahang,5,2,3,2010
2010-12-01,Pahang,1,0,1,2010
2010-12-02,Pahang,5,1,4,2010
2010-12-03,Pahang,14,7,7,2010
2010-12-04,Pahang,12,8,4,2010
2010-12-05,Pahang,30,18,12,2010
2010-12-06,Pahang,2,1,1,2010
2010-12-07,Pahang,0,0,0,2010
2010-12-08,Pahang,2,0,2,2010
2010-12-09,Pahang,12,6,6,2010
2010-12-10,Pahang,1,1,0,2010
2010-12-11,Pahang,10,8,2,2010
2010-12-12,Pahang,38,14,24,2010
2010-12-13,Pahang,2,0,2,2010
2010-12-14,Pahang,2,1,1,2010
2010-12-15,Pahang,3,0,3,2010
2010-12-16,Pahang,8,6,2,2010
2010-12-17,Pahang,4,1,3,2010
2010-12-18,Pahang,7,4,3,2010
2010-12-19,Pahang,12,4,8,2010
2010-12-20,Pahang,1,0,1,2010
2010-12-21,Pahang,14,4,10,2010
2010-12-22,Pahang,1,1,0,2010
2010-12-23,Pahang,10,3,7,2010
2010-12-24,Pahang,4,2,2,2010
2010-12-25,Pahang,0,0,0,2010
2010-12-26,Pahang,47,12,35,2010
2010-12-27,Pahang,1,0,1,2010
2010-12-28,Pahang,1,0,1,2010
2010-12-29,Pahang,3,1,2,2010
2010-12-30,Pahang,7,1,6,2010
2010-12-31,Pahang,0,0,0,2010
2011-01-01,Pahang,0,0,0,2011
2011-01-02,Pahang,12,4,8,2011
2011-01-03,Pahang,3,2,1,2011
2011-01-04,Pahang,2,2,0,2011
2011-01-05,Pahang,28,14,14,2011
2011-01-06,Pahang,24,8,16,2011
2011-01-07,Pahang,2,0,2,2011
2011-01-08,Pahang,14,6,8,2011
2011-01-09,Pahang,29,11,18,2011
2011-01-10,Pahang,1,0,1,2011
2011-01-11,Pahang,1,0,1,2011
2011-01-12,Pahang,23,10,13,2011
2011-01-13,Pahang,13,4,9,2011
2011-01-14,Pahang,2,1,1,2011
2011-01-15,Pahang,0,0,0,2011
2011-01-16,Pahang,8,2,6,2011
2011-01-17,Pahang,2,0,2,2011
2011-01-18,Pahang,1,0,1,2011
2011-01-19,Pahang,31,14,17,2011
2011-01-20,Pahang,19,14,5,2011
2011-01-21,Pahang,1,1,0,2011
2011-01-22,Pahang,20,10,10,2011
2011-01-23,Pahang,0,0,0,2011
2011-01-24,Pahang,0,0,0,2011
2011-01-25,Pahang,22,18,4,2011
2011-01-26,Pahang,24,15,9,2011
2011-01-27,Pahang,19,9,10,2011
2011-01-28,Pahang,1,0,1,2011
2011-01-29,Pahang,0,0,0,2011
2011-01-30,Pahang,0,0,0,2011
2011-01-31,Pahang,4,1,3,2011
2011-02-01,Pahang,12,9,3,2011
2011-02-02,Pahang,5,1,4,2011
2011-02-03,Pahang,0,0,0,2011
2011-02-04,Pahang,0,0,0,2011
2011-02-05,Pahang,0,0,0,2011
2011-02-06,Pahang,0,0,0,2011
2011-02-07,Pahang,42,19,23,2011
2011-02-08,Pahang,34,22,12,2011
2011-02-09,Pahang,28,21,7,2011
2011-02-10,Pahang,11,8,3,2011
2011-02-11,Pahang,2,0,2,2011
2011-02-12,Pahang,14,12,2,2011
2011-02-13,Pahang,0,0,0,2011
2011-02-14,Pahang,13,8,5,2011
2011-02-15,Pahang,0,0,0,2011
2011-02-16,Pahang,32,28,4,2011
2011-02-17,Pahang,15,8,7,2011
2011-02-18,Pahang,14,9,5,2011
2011-02-19,Pahang,0,0,0,2011
2011-02-20,Pahang,13,7,6,2011
2011-02-21,Pahang,1,0,1,2011
2011-02-22,Pahang,1,0,1,2011
2011-02-23,Pahang,5,1,4,2011
2011-02-24,Pahang,2,0,2,2011
2011-02-25,Pahang,3,0,3,2011
2011-02-26,Pahang,31,31,0,2011
2011-02-27,Pahang,0,0,0,2011
2011-02-28,Pahang,1,0,1,2011
2011-03-01,Pahang,1,0,1,2011
2011-03-02,Pahang,17,9,8,2011
2011-03-03,Pahang,15,13,2,2011
2011-03-04,Pahang,1,0,1,2011
2011-03-05,Pahang,19,18,1,2011
2011-03-06,Pahang,28,13,15,2011
2011-03-07,Pahang,0,0,0,2011
2011-03-08,Pahang,2,0,2,2011
2011-03-09,Pahang,2,2,0,2011
2011-03-10,Pahang,1,0,1,2011
2011-03-11,Pahang,34,24,10,2011
2011-03-12,Pahang,0,0,0,2011
2011-03-13,Pahang,23,10,13,2011
2011-03-14,Pahang,2,0,2,2011
2011-03-15,Pahang,4,0,4,2011
2011-03-16,Pahang,3,0,3,2011
2011-03-17,Pahang,29,9,20,2011
2011-03-18,Pahang,1,0,1,2011
2011-03-19,Pahang,9,3,6,2011
2011-03-20,Pahang,0,0,0,2011
2011-03-21,Pahang,2,1,1,2011
2011-03-22,Pahang,2,1,1,2011
2011-03-23,Pahang,5,1,4,2011
2011-03-24,Pahang,5,1,4,2011
2011-03-25,Pahang,9,5,4,2011
2011-03-26,Pahang,12,3,9,2011
2011-03-27,Pahang,56,17,39,2011
2011-03-28,Pahang,1,0,1,2011
2011-03-29,Pahang,3,0,3,2011
2011-03-30,Pahang,11,6,5,2011
2011-03-31,Pahang,4,2,2,2011
2011-04-01,Pahang,4,0,4,2011
2011-04-02,Pahang,0,0,0,2011
2011-04-03,Pahang,10,5,5,2011
2011-04-04,Pahang,2,1,1,2011
2011-04-05,Pahang,2,0,2,2011
2011-04-06,Pahang,1,0,1,2011
2011-04-07,Pahang,30,17,13,2011
2011-04-08,Pahang,34,18,16,2011
2011-04-09,Pahang,44,31,13,2011
2011-04-10,Pahang,0,0,0,2011
2011-04-11,Pahang,1,0,1,2011
2011-04-12,Pahang,15,10,5,2011
2011-04-13,Pahang,35,11,24,2011
2011-04-14,Pahang,1,0,1,2011
2011-04-15,Pahang,3,0,3,2011
2011-04-16,Pahang,0,0,0,2011
2011-04-17,Pahang,0,0,0,2011
2011-04-18,Pahang,2,0,2,2011
2011-04-19,Pahang,3,0,3,2011
2011-04-20,Pahang,51,24,27,2011
2011-04-21,Pahang,11,5,6,2011
2011-04-22,Pahang,2,1,1,2011
2011-04-23,Pahang,21,9,12,2011
2011-04-24,Pahang,0,0,0,2011
2011-04-25,Pahang,29,25,4,2011
2011-04-26,Pahang,30,26,4,2011
2011-04-27,Pahang,28,19,9,2011
2011-04-28,Pahang,29,28,1,2011
2011-04-29,Pahang,9,6,3,2011
2011-04-30,Pahang,25,18,7,2011
2011-05-01,Pahang,58,51,7,2011
2011-05-02,Pahang,44,41,3,2011
2011-05-03,Pahang,35,32,3,2011
2011-05-04,Pahang,25,18,7,2011
2011-05-05,Pahang,23,10,13,2011
2011-05-06,Pahang,5,3,2,2011
2011-05-07,Pahang,0,0,0,2011
2011-05-08,Pahang,108,70,38,2011
2011-05-09,Pahang,5,1,4,2011
2011-05-10,Pahang,9,7,2,2011
2011-05-11,Pahang,109,73,36,2011
2011-05-12,Pahang,10,6,4,2011
2011-05-13,Pahang,2,1,1,2011
2011-05-14,Pahang,57,43,14,2011
2011-05-15,Pahang,0,0,0,2011
2011-05-16,Pahang,8,6,2,2011
2011-05-17,Pahang,0,0,0,2011
2011-05-18,Pahang,11,6,5,2011
2011-05-19,Pahang,35,27,8,2011
2011-05-20,Pahang,22,12,10,2011
2011-05-21,Pahang,27,15,12,2011
2011-05-22,Pahang,32,16,16,2011
2011-05-23,Pahang,4,1,3,2011
2011-05-24,Pahang,4,0,4,2011
2011-05-25,Pahang,54,33,21,2011
2011-05-26,Pahang,5,4,1,2011
2011-05-27,Pahang,32,11,21,2011
2011-05-28,Pahang,18,13,5,2011
2011-05-29,Pahang,78,67,11,2011
2011-05-30,Pahang,18,13,5,2011
2011-05-31,Pahang,12,7,5,2011
2011-06-01,Pahang,24,17,7,2011
2011-06-02,Pahang,10,6,4,2011
2011-06-03,Pahang,11,7,4,2011
2011-06-04,Pahang,0,0,0,2011
2011-06-05,Pahang,0,0,0,2011
2011-06-06,Pahang,9,0,9,2011
2011-06-07,Pahang,8,5,3,2011
2011-06-08,Pahang,27,22,5,2011
2011-06-09,Pahang,14,10,4,2011
2011-06-10,Pahang,5,2,3,2011
2011-06-11,Pahang,20,19,1,2011
2011-06-12,Pahang,55,8,47,2011
2011-06-13,Pahang,2,0,2,2011
2011-06-14,Pahang,1,1,0,2011
2011-06-15,Pahang,3,2,1,2011
2011-06-16,Pahang,19,16,3,2011
2011-06-17,Pahang,3,0,3,2011
2011-06-18,Pahang,32,14,18,2011
2011-06-19,Pahang,38,21,17,2011
2011-06-20,Pahang,12,9,3,2011
2011-06-21,Pahang,2,2,0,2011
2011-06-22,Pahang,3,1,2,2011
2011-06-23,Pahang,12,4,8,2011
2011-06-24,Pahang,0,0,0,2011
2011-06-25,Pahang,0,0,0,2011
2011-06-26,Pahang,11,7,4,2011
2011-06-27,Pahang,0,0,0,2011
2011-06-28,Pahang,2,0,2,2011
2011-06-29,Pahang,13,5,8,2011
2011-06-30,Pahang,4,1,3,2011
2011-07-01,Pahang,17,3,14,2011
2011-07-02,Pahang,28,23,5,2011
2011-07-03,Pahang,50,41,9,2011
2011-07-04,Pahang,3,0,3,2011
2011-07-05,Pahang,2,0,2,2011
2011-07-06,Pahang,2,1,1,2011
2011-07-07,Pahang,2,0,2,2011
2011-07-08,Pahang,23,19,4,2011
2011-07-09,Pahang,24,22,2,2011
2011-07-10,Pahang,25,9,16,2011
2011-07-11,Pahang,17,15,2,2011
2011-07-12,Pahang,92,44,48,2011
2011-07-13,Pahang,13,8,5,2011
2011-07-14,Pahang,2,0,2,2011
2011-07-15,Pahang,1,1,0,2011
2011-07-16,Pahang,14,6,8,2011
2011-07-17,Pahang,0,0,0,2011
2011-07-18,Pahang,2,0,2,2011
2011-07-19,Pahang,6,3,3,2011
2011-07-20,Pahang,12,9,3,2011
2011-07-21,Pahang,2,1,1,2011
2011-07-22,Pahang,7,1,6,2011
2011-07-23,Pahang,0,0,0,2011
2011-07-24,Pahang,2,0,2,2011
2011-07-25,Pahang,27,26,1,2011
2011-07-26,Pahang,11,5,6,2011
2011-07-27,Pahang,27,19,8,2011
2011-07-28,Pahang,9,4,5,2011
2011-07-29,Pahang,49,35,14,2011
2011-07-30,Pahang,0,0,0,2011
2011-07-31,Pahang,10,4,6,2011
2011-08-01,Pahang,3,3,0,2011
2011-08-02,Pahang,2,1,1,2011
2011-08-03,Pahang,60,57,3,2011
2011-08-04,Pahang,3,1,2,2011
2011-08-05,Pahang,1,1,0,2011
2011-08-06,Pahang,0,0,0,2011
2011-08-07,Pahang,118,71,47,2011
2011-08-08,Pahang,5,1,4,2011
2011-08-09,Pahang,3,2,1,2011
2011-08-10,Pahang,46,42,4,2011
2011-08-11,Pahang,7,2,5,2011
2011-08-12,Pahang,0,0,0,2011
2011-08-13,Pahang,30,11,19,2011
2011-08-14,Pahang,51,49,2,2011
2011-08-15,Pahang,6,0,6,2011
2011-08-16,Pahang,1,0,1,2011
2011-08-17,Pahang,9,3,6,2011
2011-08-18,Pahang,21,9,12,2011
2011-08-19,Pahang,51,33,18,2011
2011-08-20,Pahang,58,37,21,2011
2011-08-21,Pahang,9,4,5,2011
2011-08-22,Pahang,10,6,4,2011
2011-08-23,Pahang,2,0,2,2011
2011-08-24,Pahang,61,56,5,2011
2011-08-25,Pahang,13,7,6,2011
2011-08-26,Pahang,26,10,16,2011
2011-08-27,Pahang,10,8,2,2011
2011-08-28,Pahang,72,69,3,2011
2011-08-29,Pahang,12,11,1,2011
2011-08-30,Pahang,0,0,0,2011
2011-08-31,Pahang,0,0,0,2011
2011-09-01,Pahang,7,2,5,2011
2011-09-02,Pahang,9,3,6,2011
2011-09-03,Pahang,11,5,6,2011
2011-09-04,Pahang,38,25,13,2011
2011-09-05,Pahang,12,7,5,2011
2011-09-06,Pahang,37,26,11,2011
2011-09-07,Pahang,21,12,9,2011
2011-09-08,Pahang,27,20,7,2011
2011-09-09,Pahang,19,6,13,2011
2011-09-10,Pahang,53,35,18,2011
2011-09-11,Pahang,27,11,16,2011
2011-09-12,Pahang,17,11,6,2011
2011-09-13,Pahang,6,4,2,2011
2011-09-14,Pahang,10,4,6,2011
2011-09-15,Pahang,54,44,10,2011
2011-09-16,Pahang,15,13,2,2011
2011-09-17,Pahang,28,14,14,2011
2011-09-18,Pahang,19,7,12,2011
2011-09-19,Pahang,9,4,5,2011
2011-09-20,Pahang,34,23,11,2011
2011-09-21,Pahang,48,40,8,2011
2011-09-22,Pahang,10,3,7,2011
2011-09-23,Pahang,33,25,8,2011
2011-09-24,Pahang,19,12,7,2011
2011-09-25,Pahang,111,71,40,2011
2011-09-26,Pahang,112,76,36,2011
2011-09-27,Pahang,59,44,15,2011
2011-09-28,Pahang,33,25,8,2011
2011-09-29,Pahang,77,60,17,2011
2011-09-30,Pahang,32,16,16,2011
2011-10-01,Pahang,156,135,21,2011
2011-10-02,Pahang,122,88,34,2011
2011-10-03,Pahang,16,6,10,2011
2011-10-04,Pahang,14,8,6,2011
2011-10-05,Pahang,81,62,19,2011
2011-10-06,Pahang,38,32,6,2011
2011-10-07,Pahang,6,4,2,2011
2011-10-08,Pahang,17,6,11,2011
2011-10-09,Pahang,58,34,24,2011
2011-10-10,Pahang,27,24,3,2011
2011-10-11,Pahang,4,2,2,2011
2011-10-12,Pahang,18,9,9,2011
2011-10-13,Pahang,53,46,7,2011
2011-10-14,Pahang,7,3,4,2011
2011-10-15,Pahang,20,9,11,2011
2011-10-16,Pahang,0,0,0,2011
2011-10-17,Pahang,6,1,5,2011
2011-10-18,Pahang,4,2,2,2011
2011-10-19,Pahang,58,43,15,2011
2011-10-20,Pahang,31,28,3,2011
2011-10-21,Pahang,9,4,5,2011
2011-10-22,Pahang,0,0,0,2011
2011-10-23,Pahang,85,52,33,2011
2011-10-24,Pahang,0,0,0,2011
2011-10-25,Pahang,11,4,7,2011
2011-10-26,Pahang,0,0,0,2011
2011-10-27,Pahang,99,82,17,2011
2011-10-28,Pahang,4,0,4,2011
2011-10-29,Pahang,18,9,9,2011
2011-10-30,Pahang,0,0,0,2011
2011-10-31,Pahang,19,18,1,2011
2011-11-01,Pahang,3,1,2,2011
2011-11-02,Pahang,20,17,3,2011
2011-11-03,Pahang,24,6,18,2011
2011-11-04,Pahang,72,50,22,2011
2011-11-05,Pahang,0,0,0,2011
2011-11-06,Pahang,0,0,0,2011
2011-11-07,Pahang,5,3,2,2011
2011-11-08,Pahang,13,4,9,2011
2011-11-09,Pahang,36,27,9,2011
2011-11-10,Pahang,8,5,3,2011
2011-11-11,Pahang,51,42,9,2011
2011-11-12,Pahang,72,53,19,2011
2011-11-13,Pahang,81,48,33,2011
2011-11-14,Pahang,22,13,9,2011
2011-11-15,Pahang,45,34,11,2011
2011-11-16,Pahang,28,13,15,2011
2011-11-17,Pahang,78,26,52,2011
2011-11-18,Pahang,14,7,7,2011
2011-11-19,Pahang,0,0,0,2011
2011-11-20,Pahang,71,61,10,2011
2011-11-21,Pahang,10,5,5,2011
2011-11-22,Pahang,9,8,1,2011
2011-11-23,Pahang,106,40,66,2011
2011-11-24,Pahang,57,46,11,2011
2011-11-25,Pahang,4,2,2,2011
2011-11-26,Pahang,13,11,2,2011
2011-11-27,Pahang,132,102,30,2011
2011-11-28,Pahang,0,0,0,2011
2011-11-29,Pahang,34,21,13,2011
2011-11-30,Pahang,29,20,9,2011
2011-12-01,Pahang,18,2,16,2011
2011-12-02,Pahang,5,1,4,2011
2011-12-03,Pahang,50,31,19,2011
2011-12-04,Pahang,34,21,13,2011
2011-12-05,Pahang,9,2,7,2011
2011-12-06,Pahang,45,17,28,2011
2011-12-07,Pahang,33,27,6,2011
2011-12-08,Pahang,15,10,5,2011
2011-12-09,Pahang,36,31,5,2011
2011-12-10,Pahang,34,25,9,2011
2011-12-11,Pahang,14,5,9,2011
2011-12-12,Pahang,14,6,8,2011
2011-12-13,Pahang,15,6,9,2011
2011-12-14,Pahang,25,16,9,2011
2011-12-15,Pahang,19,7,12,2011
2011-12-16,Pahang,22,18,4,2011
2011-12-17,Pahang,19,18,1,2011
2011-12-18,Pahang,0,0,0,2011
2011-12-19,Pahang,10,4,6,2011
2011-12-20,Pahang,31,23,8,2011
2011-12-21,Pahang,48,31,17,2011
2011-12-22,Pahang,30,20,10,2011
2011-12-23,Pahang,10,2,8,2011
2011-12-24,Pahang,0,0,0,2011
2011-12-25,Pahang,39,17,22,2011
2011-12-26,Pahang,0,0,0,2011
2011-12-27,Pahang,27,11,16,2011
2011-12-28,Pahang,43,28,15,2011
2011-12-29,Pahang,25,10,15,2011
2011-12-30,Pahang,87,80,7,2011
2011-12-31,Pahang,29,21,8,2011
2012-01-01,Pahang,39,30,9,2012
2012-01-02,Pahang,0,0,0,2012
2012-01-03,Pahang,13,2,11,2012
2012-01-04,Pahang,18,5,13,2012
2012-01-05,Pahang,12,9,3,2012
2012-01-06,Pahang,14,5,9,2012
2012-01-07,Pahang,4,2,2,2012
2012-01-08,Pahang,56,44,12,2012
2012-01-09,Pahang,23,21,2,2012
2012-01-10,Pahang,1,0,1,2012
2012-01-11,Pahang,21,7,14,2012
2012-01-12,Pahang,136,113,23,2012
2012-01-13,Pahang,20,16,4,2012
2012-01-14,Pahang,0,0,0,2012
2012-01-15,Pahang,104,52,52,2012
2012-01-16,Pahang,43,31,12,2012
2012-01-17,Pahang,74,54,20,2012
2012-01-18,Pahang,107,76,31,2012
2012-01-19,Pahang,49,38,11,2012
2012-01-20,Pahang,30,22,8,2012
2012-01-21,Pahang,5,2,3,2012
2012-01-22,Pahang,0,0,0,2012
2012-01-23,Pahang,0,0,0,2012
2012-01-24,Pahang,9,7,2,2012
2012-01-25,Pahang,56,25,31,2012
2012-01-26,Pahang,52,40,12,2012
2012-01-27,Pahang,75,44,31,2012
2012-01-28,Pahang,99,59,40,2012
2012-01-29,Pahang,28,13,15,2012
2012-01-30,Pahang,93,44,49,2012
2012-01-31,Pahang,16,8,8,2012
2012-02-01,Pahang,5,1,4,2012
2012-02-02,Pahang,8,5,3,2012
2012-02-03,Pahang,6,1,5,2012
2012-02-04,Pahang,46,36,10,2012
2012-02-05,Pahang,56,43,13,2012
2012-02-06,Pahang,0,0,0,2012
2012-02-07,Pahang,41,27,14,2012
2012-02-08,Pahang,7,2,5,2012
2012-02-09,Pahang,86,69,17,2012
2012-02-10,Pahang,4,0,4,2012
2012-02-11,Pahang,85,81,4,2012
2012-02-12,Pahang,41,18,23,2012
2012-02-13,Pahang,25,18,7,2012
2012-02-14,Pahang,35,31,4,2012
2012-02-15,Pahang,30,24,6,2012
2012-02-16,Pahang,5,1,4,2012
2012-02-17,Pahang,18,6,12,2012
2012-02-18,Pahang,115,74,41,2012
2012-02-19,Pahang,0,0,0,2012
2012-02-20,Pahang,48,39,9,2012
2012-02-21,Pahang,37,17,20,2012
2012-02-22,Pahang,45,31,14,2012
2012-02-23,Pahang,31,21,10,2012
2012-02-24,Pahang,2,0,2,2012
2012-02-25,Pahang,94,88,6,2012
2012-02-26,Pahang,67,29,38,2012
2012-02-27,Pahang,25,16,9,2012
2012-02-28,Pahang,24,7,17,2012
2012-02-29,Pahang,111,78,33,2012
2012-03-01,Pahang,6,2,4,2012
2012-03-02,Pahang,53,50,3,2012
2012-03-03,Pahang,15,9,6,2012
2012-03-04,Pahang,43,10,33,2012
2012-03-05,Pahang,5,1,4,2012
2012-03-06,Pahang,35,18,17,2012
2012-03-07,Pahang,112,47,65,2012
2012-03-08,Pahang,36,14,22,2012
2012-03-09,Pahang,18,6,12,2012
2012-03-10,Pahang,3,2,1,2012
2012-03-11,Pahang,91,37,54,2012
2012-03-12,Pahang,66,47,19,2012
2012-03-13,Pahang,17,9,8,2012
2012-03-14,Pahang,7,1,6,2012
2012-03-15,Pahang,25,17,8,2012
2012-03-16,Pahang,15,10,5,2012
2012-03-17,Pahang,17,11,6,2012
2012-03-18,Pahang,51,37,14,2012
2012-03-19,Pahang,31,10,21,2012
2012-03-20,Pahang,13,4,9,2012
2012-03-21,Pahang,23,12,11,2012
2012-03-22,Pahang,5,4,1,2012
2012-03-23,Pahang,29,24,5,2012
2012-03-24,Pahang,12,8,4,2012
2012-03-25,Pahang,20,18,2,2012
2012-03-26,Pahang,74,47,27,2012
2012-03-27,Pahang,33,32,1,2012
2012-03-28,Pahang,23,17,6,2012
2012-03-29,Pahang,19,1,18,2012
2012-03-30,Pahang,10,3,7,2012
2012-03-31,Pahang,0,0,0,2012
2012-04-01,Pahang,19,3,16,2012
2012-04-02,Pahang,11,2,9,2012
2012-04-03,Pahang,24,10,14,2012
2012-04-04,Pahang,40,26,14,2012
2012-04-05,Pahang,27,18,9,2012
2012-04-06,Pahang,10,4,6,2012
2012-04-07,Pahang,120,57,63,2012
2012-04-08,Pahang,148,103,45,2012
2012-04-09,Pahang,14,5,9,2012
2012-04-10,Pahang,1,0,1,2012
2012-04-11,Pahang,0,0,0,2012
2012-04-12,Pahang,65,35,30,2012
2012-04-13,Pahang,5,1,4,2012
2012-04-14,Pahang,25,6,19,2012
2012-04-15,Pahang,76,49,27,2012
2012-04-16,Pahang,6,2,4,2012
2012-04-17,Pahang,9,2,7,2012
2012-04-18,Pahang,19,11,8,2012
2012-04-19,Pahang,34,26,8,2012
2012-04-20,Pahang,5,2,3,2012
2012-04-21,Pahang,48,29,19,2012
2012-04-22,Pahang,77,51,26,2012
2012-04-23,Pahang,7,3,4,2012
2012-04-24,Pahang,26,24,2,2012
2012-04-25,Pahang,15,7,8,2012
2012-04-26,Pahang,4,3,1,2012
2012-04-27,Pahang,9,0,9,2012
2012-04-28,Pahang,9,9,0,2012
2012-04-29,Pahang,76,39,37,2012
2012-04-30,Pahang,35,14,21,2012
2012-05-01,Pahang,49,16,33,2012
2012-05-02,Pahang,9,1,8,2012
2012-05-03,Pahang,93,44,49,2012
2012-05-04,Pahang,35,9,26,2012
2012-05-05,Pahang,0,0,0,2012
2012-05-06,Pahang,0,0,0,2012
2012-05-07,Pahang,0,0,0,2012
2012-05-08,Pahang,9,1,8,2012
2012-05-09,Pahang,33,17,16,2012
2012-05-10,Pahang,65,54,11,2012
2012-05-11,Pahang,12,3,9,2012
2012-05-12,Pahang,16,8,8,2012
2012-05-13,Pahang,96,41,55,2012
2012-05-14,Pahang,9,1,8,2012
2012-05-15,Pahang,13,2,11,2012
2012-05-16,Pahang,7,1,6,2012
2012-05-17,Pahang,9,2,7,2012
2012-05-18,Pahang,7,2,5,2012
2012-05-19,Pahang,4,1,3,2012
2012-05-20,Pahang,73,51,22,2012
2012-05-21,Pahang,32,13,19,2012
2012-05-22,Pahang,3,0,3,2012
2012-05-23,Pahang,106,36,70,2012
2012-05-24,Pahang,35,9,26,2012
2012-05-25,Pahang,34,17,17,2012
2012-05-26,Pahang,39,26,13,2012
2012-05-27,Pahang,65,30,35,2012
2012-05-28,Pahang,25,12,13,2012
2012-05-29,Pahang,9,3,6,2012
2012-05-30,Pahang,7,0,7,2012
2012-05-31,Pahang,61,29,32,2012
2012-06-01,Pahang,6,0,6,2012
2012-06-02,Pahang,24,5,19,2012
2012-06-03,Pahang,76,35,41,2012
2012-06-04,Pahang,2,1,1,2012
2012-06-05,Pahang,7,5,2,2012
2012-06-06,Pahang,28,22,6,2012
2012-06-07,Pahang,16,4,12,2012
2012-06-08,Pahang,8,4,4,2012
2012-06-09,Pahang,140,133,7,2012
2012-06-10,Pahang,26,11,15,2012
2012-06-11,Pahang,12,3,9,2012
2012-06-12,Pahang,23,22,1,2012
2012-06-13,Pahang,30,18,12,2012
2012-06-14,Pahang,143,114,29,2012
2012-06-15,Pahang,44,31,13,2012
2012-06-16,Pahang,187,155,32,2012
2012-06-17,Pahang,36,10,26,2012
2012-06-18,Pahang,44,32,12,2012
2012-06-19,Pahang,9,4,5,2012
2012-06-20,Pahang,61,52,9,2012
2012-06-21,Pahang,47,39,8,2012
2012-06-22,Pahang,50,22,28,2012
2012-06-23,Pahang,0,0,0,2012
2012-06-24,Pahang,25,11,14,2012
2012-06-25,Pahang,26,15,11,2012
2012-06-26,Pahang,9,4,5,2012
2012-06-27,Pahang,28,28,0,2012
2012-06-28,Pahang,15,9,6,2012
2012-06-29,Pahang,47,42,5,2012
2012-06-30,Pahang,21,11,10,2012
2012-07-01,Pahang,119,44,75,2012
2012-07-02,Pahang,34,28,6,2012
2012-07-03,Pahang,47,28,19,2012
2012-07-04,Pahang,20,9,11,2012
2012-07-05,Pahang,73,55,18,2012
2012-07-06,Pahang,74,53,21,2012
2012-07-07,Pahang,69,38,31,2012
2012-07-08,Pahang,87,37,50,2012
2012-07-09,Pahang,37,18,19,2012
2012-07-10,Pahang,42,32,10,2012
2012-07-11,Pahang,79,61,18,2012
2012-07-12,Pahang,70,60,10,2012
2012-07-13,Pahang,89,36,53,2012
2012-07-14,Pahang,0,0,0,2012
2012-07-15,Pahang,0,0,0,2012
2012-07-16,Pahang,70,58,12,2012
2012-07-17,Pahang,44,25,19,2012
2012-07-18,Pahang,59,45,14,2012
2012-07-19,Pahang,25,6,19,2012
2012-07-20,Pahang,15,4,11,2012
2012-07-21,Pahang,0,0,0,2012
2012-07-22,Pahang,75,30,45,2012
2012-07-23,Pahang,1,0,1,2012
2012-07-24,Pahang,2,0,2,2012
2012-07-25,Pahang,1,1,0,2012
2012-07-26,Pahang,51,28,23,2012
2012-07-27,Pahang,11,8,3,2012
2012-07-28,Pahang,61,50,11,2012
2012-07-29,Pahang,38,14,24,2012
2012-07-30,Pahang,4,0,4,2012
2012-07-31,Pahang,1,1,0,2012
2012-08-01,Pahang,57,34,23,2012
2012-08-02,Pahang,6,4,2,2012
2012-08-03,Pahang,4,0,4,2012
2012-08-04,Pahang,9,6,3,2012
2012-08-05,Pahang,146,71,75,2012
2012-08-06,Pahang,0,0,0,2012
2012-08-07,Pahang,59,39,20,2012
2012-08-08,Pahang,7,4,3,2012
2012-08-09,Pahang,42,37,5,2012
2012-08-10,Pahang,23,12,11,2012
2012-08-11,Pahang,103,52,51,2012
2012-08-12,Pahang,71,29,42,2012
2012-08-13,Pahang,19,7,12,2012
2012-08-14,Pahang,17,3,14,2012
2012-08-15,Pahang,17,9,8,2012
2012-08-16,Pahang,25,13,12,2012
2012-08-17,Pahang,1,0,1,2012
2012-08-18,Pahang,11,7,4,2012
2012-08-19,Pahang,0,0,0,2012
2012-08-20,Pahang,0,0,0,2012
2012-08-21,Pahang,29,9,20,2012
2012-08-22,Pahang,40,18,22,2012
2012-08-23,Pahang,49,18,31,2012
2012-08-24,Pahang,10,3,7,2012
2012-08-25,Pahang,5,1,4,2012
2012-08-26,Pahang,24,9,15,2012
2012-08-27,Pahang,43,18,25,2012
2012-08-28,Pahang,7,0,7,2012
2012-08-29,Pahang,89,58,31,2012
2012-08-30,Pahang,30,25,5,2012
2012-08-31,Pahang,44,30,14,2012
2012-09-01,Pahang,0,0,0,2012
2012-09-02,Pahang,0,0,0,2012
2012-09-03,Pahang,22,8,14,2012
2012-09-04,Pahang,61,43,18,2012
2012-09-05,Pahang,9,3,6,2012
2012-09-06,Pahang,138,116,22,2012
2012-09-07,Pahang,4,0,4,2012
2012-09-08,Pahang,78,66,12,2012
2012-09-09,Pahang,89,34,55,2012
2012-09-10,Pahang,30,9,21,2012
2012-09-11,Pahang,353,284,69,2012
2012-09-12,Pahang,6,1,5,2012
2012-09-13,Pahang,36,8,28,2012
2012-09-14,Pahang,75,54,21,2012
2012-09-15,Pahang,0,0,0,2012
2012-09-16,Pahang,0,0,0,2012
2012-09-17,Pahang,0,0,0,2012
2012-09-18,Pahang,32,24,8,2012
2012-09-19,Pahang,65,27,38,2012
2012-09-20,Pahang,23,14,9,2012
2012-09-21,Pahang,7,1,6,2012
2012-09-22,Pahang,0,0,0,2012
2012-09-23,Pahang,9,2,7,2012
2012-09-24,Pahang,2,0,2,2012
2012-09-25,Pahang,17,10,7,2012
2012-09-26,Pahang,34,11,23,2012
2012-09-27,Pahang,40,21,19,2012
2012-09-28,Pahang,22,12,10,2012
2012-09-29,Pahang,17,8,9,2012
2012-09-30,Pahang,0,0,0,2012
2012-10-01,Pahang,5,2,3,2012
2012-10-02,Pahang,21,12,9,2012
2012-10-03,Pahang,5,2,3,2012
2012-10-04,Pahang,34,20,14,2012
2012-10-05,Pahang,5,0,5,2012
2012-10-06,Pahang,51,28,23,2012
2012-10-07,Pahang,59,26,33,2012
2012-10-08,Pahang,10,0,10,2012
2012-10-09,Pahang,57,31,26,2012
2012-10-10,Pahang,13,7,6,2012
2012-10-11,Pahang,58,25,33,2012
2012-10-12,Pahang,10,2,8,2012
2012-10-13,Pahang,62,48,14,2012
2012-10-14,Pahang,0,0,0,2012
2012-10-15,Pahang,3,0,3,2012
2012-10-16,Pahang,9,2,7,2012
2012-10-17,Pahang,48,40,8,2012
2012-10-18,Pahang,100,61,39,2012
2012-10-19,Pahang,32,8,24,2012
2012-10-20,Pahang,0,0,0,2012
2012-10-21,Pahang,60,14,46,2012
2012-10-22,Pahang,6,1,5,2012
2012-10-23,Pahang,33,14,19,2012
2012-10-24,Pahang,43,13,30,2012
2012-10-25,Pahang,26,7,19,2012
2012-10-26,Pahang,0,0,0,2012
2012-10-27,Pahang,116,48,68,2012
2012-10-28,Pahang,152,61,91,2012
2012-10-29,Pahang,12,4,8,2012
2012-10-30,Pahang,16,11,5,2012
2012-10-31,Pahang,38,14,24,2012
2012-11-01,Pahang,20,12,8,2012
2012-11-02,Pahang,8,4,4,2012
2012-11-03,Pahang,55,19,36,2012
2012-11-04,Pahang,89,30,59,2012
2012-11-05,Pahang,27,8,19,2012
2012-11-06,Pahang,2,1,1,2012
2012-11-07,Pahang,93,61,32,2012
2012-11-08,Pahang,18,2,16,2012
2012-11-09,Pahang,8,2,6,2012
2012-11-10,Pahang,59,55,4,2012
2012-11-11,Pahang,48,32,16,2012
2012-11-12,Pahang,66,41,25,2012
2012-11-13,Pahang,0,0,0,2012
2012-11-14,Pahang,12,2,10,2012
2012-11-15,Pahang,0,0,0,2012
2012-11-16,Pahang,11,2,9,2012
2012-11-17,Pahang,13,13,0,2012
2012-11-18,Pahang,109,34,75,2012
2012-11-19,Pahang,10,1,9,2012
2012-11-20,Pahang,48,17,31,2012
2012-11-21,Pahang,22,14,8,2012
2012-11-22,Pahang,9,1,8,2012
2012-11-23,Pahang,7,0,7,2012
2012-11-24,Pahang,9,8,1,2012
2012-11-25,Pahang,0,0,0,2012
2012-11-26,Pahang,7,1,6,2012
2012-11-27,Pahang,102,47,55,2012
2012-11-28,Pahang,19,12,7,2012
2012-11-29,Pahang,41,18,23,2012
2012-11-30,Pahang,16,3,13,2012
2012-12-01,Pahang,0,0,0,2012
2012-12-02,Pahang,0,0,0,2012
2012-12-03,Pahang,35,13,22,2012
2012-12-04,Pahang,19,7,12,2012
2012-12-05,Pahang,6,0,6,2012
2012-12-06,Pahang,31,15,16,2012
2012-12-07,Pahang,31,12,19,2012
2012-12-08,Pahang,78,44,34,2012
2012-12-09,Pahang,57,22,35,2012
2012-12-10,Pahang,2,1,1,2012
2012-12-11,Pahang,24,17,7,2012
2012-12-12,Pahang,21,10,11,2012
2012-12-13,Pahang,26,11,15,2012
2012-12-14,Pahang,35,17,18,2012
2012-12-15,Pahang,26,11,15,2012
2012-12-16,Pahang,22,6,16,2012
2012-12-17,Pahang,7,0,7,2012
2012-12-18,Pahang,64,31,33,2012
2012-12-19,Pahang,37,28,9,2012
2012-12-20,Pahang,35,23,12,2012
2012-12-21,Pahang,32,20,12,2012
2012-12-22,Pahang,25,12,13,2012
2012-12-23,Pahang,34,7,27,2012
2012-12-24,Pahang,5,2,3,2012
2012-12-25,Pahang,52,15,37,2012
2012-12-26,Pahang,4,1,3,2012
2012-12-27,Pahang,19,7,12,2012
2012-12-28,Pahang,69,38,31,2012
2012-12-29,Pahang,0,0,0,2012
2012-12-30,Pahang,0,0,0,2012
2012-12-31,Pahang,15,5,10,2012
2013-01-01,Pahang,45,25,20,2013
2013-01-02,Pahang,101,51,50,2013
2013-01-03,Pahang,27,4,23,2013
2013-01-04,Pahang,10,4,6,2013
2013-01-05,Pahang,29,18,11,2013
2013-01-06,Pahang,59,18,41,2013
2013-01-07,Pahang,32,12,20,2013
2013-01-08,Pahang,39,18,21,2013
2013-01-09,Pahang,17,5,12,2013
2013-01-10,Pahang,44,25,19,2013
2013-01-11,Pahang,25,14,11,2013
2013-01-12,Pahang,15,7,8,2013
2013-01-13,Pahang,0,0,0,2013
2013-01-14,Pahang,50,28,22,2013
2013-01-15,Pahang,25,11,14,2013
2013-01-16,Pahang,43,36,7,2013
2013-01-17,Pahang,32,17,15,2013
2013-01-18,Pahang,80,54,26,2013
2013-01-19,Pahang,0,0,0,2013
2013-01-20,Pahang,156,44,112,2013
2013-01-21,Pahang,27,15,12,2013
2013-01-22,Pahang,46,14,32,2013
2013-01-23,Pahang,82,24,58,2013
2013-01-24,Pahang,0,0,0,2013
2013-01-25,Pahang,3,1,2,2013
2013-01-26,Pahang,11,2,9,2013
2013-01-27,Pahang,42,15,27,2013
2013-01-28,Pahang,64,35,29,2013
2013-01-29,Pahang,34,22,12,2013
2013-01-30,Pahang,73,35,38,2013
2013-01-31,Pahang,19,15,4,2013
2013-02-01,Pahang,32,24,8,2013
2013-02-02,Pahang,54,39,15,2013
2013-02-03,Pahang,61,39,22,2013
2013-02-04,Pahang,18,11,7,2013
2013-02-05,Pahang,16,7,9,2013
2013-02-06,Pahang,76,39,37,2013
2013-02-07,Pahang,51,34,17,2013
2013-02-08,Pahang,47,29,18,2013
2013-02-09,Pahang,72,33,39,2013
2013-02-10,Pahang,0,0,0,2013
2013-02-11,Pahang,0,0,0,2013
2013-02-12,Pahang,0,0,0,2013
2013-02-13,Pahang,44,19,25,2013
2013-02-14,Pahang,41,14,27,2013
2013-02-15,Pahang,8,2,6,2013
2013-02-16,Pahang,102,94,8,2013
2013-02-17,Pahang,0,0,0,2013
2013-02-18,Pahang,10,0,10,2013
2013-02-19,Pahang,9,2,7,2013
2013-02-20,Pahang,27,18,9,2013
2013-02-21,Pahang,23,8,15,2013
2013-02-22,Pahang,27,15,12,2013
2013-02-23,Pahang,93,42,51,2013
2013-02-24,Pahang,22,19,3,2013
2013-02-25,Pahang,5,2,3,2013
2013-02-26,Pahang,5,1,4,2013
2013-02-27,Pahang,79,49,30,2013
2013-02-28,Pahang,42,33,9,2013
2013-03-01,Pahang,50,13,37,2013
2013-03-02,Pahang,122,114,8,2013
2013-03-03,Pahang,35,11,24,2013
2013-03-04,Pahang,6,2,4,2013
2013-03-05,Pahang,32,21,11,2013
2013-03-06,Pahang,34,9,25,2013
2013-03-07,Pahang,111,49,62,2013
2013-03-08,Pahang,9,4,5,2013
2013-03-09,Pahang,54,42,12,2013
2013-03-10,Pahang,96,18,78,2013
2013-03-11,Pahang,12,4,8,2013
2013-03-12,Pahang,92,41,51,2013
2013-03-13,Pahang,66,41,25,2013
2013-03-14,Pahang,12,4,8,2013
2013-03-15,Pahang,11,4,7,2013
2013-03-16,Pahang,15,6,9,2013
2013-03-17,Pahang,59,14,45,2013
2013-03-18,Pahang,108,46,62,2013
2013-03-19,Pahang,18,15,3,2013
2013-03-20,Pahang,24,8,16,2013
2013-03-21,Pahang,46,23,23,2013
2013-03-22,Pahang,6,2,4,2013
2013-03-23,Pahang,0,0,0,2013
2013-03-24,Pahang,15,3,12,2013
2013-03-25,Pahang,30,19,11,2013
2013-03-26,Pahang,11,1,10,2013
2013-03-27,Pahang,57,29,28,2013
2013-03-28,Pahang,6,2,4,2013
2013-03-29,Pahang,7,0,7,2013
2013-03-30,Pahang,14,2,12,2013
2013-03-31,Pahang,69,33,36,2013
2013-04-01,Pahang,2,0,2,2013
2013-04-02,Pahang,31,11,20,2013
2013-04-03,Pahang,13,3,10,2013
2013-04-04,Pahang,26,14,12,2013
2013-04-05,Pahang,20,15,5,2013
2013-04-06,Pahang,4,1,3,2013
2013-04-07,Pahang,0,0,0,2013
2013-04-08,Pahang,19,10,9,2013
2013-04-09,Pahang,27,15,12,2013
2013-04-10,Pahang,8,3,5,2013
2013-04-11,Pahang,11,3,8,2013
2013-04-12,Pahang,23,12,11,2013
2013-04-13,Pahang,56,27,29,2013
2013-04-14,Pahang,0,0,0,2013
2013-04-15,Pahang,26,16,10,2013
2013-04-16,Pahang,26,11,15,2013
2013-04-17,Pahang,35,23,12,2013
2013-04-18,Pahang,19,7,12,2013
2013-04-19,Pahang,18,8,10,2013
2013-04-20,Pahang,100,64,36,2013
2013-04-21,Pahang,37,17,20,2013
2013-04-22,Pahang,81,35,46,2013
2013-04-23,Pahang,27,5,22,2013
2013-04-24,Pahang,56,35,21,2013
2013-04-25,Pahang,3,0,3,2013
2013-04-26,Pahang,10,2,8,2013
2013-04-27,Pahang,49,34,15,2013
2013-04-28,Pahang,26,10,16,2013
2013-04-29,Pahang,31,15,16,2013
2013-04-30,Pahang,29,19,10,2013
2013-05-01,Pahang,45,9,36,2013
2013-05-02,Pahang,10,4,6,2013
2013-05-03,Pahang,12,1,11,2013
2013-05-04,Pahang,23,8,15,2013
2013-05-05,Pahang,0,0,0,2013
2013-05-06,Pahang,5,0,5,2013
2013-05-07,Pahang,0,0,0,2013
2013-05-08,Pahang,5,0,5,2013
2013-05-09,Pahang,35,11,24,2013
2013-05-10,Pahang,11,1,10,2013
2013-05-11,Pahang,77,75,2,2013
2013-05-12,Pahang,135,41,94,2013
2013-05-13,Pahang,4,0,4,2013
2013-05-14,Pahang,35,9,26,2013
2013-05-15,Pahang,59,35,24,2013
2013-05-16,Pahang,58,49,9,2013
2013-05-17,Pahang,3,0,3,2013
2013-05-18,Pahang,30,18,12,2013
2013-05-19,Pahang,87,37,50,2013
2013-05-20,Pahang,12,1,11,2013
2013-05-21,Pahang,48,39,9,2013
2013-05-22,Pahang,28,8,20,2013
2013-05-23,Pahang,29,17,12,2013
2013-05-24,Pahang,0,0,0,2013
2013-05-25,Pahang,79,67,12,2013
2013-05-26,Pahang,86,29,57,2013
2013-05-27,Pahang,4,0,4,2013
2013-05-28,Pahang,0,0,0,2013
2013-05-29,Pahang,21,3,18,2013
2013-05-30,Pahang,15,12,3,2013
2013-05-31,Pahang,7,4,3,2013
2013-06-01,Pahang,0,0,0,2013
2013-06-02,Pahang,5,0,5,2013
2013-06-03,Pahang,5,3,2,2013
2013-06-04,Pahang,22,14,8,2013
2013-06-05,Pahang,50,25,25,2013
2013-06-06,Pahang,2,0,2,2013
2013-06-07,Pahang,2,0,2,2013
2013-06-08,Pahang,22,5,17,2013
2013-06-09,Pahang,26,4,22,2013
2013-06-10,Pahang,45,27,18,2013
2013-06-11,Pahang,23,14,9,2013
2013-06-12,Pahang,9,2,7,2013
2013-06-13,Pahang,28,15,13,2013
2013-06-14,Pahang,9,1,8,2013
2013-06-15,Pahang,36,27,9,2013
2013-06-16,Pahang,117,26,91,2013
2013-06-17,Pahang,27,5,22,2013
2013-06-18,Pahang,63,55,8,2013
2013-06-19,Pahang,4,1,3,2013
2013-06-20,Pahang,56,18,38,2013
2013-06-21,Pahang,3,0,3,2013
2013-06-22,Pahang,6,3,3,2013
2013-06-23,Pahang,79,19,60,2013
2013-06-24,Pahang,23,7,16,2013
2013-06-25,Pahang,37,12,25,2013
2013-06-26,Pahang,36,17,19,2013
2013-06-27,Pahang,68,42,26,2013
2013-06-28,Pahang,27,10,17,2013
2013-06-29,Pahang,32,20,12,2013
2013-06-30,Pahang,0,0,0,2013
2013-07-01,Pahang,40,35,5,2013
2013-07-02,Pahang,30,14,16,2013
2013-07-03,Pahang,60,44,16,2013
2013-07-04,Pahang,98,60,38,2013
2013-07-05,Pahang,16,9,7,2013
2013-07-06,Pahang,62,42,20,2013
2013-07-07,Pahang,117,59,58,2013
2013-07-08,Pahang,109,76,33,2013
2013-07-09,Pahang,24,3,21,2013
2013-07-10,Pahang,1,1,0,2013
2013-07-11,Pahang,7,1,6,2013
2013-07-12,Pahang,3,0,3,2013
2013-07-13,Pahang,75,29,46,2013
2013-07-14,Pahang,101,42,59,2013
2013-07-15,Pahang,2,1,1,2013
2013-07-16,Pahang,16,3,13,2013
2013-07-17,Pahang,2,1,1,2013
2013-07-18,Pahang,71,54,17,2013
2013-07-19,Pahang,2,0,2,2013
2013-07-20,Pahang,0,0,0,2013
2013-07-21,Pahang,130,56,74,2013
2013-07-22,Pahang,10,1,9,2013
2013-07-23,Pahang,12,3,9,2013
2013-07-24,Pahang,1,0,1,2013
2013-07-25,Pahang,98,57,41,2013
2013-07-26,Pahang,51,21,30,2013
2013-07-27,Pahang,64,31,33,2013
2013-07-28,Pahang,94,25,69,2013
2013-07-29,Pahang,4,1,3,2013
2013-07-30,Pahang,4,2,2,2013
2013-07-31,Pahang,6,1,5,2013
2013-08-01,Pahang,25,21,4,2013
2013-08-02,Pahang,10,2,8,2013
2013-08-03,Pahang,8,2,6,2013
2013-08-04,Pahang,119,59,60,2013
2013-08-05,Pahang,4,1,3,2013
2013-08-06,Pahang,5,0,5,2013
2013-08-07,Pahang,3,0,3,2013
2013-08-08,Pahang,0,0,0,2013
2013-08-09,Pahang,0,0,0,2013
2013-08-10,Pahang,7,2,5,2013
2013-08-11,Pahang,53,21,32,2013
2013-08-12,Pahang,9,0,9,2013
2013-08-13,Pahang,10,1,9,2013
2013-08-14,Pahang,28,11,17,2013
2013-08-15,Pahang,11,3,8,2013
2013-08-16,Pahang,30,7,23,2013
2013-08-17,Pahang,20,9,11,2013
2013-08-18,Pahang,16,6,10,2013
2013-08-19,Pahang,7,0,7,2013
2013-08-20,Pahang,74,32,42,2013
2013-08-21,Pahang,76,49,27,2013
2013-08-22,Pahang,20,8,12,2013
2013-08-23,Pahang,54,26,28,2013
2013-08-24,Pahang,0,0,0,2013
2013-08-25,Pahang,56,16,40,2013
2013-08-26,Pahang,9,3,6,2013
2013-08-27,Pahang,20,14,6,2013
2013-08-28,Pahang,75,28,47,2013
2013-08-29,Pahang,53,39,14,2013
2013-08-30,Pahang,5,1,4,2013
2013-08-31,Pahang,42,19,23,2013
2013-09-01,Pahang,16,6,10,2013
2013-09-02,Pahang,3,0,3,2013
2013-09-03,Pahang,16,2,14,2013
2013-09-04,Pahang,22,8,14,2013
2013-09-05,Pahang,20,4,16,2013
2013-09-06,Pahang,11,3,8,2013
2013-09-07,Pahang,16,5,11,2013
2013-09-08,Pahang,0,0,0,2013
2013-09-09,Pahang,26,11,15,2013
2013-09-10,Pahang,24,10,14,2013
2013-09-11,Pahang,29,16,13,2013
2013-09-12,Pahang,9,1,8,2013
2013-09-13,Pahang,59,28,31,2013
2013-09-14,Pahang,30,13,17,2013
2013-09-15,Pahang,37,5,32,2013
2013-09-16,Pahang,0,0,0,2013
2013-09-17,Pahang,32,16,16,2013
2013-09-18,Pahang,11,2,9,2013
2013-09-19,Pahang,128,78,50,2013
2013-09-20,Pahang,5,1,4,2013
2013-09-21,Pahang,1,0,1,2013
2013-09-22,Pahang,74,31,43,2013
2013-09-23,Pahang,43,39,4,2013
2013-09-24,Pahang,6,0,6,2013
2013-09-25,Pahang,40,20,20,2013
2013-09-26,Pahang,36,20,16,2013
2013-09-27,Pahang,7,0,7,2013
2013-09-28,Pahang,54,24,30,2013
2013-09-29,Pahang,40,15,25,2013
2013-09-30,Pahang,6,2,4,2013
2013-10-01,Pahang,15,8,7,2013
2013-10-02,Pahang,66,49,17,2013
2013-10-03,Pahang,31,17,14,2013
2013-10-04,Pahang,7,2,5,2013
2013-10-05,Pahang,7,6,1,2013
2013-10-06,Pahang,2,0,2,2013
2013-10-07,Pahang,31,19,12,2013
2013-10-08,Pahang,34,28,6,2013
2013-10-09,Pahang,35,14,21,2013
2013-10-10,Pahang,42,32,10,2013
2013-10-11,Pahang,26,18,8,2013
2013-10-12,Pahang,45,44,1,2013
2013-10-13,Pahang,61,20,41,2013
2013-10-14,Pahang,5,1,4,2013
2013-10-15,Pahang,0,0,0,2013
2013-10-16,Pahang,3,1,2,2013
2013-10-17,Pahang,26,23,3,2013
2013-10-18,Pahang,4,0,4,2013
2013-10-19,Pahang,10,9,1,2013
2013-10-20,Pahang,101,29,72,2013
2013-10-21,Pahang,14,9,5,2013
2013-10-22,Pahang,14,4,10,2013
2013-10-23,Pahang,48,31,17,2013
2013-10-24,Pahang,0,0,0,2013
2013-10-25,Pahang,5,1,4,2013
2013-10-26,Pahang,65,58,7,2013
2013-10-27,Pahang,71,20,51,2013
2013-10-28,Pahang,17,6,11,2013
2013-10-29,Pahang,8,2,6,2013
2013-10-30,Pahang,59,30,29,2013
2013-10-31,Pahang,17,3,14,2013
2013-11-01,Pahang,19,8,11,2013
2013-11-02,Pahang,10,2,8,2013
2013-11-03,Pahang,52,14,38,2013
2013-11-04,Pahang,0,0,0,2013
2013-11-05,Pahang,0,0,0,2013
2013-11-06,Pahang,32,17,15,2013
2013-11-07,Pahang,17,6,11,2013
2013-11-08,Pahang,65,25,40,2013
2013-11-09,Pahang,0,0,0,2013
2013-11-10,Pahang,40,13,27,2013
2013-11-11,Pahang,95,26,69,2013
2013-11-12,Pahang,11,4,7,2013
2013-11-13,Pahang,22,6,16,2013
2013-11-14,Pahang,24,10,14,2013
2013-11-15,Pahang,6,0,6,2013
2013-11-16,Pahang,0,0,0,2013
2013-11-17,Pahang,52,8,44,2013
2013-11-18,Pahang,15,4,11,2013
2013-11-19,Pahang,33,9,24,2013
2013-11-20,Pahang,38,17,21,2013
2013-11-21,Pahang,32,11,21,2013
2013-11-22,Pahang,10,2,8,2013
2013-11-23,Pahang,5,4,1,2013
2013-11-24,Pahang,33,20,13,2013
2013-11-25,Pahang,7,1,6,2013
2013-11-26,Pahang,28,12,16,2013
2013-11-27,Pahang,56,25,31,2013
2013-11-28,Pahang,50,18,32,2013
2013-11-29,Pahang,24,7,17,2013
2013-11-30,Pahang,18,8,10,2013
2013-12-01,Pahang,22,5,17,2013
2013-12-02,Pahang,29,9,20,2013
2013-12-03,Pahang,8,1,7,2013
2013-12-04,Pahang,7,1,6,2013
2013-12-05,Pahang,32,10,22,2013
2013-12-06,Pahang,12,2,10,2013
2013-12-07,Pahang,1,0,1,2013
2013-12-08,Pahang,68,32,36,2013
2013-12-09,Pahang,76,24,52,2013
2013-12-10,Pahang,12,4,8,2013
2013-12-11,Pahang,12,1,11,2013
2013-12-12,Pahang,21,8,13,2013
2013-12-13,Pahang,15,2,13,2013
2013-12-14,Pahang,22,11,11,2013
2013-12-15,Pahang,13,7,6,2013
2013-12-16,Pahang,11,2,9,2013
2013-12-17,Pahang,39,7,32,2013
2013-12-18,Pahang,22,12,10,2013
2013-12-19,Pahang,8,3,5,2013
2013-12-20,Pahang,5,0,5,2013
2013-12-21,Pahang,0,0,0,2013
2013-12-22,Pahang,118,18,100,2013
2013-12-23,Pahang,16,5,11,2013
2013-12-24,Pahang,33,8,25,2013
2013-12-25,Pahang,46,9,37,2013
2013-12-26,Pahang,25,9,16,2013
2013-12-27,Pahang,68,30,38,2013
2013-12-28,Pahang,17,5,12,2013
2013-12-29,Pahang,8,2,6,2013
2013-12-30,Pahang,12,1,11,2013
2013-12-31,Pahang,31,9,22,2013
2014-01-01,Pahang,18,7,11,2014
2014-01-02,Pahang,10,1,9,2014
2014-01-03,Pahang,11,0,11,2014
2014-01-04,Pahang,18,9,9,2014
2014-01-05,Pahang,14,6,8,2014
2014-01-06,Pahang,24,9,15,2014
2014-01-07,Pahang,13,5,8,2014
2014-01-08,Pahang,152,67,85,2014
2014-01-09,Pahang,87,22,65,2014
2014-01-10,Pahang,16,7,9,2014
2014-01-11,Pahang,23,14,9,2014
2014-01-12,Pahang,0,0,0,2014
2014-01-13,Pahang,43,14,29,2014
2014-01-14,Pahang,16,3,13,2014
2014-01-15,Pahang,47,21,26,2014
2014-01-16,Pahang,26,15,11,2014
2014-01-17,Pahang,63,39,24,2014
2014-01-18,Pahang,174,132,42,2014
2014-01-19,Pahang,252,185,67,2014
2014-01-20,Pahang,4,1,3,2014
2014-01-21,Pahang,52,30,22,2014
2014-01-22,Pahang,14,11,3,2014
2014-01-23,Pahang,33,20,13,2014
2014-01-24,Pahang,33,20,13,2014
2014-01-25,Pahang,4,1,3,2014
2014-01-26,Pahang,10,4,6,2014
2014-01-27,Pahang,34,12,22,2014
2014-01-28,Pahang,40,8,32,2014
2014-01-29,Pahang,32,9,23,2014
2014-01-30,Pahang,68,23,45,2014
2014-01-31,Pahang,0,0,0,2014
2014-02-01,Pahang,15,7,8,2014
2014-02-02,Pahang,16,6,10,2014
2014-02-03,Pahang,14,4,10,2014
2014-02-04,Pahang,40,20,20,2014
2014-02-05,Pahang,13,3,10,2014
2014-02-06,Pahang,42,27,15,2014
2014-02-07,Pahang,5,0,5,2014
2014-02-08,Pahang,17,15,2,2014
2014-02-09,Pahang,15,7,8,2014
2014-02-10,Pahang,5,0,5,2014
2014-02-11,Pahang,29,11,18,2014
2014-02-12,Pahang,53,36,17,2014
2014-02-13,Pahang,78,38,40,2014
2014-02-14,Pahang,49,36,13,2014
2014-02-15,Pahang,84,81,3,2014
2014-02-16,Pahang,18,6,12,2014
2014-02-17,Pahang,7,0,7,2014
2014-02-18,Pahang,10,2,8,2014
2014-02-19,Pahang,14,4,10,2014
2014-02-20,Pahang,53,19,34,2014
2014-02-21,Pahang,4,0,4,2014
2014-02-22,Pahang,31,15,16,2014
2014-02-23,Pahang,116,37,79,2014
2014-02-24,Pahang,7,0,7,2014
2014-02-25,Pahang,42,11,31,2014
2014-02-26,Pahang,45,18,27,2014
2014-02-27,Pahang,10,2,8,2014
2014-02-28,Pahang,4,1,3,2014
2014-03-01,Pahang,22,10,12,2014
2014-03-02,Pahang,105,31,74,2014
2014-03-03,Pahang,7,1,6,2014
2014-03-04,Pahang,11,2,9,2014
2014-03-05,Pahang,44,24,20,2014
2014-03-06,Pahang,42,21,21,2014
2014-03-07,Pahang,6,1,5,2014
2014-03-08,Pahang,129,119,10,2014
2014-03-09,Pahang,117,28,89,2014
2014-03-10,Pahang,4,1,3,2014
2014-03-11,Pahang,13,6,7,2014
2014-03-12,Pahang,28,24,4,2014
2014-03-13,Pahang,3,0,3,2014
2014-03-14,Pahang,24,3,21,2014
2014-03-15,Pahang,53,22,31,2014
2014-03-16,Pahang,130,33,97,2014
2014-03-17,Pahang,8,0,8,2014
2014-03-18,Pahang,4,0,4,2014
2014-03-19,Pahang,51,23,28,2014
2014-03-20,Pahang,41,25,16,2014
2014-03-21,Pahang,6,0,6,2014
2014-03-22,Pahang,9,5,4,2014
2014-03-23,Pahang,0,0,0,2014
2014-03-24,Pahang,15,9,6,2014
2014-03-25,Pahang,42,16,26,2014
2014-03-26,Pahang,68,23,45,2014
2014-03-27,Pahang,6,1,5,2014
2014-03-28,Pahang,6,0,6,2014
2014-03-29,Pahang,27,11,16,2014
2014-03-30,Pahang,52,28,24,2014
2014-03-31,Pahang,13,2,11,2014
2014-04-01,Pahang,50,26,24,2014
2014-04-02,Pahang,8,1,7,2014
2014-04-03,Pahang,17,7,10,2014
2014-04-04,Pahang,8,1,7,2014
2014-04-05,Pahang,9,3,6,2014
2014-04-06,Pahang,1,0,1,2014
2014-04-07,Pahang,6,2,4,2014
2014-04-08,Pahang,9,0,9,2014
2014-04-09,Pahang,16,5,11,2014
2014-04-10,Pahang,64,38,26,2014
2014-04-11,Pahang,10,4,6,2014
2014-04-12,Pahang,6,4,2,2014
2014-04-13,Pahang,0,0,0,2014
2014-04-14,Pahang,5,0,5,2014
2014-04-15,Pahang,38,11,27,2014
2014-04-16,Pahang,30,20,10,2014
2014-04-17,Pahang,9,2,7,2014
2014-04-18,Pahang,5,1,4,2014
2014-04-19,Pahang,35,21,14,2014
2014-04-20,Pahang,48,20,28,2014
2014-04-21,Pahang,10,0,10,2014
2014-04-22,Pahang,14,5,9,2014
2014-04-23,Pahang,15,14,1,2014
2014-04-24,Pahang,5,0,5,2014
2014-04-25,Pahang,5,1,4,2014
2014-04-26,Pahang,35,12,23,2014
2014-04-27,Pahang,44,17,27,2014
2014-04-28,Pahang,25,5,20,2014
2014-04-29,Pahang,31,16,15,2014
2014-04-30,Pahang,22,7,15,2014
2014-05-01,Pahang,31,3,28,2014
2014-05-02,Pahang,6,1,5,2014
2014-05-03,Pahang,42,39,3,2014
2014-05-04,Pahang,78,23,55,2014
2014-05-05,Pahang,6,1,5,2014
2014-05-06,Pahang,18,6,12,2014
2014-05-07,Pahang,0,0,0,2014
2014-05-08,Pahang,19,5,14,2014
2014-05-09,Pahang,7,0,7,2014
2014-05-10,Pahang,0,0,0,2014
2014-05-11,Pahang,129,40,89,2014
2014-05-12,Pahang,56,20,36,2014
2014-05-13,Pahang,24,10,14,2014
2014-05-14,Pahang,70,36,34,2014
2014-05-15,Pahang,14,4,10,2014
2014-05-16,Pahang,7,1,6,2014
2014-05-17,Pahang,18,16,2,2014
2014-05-18,Pahang,47,17,30,2014
2014-05-19,Pahang,11,3,8,2014
2014-05-20,Pahang,21,9,12,2014
2014-05-21,Pahang,35,24,11,2014
2014-05-22,Pahang,4,0,4,2014
2014-05-23,Pahang,24,6,18,2014
2014-05-24,Pahang,94,57,37,2014
2014-05-25,Pahang,54,12,42,2014
2014-05-26,Pahang,4,3,1,2014
2014-05-27,Pahang,21,8,13,2014
2014-05-28,Pahang,6,0,6,2014
2014-05-29,Pahang,24,9,15,2014
2014-05-30,Pahang,69,36,33,2014
2014-05-31,Pahang,17,12,5,2014
2014-06-01,Pahang,0,0,0,2014
2014-06-02,Pahang,34,2,32,2014
2014-06-03,Pahang,5,0,5,2014
2014-06-04,Pahang,9,2,7,2014
2014-06-05,Pahang,21,12,9,2014
2014-06-06,Pahang,4,1,3,2014
2014-06-07,Pahang,14,9,5,2014
2014-06-08,Pahang,39,8,31,2014
2014-06-09,Pahang,7,1,6,2014
2014-06-10,Pahang,52,17,35,2014
2014-06-11,Pahang,22,8,14,2014
2014-06-12,Pahang,21,7,14,2014
2014-06-13,Pahang,11,1,10,2014
2014-06-14,Pahang,22,15,7,2014
2014-06-15,Pahang,29,16,13,2014
2014-06-16,Pahang,31,12,19,2014
2014-06-17,Pahang,46,21,25,2014
2014-06-18,Pahang,9,3,6,2014
2014-06-19,Pahang,55,28,27,2014
2014-06-20,Pahang,0,0,0,2014
2014-06-21,Pahang,14,13,1,2014
2014-06-22,Pahang,0,0,0,2014
2014-06-23,Pahang,77,40,37,2014
2014-06-24,Pahang,59,40,19,2014
2014-06-25,Pahang,48,20,28,2014
2014-06-26,Pahang,65,20,45,2014
2014-06-27,Pahang,4,0,4,2014
2014-06-28,Pahang,53,11,42,2014
2014-06-29,Pahang,102,26,76,2014
2014-06-30,Pahang,1,0,1,2014
2014-07-01,Pahang,5,0,5,2014
2014-07-02,Pahang,57,47,10,2014
2014-07-03,Pahang,2,0,2,2014
2014-07-04,Pahang,2,1,1,2014
2014-07-05,Pahang,47,20,27,2014
2014-07-06,Pahang,24,10,14,2014
2014-07-07,Pahang,1,0,1,2014
2014-07-08,Pahang,36,24,12,2014
2014-07-09,Pahang,10,5,5,2014
2014-07-10,Pahang,30,27,3,2014
2014-07-11,Pahang,9,3,6,2014
2014-07-12,Pahang,19,10,9,2014
2014-07-13,Pahang,89,24,65,2014
2014-07-14,Pahang,3,0,3,2014
2014-07-15,Pahang,17,5,12,2014
2014-07-16,Pahang,67,39,28,2014
2014-07-17,Pahang,17,9,8,2014
2014-07-18,Pahang,2,0,2,2014
2014-07-19,Pahang,68,22,46,2014
2014-07-20,Pahang,90,17,73,2014
2014-07-21,Pahang,6,0,6,2014
2014-07-22,Pahang,12,3,9,2014
2014-07-23,Pahang,35,24,11,2014
2014-07-24,Pahang,6,1,5,2014
2014-07-25,Pahang,28,8,20,2014
2014-07-26,Pahang,32,10,22,2014
2014-07-27,Pahang,0,0,0,2014
2014-07-28,Pahang,0,0,0,2014
2014-07-29,Pahang,0,0,0,2014
2014-07-30,Pahang,20,5,15,2014
2014-07-31,Pahang,12,4,8,2014
2014-08-01,Pahang,10,2,8,2014
2014-08-02,Pahang,27,14,13,2014
2014-08-03,Pahang,20,6,14,2014
2014-08-04,Pahang,10,1,9,2014
2014-08-05,Pahang,25,12,13,2014
2014-08-06,Pahang,25,16,9,2014
2014-08-07,Pahang,104,83,21,2014
2014-08-08,Pahang,17,9,8,2014
2014-08-09,Pahang,55,29,26,2014
2014-08-10,Pahang,109,32,77,2014
2014-08-11,Pahang,19,4,15,2014
2014-08-12,Pahang,19,3,16,2014
2014-08-13,Pahang,62,41,21,2014
2014-08-14,Pahang,65,36,29,2014
2014-08-15,Pahang,14,2,12,2014
2014-08-16,Pahang,0,0,0,2014
2014-08-17,Pahang,31,10,21,2014
2014-08-18,Pahang,12,2,10,2014
2014-08-19,Pahang,50,28,22,2014
2014-08-20,Pahang,3,0,3,2014
2014-08-21,Pahang,36,10,26,2014
2014-08-22,Pahang,21,8,13,2014
2014-08-23,Pahang,60,36,24,2014
2014-08-24,Pahang,42,16,26,2014
2014-08-25,Pahang,18,6,12,2014
2014-08-26,Pahang,61,27,34,2014
2014-08-27,Pahang,40,35,5,2014
2014-08-28,Pahang,62,46,16,2014
2014-08-29,Pahang,37,13,24,2014
2014-08-30,Pahang,27,12,15,2014
2014-08-31,Pahang,0,0,0,2014
2014-09-01,Pahang,0,0,0,2014
2014-09-02,Pahang,9,1,8,2014
2014-09-03,Pahang,47,33,14,2014
2014-09-04,Pahang,38,31,7,2014
2014-09-05,Pahang,60,19,41,2014
2014-09-06,Pahang,1,1,0,2014
2014-09-07,Pahang,92,24,68,2014
2014-09-08,Pahang,4,0,4,2014
2014-09-09,Pahang,103,82,21,2014
2014-09-10,Pahang,69,56,13,2014
2014-09-11,Pahang,73,52,21,2014
2014-09-12,Pahang,8,1,7,2014
2014-09-13,Pahang,198,149,49,2014
2014-09-14,Pahang,255,203,52,2014
2014-09-15,Pahang,9,3,6,2014
2014-09-16,Pahang,0,0,0,2014
2014-09-17,Pahang,78,63,15,2014
2014-09-18,Pahang,36,17,19,2014
2014-09-19,Pahang,6,0,6,2014
2014-09-20,Pahang,9,2,7,2014
2014-09-21,Pahang,91,25,66,2014
2014-09-22,Pahang,9,2,7,2014
2014-09-23,Pahang,70,32,38,2014
2014-09-24,Pahang,43,14,29,2014
2014-09-25,Pahang,8,1,7,2014
2014-09-26,Pahang,8,1,7,2014
2014-09-27,Pahang,12,3,9,2014
2014-09-28,Pahang,97,20,77,2014
2014-09-29,Pahang,24,11,13,2014
2014-09-30,Pahang,40,15,25,2014
2014-10-01,Pahang,67,47,20,2014
2014-10-02,Pahang,32,19,13,2014
2014-10-03,Pahang,6,0,6,2014
2014-10-04,Pahang,0,0,0,2014
2014-10-05,Pahang,0,0,0,2014
2014-10-06,Pahang,0,0,0,2014
2014-10-07,Pahang,1,0,1,2014
2014-10-08,Pahang,42,15,27,2014
2014-10-09,Pahang,25,10,15,2014
2014-10-10,Pahang,127,61,66,2014
2014-10-11,Pahang,48,31,17,2014
2014-10-12,Pahang,42,16,26,2014
2014-10-13,Pahang,4,1,3,2014
2014-10-14,Pahang,40,12,28,2014
2014-10-15,Pahang,27,13,14,2014
2014-10-16,Pahang,9,3,6,2014
2014-10-17,Pahang,6,1,5,2014
2014-10-18,Pahang,38,36,2,2014
2014-10-19,Pahang,94,20,74,2014
2014-10-20,Pahang,65,31,34,2014
2014-10-21,Pahang,9,6,3,2014
2014-10-22,Pahang,18,7,11,2014
2014-10-23,Pahang,7,1,6,2014
2014-10-24,Pahang,0,0,0,2014
2014-10-25,Pahang,35,9,26,2014
2014-10-26,Pahang,61,18,43,2014
2014-10-27,Pahang,4,1,3,2014
2014-10-28,Pahang,34,23,11,2014
2014-10-29,Pahang,38,29,9,2014
2014-10-30,Pahang,68,33,35,2014
2014-10-31,Pahang,13,5,8,2014
2014-11-01,Pahang,7,4,3,2014
2014-11-02,Pahang,28,5,23,2014
2014-11-03,Pahang,48,43,5,2014
2014-11-04,Pahang,27,8,19,2014
2014-11-05,Pahang,35,11,24,2014
2014-11-06,Pahang,42,17,25,2014
2014-11-07,Pahang,35,20,15,2014
2014-11-08,Pahang,30,9,21,2014
2014-11-09,Pahang,18,6,12,2014
2014-11-10,Pahang,3,0,3,2014
2014-11-11,Pahang,46,22,24,2014
2014-11-12,Pahang,112,48,64,2014
2014-11-13,Pahang,39,20,19,2014
2014-11-14,Pahang,91,52,39,2014
2014-11-15,Pahang,0,0,0,2014
2014-11-16,Pahang,39,1,38,2014
2014-11-17,Pahang,7,0,7,2014
2014-11-18,Pahang,38,25,13,2014
2014-11-19,Pahang,7,2,5,2014
2014-11-20,Pahang,10,1,9,2014
2014-11-21,Pahang,32,16,16,2014
2014-11-22,Pahang,41,17,24,2014
2014-11-23,Pahang,33,9,24,2014
2014-11-24,Pahang,6,1,5,2014
2014-11-25,Pahang,100,87,13,2014
2014-11-26,Pahang,18,10,8,2014
2014-11-27,Pahang,16,7,9,2014
2014-11-28,Pahang,23,7,16,2014
2014-11-29,Pahang,0,0,0,2014
2014-11-30,Pahang,8,4,4,2014
2014-12-01,Pahang,19,7,12,2014
2014-12-02,Pahang,15,4,11,2014
2014-12-03,Pahang,5,0,5,2014
2014-12-04,Pahang,47,12,35,2014
2014-12-05,Pahang,29,8,21,2014
2014-12-06,Pahang,7,3,4,2014
2014-12-07,Pahang,76,23,53,2014
2014-12-08,Pahang,26,8,18,2014
2014-12-09,Pahang,26,8,18,2014
2014-12-10,Pahang,60,21,39,2014
2014-12-11,Pahang,17,4,13,2014
2014-12-12,Pahang,7,2,5,2014
2014-12-13,Pahang,24,14,10,2014
2014-12-14,Pahang,73,54,19,2014
2014-12-15,Pahang,18,9,9,2014
2014-12-16,Pahang,16,1,15,2014
2014-12-17,Pahang,48,16,32,2014
2014-12-18,Pahang,30,9,21,2014
2014-12-19,Pahang,21,7,14,2014
2014-12-20,Pahang,41,18,23,2014
2014-12-21,Pahang,0,0,0,2014
2014-12-22,Pahang,11,2,9,2014
2014-12-23,Pahang,8,1,7,2014
2014-12-24,Pahang,19,7,12,2014
2014-12-25,Pahang,0,0,0,2014
2014-12-26,Pahang,8,1,7,2014
2014-12-27,Pahang,0,0,0,2014
2014-12-28,Pahang,0,0,0,2014
2014-12-29,Pahang,8,0,8,2014
2014-12-30,Pahang,3,0,3,2014
2014-12-31,Pahang,22,17,5,2014
2015-01-01,Pahang,27,8,19,2015
2015-01-02,Pahang,7,0,7,2015
2015-01-03,Pahang,25,7,18,2015
2015-01-04,Pahang,0,0,0,2015
2015-01-05,Pahang,14,3,11,2015
2015-01-06,Pahang,18,7,11,2015
2015-01-07,Pahang,60,32,28,2015
2015-01-08,Pahang,36,9,27,2015
2015-01-09,Pahang,11,3,8,2015
2015-01-10,Pahang,20,4,16,2015
2015-01-11,Pahang,40,9,31,2015
2015-01-12,Pahang,14,1,13,2015
2015-01-13,Pahang,8,1,7,2015
2015-01-14,Pahang,55,26,29,2015
2015-01-15,Pahang,19,7,12,2015
2015-01-16,Pahang,9,2,7,2015
2015-01-17,Pahang,91,71,20,2015
2015-01-18,Pahang,0,0,0,2015
2015-01-19,Pahang,4,0,4,2015
2015-01-20,Pahang,7,0,7,2015
2015-01-21,Pahang,15,11,4,2015
2015-01-22,Pahang,31,9,22,2015
2015-01-23,Pahang,19,5,14,2015
2015-01-24,Pahang,107,95,12,2015
2015-01-25,Pahang,0,0,0,2015
2015-01-26,Pahang,3,2,1,2015
2015-01-27,Pahang,57,31,26,2015
2015-01-28,Pahang,10,1,9,2015
2015-01-29,Pahang,38,29,9,2015
2015-01-30,Pahang,10,4,6,2015
2015-01-31,Pahang,234,154,80,2015
2015-02-01,Pahang,281,182,99,2015
2015-02-02,Pahang,7,2,5,2015
2015-02-03,Pahang,70,26,44,2015
2015-02-04,Pahang,22,6,16,2015
2015-02-05,Pahang,3,2,1,2015
2015-02-06,Pahang,11,2,9,2015
2015-02-07,Pahang,10,10,0,2015
2015-02-08,Pahang,17,9,8,2015
2015-02-09,Pahang,13,2,11,2015
2015-02-10,Pahang,31,12,19,2015
2015-02-11,Pahang,13,5,8,2015
2015-02-12,Pahang,5,1,4,2015
2015-02-13,Pahang,39,30,9,2015
2015-02-14,Pahang,49,35,14,2015
2015-02-15,Pahang,6,2,4,2015
2015-02-16,Pahang,32,16,16,2015
2015-02-17,Pahang,24,10,14,2015
2015-02-18,Pahang,70,22,48,2015
2015-02-19,Pahang,0,0,0,2015
2015-02-20,Pahang,0,0,0,2015
2015-02-21,Pahang,0,0,0,2015
2015-02-22,Pahang,14,5,9,2015
2015-02-23,Pahang,8,2,6,2015
2015-02-24,Pahang,20,4,16,2015
2015-02-25,Pahang,3,1,2,2015
2015-02-26,Pahang,34,12,22,2015
2015-02-27,Pahang,90,23,67,2015
2015-02-28,Pahang,38,10,28,2015
2015-03-01,Pahang,55,9,46,2015
2015-03-02,Pahang,18,4,14,2015
2015-03-03,Pahang,82,41,41,2015
2015-03-04,Pahang,11,6,5,2015
2015-03-05,Pahang,87,59,28,2015
2015-03-06,Pahang,13,4,9,2015
2015-03-07,Pahang,23,9,14,2015
2015-03-08,Pahang,96,12,84,2015
2015-03-09,Pahang,3,1,2,2015
2015-03-10,Pahang,44,36,8,2015
2015-03-11,Pahang,54,21,33,2015
2015-03-12,Pahang,121,24,97,2015
2015-03-13,Pahang,102,53,49,2015
2015-03-14,Pahang,22,11,11,2015
2015-03-15,Pahang,34,9,25,2015
2015-03-16,Pahang,4,1,3,2015
2015-03-17,Pahang,7,1,6,2015
2015-03-18,Pahang,103,46,57,2015
2015-03-19,Pahang,57,28,29,2015
2015-03-20,Pahang,8,2,6,2015
2015-03-21,Pahang,0,0,0,2015
2015-03-22,Pahang,157,40,117,2015
2015-03-23,Pahang,5,1,4,2015
2015-03-24,Pahang,18,12,6,2015
2015-03-25,Pahang,64,28,36,2015
2015-03-26,Pahang,31,21,10,2015
2015-03-27,Pahang,9,2,7,2015
2015-03-28,Pahang,10,3,7,2015
2015-03-29,Pahang,16,6,10,2015
2015-03-30,Pahang,4,1,3,2015
2015-03-31,Pahang,57,19,38,2015
2015-04-01,Pahang,46,20,26,2015
2015-04-02,Pahang,41,25,16,2015
2015-04-03,Pahang,45,21,24,2015
2015-04-04,Pahang,3,1,2,2015
2015-04-05,Pahang,0,0,0,2015
2015-04-06,Pahang,11,2,9,2015
2015-04-07,Pahang,24,18,6,2015
2015-04-08,Pahang,33,21,12,2015
2015-04-09,Pahang,33,15,18,2015
2015-04-10,Pahang,30,10,20,2015
2015-04-11,Pahang,23,5,18,2015
2015-04-12,Pahang,20,4,16,2015
2015-04-13,Pahang,1,0,1,2015
2015-04-14,Pahang,7,0,7,2015
2015-04-15,Pahang,59,33,26,2015
2015-04-16,Pahang,8,1,7,2015
2015-04-17,Pahang,30,15,15,2015
2015-04-18,Pahang,0,0,0,2015
2015-04-19,Pahang,101,29,72,2015
2015-04-20,Pahang,8,0,8,2015
2015-04-21,Pahang,43,16,27,2015
2015-04-22,Pahang,10,2,8,2015
2015-04-23,Pahang,103,88,15,2015
2015-04-24,Pahang,3,1,2,2015
2015-04-25,Pahang,13,7,6,2015
2015-04-26,Pahang,70,22,48,2015
2015-04-27,Pahang,24,12,12,2015
2015-04-28,Pahang,38,27,11,2015
2015-04-29,Pahang,10,1,9,2015
2015-04-30,Pahang,3,1,2,2015
2015-05-01,Pahang,46,10,36,2015
2015-05-02,Pahang,0,0,0,2015
2015-05-03,Pahang,0,0,0,2015
2015-05-04,Pahang,0,0,0,2015
2015-05-05,Pahang,17,12,5,2015
2015-05-06,Pahang,34,18,16,2015
2015-05-07,Pahang,35,5,30,2015
2015-05-08,Pahang,67,20,47,2015
2015-05-09,Pahang,0,0,0,2015
2015-05-10,Pahang,119,33,86,2015
2015-05-11,Pahang,19,5,14,2015
2015-05-12,Pahang,39,16,23,2015
2015-05-13,Pahang,40,23,17,2015
2015-05-14,Pahang,2,0,2,2015
2015-05-15,Pahang,6,2,4,2015
2015-05-16,Pahang,28,11,17,2015
2015-05-17,Pahang,14,7,7,2015
2015-05-18,Pahang,20,7,13,2015
2015-05-19,Pahang,75,28,47,2015
2015-05-20,Pahang,7,0,7,2015
2015-05-21,Pahang,17,7,10,2015
2015-05-22,Pahang,6,0,6,2015
2015-05-23,Pahang,5,4,1,2015
2015-05-24,Pahang,80,29,51,2015
2015-05-25,Pahang,6,4,2,2015
2015-05-26,Pahang,78,27,51,2015
2015-05-27,Pahang,79,32,47,2015
2015-05-28,Pahang,13,6,7,2015
2015-05-29,Pahang,25,8,17,2015
2015-05-30,Pahang,9,3,6,2015
2015-05-31,Pahang,76,30,46,2015
2015-06-01,Pahang,10,0,10,2015
2015-06-02,Pahang,25,19,6,2015
2015-06-03,Pahang,39,5,34,2015
2015-06-04,Pahang,12,4,8,2015
2015-06-05,Pahang,2,1,1,2015
2015-06-06,Pahang,5,1,4,2015
2015-06-07,Pahang,105,35,70,2015
2015-06-08,Pahang,4,0,4,2015
2015-06-09,Pahang,11,5,6,2015
2015-06-10,Pahang,35,22,13,2015
2015-06-11,Pahang,45,21,24,2015
2015-06-12,Pahang,6,1,5,2015
2015-06-13,Pahang,65,33,32,2015
2015-06-14,Pahang,136,65,71,2015
2015-06-15,Pahang,27,10,17,2015
2015-06-16,Pahang,28,21,7,2015
2015-06-17,Pahang,40,11,29,2015
2015-06-18,Pahang,4,0,4,2015
2015-06-19,Pahang,3,0,3,2015
2015-06-20,Pahang,0,0,0,2015
2015-06-21,Pahang,22,5,17,2015
2015-06-22,Pahang,14,8,6,2015
2015-06-23,Pahang,4,0,4,2015
2015-06-24,Pahang,11,4,7,2015
2015-06-25,Pahang,7,1,6,2015
2015-06-26,Pahang,28,10,18,2015
2015-06-27,Pahang,0,0,0,2015
2015-06-28,Pahang,41,10,31,2015
2015-06-29,Pahang,10,1,9,2015
2015-06-30,Pahang,35,27,8,2015
2015-07-01,Pahang,50,38,12,2015
2015-07-02,Pahang,71,56,15,2015
2015-07-03,Pahang,1,0,1,2015
2015-07-04,Pahang,61,11,50,2015
2015-07-05,Pahang,70,10,60,2015
2015-07-06,Pahang,2,0,2,2015
2015-07-07,Pahang,48,26,22,2015
2015-07-08,Pahang,12,5,7,2015
2015-07-09,Pahang,2,0,2,2015
2015-07-10,Pahang,14,5,9,2015
2015-07-11,Pahang,91,23,68,2015
2015-07-12,Pahang,114,35,79,2015
2015-07-13,Pahang,6,0,6,2015
2015-07-14,Pahang,70,25,45,2015
2015-07-15,Pahang,24,6,18,2015
2015-07-16,Pahang,0,0,0,2015
2015-07-17,Pahang,0,0,0,2015
2015-07-18,Pahang,0,0,0,2015
2015-07-19,Pahang,0,0,0,2015
2015-07-20,Pahang,26,7,19,2015
2015-07-21,Pahang,29,13,16,2015
2015-07-22,Pahang,73,47,26,2015
2015-07-23,Pahang,71,51,20,2015
2015-07-24,Pahang,51,22,29,2015
2015-07-25,Pahang,14,4,10,2015
2015-07-26,Pahang,18,5,13,2015
2015-07-27,Pahang,103,35,68,2015
2015-07-28,Pahang,63,46,17,2015
2015-07-29,Pahang,56,38,18,2015
2015-07-30,Pahang,19,9,10,2015
2015-07-31,Pahang,4,0,4,2015
2015-08-01,Pahang,0,0,0,2015
2015-08-02,Pahang,108,39,69,2015
2015-08-03,Pahang,17,6,11,2015
2015-08-04,Pahang,36,6,30,2015
2015-08-05,Pahang,63,48,15,2015
2015-08-06,Pahang,103,58,45,2015
2015-08-07,Pahang,5,0,5,2015
2015-08-08,Pahang,15,6,9,2015
2015-08-09,Pahang,25,6,19,2015
2015-08-10,Pahang,5,1,4,2015
2015-08-11,Pahang,4,0,4,2015
2015-08-12,Pahang,200,164,36,2015
2015-08-13,Pahang,8,0,8,2015
2015-08-14,Pahang,9,1,8,2015
2015-08-15,Pahang,21,16,5,2015
2015-08-16,Pahang,19,7,12,2015
2015-08-17,Pahang,22,15,7,2015
2015-08-18,Pahang,53,32,21,2015
2015-08-19,Pahang,96,68,28,2015
2015-08-20,Pahang,21,8,13,2015
2015-08-21,Pahang,43,29,14,2015
2015-08-22,Pahang,42,18,24,2015
2015-08-23,Pahang,75,29,46,2015
2015-08-24,Pahang,31,22,9,2015
2015-08-25,Pahang,128,59,69,2015
2015-08-26,Pahang,2,0,2,2015
2015-08-27,Pahang,113,97,16,2015
2015-08-28,Pahang,4,1,3,2015
2015-08-29,Pahang,4,1,3,2015
2015-08-30,Pahang,86,18,68,2015
2015-08-31,Pahang,0,0,0,2015
2015-09-01,Pahang,44,31,13,2015
2015-09-02,Pahang,53,12,41,2015
2015-09-03,Pahang,83,34,49,2015
2015-09-04,Pahang,76,41,35,2015
2015-09-05,Pahang,13,5,8,2015
2015-09-06,Pahang,49,8,41,2015
2015-09-07,Pahang,36,21,15,2015
2015-09-08,Pahang,45,25,20,2015
2015-09-09,Pahang,17,2,15,2015
2015-09-10,Pahang,36,29,7,2015
2015-09-11,Pahang,18,5,13,2015
2015-09-12,Pahang,76,41,35,2015
2015-09-13,Pahang,36,12,24,2015
2015-09-14,Pahang,9,1,8,2015
2015-09-15,Pahang,59,27,32,2015
2015-09-16,Pahang,23,9,14,2015
2015-09-17,Pahang,25,16,9,2015
2015-09-18,Pahang,4,1,3,2015
2015-09-19,Pahang,35,15,20,2015
2015-09-20,Pahang,68,21,47,2015
2015-09-21,Pahang,8,1,7,2015
2015-09-22,Pahang,13,5,8,2015
2015-09-23,Pahang,4,1,3,2015
2015-09-24,Pahang,0,0,0,2015
2015-09-25,Pahang,1,0,1,2015
2015-09-26,Pahang,0,0,0,2015
2015-09-27,Pahang,0,0,0,2015
2015-09-28,Pahang,9,0,9,2015
2015-09-29,Pahang,36,13,23,2015
2015-09-30,Pahang,17,5,12,2015
2015-10-01,Pahang,22,7,15,2015
2015-10-02,Pahang,5,1,4,2015
2015-10-03,Pahang,2,0,2,2015
2015-10-04,Pahang,12,6,6,2015
2015-10-05,Pahang,7,1,6,2015
2015-10-06,Pahang,14,8,6,2015
2015-10-07,Pahang,41,30,11,2015
2015-10-08,Pahang,30,15,15,2015
2015-10-09,Pahang,28,10,18,2015
2015-10-10,Pahang,90,49,41,2015
2015-10-11,Pahang,60,25,35,2015
2015-10-12,Pahang,5,0,5,2015
2015-10-13,Pahang,3,0,3,2015
2015-10-14,Pahang,41,23,18,2015
2015-10-15,Pahang,13,2,11,2015
2015-10-16,Pahang,4,0,4,2015
2015-10-17,Pahang,37,18,19,2015
2015-10-18,Pahang,74,17,57,2015
2015-10-19,Pahang,6,2,4,2015
2015-10-20,Pahang,49,22,27,2015
2015-10-21,Pahang,56,46,10,2015
2015-10-22,Pahang,53,10,43,2015
2015-10-23,Pahang,10,0,10,2015
2015-10-24,Pahang,40,7,33,2015
2015-10-25,Pahang,21,8,13,2015
2015-10-26,Pahang,4,1,3,2015
2015-10-27,Pahang,54,15,39,2015
2015-10-28,Pahang,6,1,5,2015
2015-10-29,Pahang,44,24,20,2015
2015-10-30,Pahang,3,0,3,2015
2015-10-31,Pahang,0,0,0,2015
2015-11-01,Pahang,27,13,14,2015
2015-11-02,Pahang,48,11,37,2015
2015-11-03,Pahang,3,1,2,2015
2015-11-04,Pahang,10,4,6,2015
2015-11-05,Pahang,1,0,1,2015
2015-11-06,Pahang,19,7,12,2015
2015-11-07,Pahang,0,0,0,2015
2015-11-08,Pahang,24,15,9,2015
2015-11-09,Pahang,18,9,9,2015
2015-11-10,Pahang,20,6,14,2015
2015-11-11,Pahang,24,20,4,2015
2015-11-12,Pahang,65,12,53,2015
2015-11-13,Pahang,10,0,10,2015
2015-11-14,Pahang,9,4,5,2015
2015-11-15,Pahang,27,4,23,2015
2015-11-16,Pahang,8,1,7,2015
2015-11-17,Pahang,50,21,29,2015
2015-11-18,Pahang,40,24,16,2015
2015-11-19,Pahang,76,28,48,2015
2015-11-20,Pahang,70,18,52,2015
2015-11-21,Pahang,20,7,13,2015
2015-11-22,Pahang,10,1,9,2015
2015-11-23,Pahang,15,4,11,2015
2015-11-24,Pahang,40,13,27,2015
2015-11-25,Pahang,40,22,18,2015
2015-11-26,Pahang,52,20,32,2015
2015-11-27,Pahang,6,2,4,2015
2015-11-28,Pahang,0,0,0,2015
2015-11-29,Pahang,27,5,22,2015
2015-11-30,Pahang,7,1,6,2015
2015-12-01,Pahang,19,4,15,2015
2015-12-02,Pahang,23,5,18,2015
2015-12-03,Pahang,50,21,29,2015
2015-12-04,Pahang,5,2,3,2015
2015-12-05,Pahang,23,8,15,2015
2015-12-06,Pahang,18,11,7,2015
2015-12-07,Pahang,16,2,14,2015
2015-12-08,Pahang,57,41,16,2015
2015-12-09,Pahang,37,23,14,2015
2015-12-10,Pahang,14,7,7,2015
2015-12-11,Pahang,61,17,44,2015
2015-12-12,Pahang,24,12,12,2015
2015-12-13,Pahang,89,29,60,2015
2015-12-14,Pahang,9,2,7,2015
2015-12-15,Pahang,40,18,22,2015
2015-12-16,Pahang,16,5,11,2015
2015-12-17,Pahang,77,51,26,2015
2015-12-18,Pahang,7,4,3,2015
2015-12-19,Pahang,3,1,2,2015
2015-12-20,Pahang,63,11,52,2015
2015-12-21,Pahang,11,0,11,2015
2015-12-22,Pahang,26,6,20,2015
2015-12-23,Pahang,43,18,25,2015
2015-12-24,Pahang,12,4,8,2015
2015-12-25,Pahang,34,8,26,2015
2015-12-26,Pahang,4,1,3,2015
2015-12-27,Pahang,64,17,47,2015
2015-12-28,Pahang,8,3,5,2015
2015-12-29,Pahang,6,0,6,2015
2015-12-30,Pahang,9,3,6,2015
2015-12-31,Pahang,5,1,4,2015
2016-01-01,Pahang,82,16,66,2016
2016-01-02,Pahang,10,1,9,2016
2016-01-03,Pahang,14,4,10,2016
2016-01-04,Pahang,10,1,9,2016
2016-01-05,Pahang,4,0,4,2016
2016-01-06,Pahang,41,9,32,2016
2016-01-07,Pahang,47,11,36,2016
2016-01-08,Pahang,7,2,5,2016
2016-01-09,Pahang,22,6,16,2016
2016-01-10,Pahang,32,8,24,2016
2016-01-11,Pahang,106,44,62,2016
2016-01-12,Pahang,28,6,22,2016
2016-01-13,Pahang,58,28,30,2016
2016-01-14,Pahang,68,27,41,2016
2016-01-15,Pahang,29,18,11,2016
2016-01-16,Pahang,66,36,30,2016
2016-01-17,Pahang,132,49,83,2016
2016-01-18,Pahang,93,49,44,2016
2016-01-19,Pahang,13,2,11,2016
2016-01-20,Pahang,70,24,46,2016
2016-01-21,Pahang,93,42,51,2016
2016-01-22,Pahang,2,1,1,2016
2016-01-23,Pahang,17,6,11,2016
2016-01-24,Pahang,54,13,41,2016
2016-01-25,Pahang,5,1,4,2016
2016-01-26,Pahang,0,0,0,2016
2016-01-27,Pahang,39,22,17,2016
2016-01-28,Pahang,54,28,26,2016
2016-01-29,Pahang,10,2,8,2016
2016-01-30,Pahang,5,3,2,2016
2016-01-31,Pahang,0,0,0,2016
2016-02-01,Pahang,15,7,8,2016
2016-02-02,Pahang,22,6,16,2016
2016-02-03,Pahang,14,7,7,2016
2016-02-04,Pahang,4,2,2,2016
2016-02-05,Pahang,40,14,26,2016
2016-02-06,Pahang,0,0,0,2016
2016-02-07,Pahang,18,4,14,2016
2016-02-08,Pahang,0,0,0,2016
2016-02-09,Pahang,0,0,0,2016
2016-02-10,Pahang,17,6,11,2016
2016-02-11,Pahang,36,15,21,2016
2016-02-12,Pahang,9,1,8,2016
2016-02-13,Pahang,30,26,4,2016
2016-02-14,Pahang,22,11,11,2016
2016-02-15,Pahang,8,1,7,2016
2016-02-16,Pahang,28,3,25,2016
2016-02-17,Pahang,92,52,40,2016
2016-02-18,Pahang,17,7,10,2016
2016-02-19,Pahang,11,3,8,2016
2016-02-20,Pahang,13,5,8,2016
2016-02-21,Pahang,32,11,21,2016
2016-02-22,Pahang,11,3,8,2016
2016-02-23,Pahang,71,20,51,2016
2016-02-24,Pahang,14,8,6,2016
2016-02-25,Pahang,9,2,7,2016
2016-02-26,Pahang,4,0,4,2016
2016-02-27,Pahang,37,6,31,2016
2016-02-28,Pahang,22,11,11,2016
2016-02-29,Pahang,16,4,12,2016
2016-03-01,Pahang,3,0,3,2016
2016-03-02,Pahang,47,19,28,2016
2016-03-03,Pahang,87,52,35,2016
2016-03-04,Pahang,8,0,8,2016
2016-03-05,Pahang,94,48,46,2016
2016-03-06,Pahang,28,5,23,2016
2016-03-07,Pahang,19,8,11,2016
2016-03-08,Pahang,7,1,6,2016
2016-03-09,Pahang,63,18,45,2016
2016-03-10,Pahang,81,48,33,2016
2016-03-11,Pahang,54,44,10,2016
2016-03-12,Pahang,0,0,0,2016
2016-03-13,Pahang,51,5,46,2016
2016-03-14,Pahang,3,1,2,2016
2016-03-15,Pahang,33,18,15,2016
2016-03-16,Pahang,5,1,4,2016
2016-03-17,Pahang,42,13,29,2016
2016-03-18,Pahang,12,1,11,2016
2016-03-19,Pahang,62,21,41,2016
2016-03-20,Pahang,10,3,7,2016
2016-03-21,Pahang,12,5,7,2016
2016-03-22,Pahang,7,0,7,2016
2016-03-23,Pahang,42,23,19,2016
2016-03-24,Pahang,90,11,79,2016
2016-03-25,Pahang,7,2,5,2016
2016-03-26,Pahang,8,7,1,2016
2016-03-27,Pahang,59,10,49,2016
2016-03-28,Pahang,5,1,4,2016
2016-03-29,Pahang,13,7,6,2016
2016-03-30,Pahang,31,17,14,2016
2016-03-31,Pahang,39,14,25,2016
2016-04-01,Pahang,7,0,7,2016
2016-04-02,Pahang,10,3,7,2016
2016-04-03,Pahang,0,0,0,2016
2016-04-04,Pahang,9,1,8,2016
2016-04-05,Pahang,41,23,18,2016
2016-04-06,Pahang,122,54,68,2016
2016-04-07,Pahang,15,8,7,2016
2016-04-08,Pahang,24,9,15,2016
2016-04-09,Pahang,15,8,7,2016
2016-04-10,Pahang,30,12,18,2016
2016-04-11,Pahang,7,0,7,2016
2016-04-12,Pahang,51,21,30,2016
2016-04-13,Pahang,8,0,8,2016
2016-04-14,Pahang,32,15,17,2016
2016-04-15,Pahang,7,1,6,2016
2016-04-16,Pahang,27,11,16,2016
2016-04-17,Pahang,120,25,95,2016
2016-04-18,Pahang,6,2,4,2016
2016-04-19,Pahang,55,18,37,2016
2016-04-20,Pahang,16,7,9,2016
2016-04-21,Pahang,18,7,11,2016
2016-04-22,Pahang,16,9,7,2016
2016-04-23,Pahang,0,0,0,2016
2016-04-24,Pahang,92,22,70,2016
2016-04-25,Pahang,5,1,4,2016
2016-04-26,Pahang,95,27,68,2016
2016-04-27,Pahang,25,13,12,2016
2016-04-28,Pahang,25,13,12,2016
2016-04-29,Pahang,8,3,5,2016
2016-04-30,Pahang,26,15,11,2016
2016-05-01,Pahang,53,15,38,2016
2016-05-02,Pahang,0,0,0,2016
2016-05-03,Pahang,4,0,4,2016
2016-05-04,Pahang,86,21,65,2016
2016-05-05,Pahang,7,2,5,2016
2016-05-06,Pahang,20,5,15,2016
2016-05-07,Pahang,39,7,32,2016
2016-05-08,Pahang,102,18,84,2016
2016-05-09,Pahang,6,1,5,2016
2016-05-10,Pahang,42,17,25,2016
2016-05-11,Pahang,35,14,21,2016
2016-05-12,Pahang,27,15,12,2016
2016-05-13,Pahang,3,0,3,2016
2016-05-14,Pahang,0,0,0,2016
2016-05-15,Pahang,137,36,101,2016
2016-05-16,Pahang,18,5,13,2016
2016-05-17,Pahang,30,9,21,2016
2016-05-18,Pahang,26,6,20,2016
2016-05-19,Pahang,41,15,26,2016
2016-05-20,Pahang,4,1,3,2016
2016-05-21,Pahang,57,43,14,2016
2016-05-22,Pahang,24,5,19,2016
2016-05-23,Pahang,34,11,23,2016
2016-05-24,Pahang,52,17,35,2016
2016-05-25,Pahang,5,0,5,2016
2016-05-26,Pahang,11,4,7,2016
2016-05-27,Pahang,40,20,20,2016
2016-05-28,Pahang,11,4,7,2016
2016-05-29,Pahang,84,29,55,2016
2016-05-30,Pahang,11,1,10,2016
2016-05-31,Pahang,8,0,8,2016
2016-06-01,Pahang,15,4,11,2016
2016-06-02,Pahang,20,4,16,2016
2016-06-03,Pahang,34,9,25,2016
2016-06-04,Pahang,30,8,22,2016
2016-06-05,Pahang,72,20,52,2016
2016-06-06,Pahang,4,0,4,2016
2016-06-07,Pahang,1,1,0,2016
2016-06-08,Pahang,8,1,7,2016
2016-06-09,Pahang,5,0,5,2016
2016-06-10,Pahang,0,0,0,2016
2016-06-11,Pahang,0,0,0,2016
2016-06-12,Pahang,66,14,52,2016
2016-06-13,Pahang,1,0,1,2016
2016-06-14,Pahang,1,0,1,2016
2016-06-15,Pahang,24,7,17,2016
2016-06-16,Pahang,0,0,0,2016
2016-06-17,Pahang,13,4,9,2016
2016-06-18,Pahang,0,0,0,2016
2016-06-19,Pahang,38,18,20,2016
2016-06-20,Pahang,2,0,2,2016
2016-06-21,Pahang,24,5,19,2016
2016-06-22,Pahang,5,1,4,2016
2016-06-23,Pahang,10,6,4,2016
2016-06-24,Pahang,13,6,7,2016
2016-06-25,Pahang,14,1,13,2016
2016-06-26,Pahang,51,12,39,2016
2016-06-27,Pahang,1,0,1,2016
2016-06-28,Pahang,7,0,7,2016
2016-06-29,Pahang,29,19,10,2016
2016-06-30,Pahang,39,15,24,2016
2016-07-01,Pahang,46,9,37,2016
2016-07-02,Pahang,60,9,51,2016
2016-07-03,Pahang,72,22,50,2016
2016-07-04,Pahang,24,7,17,2016
2016-07-05,Pahang,0,0,0,2016
2016-07-06,Pahang,0,0,0,2016
2016-07-07,Pahang,0,0,0,2016
2016-07-08,Pahang,5,2,3,2016
2016-07-09,Pahang,0,0,0,2016
2016-07-10,Pahang,0,0,0,2016
2016-07-11,Pahang,19,3,16,2016
2016-07-12,Pahang,67,29,38,2016
2016-07-13,Pahang,37,26,11,2016
2016-07-14,Pahang,22,8,14,2016
2016-07-15,Pahang,3,0,3,2016
2016-07-16,Pahang,11,4,7,2016
2016-07-17,Pahang,10,4,6,2016
2016-07-18,Pahang,20,7,13,2016
2016-07-19,Pahang,56,16,40,2016
2016-07-20,Pahang,37,20,17,2016
2016-07-21,Pahang,10,2,8,2016
2016-07-22,Pahang,7,1,6,2016
2016-07-23,Pahang,9,3,6,2016
2016-07-24,Pahang,57,17,40,2016
2016-07-25,Pahang,90,25,65,2016
2016-07-26,Pahang,24,4,20,2016
2016-07-27,Pahang,87,45,42,2016
2016-07-28,Pahang,7,1,6,2016
2016-07-29,Pahang,103,59,44,2016
2016-07-30,Pahang,6,1,5,2016
2016-07-31,Pahang,113,32,81,2016
2016-08-01,Pahang,3,0,3,2016
2016-08-02,Pahang,34,16,18,2016
2016-08-03,Pahang,42,21,21,2016
2016-08-04,Pahang,50,18,32,2016
2016-08-05,Pahang,21,4,17,2016
2016-08-06,Pahang,32,10,22,2016
2016-08-07,Pahang,110,18,92,2016
2016-08-08,Pahang,8,0,8,2016
2016-08-09,Pahang,25,7,18,2016
2016-08-10,Pahang,50,32,18,2016
2016-08-11,Pahang,87,45,42,2016
2016-08-12,Pahang,19,9,10,2016
2016-08-13,Pahang,47,33,14,2016
2016-08-14,Pahang,69,53,16,2016
2016-08-15,Pahang,23,8,15,2016
2016-08-16,Pahang,52,27,25,2016
2016-08-17,Pahang,56,42,14,2016
2016-08-18,Pahang,34,22,12,2016
2016-08-19,Pahang,20,8,12,2016
2016-08-20,Pahang,46,18,28,2016
2016-08-21,Pahang,43,21,22,2016
2016-08-22,Pahang,8,3,5,2016
2016-08-23,Pahang,9,1,8,2016
2016-08-24,Pahang,39,30,9,2016
2016-08-25,Pahang,99,47,52,2016
2016-08-26,Pahang,5,2,3,2016
2016-08-27,Pahang,28,24,4,2016
2016-08-28,Pahang,76,21,55,2016
2016-08-29,Pahang,24,6,18,2016
2016-08-30,Pahang,128,95,33,2016
2016-08-31,Pahang,0,0,0,2016
2016-09-01,Pahang,71,34,37,2016
2016-09-02,Pahang,9,0,9,2016
2016-09-03,Pahang,0,0,0,2016
2016-09-04,Pahang,55,7,48,2016
2016-09-05,Pahang,14,3,11,2016
2016-09-06,Pahang,32,19,13,2016
2016-09-07,Pahang,58,37,21,2016
2016-09-08,Pahang,48,41,7,2016
2016-09-09,Pahang,26,7,19,2016
2016-09-10,Pahang,8,3,5,2016
2016-09-11,Pahang,0,0,0,2016
2016-09-12,Pahang,0,0,0,2016
2016-09-13,Pahang,4,2,2,2016
2016-09-14,Pahang,44,26,18,2016
2016-09-15,Pahang,4,0,4,2016
2016-09-16,Pahang,6,4,2,2016
2016-09-17,Pahang,8,3,5,2016
2016-09-18,Pahang,97,26,71,2016
2016-09-19,Pahang,30,8,22,2016
2016-09-20,Pahang,79,62,17,2016
2016-09-21,Pahang,5,0,5,2016
2016-09-22,Pahang,35,17,18,2016
2016-09-23,Pahang,13,1,12,2016
2016-09-24,Pahang,8,2,6,2016
2016-09-25,Pahang,43,10,33,2016
2016-09-26,Pahang,10,3,7,2016
2016-09-27,Pahang,11,3,8,2016
2016-09-28,Pahang,119,32,87,2016
2016-09-29,Pahang,19,17,2,2016
2016-09-30,Pahang,12,1,11,2016
2016-10-01,Pahang,6,4,2,2016
2016-10-02,Pahang,35,14,21,2016
2016-10-03,Pahang,0,0,0,2016
2016-10-04,Pahang,4,0,4,2016
2016-10-05,Pahang,76,43,33,2016
2016-10-06,Pahang,26,12,14,2016
2016-10-07,Pahang,8,1,7,2016
2016-10-08,Pahang,2,0,2,2016
2016-10-09,Pahang,64,20,44,2016
2016-10-10,Pahang,11,0,11,2016
2016-10-11,Pahang,49,11,38,2016
2016-10-12,Pahang,76,45,31,2016
2016-10-13,Pahang,41,28,13,2016
2016-10-14,Pahang,12,2,10,2016
2016-10-15,Pahang,44,16,28,2016
2016-10-16,Pahang,99,16,83,2016
2016-10-17,Pahang,7,0,7,2016
2016-10-18,Pahang,42,15,27,2016
2016-10-19,Pahang,27,17,10,2016
2016-10-20,Pahang,34,9,25,2016
2016-10-21,Pahang,17,1,16,2016
2016-10-22,Pahang,16,15,1,2016
2016-10-23,Pahang,16,2,14,2016
2016-10-24,Pahang,22,7,15,2016
2016-10-25,Pahang,7,0,7,2016
2016-10-26,Pahang,3,0,3,2016
2016-10-27,Pahang,19,4,15,2016
2016-10-28,Pahang,8,2,6,2016
2016-10-29,Pahang,37,15,22,2016
2016-10-30,Pahang,44,25,19,2016
2016-10-31,Pahang,7,0,7,2016
2016-11-01,Pahang,13,2,11,2016
2016-11-02,Pahang,35,19,16,2016
2016-11-03,Pahang,68,29,39,2016
2016-11-04,Pahang,27,7,20,2016
2016-11-05,Pahang,1,0,1,2016
2016-11-06,Pahang,111,29,82,2016
2016-11-07,Pahang,9,3,6,2016
2016-11-08,Pahang,14,3,11,2016
2016-11-09,Pahang,19,15,4,2016
2016-11-10,Pahang,21,7,14,2016
2016-11-11,Pahang,48,16,32,2016
2016-11-12,Pahang,8,2,6,2016
2016-11-13,Pahang,83,16,67,2016
2016-11-14,Pahang,7,0,7,2016
2016-11-15,Pahang,9,1,8,2016
2016-11-16,Pahang,37,13,24,2016
2016-11-17,Pahang,34,17,17,2016
2016-11-18,Pahang,26,6,20,2016
2016-11-19,Pahang,31,15,16,2016
2016-11-20,Pahang,70,16,54,2016
2016-11-21,Pahang,3,0,3,2016
2016-11-22,Pahang,35,5,30,2016
2016-11-23,Pahang,8,2,6,2016
2016-11-24,Pahang,7,1,6,2016
2016-11-25,Pahang,23,5,18,2016
2016-11-26,Pahang,19,12,7,2016
2016-11-27,Pahang,37,6,31,2016
2016-11-28,Pahang,2,0,2,2016
2016-11-29,Pahang,40,9,31,2016
2016-11-30,Pahang,32,15,17,2016
2016-12-01,Pahang,6,1,5,2016
2016-12-02,Pahang,4,2,2,2016
2016-12-03,Pahang,0,0,0,2016
2016-12-04,Pahang,37,7,30,2016
2016-12-05,Pahang,8,0,8,2016
2016-12-06,Pahang,7,2,5,2016
2016-12-07,Pahang,46,15,31,2016
2016-12-08,Pahang,33,11,22,2016
2016-12-09,Pahang,4,0,4,2016
2016-12-10,Pahang,115,82,33,2016
2016-12-11,Pahang,125,76,49,2016
2016-12-12,Pahang,0,0,0,2016
2016-12-13,Pahang,3,1,2,2016
2016-12-14,Pahang,37,17,20,2016
2016-12-15,Pahang,24,6,18,2016
2016-12-16,Pahang,9,2,7,2016
2016-12-17,Pahang,5,2,3,2016
2016-12-18,Pahang,77,30,47,2016
2016-12-19,Pahang,10,2,8,2016
2016-12-20,Pahang,3,0,3,2016
2016-12-21,Pahang,27,7,20,2016
2016-12-22,Pahang,52,25,27,2016
2016-12-23,Pahang,7,0,7,2016
2016-12-24,Pahang,33,6,27,2016
2016-12-25,Pahang,25,2,23,2016
2016-12-26,Pahang,7,1,6,2016
2016-12-27,Pahang,6,0,6,2016
2016-12-28,Pahang,63,35,28,2016
2016-12-29,Pahang,15,2,13,2016
2016-12-30,Pahang,13,0,13,2016
2016-12-31,Pahang,0,0,0,2016
2017-01-01,Pahang,45,14,31,2017
2017-01-02,Pahang,0,0,0,2017
2017-01-03,Pahang,7,0,7,2017
2017-01-04,Pahang,24,16,8,2017
2017-01-05,Pahang,26,17,9,2017
2017-01-06,Pahang,8,1,7,2017
2017-01-07,Pahang,22,9,13,2017
2017-01-08,Pahang,34,10,24,2017
2017-01-09,Pahang,6,1,5,2017
2017-01-10,Pahang,6,0,6,2017
2017-01-11,Pahang,132,47,85,2017
2017-01-12,Pahang,15,4,11,2017
2017-01-13,Pahang,1,0,1,2017
2017-01-14,Pahang,20,8,12,2017
2017-01-15,Pahang,90,14,76,2017
2017-01-16,Pahang,1,0,1,2017
2017-01-17,Pahang,35,16,19,2017
2017-01-18,Pahang,127,37,90,2017
2017-01-19,Pahang,10,1,9,2017
2017-01-20,Pahang,8,0,8,2017
2017-01-21,Pahang,6,3,3,2017
2017-01-22,Pahang,20,3,17,2017
2017-01-23,Pahang,10,3,7,2017
2017-01-24,Pahang,12,3,9,2017
2017-01-25,Pahang,36,19,17,2017
2017-01-26,Pahang,26,9,17,2017
2017-01-27,Pahang,91,32,59,2017
2017-01-28,Pahang,0,0,0,2017
2017-01-29,Pahang,0,0,0,2017
2017-01-30,Pahang,0,0,0,2017
2017-01-31,Pahang,18,7,11,2017
2017-02-01,Pahang,7,2,5,2017
2017-02-02,Pahang,19,9,10,2017
2017-02-03,Pahang,30,8,22,2017
2017-02-04,Pahang,8,4,4,2017
2017-02-05,Pahang,11,2,9,2017
2017-02-06,Pahang,25,6,19,2017
2017-02-07,Pahang,7,0,7,2017
2017-02-08,Pahang,58,29,29,2017
2017-02-09,Pahang,57,20,37,2017
2017-02-10,Pahang,3,0,3,2017
2017-02-11,Pahang,0,0,0,2017
2017-02-12,Pahang,40,22,18,2017
2017-02-13,Pahang,82,54,28,2017
2017-02-14,Pahang,179,116,63,2017
2017-02-15,Pahang,4,0,4,2017
2017-02-16,Pahang,29,17,12,2017
2017-02-17,Pahang,9,3,6,2017
2017-02-18,Pahang,24,7,17,2017
2017-02-19,Pahang,32,7,25,2017
2017-02-20,Pahang,3,0,3,2017
2017-02-21,Pahang,81,27,54,2017
2017-02-22,Pahang,9,2,7,2017
2017-02-23,Pahang,52,23,29,2017
2017-02-24,Pahang,19,4,15,2017
2017-02-25,Pahang,26,11,15,2017
2017-02-26,Pahang,47,13,34,2017
2017-02-27,Pahang,2,1,1,2017
2017-02-28,Pahang,61,25,36,2017
2017-03-01,Pahang,66,29,37,2017
2017-03-02,Pahang,26,5,21,2017
2017-03-03,Pahang,40,21,19,2017
2017-03-04,Pahang,20,12,8,2017
2017-03-05,Pahang,46,26,20,2017
2017-03-06,Pahang,2,1,1,2017
2017-03-07,Pahang,29,8,21,2017
2017-03-08,Pahang,33,2,31,2017
2017-03-09,Pahang,43,11,32,2017
2017-03-10,Pahang,10,5,5,2017
2017-03-11,Pahang,22,6,16,2017
2017-03-12,Pahang,76,24,52,2017
2017-03-13,Pahang,4,0,4,2017
2017-03-14,Pahang,42,17,25,2017
2017-03-15,Pahang,6,1,5,2017
2017-03-16,Pahang,2,1,1,2017
2017-03-17,Pahang,58,19,39,2017
2017-03-18,Pahang,21,10,11,2017
2017-03-19,Pahang,158,30,128,2017
2017-03-20,Pahang,6,0,6,2017
2017-03-21,Pahang,3,0,3,2017
2017-03-22,Pahang,76,22,54,2017
2017-03-23,Pahang,5,0,5,2017
2017-03-24,Pahang,8,0,8,2017
2017-03-25,Pahang,26,12,14,2017
2017-03-26,Pahang,34,6,28,2017
2017-03-27,Pahang,4,0,4,2017
2017-03-28,Pahang,60,20,40,2017
2017-03-29,Pahang,35,15,20,2017
2017-03-30,Pahang,62,48,14,2017
2017-03-31,Pahang,8,2,6,2017
2017-04-01,Pahang,9,6,3,2017
2017-04-02,Pahang,0,0,0,2017
2017-04-03,Pahang,5,1,4,2017
2017-04-04,Pahang,41,17,24,2017
2017-04-05,Pahang,9,1,8,2017
2017-04-06,Pahang,29,10,19,2017
2017-04-07,Pahang,38,17,21,2017
2017-04-08,Pahang,61,31,30,2017
2017-04-09,Pahang,30,13,17,2017
2017-04-10,Pahang,6,2,4,2017
2017-04-11,Pahang,19,5,14,2017
2017-04-12,Pahang,57,27,30,2017
2017-04-13,Pahang,24,7,17,2017
2017-04-14,Pahang,14,5,9,2017
2017-04-15,Pahang,37,17,20,2017
2017-04-16,Pahang,42,16,26,2017
2017-04-17,Pahang,11,0,11,2017
2017-04-18,Pahang,20,5,15,2017
2017-04-19,Pahang,3,1,2,2017
2017-04-20,Pahang,6,5,1,2017
2017-04-21,Pahang,50,16,34,2017
2017-04-22,Pahang,0,0,0,2017
2017-04-23,Pahang,87,16,71,2017
2017-04-24,Pahang,0,0,0,2017
2017-04-25,Pahang,12,3,9,2017
2017-04-26,Pahang,25,14,11,2017
2017-04-27,Pahang,31,19,12,2017
2017-04-28,Pahang,5,1,4,2017
2017-04-29,Pahang,16,7,9,2017
2017-04-30,Pahang,90,18,72,2017
2017-05-01,Pahang,58,13,45,2017
2017-05-02,Pahang,5,1,4,2017
2017-05-03,Pahang,22,8,14,2017
2017-05-04,Pahang,124,28,96,2017
2017-05-05,Pahang,20,6,14,2017
2017-05-06,Pahang,0,0,0,2017
2017-05-07,Pahang,80,27,53,2017
2017-05-08,Pahang,0,0,0,2017
2017-05-09,Pahang,8,3,5,2017
2017-05-10,Pahang,35,3,32,2017
2017-05-11,Pahang,10,3,7,2017
2017-05-12,Pahang,8,2,6,2017
2017-05-13,Pahang,0,0,0,2017
2017-05-14,Pahang,101,21,80,2017
2017-05-15,Pahang,8,0,8,2017
2017-05-16,Pahang,16,7,9,2017
2017-05-17,Pahang,36,6,30,2017
2017-05-18,Pahang,22,7,15,2017
2017-05-19,Pahang,7,1,6,2017
2017-05-20,Pahang,28,9,19,2017
2017-05-21,Pahang,0,0,0,2017
2017-05-22,Pahang,8,0,8,2017
2017-05-23,Pahang,9,0,9,2017
2017-05-24,Pahang,56,13,43,2017
2017-05-25,Pahang,27,3,24,2017
2017-05-26,Pahang,10,2,8,2017
2017-05-27,Pahang,0,0,0,2017
2017-05-28,Pahang,86,13,73,2017
2017-05-29,Pahang,0,0,0,2017
2017-05-30,Pahang,10,3,7,2017
2017-05-31,Pahang,1,0,1,2017
2017-06-01,Pahang,6,1,5,2017
2017-06-02,Pahang,6,4,2,2017
2017-06-03,Pahang,0,0,0,2017
2017-06-04,Pahang,69,10,59,2017
2017-06-05,Pahang,0,0,0,2017
2017-06-06,Pahang,2,0,2,2017
2017-06-07,Pahang,17,6,11,2017
2017-06-08,Pahang,6,1,5,2017
2017-06-09,Pahang,8,2,6,2017
2017-06-10,Pahang,8,5,3,2017
2017-06-11,Pahang,27,6,21,2017
2017-06-12,Pahang,0,0,0,2017
2017-06-13,Pahang,0,0,0,2017
2017-06-14,Pahang,12,6,6,2017
2017-06-15,Pahang,12,3,9,2017
2017-06-16,Pahang,0,0,0,2017
2017-06-17,Pahang,0,0,0,2017
2017-06-18,Pahang,20,2,18,2017
2017-06-19,Pahang,2,0,2,2017
2017-06-20,Pahang,2,0,2,2017
2017-06-21,Pahang,3,0,3,2017
2017-06-22,Pahang,3,2,1,2017
2017-06-23,Pahang,3,0,3,2017
2017-06-24,Pahang,1,1,0,2017
2017-06-25,Pahang,0,0,0,2017
2017-06-26,Pahang,0,0,0,2017
2017-06-27,Pahang,0,0,0,2017
2017-06-28,Pahang,6,3,3,2017
2017-06-29,Pahang,12,4,8,2017
2017-06-30,Pahang,1,0,1,2017
2017-07-01,Pahang,0,0,0,2017
2017-07-02,Pahang,42,7,35,2017
2017-07-03,Pahang,1,0,1,2017
2017-07-04,Pahang,4,0,4,2017
2017-07-05,Pahang,48,24,24,2017
2017-07-06,Pahang,11,4,7,2017
2017-07-07,Pahang,6,0,6,2017
2017-07-08,Pahang,25,13,12,2017
2017-07-09,Pahang,105,30,75,2017
2017-07-10,Pahang,9,1,8,2017
2017-07-11,Pahang,38,13,25,2017
2017-07-12,Pahang,6,2,4,2017
2017-07-13,Pahang,76,50,26,2017
2017-07-14,Pahang,17,8,9,2017
2017-07-15,Pahang,6,1,5,2017
2017-07-16,Pahang,8,2,6,2017
2017-07-17,Pahang,12,2,10,2017
2017-07-18,Pahang,14,6,8,2017
2017-07-19,Pahang,19,8,11,2017
2017-07-20,Pahang,16,10,6,2017
2017-07-21,Pahang,96,44,52,2017
2017-07-22,Pahang,8,1,7,2017
2017-07-23,Pahang,0,0,0,2017
2017-07-24,Pahang,18,8,10,2017
2017-07-25,Pahang,64,44,20,2017
2017-07-26,Pahang,52,21,31,2017
2017-07-27,Pahang,22,10,12,2017
2017-07-28,Pahang,17,6,11,2017
2017-07-29,Pahang,8,0,8,2017
2017-07-30,Pahang,12,4,8,2017
2017-07-31,Pahang,9,2,7,2017
2017-08-01,Pahang,93,58,35,2017
2017-08-02,Pahang,39,11,28,2017
2017-08-03,Pahang,21,7,14,2017
2017-08-04,Pahang,5,0,5,2017
2017-08-05,Pahang,23,8,15,2017
2017-08-06,Pahang,134,32,102,2017
2017-08-07,Pahang,12,2,10,2017
2017-08-08,Pahang,94,40,54,2017
2017-08-09,Pahang,19,3,16,2017
2017-08-10,Pahang,76,48,28,2017
2017-08-11,Pahang,3,1,2,2017
2017-08-12,Pahang,34,11,23,2017
2017-08-13,Pahang,62,15,47,2017
2017-08-14,Pahang,10,2,8,2017
2017-08-15,Pahang,31,24,7,2017
2017-08-16,Pahang,24,14,10,2017
2017-08-17,Pahang,16,5,11,2017
2017-08-18,Pahang,5,3,2,2017
2017-08-19,Pahang,59,23,36,2017
2017-08-20,Pahang,56,17,39,2017
2017-08-21,Pahang,7,0,7,2017
2017-08-22,Pahang,2,0,2,2017
2017-08-23,Pahang,6,3,3,2017
2017-08-24,Pahang,7,1,6,2017
2017-08-25,Pahang,12,3,9,2017
2017-08-26,Pahang,5,3,2,2017
2017-08-27,Pahang,1,1,0,2017
2017-08-28,Pahang,11,0,11,2017
2017-08-29,Pahang,31,2,29,2017
2017-08-30,Pahang,6,4,2,2017
2017-08-31,Pahang,17,7,10,2017
2017-09-01,Pahang,0,0,0,2017
2017-09-02,Pahang,0,0,0,2017
2017-09-03,Pahang,10,6,4,2017
2017-09-04,Pahang,0,0,0,2017
2017-09-05,Pahang,23,15,8,2017
2017-09-06,Pahang,57,20,37,2017
2017-09-07,Pahang,58,21,37,2017
2017-09-08,Pahang,11,3,8,2017
2017-09-09,Pahang,17,4,13,2017
2017-09-10,Pahang,61,17,44,2017
2017-09-11,Pahang,13,1,12,2017
2017-09-12,Pahang,69,40,29,2017
2017-09-13,Pahang,68,21,47,2017
2017-09-14,Pahang,7,0,7,2017
2017-09-15,Pahang,15,0,15,2017
2017-09-16,Pahang,69,24,45,2017
2017-09-17,Pahang,16,2,14,2017
2017-09-18,Pahang,5,1,4,2017
2017-09-19,Pahang,57,40,17,2017
2017-09-20,Pahang,38,20,18,2017
2017-09-21,Pahang,34,15,19,2017
2017-09-22,Pahang,0,0,0,2017
2017-09-23,Pahang,13,6,7,2017
2017-09-24,Pahang,38,9,29,2017
2017-09-25,Pahang,3,0,3,2017
2017-09-26,Pahang,39,4,35,2017
2017-09-27,Pahang,10,1,9,2017
2017-09-28,Pahang,29,13,16,2017
2017-09-29,Pahang,5,1,4,2017
2017-09-30,Pahang,60,45,15,2017
2017-10-01,Pahang,68,45,23,2017
2017-10-02,Pahang,7,1,6,2017
2017-10-03,Pahang,59,36,23,2017
2017-10-04,Pahang,79,68,11,2017
2017-10-05,Pahang,6,1,5,2017
2017-10-06,Pahang,6,1,5,2017
2017-10-07,Pahang,23,13,10,2017
2017-10-08,Pahang,22,2,20,2017
2017-10-09,Pahang,5,0,5,2017
2017-10-10,Pahang,109,81,28,2017
2017-10-11,Pahang,147,99,48,2017
2017-10-12,Pahang,17,12,5,2017
2017-10-13,Pahang,1,0,1,2017
2017-10-14,Pahang,34,13,21,2017
2017-10-15,Pahang,59,11,48,2017
2017-10-16,Pahang,9,2,7,2017
2017-10-17,Pahang,12,2,10,2017
2017-10-18,Pahang,15,5,10,2017
2017-10-19,Pahang,14,6,8,2017
2017-10-20,Pahang,6,3,3,2017
2017-10-21,Pahang,0,0,0,2017
2017-10-22,Pahang,16,5,11,2017
2017-10-23,Pahang,10,1,9,2017
2017-10-24,Pahang,59,15,44,2017
2017-10-25,Pahang,12,2,10,2017
2017-10-26,Pahang,6,0,6,2017
2017-10-27,Pahang,8,1,7,2017
2017-10-28,Pahang,12,7,5,2017
2017-10-29,Pahang,89,32,57,2017
2017-10-30,Pahang,10,3,7,2017
2017-10-31,Pahang,19,7,12,2017
2017-11-01,Pahang,37,9,28,2017
2017-11-02,Pahang,31,11,20,2017
2017-11-03,Pahang,7,2,5,2017
2017-11-04,Pahang,12,3,9,2017
2017-11-05,Pahang,27,3,24,2017
2017-11-06,Pahang,10,0,10,2017
2017-11-07,Pahang,11,4,7,2017
2017-11-08,Pahang,34,8,26,2017
2017-11-09,Pahang,33,12,21,2017
2017-11-10,Pahang,64,17,47,2017
2017-11-11,Pahang,14,3,11,2017
2017-11-12,Pahang,65,21,44,2017
2017-11-13,Pahang,9,1,8,2017
2017-11-14,Pahang,31,9,22,2017
2017-11-15,Pahang,44,8,36,2017
2017-11-16,Pahang,42,14,28,2017
2017-11-17,Pahang,7,1,6,2017
2017-11-18,Pahang,7,1,6,2017
2017-11-19,Pahang,48,14,34,2017
2017-11-20,Pahang,4,1,3,2017
2017-11-21,Pahang,48,26,22,2017
2017-11-22,Pahang,33,15,18,2017
2017-11-23,Pahang,43,13,30,2017
2017-11-24,Pahang,4,0,4,2017
2017-11-25,Pahang,14,4,10,2017
2017-11-26,Pahang,13,4,9,2017
2017-11-27,Pahang,8,0,8,2017
2017-11-28,Pahang,39,7,32,2017
2017-11-29,Pahang,4,0,4,2017
2017-11-30,Pahang,29,12,17,2017
2017-12-01,Pahang,12,4,8,2017
2017-12-02,Pahang,2,1,1,2017
2017-12-03,Pahang,63,23,40,2017
2017-12-04,Pahang,8,3,5,2017
2017-12-05,Pahang,13,6,7,2017
2017-12-06,Pahang,24,5,19,2017
2017-12-07,Pahang,21,15,6,2017
2017-12-08,Pahang,10,2,8,2017
2017-12-09,Pahang,18,8,10,2017
2017-12-10,Pahang,90,35,55,2017
2017-12-11,Pahang,13,3,10,2017
2017-12-12,Pahang,1,0,1,2017
2017-12-13,Pahang,48,28,20,2017
2017-12-14,Pahang,8,1,7,2017
2017-12-15,Pahang,16,7,9,2017
2017-12-16,Pahang,0,0,0,2017
2017-12-17,Pahang,68,25,43,2017
2017-12-18,Pahang,7,0,7,2017
2017-12-19,Pahang,7,0,7,2017
2017-12-20,Pahang,17,11,6,2017
2017-12-21,Pahang,29,22,7,2017
2017-12-22,Pahang,51,9,42,2017
2017-12-23,Pahang,1,1,0,2017
2017-12-24,Pahang,22,9,13,2017
2017-12-25,Pahang,37,4,33,2017
2017-12-26,Pahang,10,3,7,2017
2017-12-27,Pahang,51,23,28,2017
2017-12-28,Pahang,20,7,13,2017
2017-12-29,Pahang,9,3,6,2017
2017-12-30,Pahang,0,0,0,2017
2017-12-31,Pahang,61,10,51,2017
2018-01-01,Pahang,102,23,79,2018
2018-01-02,Pahang,6,2,4,2018
2018-01-03,Pahang,44,9,35,2018
2018-01-04,Pahang,41,8,33,2018
2018-01-05,Pahang,23,5,18,2018
2018-01-06,Pahang,13,4,9,2018
2018-01-07,Pahang,19,9,10,2018
2018-01-08,Pahang,11,3,8,2018
2018-01-09,Pahang,47,14,33,2018
2018-01-10,Pahang,47,23,24,2018
2018-01-11,Pahang,43,20,23,2018
2018-01-12,Pahang,8,2,6,2018
2018-01-13,Pahang,12,6,6,2018
2018-01-14,Pahang,50,15,35,2018
2018-01-15,Pahang,3,0,3,2018
2018-01-16,Pahang,20,8,12,2018
2018-01-17,Pahang,52,20,32,2018
2018-01-18,Pahang,60,29,31,2018
2018-01-19,Pahang,23,16,7,2018
2018-01-20,Pahang,16,5,11,2018
2018-01-21,Pahang,55,8,47,2018
2018-01-22,Pahang,11,0,11,2018
2018-01-23,Pahang,32,14,18,2018
2018-01-24,Pahang,34,10,24,2018
2018-01-25,Pahang,33,18,15,2018
2018-01-26,Pahang,61,46,15,2018
2018-01-27,Pahang,0,0,0,2018
2018-01-28,Pahang,37,9,28,2018
2018-01-29,Pahang,7,0,7,2018
2018-01-30,Pahang,4,1,3,2018
2018-01-31,Pahang,42,5,37,2018
2018-02-01,Pahang,2,0,2,2018
2018-02-02,Pahang,3,2,1,2018
2018-02-03,Pahang,24,12,12,2018
2018-02-04,Pahang,0,0,0,2018
2018-02-05,Pahang,5,2,3,2018
2018-02-06,Pahang,17,4,13,2018
2018-02-07,Pahang,59,37,22,2018
2018-02-08,Pahang,2,0,2,2018
2018-02-09,Pahang,16,4,12,2018
2018-02-10,Pahang,0,0,0,2018
2018-02-11,Pahang,8,2,6,2018
2018-02-12,Pahang,7,2,5,2018
2018-02-13,Pahang,32,12,20,2018
2018-02-14,Pahang,10,0,10,2018
2018-02-15,Pahang,38,16,22,2018
2018-02-16,Pahang,0,0,0,2018
2018-02-17,Pahang,0,0,0,2018
2018-02-18,Pahang,0,0,0,2018
2018-02-19,Pahang,2,1,1,2018
2018-02-20,Pahang,40,15,25,2018
2018-02-21,Pahang,68,40,28,2018
2018-02-22,Pahang,5,1,4,2018
2018-02-23,Pahang,22,6,16,2018
2018-02-24,Pahang,38,29,9,2018
2018-02-25,Pahang,29,10,19,2018
2018-02-26,Pahang,0,0,0,2018
2018-02-27,Pahang,10,2,8,2018
2018-02-28,Pahang,83,53,30,2018
2018-03-01,Pahang,3,1,2,2018
2018-03-02,Pahang,60,53,7,2018
2018-03-03,Pahang,0,0,0,2018
2018-03-04,Pahang,0,0,0,2018
2018-03-05,Pahang,7,1,6,2018
2018-03-06,Pahang,52,15,37,2018
2018-03-07,Pahang,6,2,4,2018
2018-03-08,Pahang,50,37,13,2018
2018-03-09,Pahang,3,0,3,2018
2018-03-10,Pahang,0,0,0,2018
2018-03-11,Pahang,131,32,99,2018
2018-03-12,Pahang,0,0,0,2018
2018-03-13,Pahang,39,13,26,2018
2018-03-14,Pahang,45,22,23,2018
2018-03-15,Pahang,128,42,86,2018
2018-03-16,Pahang,1,1,0,2018
2018-03-17,Pahang,0,0,0,2018
2018-03-18,Pahang,0,0,0,2018
2018-03-19,Pahang,8,1,7,2018
2018-03-20,Pahang,5,0,5,2018
2018-03-21,Pahang,5,0,5,2018
2018-03-22,Pahang,12,3,9,2018
2018-03-23,Pahang,8,1,7,2018
2018-03-24,Pahang,0,0,0,2018
2018-03-25,Pahang,48,7,41,2018
2018-03-26,Pahang,6,1,5,2018
2018-03-27,Pahang,64,29,35,2018
2018-03-28,Pahang,27,3,24,2018
2018-03-29,Pahang,27,10,17,2018
2018-03-30,Pahang,32,8,24,2018
2018-03-31,Pahang,0,0,0,2018
2018-04-01,Pahang,66,14,52,2018
2018-04-02,Pahang,6,1,5,2018
2018-04-03,Pahang,29,10,19,2018
2018-04-04,Pahang,2,0,2,2018
2018-04-05,Pahang,28,15,13,2018
2018-04-06,Pahang,7,0,7,2018
2018-04-07,Pahang,0,0,0,2018
2018-04-08,Pahang,0,0,0,2018
2018-04-09,Pahang,8,1,7,2018
2018-04-10,Pahang,15,4,11,2018
2018-04-11,Pahang,36,25,11,2018
2018-04-12,Pahang,8,1,7,2018
2018-04-13,Pahang,8,0,8,2018
2018-04-14,Pahang,13,10,3,2018
2018-04-15,Pahang,59,13,46,2018
2018-04-16,Pahang,5,0,5,2018
2018-04-17,Pahang,53,12,41,2018
2018-04-18,Pahang,6,1,5,2018
2018-04-19,Pahang,1,0,1,2018
2018-04-20,Pahang,19,9,10,2018
2018-04-21,Pahang,0,0,0,2018
2018-04-22,Pahang,0,0,0,2018
2018-04-23,Pahang,6,0,6,2018
2018-04-24,Pahang,4,0,4,2018
2018-04-25,Pahang,7,0,7,2018
2018-04-26,Pahang,37,21,16,2018
2018-04-27,Pahang,5,0,5,2018
2018-04-28,Pahang,0,0,0,2018
2018-04-29,Pahang,34,9,25,2018
2018-04-30,Pahang,2,0,2,2018
2018-05-01,Pahang,44,12,32,2018
2018-05-02,Pahang,3,0,3,2018
2018-05-03,Pahang,1,0,1,2018
2018-05-04,Pahang,67,24,43,2018
2018-05-05,Pahang,0,0,0,2018
2018-05-06,Pahang,68,11,57,2018
2018-05-07,Pahang,0,0,0,2018
2018-05-08,Pahang,3,0,3,2018
2018-05-09,Pahang,0,0,0,2018
2018-05-10,Pahang,21,6,15,2018
2018-05-11,Pahang,0,0,0,2018
2018-05-12,Pahang,0,0,0,2018
2018-05-13,Pahang,61,24,37,2018
2018-05-14,Pahang,11,2,9,2018
2018-05-15,Pahang,10,2,8,2018
2018-05-16,Pahang,36,6,30,2018
2018-05-17,Pahang,1,0,1,2018
2018-05-18,Pahang,1,0,1,2018
2018-05-19,Pahang,0,0,0,2018
2018-05-20,Pahang,0,0,0,2018
2018-05-21,Pahang,64,10,54,2018
2018-05-22,Pahang,3,0,3,2018
2018-05-23,Pahang,3,0,3,2018
2018-05-24,Pahang,30,2,28,2018
2018-05-25,Pahang,2,1,1,2018
2018-05-26,Pahang,0,0,0,2018
2018-05-27,Pahang,0,0,0,2018
2018-05-28,Pahang,4,0,4,2018
2018-05-29,Pahang,0,0,0,2018
2018-05-30,Pahang,31,22,9,2018
2018-05-31,Pahang,2,0,2,2018
2018-06-01,Pahang,1,0,1,2018
2018-06-02,Pahang,13,3,10,2018
2018-06-03,Pahang,106,23,83,2018
2018-06-04,Pahang,2,0,2,2018
2018-06-05,Pahang,3,0,3,2018
2018-06-06,Pahang,8,2,6,2018
2018-06-07,Pahang,6,1,5,2018
2018-06-08,Pahang,1,0,1,2018
2018-06-09,Pahang,15,9,6,2018
2018-06-10,Pahang,40,10,30,2018
2018-06-11,Pahang,5,0,5,2018
2018-06-12,Pahang,25,11,14,2018
2018-06-13,Pahang,8,4,4,2018
2018-06-14,Pahang,1,0,1,2018
2018-06-15,Pahang,0,0,0,2018
2018-06-16,Pahang,0,0,0,2018
2018-06-17,Pahang,0,0,0,2018
2018-06-18,Pahang,5,0,5,2018
2018-06-19,Pahang,9,1,8,2018
2018-06-20,Pahang,22,8,14,2018
2018-06-21,Pahang,3,1,2,2018
2018-06-22,Pahang,8,0,8,2018
2018-06-23,Pahang,21,7,14,2018
2018-06-24,Pahang,27,4,23,2018
2018-06-25,Pahang,6,1,5,2018
2018-06-26,Pahang,77,20,57,2018
2018-06-27,Pahang,42,35,7,2018
2018-06-28,Pahang,13,0,13,2018
2018-06-29,Pahang,27,13,14,2018
2018-06-30,Pahang,0,0,0,2018
2018-07-01,Pahang,88,8,80,2018
2018-07-02,Pahang,7,0,7,2018
2018-07-03,Pahang,6,1,5,2018
2018-07-04,Pahang,43,28,15,2018
2018-07-05,Pahang,57,32,25,2018
2018-07-06,Pahang,40,18,22,2018
2018-07-07,Pahang,0,0,0,2018
2018-07-08,Pahang,50,7,43,2018
2018-07-09,Pahang,7,1,6,2018
2018-07-10,Pahang,61,11,50,2018
2018-07-11,Pahang,43,30,13,2018
2018-07-12,Pahang,5,0,5,2018
2018-07-13,Pahang,8,1,7,2018
2018-07-14,Pahang,0,0,0,2018
2018-07-15,Pahang,74,12,62,2018
2018-07-16,Pahang,7,1,6,2018
2018-07-17,Pahang,6,1,5,2018
2018-07-18,Pahang,83,33,50,2018
2018-07-19,Pahang,10,3,7,2018
2018-07-20,Pahang,7,0,7,2018
2018-07-21,Pahang,0,0,0,2018
2018-07-22,Pahang,0,0,0,2018
2018-07-23,Pahang,10,1,9,2018
2018-07-24,Pahang,32,19,13,2018
2018-07-25,Pahang,55,35,20,2018
2018-07-26,Pahang,5,2,3,2018
2018-07-27,Pahang,3,0,3,2018
2018-07-28,Pahang,0,0,0,2018
2018-07-29,Pahang,0,0,0,2018
2018-07-30,Pahang,7,2,5,2018
2018-07-31,Pahang,5,0,5,2018
2018-08-01,Pahang,23,8,15,2018
2018-08-02,Pahang,7,2,5,2018
2018-08-03,Pahang,10,6,4,2018
2018-08-04,Pahang,0,0,0,2018
2018-08-05,Pahang,0,0,0,2018
2018-08-06,Pahang,28,6,22,2018
2018-08-07,Pahang,7,1,6,2018
2018-08-08,Pahang,6,0,6,2018
2018-08-09,Pahang,17,4,13,2018
2018-08-10,Pahang,31,10,21,2018
2018-08-11,Pahang,14,5,9,2018
2018-08-12,Pahang,131,22,109,2018
2018-08-13,Pahang,6,1,5,2018
2018-08-14,Pahang,47,17,30,2018
2018-08-15,Pahang,50,17,33,2018
2018-08-16,Pahang,23,6,17,2018
2018-08-17,Pahang,14,7,7,2018
2018-08-18,Pahang,51,18,33,2018
2018-08-19,Pahang,24,10,14,2018
2018-08-20,Pahang,7,1,6,2018
2018-08-21,Pahang,0,0,0,2018
2018-08-22,Pahang,0,0,0,2018
2018-08-23,Pahang,8,1,7,2018
2018-08-24,Pahang,8,2,6,2018
2018-08-25,Pahang,13,4,9,2018
2018-08-26,Pahang,30,12,18,2018
2018-08-27,Pahang,2,0,2,2018
2018-08-28,Pahang,7,0,7,2018
2018-08-29,Pahang,46,35,11,2018
2018-08-30,Pahang,30,8,22,2018
2018-08-31,Pahang,48,9,39,2018
2018-09-01,Pahang,73,20,53,2018
2018-09-02,Pahang,0,0,0,2018
2018-09-03,Pahang,4,1,3,2018
2018-09-04,Pahang,29,2,27,2018
2018-09-05,Pahang,9,2,7,2018
2018-09-06,Pahang,5,0,5,2018
2018-09-07,Pahang,3,0,3,2018
2018-09-08,Pahang,35,13,22,2018
2018-09-09,Pahang,51,12,39,2018
2018-09-10,Pahang,0,0,0,2018
2018-09-11,Pahang,0,0,0,2018
2018-09-12,Pahang,1,1,0,2018
2018-09-13,Pahang,27,10,17,2018
2018-09-14,Pahang,10,1,9,2018
2018-09-15,Pahang,0,0,0,2018
2018-09-16,Pahang,70,10,60,2018
2018-09-17,Pahang,0,0,0,2018
2018-09-18,Pahang,2,0,2,2018
2018-09-19,Pahang,32,18,14,2018
2018-09-20,Pahang,4,0,4,2018
2018-09-21,Pahang,11,2,9,2018
2018-09-22,Pahang,52,37,15,2018
2018-09-23,Pahang,0,0,0,2018
2018-09-24,Pahang,13,3,10,2018
2018-09-25,Pahang,66,23,43,2018
2018-09-26,Pahang,2,0,2,2018
2018-09-27,Pahang,72,32,40,2018
2018-09-28,Pahang,8,0,8,2018
2018-09-29,Pahang,17,5,12,2018
2018-09-30,Pahang,0,0,0,2018
2018-10-01,Pahang,6,0,6,2018
2018-10-02,Pahang,8,1,7,2018
2018-10-03,Pahang,3,0,3,2018
2018-10-04,Pahang,32,18,14,2018
2018-10-05,Pahang,9,2,7,2018
2018-10-06,Pahang,0,0,0,2018
2018-10-07,Pahang,0,0,0,2018
2018-10-08,Pahang,8,1,7,2018
2018-10-09,Pahang,20,5,15,2018
2018-10-10,Pahang,7,1,6,2018
2018-10-11,Pahang,60,15,45,2018
2018-10-12,Pahang,7,3,4,2018
2018-10-13,Pahang,56,25,31,2018
2018-10-14,Pahang,43,3,40,2018
2018-10-15,Pahang,7,1,6,2018
2018-10-16,Pahang,6,1,5,2018
2018-10-17,Pahang,21,9,12,2018
2018-10-18,Pahang,12,3,9,2018
2018-10-19,Pahang,8,0,8,2018
2018-10-20,Pahang,0,0,0,2018
2018-10-21,Pahang,36,5,31,2018
2018-10-22,Pahang,8,3,5,2018
2018-10-23,Pahang,19,12,7,2018
2018-10-24,Pahang,0,0,0,2018
2018-10-25,Pahang,2,0,2,2018
2018-10-26,Pahang,2,0,2,2018
2018-10-27,Pahang,31,12,19,2018
2018-10-28,Pahang,23,2,21,2018
2018-10-29,Pahang,6,0,6,2018
2018-10-30,Pahang,5,1,4,2018
2018-10-31,Pahang,4,0,4,2018
2018-11-01,Pahang,8,0,8,2018
2018-11-02,Pahang,9,0,9,2018
2018-11-03,Pahang,0,0,0,2018
2018-11-04,Pahang,0,0,0,2018
2018-11-05,Pahang,8,2,6,2018
2018-11-06,Pahang,0,0,0,2018
2018-11-07,Pahang,28,7,21,2018
2018-11-08,Pahang,25,3,22,2018
2018-11-09,Pahang,10,2,8,2018
2018-11-10,Pahang,0,0,0,2018
2018-11-11,Pahang,28,7,21,2018
2018-11-12,Pahang,8,0,8,2018
2018-11-13,Pahang,8,0,8,2018
2018-11-14,Pahang,5,2,3,2018
2018-11-15,Pahang,4,2,2,2018
2018-11-16,Pahang,54,10,44,2018
2018-11-17,Pahang,28,13,15,2018
2018-11-18,Pahang,56,17,39,2018
2018-11-19,Pahang,7,1,6,2018
2018-11-20,Pahang,0,0,0,2018
2018-11-21,Pahang,8,2,6,2018
2018-11-22,Pahang,9,0,9,2018
2018-11-23,Pahang,3,1,2,2018
2018-11-24,Pahang,0,0,0,2018
2018-11-25,Pahang,47,24,23,2018
2018-11-26,Pahang,14,5,9,2018
2018-11-27,Pahang,63,45,18,2018
2018-11-28,Pahang,6,2,4,2018
2018-11-29,Pahang,2,0,2,2018
2018-11-30,Pahang,8,1,7,2018
2018-12-01,Pahang,0,0,0,2018
2018-12-02,Pahang,47,14,33,2018
2018-12-03,Pahang,7,2,5,2018
2018-12-04,Pahang,59,17,42,2018
2018-12-05,Pahang,1,0,1,2018
2018-12-06,Pahang,10,2,8,2018
2018-12-07,Pahang,6,0,6,2018
2018-12-08,Pahang,32,9,23,2018
2018-12-09,Pahang,46,10,36,2018
2018-12-10,Pahang,4,1,3,2018
2018-12-11,Pahang,8,1,7,2018
2018-12-12,Pahang,5,0,5,2018
2018-12-13,Pahang,29,8,21,2018
2018-12-14,Pahang,3,2,1,2018
2018-12-15,Pahang,0,0,0,2018
2018-12-16,Pahang,29,14,15,2018
2018-12-17,Pahang,9,2,7,2018
2018-12-18,Pahang,25,0,25,2018
2018-12-19,Pahang,34,16,18,2018
2018-12-20,Pahang,6,1,5,2018
2018-12-21,Pahang,2,0,2,2018
2018-12-22,Pahang,13,6,7,2018
2018-12-23,Pahang,0,0,0,2018
2018-12-24,Pahang,5,1,4,2018
2018-12-25,Pahang,30,5,25,2018
2018-12-26,Pahang,11,1,10,2018
2018-12-27,Pahang,11,2,9,2018
2018-12-28,Pahang,3,1,2,2018
2018-12-29,Pahang,55,14,41,2018
2018-12-30,Pahang,29,8,21,2018
2018-12-31,Pahang,11,1,10,2018
2019-01-01,Pahang,60,8,52,2019
2019-01-02,Pahang,6,1,5,2019
2019-01-03,Pahang,4,1,3,2019
2019-01-04,Pahang,7,2,5,2019
2019-01-05,Pahang,0,0,0,2019
2019-01-06,Pahang,0,0,0,2019
2019-01-07,Pahang,3,0,3,2019
2019-01-08,Pahang,13,6,7,2019
2019-01-09,Pahang,5,0,5,2019
2019-01-10,Pahang,5,0,5,2019
2019-01-11,Pahang,14,4,10,2019
2019-01-12,Pahang,28,16,12,2019
2019-01-13,Pahang,0,0,0,2019
2019-01-14,Pahang,83,27,56,2019
2019-01-15,Pahang,33,7,26,2019
2019-01-16,Pahang,8,3,5,2019
2019-01-17,Pahang,97,20,77,2019
2019-01-18,Pahang,18,3,15,2019
2019-01-19,Pahang,0,0,0,2019
2019-01-20,Pahang,42,13,29,2019
2019-01-21,Pahang,41,9,32,2019
2019-01-22,Pahang,1,1,0,2019
2019-01-23,Pahang,30,5,25,2019
2019-01-24,Pahang,63,18,45,2019
2019-01-25,Pahang,8,2,6,2019
2019-01-26,Pahang,30,15,15,2019
2019-01-27,Pahang,0,0,0,2019
2019-01-28,Pahang,7,0,7,2019
2019-01-29,Pahang,21,17,4,2019
2019-01-30,Pahang,4,0,4,2019
2019-01-31,Pahang,0,0,0,2019
2019-02-01,Pahang,69,13,56,2019
2019-02-02,Pahang,12,2,10,2019
2019-02-03,Pahang,16,8,8,2019
2019-02-04,Pahang,8,5,3,2019
2019-02-05,Pahang,0,0,0,2019
2019-02-06,Pahang,0,0,0,2019
2019-02-07,Pahang,11,2,9,2019
2019-02-08,Pahang,9,2,7,2019
2019-02-09,Pahang,0,0,0,2019
2019-02-10,Pahang,34,21,13,2019
2019-02-11,Pahang,7,1,6,2019
2019-02-12,Pahang,12,3,9,2019
2019-02-13,Pahang,76,36,40,2019
2019-02-14,Pahang,3,0,3,2019
2019-02-15,Pahang,6,0,6,2019
2019-02-16,Pahang,4,1,3,2019
2019-02-17,Pahang,0,0,0,2019
2019-02-18,Pahang,11,0,11,2019
2019-02-19,Pahang,3,1,2,2019
2019-02-20,Pahang,42,17,25,2019
2019-02-21,Pahang,2,0,2,2019
2019-02-22,Pahang,5,2,3,2019
2019-02-23,Pahang,28,10,18,2019
2019-02-24,Pahang,0,0,0,2019
2019-02-25,Pahang,2,1,1,2019
2019-02-26,Pahang,75,22,53,2019
2019-02-27,Pahang,6,1,5,2019
2019-02-28,Pahang,46,29,17,2019
2019-03-01,Pahang,36,6,30,2019
2019-03-02,Pahang,0,0,0,2019
2019-03-03,Pahang,47,14,33,2019
2019-03-04,Pahang,10,1,9,2019
2019-03-05,Pahang,1,0,1,2019
2019-03-06,Pahang,6,1,5,2019
2019-03-07,Pahang,5,0,5,2019
2019-03-08,Pahang,9,0,9,2019
2019-03-09,Pahang,0,0,0,2019
2019-03-10,Pahang,77,14,63,2019
2019-03-11,Pahang,5,1,4,2019
2019-03-12,Pahang,10,1,9,2019
2019-03-13,Pahang,4,0,4,2019
2019-03-14,Pahang,8,0,8,2019
2019-03-15,Pahang,13,2,11,2019
2019-03-16,Pahang,0,0,0,2019
2019-03-17,Pahang,81,11,70,2019
2019-03-18,Pahang,4,1,3,2019
2019-03-19,Pahang,8,3,5,2019
2019-03-20,Pahang,8,0,8,2019
2019-03-21,Pahang,8,1,7,2019
2019-03-22,Pahang,9,1,8,2019
2019-03-23,Pahang,0,0,0,2019
2019-03-24,Pahang,19,8,11,2019
2019-03-25,Pahang,25,7,18,2019
2019-03-26,Pahang,1,0,1,2019
2019-03-27,Pahang,3,0,3,2019
2019-03-28,Pahang,5,0,5,2019
2019-03-29,Pahang,10,2,8,2019
2019-03-30,Pahang,0,0,0,2019
2019-03-31,Pahang,0,0,0,2019
2019-04-01,Pahang,7,1,6,2019
2019-04-02,Pahang,30,9,21,2019
2019-04-03,Pahang,4,1,3,2019
2019-04-04,Pahang,55,45,10,2019
2019-04-05,Pahang,8,0,8,2019
2019-04-06,Pahang,0,0,0,2019
2019-04-07,Pahang,33,9,24,2019
2019-04-08,Pahang,9,1,8,2019
2019-04-09,Pahang,11,3,8,2019
2019-04-10,Pahang,55,37,18,2019
2019-04-11,Pahang,3,0,3,2019
2019-04-12,Pahang,6,0,6,2019
2019-04-13,Pahang,59,11,48,2019
2019-04-14,Pahang,0,0,0,2019
2019-04-15,Pahang,6,0,6,2019
2019-04-16,Pahang,53,33,20,2019
2019-04-17,Pahang,40,20,20,2019
2019-04-18,Pahang,8,1,7,2019
2019-04-19,Pahang,8,0,8,2019
2019-04-20,Pahang,21,13,8,2019
2019-04-21,Pahang,38,11,27,2019
2019-04-22,Pahang,5,1,4,2019
2019-04-23,Pahang,73,24,49,2019
2019-04-24,Pahang,4,0,4,2019
2019-04-25,Pahang,5,0,5,2019
2019-04-26,Pahang,1,0,1,2019
2019-04-27,Pahang,0,0,0,2019
2019-04-28,Pahang,79,23,56,2019
2019-04-29,Pahang,10,1,9,2019
2019-04-30,Pahang,22,13,9,2019
2019-05-01,Pahang,29,8,21,2019
2019-05-02,Pahang,4,0,4,2019
2019-05-03,Pahang,89,27,62,2019
2019-05-04,Pahang,23,16,7,2019
2019-05-05,Pahang,0,0,0,2019
2019-05-06,Pahang,3,0,3,2019
2019-05-07,Pahang,0,0,0,2019
2019-05-08,Pahang,8,3,5,2019
2019-05-09,Pahang,47,27,20,2019
2019-05-10,Pahang,4,0,4,2019
2019-05-11,Pahang,75,36,39,2019
2019-05-12,Pahang,119,51,68,2019
2019-05-13,Pahang,5,1,4,2019
2019-05-14,Pahang,28,11,17,2019
2019-05-15,Pahang,23,12,11,2019
2019-05-16,Pahang,20,11,9,2019
2019-05-17,Pahang,6,3,3,2019
2019-05-18,Pahang,0,0,0,2019
2019-05-19,Pahang,0,0,0,2019
2019-05-20,Pahang,12,8,4,2019
2019-05-21,Pahang,3,1,2,2019
2019-05-22,Pahang,10,4,6,2019
2019-05-23,Pahang,0,0,0,2019
2019-05-24,Pahang,27,16,11,2019
2019-05-25,Pahang,0,0,0,2019
2019-05-26,Pahang,166,69,97,2019
2019-05-27,Pahang,7,3,4,2019
2019-05-28,Pahang,23,15,8,2019
2019-05-29,Pahang,29,5,24,2019
2019-05-30,Pahang,16,9,7,2019
2019-05-31,Pahang,35,11,24,2019
2019-06-01,Pahang,45,20,25,2019
2019-06-02,Pahang,73,22,51,2019
2019-06-03,Pahang,15,3,12,2019
2019-06-04,Pahang,28,17,11,2019
2019-06-05,Pahang,0,0,0,2019
2019-06-06,Pahang,0,0,0,2019
2019-06-07,Pahang,8,3,5,2019
2019-06-08,Pahang,0,0,0,2019
2019-06-09,Pahang,97,45,52,2019
2019-06-10,Pahang,16,2,14,2019
2019-06-11,Pahang,35,16,19,2019
2019-06-12,Pahang,46,28,18,2019
2019-06-13,Pahang,53,30,23,2019
2019-06-14,Pahang,79,35,44,2019
2019-06-15,Pahang,104,61,43,2019
2019-06-16,Pahang,206,94,112,2019
2019-06-17,Pahang,46,11,35,2019
2019-06-18,Pahang,117,94,23,2019
2019-06-19,Pahang,27,6,21,2019
2019-06-20,Pahang,52,11,41,2019
2019-06-21,Pahang,84,46,38,2019
2019-06-22,Pahang,94,64,30,2019
2019-06-23,Pahang,185,83,102,2019
2019-06-24,Pahang,22,6,16,2019
2019-06-25,Pahang,41,23,18,2019
2019-06-26,Pahang,125,63,62,2019
2019-06-27,Pahang,80,40,40,2019
2019-06-28,Pahang,23,11,12,2019
2019-06-29,Pahang,89,68,21,2019
2019-06-30,Pahang,103,69,34,2019
2019-07-01,Pahang,20,6,14,2019
2019-07-02,Pahang,102,79,23,2019
2019-07-03,Pahang,102,74,28,2019
2019-07-04,Pahang,75,49,26,2019
2019-07-05,Pahang,19,4,15,2019
2019-07-06,Pahang,0,0,0,2019
2019-07-07,Pahang,89,41,48,2019
2019-07-08,Pahang,24,8,16,2019
2019-07-09,Pahang,83,38,45,2019
2019-07-10,Pahang,71,34,37,2019
2019-07-11,Pahang,64,28,36,2019
2019-07-12,Pahang,11,5,6,2019
2019-07-13,Pahang,88,49,39,2019
2019-07-14,Pahang,147,50,97,2019
2019-07-15,Pahang,22,8,14,2019
2019-07-16,Pahang,177,118,59,2019
2019-07-17,Pahang,25,10,15,2019
2019-07-18,Pahang,97,49,48,2019
2019-07-19,Pahang,15,1,14,2019
2019-07-20,Pahang,48,21,27,2019
2019-07-21,Pahang,147,65,82,2019
2019-07-22,Pahang,10,3,7,2019
2019-07-23,Pahang,75,53,22,2019
2019-07-24,Pahang,106,81,25,2019
2019-07-25,Pahang,145,101,44,2019
2019-07-26,Pahang,19,10,9,2019
2019-07-27,Pahang,0,0,0,2019
2019-07-28,Pahang,96,30,66,2019
2019-07-29,Pahang,17,6,11,2019
2019-07-30,Pahang,57,36,21,2019
2019-07-31,Pahang,0,0,0,2019
2019-08-01,Pahang,49,26,23,2019
2019-08-02,Pahang,12,3,9,2019
2019-08-03,Pahang,33,23,10,2019
2019-08-04,Pahang,140,62,78,2019
2019-08-05,Pahang,12,1,11,2019
2019-08-06,Pahang,113,57,56,2019
2019-08-07,Pahang,13,5,8,2019
2019-08-08,Pahang,107,82,25,2019
2019-08-09,Pahang,9,3,6,2019
2019-08-10,Pahang,40,19,21,2019
2019-08-11,Pahang,0,0,0,2019
2019-08-12,Pahang,0,0,0,2019
2019-08-13,Pahang,19,3,16,2019
2019-08-14,Pahang,31,12,19,2019
2019-08-15,Pahang,30,12,18,2019
2019-08-16,Pahang,11,4,7,2019
2019-08-17,Pahang,48,23,25,2019
2019-08-18,Pahang,92,60,32,2019
2019-08-19,Pahang,9,0,9,2019
2019-08-20,Pahang,67,47,20,2019
2019-08-21,Pahang,25,8,17,2019
2019-08-22,Pahang,46,23,23,2019
2019-08-23,Pahang,7,1,6,2019
2019-08-24,Pahang,192,76,116,2019
2019-08-25,Pahang,167,94,73,2019
2019-08-26,Pahang,12,5,7,2019
2019-08-27,Pahang,20,7,13,2019
2019-08-28,Pahang,24,5,19,2019
2019-08-29,Pahang,98,43,55,2019
2019-08-30,Pahang,8,2,6,2019
2019-08-31,Pahang,124,58,66,2019
2019-09-01,Pahang,133,69,64,2019
2019-09-02,Pahang,0,0,0,2019
2019-09-03,Pahang,40,20,20,2019
2019-09-04,Pahang,59,38,21,2019
2019-09-05,Pahang,37,15,22,2019
2019-09-06,Pahang,29,13,16,2019
2019-09-07,Pahang,120,39,81,2019
2019-09-08,Pahang,112,44,68,2019
2019-09-09,Pahang,0,0,0,2019
2019-09-10,Pahang,130,60,70,2019
2019-09-11,Pahang,114,49,65,2019
2019-09-12,Pahang,104,40,64,2019
2019-09-13,Pahang,13,3,10,2019
2019-09-14,Pahang,52,9,43,2019
2019-09-15,Pahang,126,39,87,2019
2019-09-16,Pahang,0,0,0,2019
2019-09-17,Pahang,22,8,14,2019
2019-09-18,Pahang,130,53,77,2019
2019-09-19,Pahang,91,47,44,2019
2019-09-20,Pahang,26,6,20,2019
2019-09-21,Pahang,189,161,28,2019
2019-09-22,Pahang,270,249,21,2019
2019-09-23,Pahang,23,3,20,2019
2019-09-24,Pahang,130,62,68,2019
2019-09-25,Pahang,19,7,12,2019
2019-09-26,Pahang,45,11,34,2019
2019-09-27,Pahang,90,35,55,2019
2019-09-28,Pahang,0,0,0,2019
2019-09-29,Pahang,110,44,66,2019
2019-09-30,Pahang,16,0,16,2019
2019-10-01,Pahang,76,31,45,2019
2019-10-02,Pahang,80,44,36,2019
2019-10-03,Pahang,16,1,15,2019
2019-10-04,Pahang,73,40,33,2019
2019-10-05,Pahang,74,30,44,2019
2019-10-06,Pahang,93,56,37,2019
2019-10-07,Pahang,39,9,30,2019
2019-10-08,Pahang,30,7,23,2019
2019-10-09,Pahang,146,98,48,2019
2019-10-10,Pahang,17,3,14,2019
2019-10-11,Pahang,16,4,12,2019
2019-10-12,Pahang,83,22,61,2019
2019-10-13,Pahang,204,73,131,2019
2019-10-14,Pahang,27,5,22,2019
2019-10-15,Pahang,107,43,64,2019
2019-10-16,Pahang,179,92,87,2019
2019-10-17,Pahang,15,2,13,2019
2019-10-18,Pahang,12,3,9,2019
2019-10-19,Pahang,100,34,66,2019
2019-10-20,Pahang,114,34,80,2019
2019-10-21,Pahang,10,0,10,2019
2019-10-22,Pahang,36,14,22,2019
2019-10-23,Pahang,146,83,63,2019
2019-10-24,Pahang,13,3,10,2019
2019-10-25,Pahang,40,23,17,2019
2019-10-26,Pahang,47,27,20,2019
2019-10-27,Pahang,0,0,0,2019
2019-10-28,Pahang,0,0,0,2019
2019-10-29,Pahang,61,22,39,2019
2019-10-30,Pahang,44,23,21,2019
2019-10-31,Pahang,35,7,28,2019
2019-11-01,Pahang,17,4,13,2019
2019-11-02,Pahang,95,32,63,2019
2019-11-03,Pahang,162,63,99,2019
2019-11-04,Pahang,15,1,14,2019
2019-11-05,Pahang,13,0,13,2019
2019-11-06,Pahang,54,24,30,2019
2019-11-07,Pahang,67,42,25,2019
2019-11-08,Pahang,22,8,14,2019
2019-11-09,Pahang,34,11,23,2019
2019-11-10,Pahang,133,46,87,2019
2019-11-11,Pahang,17,1,16,2019
2019-11-12,Pahang,98,42,56,2019
2019-11-13,Pahang,120,64,56,2019
2019-11-14,Pahang,105,66,39,2019
2019-11-15,Pahang,16,3,13,2019
2019-11-16,Pahang,43,20,23,2019
2019-11-17,Pahang,56,15,41,2019
2019-11-18,Pahang,40,14,26,2019
2019-11-19,Pahang,19,1,18,2019
2019-11-20,Pahang,44,15,29,2019
2019-11-21,Pahang,84,56,28,2019
2019-11-22,Pahang,12,3,9,2019
2019-11-23,Pahang,0,0,0,2019
2019-11-24,Pahang,98,33,65,2019
2019-11-25,Pahang,14,3,11,2019
2019-11-26,Pahang,74,45,29,2019
2019-11-27,Pahang,41,18,23,2019
2019-11-28,Pahang,94,41,53,2019
2019-11-29,Pahang,7,1,6,2019
2019-11-30,Pahang,15,8,7,2019
2019-12-01,Pahang,54,32,22,2019
2019-12-02,Pahang,6,0,6,2019
2019-12-03,Pahang,85,32,53,2019
2019-12-04,Pahang,65,24,41,2019
2019-12-05,Pahang,10,2,8,2019
2019-12-06,Pahang,26,4,22,2019
2019-12-07,Pahang,16,9,7,2019
2019-12-08,Pahang,91,24,67,2019
2019-12-09,Pahang,11,1,10,2019
2019-12-10,Pahang,144,52,92,2019
2019-12-11,Pahang,12,3,9,2019
2019-12-12,Pahang,76,31,45,2019
2019-12-13,Pahang,55,12,43,2019
2019-12-14,Pahang,30,11,19,2019
2019-12-15,Pahang,91,25,66,2019
2019-12-16,Pahang,41,9,32,2019
2019-12-17,Pahang,73,35,38,2019
2019-12-18,Pahang,72,40,32,2019
2019-12-19,Pahang,53,25,28,2019
2019-12-20,Pahang,14,2,12,2019
2019-12-21,Pahang,46,21,25,2019
2019-12-22,Pahang,149,43,106,2019
2019-12-23,Pahang,50,15,35,2019
2019-12-24,Pahang,52,22,30,2019
2019-12-25,Pahang,96,32,64,2019
2019-12-26,Pahang,22,3,19,2019
2019-12-27,Pahang,57,11,46,2019
2019-12-28,Pahang,42,13,29,2019
2019-12-29,Pahang,65,14,51,2019
2019-12-30,Pahang,19,3,16,2019
2019-12-31,Pahang,19,6,13,2019
2020-01-01,Pahang,134,35,99,2020
2020-01-02,Pahang,13,2,11,2020
2020-01-03,Pahang,11,1,10,2020
2020-01-04,Pahang,42,12,30,2020
2020-01-05,Pahang,50,13,37,2020
2020-01-06,Pahang,19,8,11,2020
2020-01-07,Pahang,90,61,29,2020
2020-01-08,Pahang,109,40,69,2020
2020-01-09,Pahang,79,25,54,2020
2020-01-10,Pahang,57,8,49,2020
2020-01-11,Pahang,54,16,38,2020
2020-01-12,Pahang,121,43,78,2020
2020-01-13,Pahang,12,0,12,2020
2020-01-14,Pahang,149,75,74,2020
2020-01-15,Pahang,168,104,64,2020
2020-01-16,Pahang,48,20,28,2020
2020-01-17,Pahang,31,16,15,2020
2020-01-18,Pahang,40,12,28,2020
2020-01-19,Pahang,71,17,54,2020
2020-01-20,Pahang,18,4,14,2020
2020-01-21,Pahang,64,25,39,2020
2020-01-22,Pahang,128,55,73,2020
2020-01-23,Pahang,117,70,47,2020
2020-01-24,Pahang,131,21,110,2020
2020-01-25,Pahang,36,11,25,2020
2020-01-26,Pahang,0,0,0,2020
2020-01-27,Pahang,0,0,0,2020
2020-01-28,Pahang,93,40,53,2020
2020-01-29,Pahang,86,28,58,2020
2020-01-30,Pahang,103,51,52,2020
2020-01-31,Pahang,32,11,21,2020
2020-02-01,Pahang,44,10,34,2020
2020-02-02,Pahang,27,13,14,2020
2020-02-03,Pahang,110,76,34,2020
2020-02-04,Pahang,23,2,21,2020
2020-02-05,Pahang,119,52,67,2020
2020-02-06,Pahang,46,22,24,2020
2020-02-07,Pahang,45,15,30,2020
2020-02-08,Pahang,45,16,29,2020
2020-02-09,Pahang,59,13,46,2020
2020-02-10,Pahang,23,3,20,2020
2020-02-11,Pahang,78,45,33,2020
2020-02-12,Pahang,137,78,59,2020
2020-02-13,Pahang,77,33,44,2020
2020-02-14,Pahang,80,60,20,2020
2020-02-15,Pahang,64,21,43,2020
2020-02-16,Pahang,44,20,24,2020
2020-02-17,Pahang,19,2,17,2020
2020-02-18,Pahang,55,16,39,2020
2020-02-19,Pahang,233,96,137,2020
2020-02-20,Pahang,5,0,5,2020
2020-02-21,Pahang,13,3,10,2020
2020-02-22,Pahang,90,44,46,2020
2020-02-23,Pahang,123,30,93,2020
2020-02-24,Pahang,8,0,8,2020
2020-02-25,Pahang,84,40,44,2020
2020-02-26,Pahang,145,94,51,2020
2020-02-27,Pahang,60,33,27,2020
2020-02-28,Pahang,105,69,36,2020
2020-02-29,Pahang,77,42,35,2020
2020-03-01,Pahang,34,18,16,2020
2020-03-02,Pahang,17,2,15,2020
2020-03-03,Pahang,59,12,47,2020
2020-03-04,Pahang,29,11,18,2020
2020-03-05,Pahang,85,24,61,2020
2020-03-06,Pahang,19,3,16,2020
2020-03-07,Pahang,66,21,45,2020
2020-03-08,Pahang,177,26,151,2020
2020-03-09,Pahang,12,4,8,2020
2020-03-10,Pahang,214,94,120,2020
2020-03-11,Pahang,16,4,12,2020
2020-03-12,Pahang,132,48,84,2020
2020-03-13,Pahang,15,6,9,2020
2020-03-14,Pahang,24,4,20,2020
2020-03-15,Pahang,107,23,84,2020
2020-03-16,Pahang,10,3,7,2020
2020-03-17,Pahang,10,4,6,2020
2020-03-18,Pahang,35,14,21,2020
2020-03-19,Pahang,18,2,16,2020
2020-03-20,Pahang,34,9,25,2020
2020-03-21,Pahang,67,41,26,2020
2020-03-22,Pahang,44,11,33,2020
2020-03-23,Pahang,58,9,49,2020
2020-03-24,Pahang,54,14,40,2020
2020-03-25,Pahang,84,26,58,2020
2020-03-26,Pahang,77,25,52,2020
2020-03-27,Pahang,101,23,78,2020
2020-03-28,Pahang,45,13,32,2020
2020-03-29,Pahang,14,4,10,2020
2020-03-30,Pahang,29,9,20,2020
2020-03-31,Pahang,117,42,75,2020
2020-04-01,Pahang,17,6,11,2020
2020-04-02,Pahang,84,49,35,2020
2020-04-03,Pahang,18,4,14,2020
2020-04-04,Pahang,46,27,19,2020
2020-04-05,Pahang,41,22,19,2020
2020-04-06,Pahang,25,1,24,2020
2020-04-07,Pahang,57,22,35,2020
2020-04-08,Pahang,19,2,17,2020
2020-04-09,Pahang,20,2,18,2020
2020-04-10,Pahang,27,3,24,2020
2020-04-11,Pahang,41,7,34,2020
2020-04-12,Pahang,43,9,34,2020
2020-04-13,Pahang,14,2,12,2020
2020-04-14,Pahang,81,34,47,2020
2020-04-15,Pahang,48,23,25,2020
2020-04-16,Pahang,76,27,49,2020
2020-04-17,Pahang,28,5,23,2020
2020-04-18,Pahang,28,15,13,2020
2020-04-19,Pahang,46,17,29,2020
2020-04-20,Pahang,21,3,18,2020
2020-04-21,Pahang,83,32,51,2020
2020-04-22,Pahang,66,26,40,2020
2020-04-23,Pahang,59,10,49,2020
2020-04-24,Pahang,2,0,2,2020
2020-04-25,Pahang,0,0,0,2020
2020-04-26,Pahang,16,6,10,2020
2020-04-27,Pahang,5,0,5,2020
2020-04-28,Pahang,89,11,78,2020
2020-04-29,Pahang,82,40,42,2020
2020-04-30,Pahang,86,46,40,2020
2020-05-01,Pahang,101,20,81,2020
2020-05-02,Pahang,0,0,0,2020
2020-05-03,Pahang,36,8,28,2020
2020-05-04,Pahang,37,4,33,2020
2020-05-05,Pahang,18,2,16,2020
2020-05-06,Pahang,93,37,56,2020
2020-05-07,Pahang,21,5,16,2020
2020-05-08,Pahang,110,32,78,2020
2020-05-09,Pahang,0,0,0,2020
2020-05-10,Pahang,35,7,28,2020
2020-05-11,Pahang,69,13,56,2020
2020-05-12,Pahang,18,7,11,2020
2020-05-13,Pahang,15,3,12,2020
2020-05-14,Pahang,17,3,14,2020
2020-05-15,Pahang,33,4,29,2020
2020-05-16,Pahang,20,3,17,2020
2020-05-17,Pahang,93,15,78,2020
2020-05-18,Pahang,20,1,19,2020
2020-05-19,Pahang,20,3,17,2020
2020-05-20,Pahang,65,14,51,2020
2020-05-21,Pahang,90,21,69,2020
2020-05-22,Pahang,54,6,48,2020
2020-05-23,Pahang,4,0,4,2020
2020-05-24,Pahang,0,0,0,2020
2020-05-25,Pahang,0,0,0,2020
2020-05-26,Pahang,75,8,67,2020
2020-05-27,Pahang,48,13,35,2020
2020-05-28,Pahang,33,4,29,2020
2020-05-29,Pahang,42,5,37,2020
2020-05-30,Pahang,80,28,52,2020
2020-05-31,Pahang,90,24,66,2020
2020-06-01,Pahang,19,7,12,2020
2020-06-02,Pahang,68,16,52,2020
2020-06-03,Pahang,52,14,38,2020
2020-06-04,Pahang,74,23,51,2020
2020-06-05,Pahang,48,14,34,2020
2020-06-06,Pahang,129,30,99,2020
2020-06-07,Pahang,166,40,126,2020
2020-06-08,Pahang,69,19,50,2020
2020-06-09,Pahang,31,4,27,2020
2020-06-10,Pahang,42,14,28,2020
2020-06-11,Pahang,155,52,103,2020
2020-06-12,Pahang,19,2,17,2020
2020-06-13,Pahang,84,27,57,2020
2020-06-14,Pahang,135,38,97,2020
2020-06-15,Pahang,24,5,19,2020
2020-06-16,Pahang,78,16,62,2020
2020-06-17,Pahang,116,30,86,2020
2020-06-18,Pahang,30,4,26,2020
2020-06-19,Pahang,17,3,14,2020
2020-06-20,Pahang,71,24,47,2020
2020-06-21,Pahang,126,34,92,2020
2020-06-22,Pahang,20,0,20,2020
2020-06-23,Pahang,24,3,21,2020
2020-06-24,Pahang,109,39,70,2020
2020-06-25,Pahang,30,3,27,2020
2020-06-26,Pahang,18,2,16,2020
2020-06-27,Pahang,84,22,62,2020
2020-06-28,Pahang,150,40,110,2020
2020-06-29,Pahang,17,1,16,2020
2020-06-30,Pahang,78,28,50,2020
2020-07-01,Pahang,61,12,49,2020
2020-07-02,Pahang,19,5,14,2020
2020-07-03,Pahang,18,2,16,2020
2020-07-04,Pahang,64,12,52,2020
2020-07-05,Pahang,61,14,47,2020
2020-07-06,Pahang,15,2,13,2020
2020-07-07,Pahang,43,14,29,2020
2020-07-08,Pahang,78,33,45,2020
2020-07-09,Pahang,48,14,34,2020
2020-07-10,Pahang,11,1,10,2020
2020-07-11,Pahang,35,6,29,2020
2020-07-12,Pahang,121,34,87,2020
2020-07-13,Pahang,104,48,56,2020
2020-07-14,Pahang,45,9,36,2020
2020-07-15,Pahang,12,0,12,2020
2020-07-16,Pahang,34,4,30,2020
2020-07-17,Pahang,16,2,14,2020
2020-07-18,Pahang,23,5,18,2020
2020-07-19,Pahang,172,43,129,2020
2020-07-20,Pahang,51,17,34,2020
2020-07-21,Pahang,64,31,33,2020
2020-07-22,Pahang,13,1,12,2020
2020-07-23,Pahang,39,13,26,2020
2020-07-24,Pahang,18,5,13,2020
2020-07-25,Pahang,23,9,14,2020
2020-07-26,Pahang,67,17,50,2020
2020-07-27,Pahang,42,14,28,2020
2020-07-28,Pahang,94,35,59,2020
2020-07-29,Pahang,22,1,21,2020
2020-07-30,Pahang,99,30,69,2020
2020-07-31,Pahang,0,0,0,2020
2020-08-01,Pahang,0,0,0,2020
2020-08-02,Pahang,102,25,77,2020
2020-08-03,Pahang,25,4,21,2020
2020-08-04,Pahang,19,1,18,2020
2020-08-05,Pahang,73,17,56,2020
2020-08-06,Pahang,154,62,92,2020
2020-08-07,Pahang,15,2,13,2020
2020-08-08,Pahang,131,47,84,2020
2020-08-09,Pahang,174,32,142,2020
2020-08-10,Pahang,31,6,25,2020
2020-08-11,Pahang,21,8,13,2020
2020-08-12,Pahang,178,54,124,2020
2020-08-13,Pahang,23,7,16,2020
2020-08-14,Pahang,35,10,25,2020
2020-08-15,Pahang,82,20,62,2020
2020-08-16,Pahang,192,61,131,2020
2020-08-17,Pahang,30,9,21,2020
2020-08-18,Pahang,96,29,67,2020
2020-08-19,Pahang,37,11,26,2020
2020-08-20,Pahang,166,57,109,2020
2020-08-21,Pahang,22,3,19,2020
2020-08-22,Pahang,80,20,60,2020
2020-08-23,Pahang,59,7,52,2020
2020-08-24,Pahang,22,5,17,2020
2020-08-25,Pahang,53,16,37,2020
2020-08-26,Pahang,52,6,46,2020
2020-08-27,Pahang,30,14,16,2020
2020-08-28,Pahang,16,1,15,2020
2020-08-29,Pahang,0,0,0,2020
2020-08-30,Pahang,108,25,83,2020
2020-08-31,Pahang,163,28,135,2020
2020-09-01,Pahang,18,2,16,2020
2020-09-02,Pahang,72,30,42,2020
2020-09-03,Pahang,55,18,37,2020
2020-09-04,Pahang,15,0,15,2020
2020-09-05,Pahang,74,19,55,2020
2020-09-06,Pahang,104,26,78,2020
2020-09-07,Pahang,13,0,13,2020
2020-09-08,Pahang,30,6,24,2020
2020-09-09,Pahang,78,34,44,2020
2020-09-10,Pahang,46,13,33,2020
2020-09-11,Pahang,10,0,10,2020
2020-09-12,Pahang,20,6,14,2020
2020-09-13,Pahang,250,37,213,2020
2020-09-14,Pahang,21,2,19,2020
2020-09-15,Pahang,16,4,12,2020
2020-09-16,Pahang,132,18,114,2020
2020-09-17,Pahang,13,2,11,2020
2020-09-18,Pahang,52,27,25,2020
2020-09-19,Pahang,35,20,15,2020
2020-09-20,Pahang,85,12,73,2020
2020-09-21,Pahang,24,1,23,2020
2020-09-22,Pahang,57,12,45,2020
2020-09-23,Pahang,62,24,38,2020
2020-09-24,Pahang,131,49,82,2020
2020-09-25,Pahang,15,3,12,2020
2020-09-26,Pahang,39,14,25,2020
2020-09-27,Pahang,94,22,72,2020
2020-09-28,Pahang,42,5,37,2020
2020-09-29,Pahang,40,10,30,2020
2020-09-30,Pahang,105,63,42,2020
2020-10-01,Pahang,185,68,117,2020
2020-10-02,Pahang,12,1,11,2020
2020-10-03,Pahang,33,5,28,2020
2020-10-04,Pahang,97,18,79,2020
2020-10-05,Pahang,13,4,9,2020
2020-10-06,Pahang,34,6,28,2020
2020-10-07,Pahang,91,39,52,2020
2020-10-08,Pahang,69,22,47,2020
2020-10-09,Pahang,17,2,15,2020
2020-10-10,Pahang,56,9,47,2020
2020-10-11,Pahang,193,56,137,2020
2020-10-12,Pahang,14,0,14,2020
2020-10-13,Pahang,169,56,113,2020
2020-10-14,Pahang,103,19,84,2020
2020-10-15,Pahang,22,5,17,2020
2020-10-16,Pahang,48,3,45,2020
2020-10-17,Pahang,234,51,183,2020
2020-10-18,Pahang,195,38,157,2020
2020-10-19,Pahang,18,4,14,2020
2020-10-20,Pahang,12,1,11,2020
2020-10-21,Pahang,44,9,35,2020
2020-10-22,Pahang,86,19,67,2020
2020-10-23,Pahang,17,4,13,2020
2020-10-24,Pahang,41,9,32,2020
2020-10-25,Pahang,158,26,132,2020
2020-10-26,Pahang,19,1,18,2020
2020-10-27,Pahang,42,8,34,2020
2020-10-28,Pahang,72,31,41,2020
2020-10-29,Pahang,0,0,0,2020
2020-10-30,Pahang,24,2,22,2020
2020-10-31,Pahang,0,0,0,2020
2020-11-01,Pahang,129,35,94,2020
2020-11-02,Pahang,21,0,21,2020
2020-11-03,Pahang,69,25,44,2020
2020-11-04,Pahang,30,8,22,2020
2020-11-05,Pahang,71,18,53,2020
2020-11-06,Pahang,35,0,35,2020
2020-11-07,Pahang,83,34,49,2020
2020-11-08,Pahang,100,21,79,2020
2020-11-09,Pahang,20,3,17,2020
2020-11-10,Pahang,49,15,34,2020
2020-11-11,Pahang,150,46,104,2020
2020-11-12,Pahang,49,14,35,2020
2020-11-13,Pahang,11,0,11,2020
2020-11-14,Pahang,128,31,97,2020
2020-11-15,Pahang,119,20,99,2020
2020-11-16,Pahang,35,8,27,2020
2020-11-17,Pahang,8,0,8,2020
2020-11-18,Pahang,56,10,46,2020
2020-11-19,Pahang,116,31,85,2020
2020-11-20,Pahang,14,2,12,2020
2020-11-21,Pahang,95,22,73,2020
2020-11-22,Pahang,136,20,116,2020
2020-11-23,Pahang,22,4,18,2020
2020-11-24,Pahang,87,38,49,2020
2020-11-25,Pahang,49,15,34,2020
2020-11-26,Pahang,109,30,79,2020
2020-11-27,Pahang,74,14,60,2020
2020-11-28,Pahang,55,5,50,2020
2020-11-29,Pahang,132,27,105,2020
2020-11-30,Pahang,20,5,15,2020
2020-12-01,Pahang,86,34,52,2020
2020-12-02,Pahang,20,1,19,2020
2020-12-03,Pahang,112,43,69,2020
2020-12-04,Pahang,19,1,18,2020
2020-12-05,Pahang,57,9,48,2020
2020-12-06,Pahang,174,18,156,2020
2020-12-07,Pahang,17,2,15,2020
2020-12-08,Pahang,29,8,21,2020
2020-12-09,Pahang,46,2,44,2020
2020-12-10,Pahang,81,5,76,2020
2020-12-11,Pahang,18,2,16,2020
2020-12-12,Pahang,36,10,26,2020
2020-12-13,Pahang,232,61,171,2020
2020-12-14,Pahang,11,2,9,2020
2020-12-15,Pahang,99,38,61,2020
2020-12-16,Pahang,19,4,15,2020
2020-12-17,Pahang,83,19,64,2020
2020-12-18,Pahang,15,3,12,2020
2020-12-19,Pahang,64,17,47,2020
2020-12-20,Pahang,219,33,186,2020
2020-12-21,Pahang,14,0,14,2020
2020-12-22,Pahang,15,0,15,2020
2020-12-23,Pahang,54,16,38,2020
2020-12-24,Pahang,60,13,47,2020
2020-12-25,Pahang,0,0,0,2020
2020-12-26,Pahang,0,0,0,2020
2020-12-27,Pahang,120,16,104,2020
2020-12-28,Pahang,20,0,20,2020
2020-12-29,Pahang,53,11,42,2020
2020-12-30,Pahang,51,7,44,2020
2020-12-31,Pahang,57,7,50,2020
2021-01-01,Pahang,52,9,43,2021
2021-01-02,Pahang,0,0,0,2021
2021-01-03,Pahang,46,10,36,2021
2021-01-04,Pahang,12,1,11,2021
2021-01-05,Pahang,10,0,10,2021
2021-01-06,Pahang,28,5,23,2021
2021-01-07,Pahang,79,19,60,2021
2021-01-08,Pahang,15,1,14,2021
2021-01-09,Pahang,55,15,40,2021
2021-01-10,Pahang,90,22,68,2021
2021-01-11,Pahang,41,4,37,2021
2021-01-12,Pahang,14,2,12,2021
2021-01-13,Pahang,77,28,49,2021
2021-01-14,Pahang,17,3,14,2021
2021-01-15,Pahang,21,2,19,2021
2021-01-16,Pahang,131,33,98,2021
2021-01-17,Pahang,142,27,115,2021
2021-01-18,Pahang,27,6,21,2021
2021-01-19,Pahang,53,12,41,2021
2021-01-20,Pahang,61,20,41,2021
2021-01-21,Pahang,25,2,23,2021
2021-01-22,Pahang,88,24,64,2021
2021-01-23,Pahang,42,1,41,2021
2021-01-24,Pahang,84,13,71,2021
2021-01-25,Pahang,20,2,18,2021
2021-01-26,Pahang,30,6,24,2021
2021-01-27,Pahang,89,12,77,2021
2021-01-28,Pahang,34,6,28,2021
2021-01-29,Pahang,15,1,14,2021
2021-01-30,Pahang,39,7,32,2021
2021-01-31,Pahang,34,9,25,2021
2021-02-01,Pahang,55,23,32,2021
2021-02-02,Pahang,23,1,22,2021
2021-02-03,Pahang,114,22,92,2021
2021-02-04,Pahang,21,6,15,2021
2021-02-05,Pahang,8,1,7,2021
2021-02-06,Pahang,115,14,101,2021
2021-02-07,Pahang,29,4,25,2021
2021-02-08,Pahang,11,1,10,2021
2021-02-09,Pahang,79,25,54,2021
2021-02-10,Pahang,159,48,111,2021
2021-02-11,Pahang,26,3,23,2021
2021-02-12,Pahang,69,6,63,2021
2021-02-13,Pahang,88,20,68,2021
2021-02-14,Pahang,71,18,53,2021
2021-02-15,Pahang,20,3,17,2021
2021-02-16,Pahang,60,29,31,2021
2021-02-17,Pahang,61,17,44,2021
2021-02-18,Pahang,62,11,51,2021
2021-02-19,Pahang,13,0,13,2021
2021-02-20,Pahang,78,14,64,2021
2021-02-21,Pahang,67,7,60,2021
2021-02-22,Pahang,42,4,38,2021
2021-02-23,Pahang,146,60,86,2021
2021-02-24,Pahang,78,26,52,2021
2021-02-25,Pahang,55,6,49,2021
2021-02-26,Pahang,16,2,14,2021
2021-02-27,Pahang,128,21,107,2021
2021-02-28,Pahang,147,28,119,2021
2021-03-01,Pahang,52,19,33,2021
2021-03-02,Pahang,69,17,52,2021
2021-03-03,Pahang,96,38,58,2021
2021-03-04,Pahang,21,3,18,2021
2021-03-05,Pahang,24,1,23,2021
2021-03-06,Pahang,72,10,62,2021
2021-03-07,Pahang,200,18,182,2021
2021-03-08,Pahang,19,2,17,2021
2021-03-09,Pahang,39,4,35,2021
2021-03-10,Pahang,21,0,21,2021
2021-03-11,Pahang,110,27,83,2021
2021-03-12,Pahang,26,4,22,2021
2021-03-13,Pahang,79,9,70,2021
2021-03-14,Pahang,233,49,184,2021
2021-03-15,Pahang,13,0,13,2021
2021-03-16,Pahang,151,78,73,2021
2021-03-17,Pahang,141,42,99,2021
2021-03-18,Pahang,104,21,83,2021
2021-03-19,Pahang,115,39,76,2021
2021-03-20,Pahang,57,16,41,2021
2021-03-21,Pahang,112,28,84,2021
2021-03-22,Pahang,22,2,20,2021
2021-03-23,Pahang,76,24,52,2021
2021-03-24,Pahang,31,3,28,2021
2021-03-25,Pahang,40,12,28,2021
2021-03-26,Pahang,15,0,15,2021
2021-03-27,Pahang,64,9,55,2021
2021-03-28,Pahang,138,37,101,2021
2021-03-29,Pahang,18,1,17,2021
2021-03-30,Pahang,15,2,13,2021
2021-03-31,Pahang,155,32,123,2021
2021-04-01,Pahang,87,26,61,2021
2021-04-02,Pahang,15,0,15,2021
2021-04-03,Pahang,0,0,0,2021
2021-04-04,Pahang,187,46,141,2021
2021-04-05,Pahang,14,2,12,2021
2021-04-06,Pahang,103,47,56,2021
2021-04-07,Pahang,83,21,62,2021
2021-04-08,Pahang,120,37,83,2021
2021-04-09,Pahang,14,1,13,2021
2021-04-10,Pahang,102,17,85,2021
2021-04-11,Pahang,177,25,152,2021
2021-04-12,Pahang,32,6,26,2021
2021-04-13,Pahang,4,0,4,2021
2021-04-14,Pahang,8,0,8,2021
2021-04-15,Pahang,66,11,55,2021
2021-04-16,Pahang,26,4,22,2021
2021-04-17,Pahang,0,0,0,2021
2021-04-18,Pahang,169,18,151,2021
2021-04-19,Pahang,3,0,3,2021
2021-04-20,Pahang,7,1,6,2021
2021-04-21,Pahang,10,3,7,2021
2021-04-22,Pahang,26,2,24,2021
2021-04-23,Pahang,50,8,42,2021
2021-04-24,Pahang,26,4,22,2021
2021-04-25,Pahang,196,46,150,2021
2021-04-26,Pahang,4,0,4,2021
2021-04-27,Pahang,119,70,49,2021
2021-04-28,Pahang,90,33,57,2021
2021-04-29,Pahang,97,15,82,2021
2021-04-30,Pahang,4,0,4,2021
2021-05-01,Pahang,162,15,147,2021
2021-05-02,Pahang,65,7,58,2021
2021-05-03,Pahang,3,0,3,2021
2021-05-04,Pahang,118,29,89,2021
2021-05-05,Pahang,64,21,43,2021
2021-05-06,Pahang,56,10,46,2021
2021-05-07,Pahang,67,6,61,2021
2021-05-08,Pahang,74,11,63,2021
2021-05-09,Pahang,171,40,131,2021
2021-05-10,Pahang,3,1,2,2021
2021-05-11,Pahang,86,14,72,2021
2021-05-12,Pahang,5,0,5,2021
2021-05-13,Pahang,0,0,0,2021
2021-05-14,Pahang,0,0,0,2021
2021-05-15,Pahang,0,0,0,2021
2021-05-16,Pahang,125,20,105,2021
2021-05-17,Pahang,34,3,31,2021
2021-05-18,Pahang,25,1,24,2021
2021-05-19,Pahang,100,21,79,2021
2021-05-20,Pahang,34,5,29,2021
2021-05-21,Pahang,30,4,26,2021
2021-05-22,Pahang,119,24,95,2021
2021-05-23,Pahang,130,21,109,2021
2021-05-24,Pahang,23,1,22,2021
2021-05-25,Pahang,27,7,20,2021
2021-05-26,Pahang,105,13,92,2021
2021-05-27,Pahang,25,1,24,2021
2021-05-28,Pahang,23,1,22,2021
2021-05-29,Pahang,70,9,61,2021
2021-05-30,Pahang,35,7,28,2021
2021-05-31,Pahang,40,5,35,2021
2021-06-01,Pahang,30,1,29,2021
2021-06-02,Pahang,43,2,41,2021
2021-06-03,Pahang,126,15,111,2021
2021-06-04,Pahang,48,8,40,2021
2021-06-05,Pahang,157,34,123,2021
2021-06-06,Pahang,192,33,159,2021
2021-06-07,Pahang,139,47,92,2021
2021-06-08,Pahang,29,4,25,2021
2021-06-09,Pahang,83,25,58,2021
2021-06-10,Pahang,179,61,118,2021
2021-06-11,Pahang,45,9,36,2021
2021-06-12,Pahang,117,18,99,2021
2021-06-13,Pahang,91,20,71,2021
2021-06-14,Pahang,41,5,36,2021
2021-06-15,Pahang,28,4,24,2021
2021-06-16,Pahang,27,5,22,2021
2021-06-17,Pahang,147,46,101,2021
2021-06-18,Pahang,20,2,18,2021
2021-06-19,Pahang,131,29,102,2021
2021-06-20,Pahang,117,20,97,2021
2021-06-21,Pahang,17,3,14,2021
2021-06-22,Pahang,14,0,14,2021
2021-06-23,Pahang,18,4,14,2021
2021-06-24,Pahang,24,2,22,2021
2021-06-25,Pahang,18,2,16,2021
2021-06-26,Pahang,0,0,0,2021
2021-06-27,Pahang,0,0,0,2021
2021-06-28,Pahang,22,2,20,2021
2021-06-29,Pahang,157,27,130,2021
2021-06-30,Pahang,18,2,16,2021
2021-07-01,Pahang,79,18,61,2021
2021-07-02,Pahang,17,3,14,2021
2021-07-03,Pahang,89,27,62,2021
2021-07-04,Pahang,156,34,122,2021
2021-07-05,Pahang,16,2,14,2021
2021-07-06,Pahang,10,0,10,2021
2021-07-07,Pahang,88,14,74,2021
2021-07-08,Pahang,16,0,16,2021
2021-07-09,Pahang,21,1,20,2021
2021-07-10,Pahang,56,6,50,2021
2021-07-11,Pahang,74,8,66,2021
2021-07-12,Pahang,11,1,10,2021
2021-07-13,Pahang,22,3,19,2021
2021-07-14,Pahang,74,22,52,2021
2021-07-15,Pahang,96,41,55,2021
2021-07-16,Pahang,13,2,11,2021
2021-07-17,Pahang,71,6,65,2021
2021-07-18,Pahang,72,10,62,2021
2021-07-19,Pahang,10,0,10,2021
2021-07-20,Pahang,0,0,0,2021
2021-07-21,Pahang,19,2,17,2021
2021-07-22,Pahang,106,15,91,2021
2021-07-23,Pahang,9,2,7,2021
2021-07-24,Pahang,53,8,45,2021
2021-07-25,Pahang,63,3,60,2021
2021-07-26,Pahang,80,22,58,2021
2021-07-27,Pahang,16,3,13,2021
2021-07-28,Pahang,65,17,48,2021
2021-07-29,Pahang,24,1,23,2021
2021-07-30,Pahang,93,14,79,2021
2021-07-31,Pahang,75,16,59,2021
2021-08-01,Pahang,40,5,35,2021
2021-08-02,Pahang,19,2,17,2021
2021-08-03,Pahang,73,14,59,2021
2021-08-04,Pahang,88,33,55,2021
2021-08-05,Pahang,92,14,78,2021
2021-08-06,Pahang,31,8,23,2021
2021-08-07,Pahang,124,20,104,2021
2021-08-08,Pahang,89,10,79,2021
2021-08-09,Pahang,21,2,19,2021
2021-08-10,Pahang,99,15,84,2021
2021-08-11,Pahang,16,0,16,2021
2021-08-12,Pahang,20,8,12,2021
2021-08-13,Pahang,16,0,16,2021
2021-08-14,Pahang,102,21,81,2021
2021-08-15,Pahang,114,20,94,2021
2021-08-16,Pahang,22,2,20,2021
2021-08-17,Pahang,13,1,12,2021
2021-08-18,Pahang,79,42,37,2021
2021-08-19,Pahang,10,0,10,2021
2021-08-20,Pahang,11,0,11,2021
2021-08-21,Pahang,60,12,48,2021
2021-08-22,Pahang,83,21,62,2021
2021-08-23,Pahang,48,1,47,2021
2021-08-24,Pahang,102,57,45,2021
2021-08-25,Pahang,23,2,21,2021
2021-08-26,Pahang,22,1,21,2021
2021-08-27,Pahang,32,5,27,2021
2021-08-28,Pahang,145,33,112,2021
2021-08-29,Pahang,125,14,111,2021
2021-08-30,Pahang,93,30,63,2021
2021-08-31,Pahang,151,39,112,2021
2021-09-01,Pahang,17,3,14,2021
2021-09-02,Pahang,75,29,46,2021
2021-09-03,Pahang,28,1,27,2021
2021-09-04,Pahang,86,18,68,2021
2021-09-05,Pahang,163,18,145,2021
2021-09-06,Pahang,34,2,32,2021
2021-09-07,Pahang,165,67,98,2021
2021-09-08,Pahang,27,5,22,2021
2021-09-09,Pahang,98,15,83,2021
2021-09-10,Pahang,30,5,25,2021
2021-09-11,Pahang,61,15,46,2021
2021-09-12,Pahang,145,20,125,2021
2021-09-13,Pahang,13,0,13,2021
2021-09-14,Pahang,35,1,34,2021
2021-09-15,Pahang,22,2,20,2021
2021-09-16,Pahang,173,38,135,2021
2021-09-17,Pahang,19,0,19,2021
2021-09-18,Pahang,49,15,34,2021
2021-09-19,Pahang,145,28,117,2021
2021-09-20,Pahang,11,1,10,2021
2021-09-21,Pahang,24,1,23,2021
2021-09-22,Pahang,58,11,47,2021
2021-09-23,Pahang,26,7,19,2021
2021-09-24,Pahang,13,1,12,2021
2021-09-25,Pahang,52,13,39,2021
2021-09-26,Pahang,77,14,63,2021
2021-09-27,Pahang,14,2,12,2021
2021-09-28,Pahang,88,13,75,2021
2021-09-29,Pahang,66,12,54,2021
2021-09-30,Pahang,21,2,19,2021
2021-10-01,Pahang,53,13,40,2021
2021-10-02,Pahang,55,10,45,2021
2021-10-03,Pahang,145,29,116,2021
2021-10-04,Pahang,18,0,18,2021
2021-10-05,Pahang,24,4,20,2021
2021-10-06,Pahang,93,20,73,2021
2021-10-07,Pahang,77,4,73,2021
2021-10-08,Pahang,21,2,19,2021
2021-10-09,Pahang,110,10,100,2021
2021-10-10,Pahang,142,28,114,2021
2021-10-11,Pahang,17,2,15,2021
2021-10-12,Pahang,45,9,36,2021
2021-10-13,Pahang,64,15,49,2021
2021-10-14,Pahang,21,2,19,2021
2021-10-15,Pahang,38,5,33,2021
2021-10-16,Pahang,64,3,61,2021
2021-10-17,Pahang,117,17,100,2021
2021-10-18,Pahang,21,2,19,2021
2021-10-19,Pahang,145,27,118,2021
2021-10-20,Pahang,18,2,16,2021
2021-10-21,Pahang,51,5,46,2021
2021-10-22,Pahang,14,3,11,2021
2021-10-23,Pahang,69,10,59,2021
2021-10-24,Pahang,175,25,150,2021
2021-10-25,Pahang,21,3,18,2021
2021-10-26,Pahang,25,1,24,2021
2021-10-27,Pahang,111,28,83,2021
2021-10-28,Pahang,76,17,59,2021
2021-10-29,Pahang,45,15,30,2021
2021-10-30,Pahang,27,1,26,2021
2021-10-31,Pahang,82,16,66,2021
2021-11-01,Pahang,40,7,33,2021
2021-11-02,Pahang,102,47,55,2021
2021-11-03,Pahang,32,0,32,2021
2021-11-04,Pahang,123,22,101,2021
2021-11-05,Pahang,61,21,40,2021
2021-11-06,Pahang,95,13,82,2021
2021-11-07,Pahang,131,18,113,2021
2021-11-08,Pahang,21,0,21,2021
2021-11-09,Pahang,40,9,31,2021
2021-11-10,Pahang,80,29,51,2021
2021-11-11,Pahang,83,17,66,2021
2021-11-12,Pahang,17,0,17,2021
2021-11-13,Pahang,34,2,32,2021
2021-11-14,Pahang,136,15,121,2021
2021-11-15,Pahang,18,3,15,2021
2021-11-16,Pahang,16,2,14,2021
2021-11-17,Pahang,182,68,114,2021
2021-11-18,Pahang,70,22,48,2021
2021-11-19,Pahang,103,11,92,2021
2021-11-20,Pahang,49,20,29,2021
2021-11-21,Pahang,210,43,167,2021
2021-11-22,Pahang,33,11,22,2021
2021-11-23,Pahang,20,3,17,2021
2021-11-24,Pahang,58,14,44,2021
2021-11-25,Pahang,155,53,102,2021
2021-11-26,Pahang,20,6,14,2021
2021-11-27,Pahang,106,14,92,2021
2021-11-28,Pahang,89,21,68,2021
2021-11-29,Pahang,23,3,20,2021
2021-11-30,Pahang,83,36,47,2021
2021-12-01,Pahang,65,15,50,2021
2021-12-02,Pahang,22,2,20,2021
2021-12-03,Pahang,13,2,11,2021
2021-12-04,Pahang,97,52,45,2021
2021-12-05,Pahang,141,29,112,2021
2021-12-06,Pahang,17,1,16,2021
2021-12-07,Pahang,87,16,71,2021
2021-12-08,Pahang,17,1,16,2021
2021-12-09,Pahang,53,10,43,2021
2021-12-10,Pahang,14,0,14,2021
2021-12-11,Pahang,65,8,57,2021
2021-12-12,Pahang,140,21,119,2021
2021-12-13,Pahang,17,0,17,2021
2021-12-14,Pahang,126,67,59,2021
2021-12-15,Pahang,160,69,91,2021
2021-12-16,Pahang,12,0,12,2021
2021-12-17,Pahang,27,1,26,2021
2021-12-18,Pahang,88,18,70,2021
2021-12-19,Pahang,72,12,60,2021
2021-12-20,Pahang,22,2,20,2021
2021-12-21,Pahang,14,1,13,2021
2021-12-22,Pahang,79,15,64,2021
2021-12-23,Pahang,11,0,11,2021
2021-12-24,Pahang,15,0,15,2021
2021-12-25,Pahang,50,8,42,2021
2021-12-26,Pahang,140,26,114,2021
2021-12-27,Pahang,18,2,16,2021
2021-12-28,Pahang,22,0,22,2021
2021-12-29,Pahang,188,38,150,2021
2021-12-30,Pahang,21,1,20,2021
2021-12-31,Pahang,33,2,31,2021
2022-01-01,Pahang,134,19,115,2022
2022-01-02,Pahang,107,12,95,2022
2022-01-03,Pahang,17,2,15,2022
2022-01-04,Pahang,64,15,49,2022
2022-01-05,Pahang,77,11,66,2022
2022-01-06,Pahang,69,13,56,2022
2022-01-07,Pahang,14,3,11,2022
2022-01-08,Pahang,85,80,5,2022
2022-01-09,Pahang,178,29,149,2022
2022-01-10,Pahang,17,1,16,2022
2022-01-11,Pahang,34,2,32,2022
2022-01-12,Pahang,60,6,54,2022
2022-01-13,Pahang,98,47,51,2022
2022-01-14,Pahang,12,1,11,2022
2022-01-15,Pahang,63,31,32,2022
2022-01-16,Pahang,173,79,94,2022
2022-01-17,Pahang,20,3,17,2022
2022-01-18,Pahang,146,69,77,2022
2022-01-19,Pahang,16,5,11,2022
2022-01-20,Pahang,158,100,58,2022
2022-01-21,Pahang,20,1,19,2022
2022-01-22,Pahang,67,9,58,2022
2022-01-23,Pahang,145,35,110,2022
2022-01-24,Pahang,24,3,21,2022
2022-01-25,Pahang,143,96,47,2022
2022-01-26,Pahang,137,46,91,2022
2022-01-27,Pahang,84,31,53,2022
2022-01-28,Pahang,15,2,13,2022
2022-01-29,Pahang,32,5,27,2022
2022-01-30,Pahang,71,10,61,2022
2022-01-31,Pahang,29,2,27,2022
2022-02-01,Pahang,21,3,18,2022
2022-02-02,Pahang,22,3,19,2022
2022-02-03,Pahang,55,14,41,2022
2022-02-04,Pahang,13,1,12,2022
2022-02-05,Pahang,43,3,40,2022
2022-02-06,Pahang,81,6,75,2022
2022-02-07,Pahang,19,1,18,2022
2022-02-08,Pahang,153,59,94,2022
2022-02-09,Pahang,21,0,21,2022
2022-02-10,Pahang,36,17,19,2022
2022-02-11,Pahang,5,0,5,2022
2022-02-12,Pahang,135,20,115,2022
2022-02-13,Pahang,103,25,78,2022
2022-02-14,Pahang,6,0,6,2022
2022-02-15,Pahang,63,14,49,2022
2022-02-16,Pahang,16,2,14,2022
2022-02-17,Pahang,47,3,44,2022
2022-02-18,Pahang,33,3,30,2022
2022-02-19,Pahang,115,20,95,2022
2022-02-20,Pahang,120,24,96,2022
2022-02-21,Pahang,32,1,31,2022
2022-02-22,Pahang,35,2,33,2022
2022-02-23,Pahang,30,4,26,2022
2022-02-24,Pahang,77,10,67,2022
2022-02-25,Pahang,77,8,69,2022
2022-02-26,Pahang,116,11,105,2022
2022-02-27,Pahang,102,25,77,2022
2022-02-28,Pahang,66,11,55,2022
2022-03-01,Pahang,61,11,50,2022
2022-03-02,Pahang,19,0,19,2022
2022-03-03,Pahang,150,69,81,2022
2022-03-04,Pahang,16,2,14,2022
2022-03-05,Pahang,56,5,51,2022
2022-03-06,Pahang,148,24,124,2022
2022-03-07,Pahang,14,0,14,2022
2022-03-08,Pahang,30,10,20,2022
2022-03-09,Pahang,48,25,23,2022
2022-03-10,Pahang,60,12,48,2022
2022-03-11,Pahang,17,1,16,2022
2022-03-12,Pahang,113,18,95,2022
2022-03-13,Pahang,66,7,59,2022
2022-03-14,Pahang,9,0,9,2022
2022-03-15,Pahang,53,10,43,2022
2022-03-16,Pahang,60,21,39,2022
2022-03-17,Pahang,47,21,26,2022
2022-03-18,Pahang,14,1,13,2022
2022-03-19,Pahang,59,21,38,2022
2022-03-20,Pahang,77,25,52,2022
2022-03-21,Pahang,20,1,19,2022
2022-03-22,Pahang,70,28,42,2022
2022-03-23,Pahang,80,19,61,2022
2022-03-24,Pahang,63,15,48,2022
2022-03-25,Pahang,123,72,51,2022
2022-03-26,Pahang,61,17,44,2022
2022-03-27,Pahang,115,25,90,2022
2022-03-28,Pahang,95,25,70,2022
2022-03-29,Pahang,150,56,94,2022
2022-03-30,Pahang,69,38,31,2022
2022-03-31,Pahang,276,126,150,2022
2022-04-01,Pahang,66,6,60,2022
2022-04-02,Pahang,162,37,125,2022
2022-04-03,Pahang,122,25,97,2022
2022-04-04,Pahang,6,0,6,2022
2022-04-05,Pahang,7,0,7,2022
2022-04-06,Pahang,31,4,27,2022
2022-04-07,Pahang,43,11,32,2022
2022-04-08,Pahang,6,1,5,2022
2022-04-09,Pahang,165,64,101,2022
2022-04-10,Pahang,91,14,77,2022
2022-04-11,Pahang,5,0,5,2022
2022-04-12,Pahang,30,4,26,2022
2022-04-13,Pahang,30,1,29,2022
2022-04-14,Pahang,59,5,54,2022
2022-04-15,Pahang,8,0,8,2022
2022-04-16,Pahang,81,31,50,2022
2022-04-17,Pahang,164,24,140,2022
2022-04-18,Pahang,6,1,5,2022
2022-04-19,Pahang,35,5,30,2022
2022-04-20,Pahang,9,0,9,2022
2022-04-21,Pahang,44,8,36,2022
2022-04-22,Pahang,31,16,15,2022
2022-04-23,Pahang,81,18,63,2022
2022-04-24,Pahang,180,35,145,2022
2022-04-25,Pahang,6,0,6,2022
2022-04-26,Pahang,57,8,49,2022
2022-04-27,Pahang,25,1,24,2022
2022-04-28,Pahang,110,9,101,2022
2022-04-29,Pahang,75,12,63,2022
2022-04-30,Pahang,37,5,32,2022
2022-05-01,Pahang,83,16,67,2022
2022-05-02,Pahang,0,0,0,2022
2022-05-03,Pahang,0,0,0,2022
2022-05-04,Pahang,0,0,0,2022
2022-05-05,Pahang,54,11,43,2022
2022-05-06,Pahang,24,2,22,2022
2022-05-07,Pahang,64,12,52,2022
2022-05-08,Pahang,81,12,69,2022
2022-05-09,Pahang,20,1,19,2022
2022-05-10,Pahang,161,68,93,2022
2022-05-11,Pahang,37,5,32,2022
2022-05-12,Pahang,97,44,53,2022
2022-05-13,Pahang,19,2,17,2022
2022-05-14,Pahang,75,7,68,2022
2022-05-15,Pahang,112,69,43,2022
2022-05-16,Pahang,105,30,75,2022
2022-05-17,Pahang,18,1,17,2022
2022-05-18,Pahang,93,10,83,2022
2022-05-19,Pahang,90,21,69,2022
2022-05-20,Pahang,59,30,29,2022
2022-05-21,Pahang,95,24,71,2022
2022-05-22,Pahang,154,20,134,2022
2022-05-23,Pahang,90,24,66,2022
2022-05-24,Pahang,21,1,20,2022
2022-05-25,Pahang,136,41,95,2022
2022-05-26,Pahang,139,29,110,2022
2022-05-27,Pahang,47,9,38,2022
2022-05-28,Pahang,77,12,65,2022
2022-05-29,Pahang,206,50,156,2022
2022-05-30,Pahang,16,0,16,2022
2022-05-31,Pahang,48,29,19,2022
2022-06-01,Pahang,201,50,151,2022
2022-06-02,Pahang,13,2,11,2022
2022-06-03,Pahang,78,20,58,2022
2022-06-04,Pahang,58,11,47,2022
2022-06-05,Pahang,132,23,109,2022
2022-06-06,Pahang,119,24,95,2022
2022-06-07,Pahang,73,17,56,2022
2022-06-08,Pahang,55,12,43,2022
2022-06-09,Pahang,68,19,49,2022
2022-06-10,Pahang,145,56,89,2022
2022-06-11,Pahang,50,8,42,2022
2022-06-12,Pahang,135,19,116,2022
2022-06-13,Pahang,18,3,15,2022
2022-06-14,Pahang,161,36,125,2022
2022-06-15,Pahang,108,18,90,2022
2022-06-16,Pahang,55,7,48,2022
2022-06-17,Pahang,29,2,27,2022
2022-06-18,Pahang,58,16,42,2022
2022-06-19,Pahang,120,12,108,2022
2022-06-20,Pahang,23,1,22,2022
2022-06-21,Pahang,21,1,20,2022
2022-06-22,Pahang,116,50,66,2022
2022-06-23,Pahang,124,94,30,2022
2022-06-24,Pahang,35,4,31,2022
2022-06-25,Pahang,38,11,27,2022
2022-06-26,Pahang,109,19,90,2022
2022-06-27,Pahang,23,0,23,2022
2022-06-28,Pahang,13,0,13,2022
2022-06-29,Pahang,43,9,34,2022
2022-06-30,Pahang,24,1,23,2022
2022-07-01,Pahang,22,1,21,2022
2022-07-02,Pahang,206,148,58,2022
2022-07-03,Pahang,60,8,52,2022
2022-07-04,Pahang,22,2,20,2022
2022-07-05,Pahang,99,37,62,2022
2022-07-06,Pahang,111,50,61,2022
2022-07-07,Pahang,139,25,114,2022
2022-07-08,Pahang,91,16,75,2022
2022-07-09,Pahang,0,0,0,2022
2022-07-10,Pahang,0,0,0,2022
2022-07-11,Pahang,0,0,0,2022
2022-07-12,Pahang,48,4,44,2022
2022-07-13,Pahang,61,35,26,2022
2022-07-14,Pahang,82,8,74,2022
2022-07-15,Pahang,18,1,17,2022
2022-07-16,Pahang,65,5,60,2022
2022-07-17,Pahang,163,22,141,2022
2022-07-18,Pahang,12,0,12,2022
2022-07-19,Pahang,13,0,13,2022
2022-07-20,Pahang,42,15,27,2022
2022-07-21,Pahang,97,28,69,2022
2022-07-22,Pahang,20,1,19,2022
2022-07-23,Pahang,37,4,33,2022
2022-07-24,Pahang,103,15,88,2022
2022-07-25,Pahang,17,2,15,2022
2022-07-26,Pahang,20,4,16,2022
2022-07-27,Pahang,30,13,17,2022
2022-07-28,Pahang,148,39,109,2022
2022-07-29,Pahang,16,1,15,2022
2022-07-30,Pahang,50,8,42,2022
2022-07-31,Pahang,65,6,59,2022
2022-08-01,Pahang,9,0,9,2022
2022-08-02,Pahang,17,0,17,2022
2022-08-03,Pahang,56,12,44,2022
2022-08-04,Pahang,9,2,7,2022
2022-08-05,Pahang,40,13,27,2022
2022-08-06,Pahang,84,18,66,2022
2022-08-07,Pahang,108,21,87,2022
2022-08-08,Pahang,17,3,14,2022
2022-08-09,Pahang,60,34,26,2022
2022-08-10,Pahang,91,22,69,2022
2022-08-11,Pahang,37,15,22,2022
2022-08-12,Pahang,18,3,15,2022
2022-08-13,Pahang,107,26,81,2022
2022-08-14,Pahang,138,13,125,2022
2022-08-15,Pahang,23,3,20,2022
2022-08-16,Pahang,33,7,26,2022
2022-08-17,Pahang,134,32,102,2022
2022-08-18,Pahang,69,13,56,2022
2022-08-19,Pahang,11,2,9,2022
2022-08-20,Pahang,144,36,108,2022
2022-08-21,Pahang,127,24,103,2022
2022-08-22,Pahang,11,1,10,2022
2022-08-23,Pahang,43,7,36,2022
2022-08-24,Pahang,45,28,17,2022
2022-08-25,Pahang,64,41,23,2022
2022-08-26,Pahang,24,6,18,2022
2022-08-27,Pahang,78,10,68,2022
2022-08-28,Pahang,104,21,83,2022
2022-08-29,Pahang,11,1,10,2022
2022-08-30,Pahang,34,20,14,2022
2022-08-31,Pahang,163,30,133,2022
2022-09-01,Pahang,35,6,29,2022
2022-09-02,Pahang,6,0,6,2022
2022-09-03,Pahang,35,6,29,2022
2022-09-04,Pahang,154,25,129,2022
2022-09-05,Pahang,22,1,21,2022
2022-09-06,Pahang,57,35,22,2022
2022-09-07,Pahang,102,42,60,2022
2022-09-08,Pahang,107,26,81,2022
2022-09-09,Pahang,15,1,14,2022
2022-09-10,Pahang,92,20,72,2022
2022-09-11,Pahang,130,22,108,2022
2022-09-12,Pahang,18,2,16,2022
2022-09-13,Pahang,50,31,19,2022
2022-09-14,Pahang,63,39,24,2022
2022-09-15,Pahang,17,1,16,2022
2022-09-16,Pahang,171,29,142,2022
2022-09-17,Pahang,55,7,48,2022
2022-09-18,Pahang,72,7,65,2022
2022-09-19,Pahang,26,1,25,2022
2022-09-20,Pahang,64,12,52,2022
2022-09-21,Pahang,128,62,66,2022
2022-09-22,Pahang,89,63,26,2022
2022-09-23,Pahang,12,1,11,2022
2022-09-24,Pahang,40,8,32,2022
2022-09-25,Pahang,122,13,109,2022
2022-09-26,Pahang,20,2,18,2022
2022-09-27,Pahang,12,0,12,2022
2022-09-28,Pahang,24,3,21,2022
2022-09-29,Pahang,94,44,50,2022
2022-09-30,Pahang,23,2,21,2022
2022-10-01,Pahang,48,16,32,2022
2022-10-02,Pahang,106,18,88,2022
2022-10-03,Pahang,25,0,25,2022
2022-10-04,Pahang,59,8,51,2022
2022-10-05,Pahang,56,30,26,2022
2022-10-06,Pahang,14,2,12,2022
2022-10-07,Pahang,10,0,10,2022
2022-10-08,Pahang,58,15,43,2022
2022-10-09,Pahang,104,22,82,2022
2022-10-10,Pahang,92,17,75,2022
2022-10-11,Pahang,23,2,21,2022
2022-10-12,Pahang,41,12,29,2022
2022-10-13,Pahang,74,25,49,2022
2022-10-14,Pahang,17,1,16,2022
2022-10-15,Pahang,79,22,57,2022
2022-10-16,Pahang,129,17,112,2022
2022-10-17,Pahang,22,1,21,2022
2022-10-18,Pahang,144,50,94,2022
2022-10-19,Pahang,90,50,40,2022
2022-10-20,Pahang,18,1,17,2022
2022-10-21,Pahang,35,6,29,2022
2022-10-22,Pahang,56,22,34,2022
2022-10-23,Pahang,55,13,42,2022
2022-10-24,Pahang,92,19,73,2022
2022-10-25,Pahang,18,2,16,2022
2022-10-26,Pahang,44,9,35,2022
2022-10-27,Pahang,86,44,42,2022
2022-10-28,Pahang,13,0,13,2022
2022-10-29,Pahang,66,19,47,2022
2022-10-30,Pahang,101,15,86,2022
2022-10-31,Pahang,16,3,13,2022
2022-11-01,Pahang,16,1,15,2022
2022-11-02,Pahang,120,82,38,2022
2022-11-03,Pahang,175,58,117,2022
2022-11-04,Pahang,13,1,12,2022
2022-11-05,Pahang,212,147,65,2022
2022-11-06,Pahang,159,71,88,2022
2022-11-07,Pahang,8,2,6,2022
2022-11-08,Pahang,17,0,17,2022
2022-11-09,Pahang,17,2,15,2022
2022-11-10,Pahang,132,31,101,2022
2022-11-11,Pahang,14,0,14,2022
2022-11-12,Pahang,99,7,92,2022
2022-11-13,Pahang,120,23,97,2022
2022-11-14,Pahang,16,2,14,2022
2022-11-15,Pahang,66,13,53,2022
2022-11-16,Pahang,135,34,101,2022
2022-11-17,Pahang,19,1,18,2022
2022-11-18,Pahang,0,0,0,2022
2022-11-19,Pahang,0,0,0,2022
2022-11-20,Pahang,113,19,94,2022
2022-11-21,Pahang,20,4,16,2022
2022-11-22,Pahang,78,22,56,2022
2022-11-23,Pahang,104,37,67,2022
2022-11-24,Pahang,17,2,15,2022
2022-11-25,Pahang,11,0,11,2022
2022-11-26,Pahang,65,14,51,2022
2022-11-27,Pahang,75,17,58,2022
2022-11-28,Pahang,0,0,0,2022
2022-11-29,Pahang,111,29,82,2022
2022-11-30,Pahang,164,73,91,2022
2022-12-01,Pahang,161,85,76,2022
2022-12-02,Pahang,18,0,18,2022
2022-12-03,Pahang,57,12,45,2022
2022-12-04,Pahang,43,17,26,2022
2022-12-05,Pahang,14,0,14,2022
2022-12-06,Pahang,18,3,15,2022
2022-12-07,Pahang,66,25,41,2022
2022-12-08,Pahang,20,4,16,2022
2022-12-09,Pahang,22,0,22,2022
2022-12-10,Pahang,125,24,101,2022
2022-12-11,Pahang,145,17,128,2022
2022-12-12,Pahang,13,0,13,2022
2022-12-13,Pahang,14,1,13,2022
2022-12-14,Pahang,77,6,71,2022
2022-12-15,Pahang,38,12,26,2022
2022-12-16,Pahang,17,3,14,2022
2022-12-17,Pahang,83,7,76,2022
2022-12-18,Pahang,91,12,79,2022
2022-12-19,Pahang,22,0,22,2022
2022-12-20,Pahang,17,0,17,2022
2022-12-21,Pahang,91,11,80,2022
2022-12-22,Pahang,31,2,29,2022
2022-12-23,Pahang,15,0,15,2022
2022-12-24,Pahang,119,33,86,2022
2022-12-25,Pahang,116,24,92,2022
2022-12-26,Pahang,98,20,78,2022
2022-12-27,Pahang,30,1,29,2022
2022-12-28,Pahang,216,46,170,2022
2022-12-29,Pahang,28,8,20,2022
2022-12-30,Pahang,110,22,88,2022
2022-12-31,Pahang,0,0,0,2022
2023-01-01,Pahang,60,5,55,2023
2023-01-02,Pahang,49,8,41,2023
2023-01-03,Pahang,26,5,21,2023
2023-01-04,Pahang,215,102,113,2023
2023-01-05,Pahang,56,10,46,2023
2023-01-06,Pahang,26,0,26,2023
2023-01-07,Pahang,68,5,63,2023
2023-01-08,Pahang,85,18,67,2023
2023-01-09,Pahang,21,1,20,2023
2023-01-10,Pahang,62,11,51,2023
2023-01-11,Pahang,89,29,60,2023
2023-01-12,Pahang,61,10,51,2023
2023-01-13,Pahang,20,1,19,2023
2023-01-14,Pahang,34,3,31,2023
2023-01-15,Pahang,113,20,93,2023
2023-01-16,Pahang,20,1,19,2023
2023-01-17,Pahang,53,15,38,2023
2023-01-18,Pahang,34,24,10,2023
2023-01-19,Pahang,13,1,12,2023
2023-01-20,Pahang,28,1,27,2023
2023-01-21,Pahang,105,17,88,2023
2023-01-22,Pahang,0,0,0,2023
2023-01-23,Pahang,0,0,0,2023
2023-01-24,Pahang,70,10,60,2023
2023-01-25,Pahang,53,23,30,2023
2023-01-26,Pahang,50,7,43,2023
2023-01-27,Pahang,24,0,24,2023
2023-01-28,Pahang,114,102,12,2023
2023-01-29,Pahang,128,12,116,2023
2023-01-30,Pahang,6,0,6,2023
2023-01-31,Pahang,22,0,22,2023
2023-02-01,Pahang,123,24,99,2023
2023-02-02,Pahang,93,53,40,2023
2023-02-03,Pahang,12,2,10,2023
2023-02-04,Pahang,42,3,39,2023
2023-02-05,Pahang,130,18,112,2023
2023-02-06,Pahang,12,0,12,2023
2023-02-07,Pahang,86,20,66,2023
2023-02-08,Pahang,54,6,48,2023
2023-02-09,Pahang,21,1,20,2023
2023-02-10,Pahang,88,36,52,2023
2023-02-11,Pahang,108,24,84,2023
2023-02-12,Pahang,132,24,108,2023
2023-02-13,Pahang,21,0,21,2023
2023-02-14,Pahang,64,13,51,2023
2023-02-15,Pahang,101,22,79,2023
2023-02-16,Pahang,80,18,62,2023
2023-02-17,Pahang,29,0,29,2023
2023-02-18,Pahang,25,5,20,2023
2023-02-19,Pahang,103,21,82,2023
2023-02-20,Pahang,14,1,13,2023
2023-02-21,Pahang,128,60,68,2023
2023-02-22,Pahang,24,3,21,2023
2023-02-23,Pahang,87,17,70,2023
2023-02-24,Pahang,18,3,15,2023
2023-02-25,Pahang,97,96,1,2023
2023-02-26,Pahang,200,20,180,2023
2023-02-27,Pahang,22,0,22,2023
2023-02-28,Pahang,201,57,144,2023
2023-03-01,Pahang,82,45,37,2023
2023-03-02,Pahang,14,2,12,2023
2023-03-03,Pahang,62,20,42,2023
2023-03-04,Pahang,108,23,85,2023
2023-03-05,Pahang,131,16,115,2023
2023-03-06,Pahang,92,17,75,2023
2023-03-07,Pahang,18,2,16,2023
2023-03-08,Pahang,188,81,107,2023
2023-03-09,Pahang,47,15,32,2023
2023-03-10,Pahang,27,0,27,2023
2023-03-11,Pahang,92,21,71,2023
2023-03-12,Pahang,94,8,86,2023
2023-03-13,Pahang,19,1,18,2023
2023-03-14,Pahang,42,4,38,2023
2023-03-15,Pahang,108,30,78,2023
2023-03-16,Pahang,152,60,92,2023
2023-03-17,Pahang,34,4,30,2023
2023-03-18,Pahang,155,28,127,2023
2023-03-19,Pahang,135,22,113,2023
2023-03-20,Pahang,24,3,21,2023
2023-03-21,Pahang,239,88,151,2023
2023-03-22,Pahang,136,46,90,2023
2023-03-23,Pahang,1,0,1,2023
2023-03-24,Pahang,4,0,4,2023
2023-03-25,Pahang,40,16,24,2023
2023-03-26,Pahang,72,9,63,2023
2023-03-27,Pahang,63,14,49,2023
2023-03-28,Pahang,51,17,34,2023
2023-03-29,Pahang,7,1,6,2023
2023-03-30,Pahang,41,5,36,2023
2023-03-31,Pahang,51,14,37,2023
2023-04-01,Pahang,108,61,47,2023
2023-04-02,Pahang,140,37,103,2023
2023-04-03,Pahang,8,0,8,2023
2023-04-04,Pahang,55,19,36,2023
2023-04-05,Pahang,4,1,3,2023
2023-04-06,Pahang,49,7,42,2023
2023-04-07,Pahang,4,0,4,2023
2023-04-08,Pahang,35,4,31,2023
2023-04-09,Pahang,215,44,171,2023
2023-04-10,Pahang,9,1,8,2023
2023-04-11,Pahang,80,5,75,2023
2023-04-12,Pahang,47,3,44,2023
2023-04-13,Pahang,65,18,47,2023
2023-04-14,Pahang,36,14,22,2023
2023-04-15,Pahang,101,17,84,2023
2023-04-16,Pahang,190,36,154,2023
2023-04-17,Pahang,6,0,6,2023
2023-04-18,Pahang,42,4,38,2023
2023-04-19,Pahang,49,6,43,2023
2023-04-20,Pahang,40,4,36,2023
2023-04-21,Pahang,2,0,2,2023
2023-04-22,Pahang,0,0,0,2023
2023-04-23,Pahang,0,0,0,2023
2023-04-24,Pahang,0,0,0,2023
2023-04-25,Pahang,66,9,57,2023
2023-04-26,Pahang,27,2,25,2023
2023-04-27,Pahang,40,9,31,2023
2023-04-28,Pahang,19,1,18,2023
2023-04-29,Pahang,69,21,48,2023
2023-04-30,Pahang,46,5,41,2023
2023-05-01,Pahang,130,32,98,2023
2023-05-02,Pahang,20,2,18,2023
2023-05-03,Pahang,136,57,79,2023
2023-05-04,Pahang,91,7,84,2023
2023-05-05,Pahang,27,3,24,2023
2023-05-06,Pahang,84,13,71,2023
2023-05-07,Pahang,114,13,101,2023
2023-05-08,Pahang,11,0,11,2023
2023-05-09,Pahang,107,24,83,2023
2023-05-10,Pahang,75,30,45,2023
2023-05-11,Pahang,99,28,71,2023
2023-05-12,Pahang,21,2,19,2023
2023-05-13,Pahang,102,48,54,2023
2023-05-14,Pahang,123,31,92,2023
2023-05-15,Pahang,19,6,13,2023
2023-05-16,Pahang,162,69,93,2023
2023-05-17,Pahang,120,71,49,2023
2023-05-18,Pahang,79,18,61,2023
2023-05-19,Pahang,13,1,12,2023
2023-05-20,Pahang,77,65,12,2023
2023-05-21,Pahang,186,94,92,2023
2023-05-22,Pahang,67,12,55,2023
2023-05-23,Pahang,39,16,23,2023
2023-05-24,Pahang,120,37,83,2023
2023-05-25,Pahang,8,3,5,2023
2023-05-26,Pahang,10,0,10,2023
2023-05-27,Pahang,45,4,41,2023
2023-05-28,Pahang,160,34,126,2023
2023-05-29,Pahang,18,5,13,2023
2023-05-30,Pahang,57,19,38,2023
2023-05-31,Pahang,63,28,35,2023
2023-06-01,Pahang,62,12,50,2023
2023-06-02,Pahang,27,4,23,2023
2023-06-03,Pahang,102,26,76,2023
2023-06-04,Pahang,59,11,48,2023
2023-06-05,Pahang,104,27,77,2023
2023-06-06,Pahang,23,1,22,2023
2023-06-07,Pahang,13,1,12,2023
2023-06-08,Pahang,159,29,130,2023
2023-06-09,Pahang,33,2,31,2023
2023-06-10,Pahang,45,5,40,2023
2023-06-11,Pahang,148,27,121,2023
2023-06-12,Pahang,17,3,14,2023
2023-06-13,Pahang,21,3,18,2023
2023-06-14,Pahang,144,18,126,2023
2023-06-15,Pahang,87,40,47,2023
2023-06-16,Pahang,19,3,16,2023
2023-06-17,Pahang,215,79,136,2023
2023-06-18,Pahang,96,14,82,2023
2023-06-19,Pahang,18,3,15,2023
2023-06-20,Pahang,13,2,11,2023
2023-06-21,Pahang,106,25,81,2023
2023-06-22,Pahang,72,15,57,2023
2023-06-23,Pahang,20,0,20,2023
2023-06-24,Pahang,106,13,93,2023
2023-06-25,Pahang,86,18,68,2023
2023-06-26,Pahang,17,2,15,2023
2023-06-27,Pahang,110,30,80,2023
2023-06-28,Pahang,13,1,12,2023
2023-06-29,Pahang,0,0,0,2023
2023-06-30,Pahang,8,1,7,2023
2023-07-01,Pahang,26,6,20,2023
2023-07-02,Pahang,134,22,112,2023
2023-07-03,Pahang,18,2,16,2023
2023-07-04,Pahang,68,23,45,2023
2023-07-05,Pahang,54,7,47,2023
2023-07-06,Pahang,126,23,103,2023
2023-07-07,Pahang,17,0,17,2023
2023-07-08,Pahang,0,0,0,2023
2023-07-09,Pahang,114,18,96,2023
2023-07-10,Pahang,17,1,16,2023
2023-07-11,Pahang,52,22,30,2023
2023-07-12,Pahang,96,46,50,2023
2023-07-13,Pahang,13,0,13,2023
2023-07-14,Pahang,53,10,43,2023
2023-07-15,Pahang,0,0,0,2023
2023-07-16,Pahang,171,32,139,2023
2023-07-17,Pahang,12,0,12,2023
2023-07-18,Pahang,175,51,124,2023
2023-07-19,Pahang,0,0,0,2023
2023-07-20,Pahang,16,2,14,2023
2023-07-21,Pahang,111,18,93,2023
2023-07-22,Pahang,114,24,90,2023
2023-07-23,Pahang,107,22,85,2023
2023-07-24,Pahang,12,1,11,2023
2023-07-25,Pahang,131,34,97,2023
2023-07-26,Pahang,86,20,66,2023
2023-07-27,Pahang,16,1,15,2023
2023-07-28,Pahang,9,2,7,2023
2023-07-29,Pahang,73,9,64,2023
2023-07-30,Pahang,15,4,11,2023
2023-07-31,Pahang,91,16,75,2023
2023-08-01,Pahang,108,74,34,2023
2023-08-02,Pahang,9,0,9,2023
2023-08-03,Pahang,64,35,29,2023
2023-08-04,Pahang,68,23,45,2023
2023-08-05,Pahang,116,22,94,2023
2023-08-06,Pahang,176,34,142,2023
2023-08-07,Pahang,21,3,18,2023
2023-08-08,Pahang,23,2,21,2023
2023-08-09,Pahang,106,22,84,2023
2023-08-10,Pahang,16,0,16,2023
2023-08-11,Pahang,13,1,12,2023
2023-08-12,Pahang,0,0,0,2023
2023-08-13,Pahang,124,31,93,2023
2023-08-14,Pahang,12,1,11,2023
2023-08-15,Pahang,84,43,41,2023
2023-08-16,Pahang,17,1,16,2023
2023-08-17,Pahang,147,38,109,2023
2023-08-18,Pahang,22,2,20,2023
2023-08-19,Pahang,0,0,0,2023
2023-08-20,Pahang,102,15,87,2023
2023-08-21,Pahang,21,1,20,2023
2023-08-22,Pahang,62,6,56,2023
2023-08-23,Pahang,5,1,4,2023
2023-08-24,Pahang,99,61,38,2023
2023-08-25,Pahang,13,1,12,2023
2023-08-26,Pahang,101,16,85,2023
2023-08-27,Pahang,40,3,37,2023
2023-08-28,Pahang,16,1,15,2023
2023-08-29,Pahang,61,20,41,2023
2023-08-30,Pahang,12,0,12,2023
2023-08-31,Pahang,99,15,84,2023
2023-09-01,Pahang,33,1,32,2023
2023-09-02,Pahang,19,2,17,2023
2023-09-03,Pahang,121,5,116,2023
2023-09-04,Pahang,16,2,14,2023
2023-09-05,Pahang,95,15,80,2023
2023-09-06,Pahang,15,0,15,2023
2023-09-07,Pahang,77,39,38,2023
2023-09-08,Pahang,18,2,16,2023
2023-09-09,Pahang,68,16,52,2023
2023-09-10,Pahang,0,0,0,2023
2023-09-11,Pahang,18,1,17,2023
2023-09-12,Pahang,23,2,21,2023
2023-09-13,Pahang,76,26,50,2023
2023-09-14,Pahang,72,19,53,2023
2023-09-15,Pahang,26,1,25,2023
2023-09-16,Pahang,0,0,0,2023
2023-09-17,Pahang,158,16,142,2023
2023-09-18,Pahang,20,3,17,2023
2023-09-19,Pahang,155,49,106,2023
2023-09-20,Pahang,68,16,52,2023
2023-09-21,Pahang,87,18,69,2023
2023-09-22,Pahang,11,1,10,2023
2023-09-23,Pahang,77,7,70,2023
2023-09-24,Pahang,141,20,121,2023
2023-09-25,Pahang,13,1,12,2023
2023-09-26,Pahang,122,22,100,2023
2023-09-27,Pahang,17,1,16,2023
2023-09-28,Pahang,73,8,65,2023
2023-09-29,Pahang,29,4,25,2023
2023-09-30,Pahang,65,15,50,2023
2023-10-01,Pahang,146,26,120,2023
2023-10-02,Pahang,18,2,16,2023
2023-10-03,Pahang,12,1,11,2023
2023-10-04,Pahang,164,52,112,2023
2023-10-05,Pahang,68,34,34,2023
2023-10-06,Pahang,10,1,9,2023
2023-10-07,Pahang,0,0,0,2023
2023-10-08,Pahang,63,11,52,2023
2023-10-09,Pahang,8,0,8,2023
2023-10-10,Pahang,18,1,17,2023
2023-10-11,Pahang,12,1,11,2023
2023-10-12,Pahang,127,40,87,2023
2023-10-13,Pahang,19,2,17,2023
2023-10-14,Pahang,121,45,76,2023
2023-10-15,Pahang,73,11,62,2023
2023-10-16,Pahang,38,8,30,2023
2023-10-17,Pahang,14,2,12,2023
2023-10-18,Pahang,21,2,19,2023
2023-10-19,Pahang,116,42,74,2023
2023-10-20,Pahang,17,1,16,2023
2023-10-21,Pahang,176,103,73,2023
2023-10-22,Pahang,186,99,87,2023
2023-10-23,Pahang,48,10,38,2023
2023-10-24,Pahang,13,1,12,2023
2023-10-25,Pahang,18,2,16,2023
2023-10-26,Pahang,107,31,76,2023
2023-10-27,Pahang,58,38,20,2023
2023-10-28,Pahang,80,11,69,2023
2023-10-29,Pahang,88,20,68,2023
2023-10-30,Pahang,14,1,13,2023
2023-10-31,Pahang,19,4,15,2023
2023-11-01,Pahang,90,13,77,2023
2023-11-02,Pahang,51,15,36,2023
2023-11-03,Pahang,13,2,11,2023
2023-11-04,Pahang,77,8,69,2023
2023-11-05,Pahang,67,14,53,2023
2023-11-06,Pahang,19,0,19,2023
2023-11-07,Pahang,133,43,90,2023
2023-11-08,Pahang,59,25,34,2023
2023-11-09,Pahang,106,15,91,2023
2023-11-10,Pahang,11,0,11,2023
2023-11-11,Pahang,47,6,41,2023
2023-11-12,Pahang,113,18,95,2023
2023-11-13,Pahang,38,8,30,2023
2023-11-14,Pahang,18,1,17,2023
2023-11-15,Pahang,52,14,38,2023
2023-11-16,Pahang,16,1,15,2023
2023-11-17,Pahang,15,0,15,2023
2023-11-18,Pahang,34,11,23,2023
2023-11-19,Pahang,102,8,94,2023
2023-11-20,Pahang,14,0,14,2023
2023-11-21,Pahang,10,0,10,2023
2023-11-22,Pahang,10,0,10,2023
2023-11-23,Pahang,40,12,28,2023
2023-11-24,Pahang,15,3,12,2023
2023-11-25,Pahang,22,6,16,2023
2023-11-26,Pahang,107,13,94,2023
2023-11-27,Pahang,12,0,12,2023
2023-11-28,Pahang,33,4,29,2023
2023-11-29,Pahang,29,4,25,2023
2023-11-30,Pahang,17,1,16,2023
2023-12-01,Pahang,10,0,10,2023
2023-12-02,Pahang,198,29,169,2023
2023-12-03,Pahang,166,21,145,2023
2023-12-04,Pahang,15,1,14,2023
2023-12-05,Pahang,49,12,37,2023
2023-12-06,Pahang,139,51,88,2023
2023-12-07,Pahang,106,31,75,2023
2023-12-08,Pahang,9,2,7,2023
2023-12-09,Pahang,41,6,35,2023
2023-12-10,Pahang,170,25,145,2023
2023-12-11,Pahang,14,1,13,2023
2023-12-12,Pahang,28,10,18,2023
2023-12-13,Pahang,66,11,55,2023
2023-12-14,Pahang,126,29,97,2023
2023-12-15,Pahang,15,1,14,2023
2023-12-16,Pahang,0,0,0,2023
2023-12-17,Pahang,115,10,105,2023
2023-12-18,Pahang,12,1,11,2023
2023-12-19,Pahang,14,3,11,2023
2023-12-20,Pahang,109,36,73,2023
2023-12-21,Pahang,108,21,87,2023
2023-12-22,Pahang,102,20,82,2023
2023-12-23,Pahang,77,11,66,2023
2023-12-24,Pahang,75,11,64,2023
2023-12-25,Pahang,82,9,73,2023
2023-12-26,Pahang,17,2,15,2023
2023-12-27,Pahang,39,3,36,2023
2023-12-28,Pahang,125,61,64,2023
2023-12-29,Pahang,38,4,34,2023
2023-12-30,Pahang,72,10,62,2023
2023-12-31,Pahang,0,0,0,2023
2024-01-01,Pahang,175,21,154,2024
2024-01-02,Pahang,11,2,9,2024
2024-01-03,Pahang,14,0,14,2024
2024-01-04,Pahang,101,39,62,2024
2024-01-05,Pahang,26,5,21,2024
2024-01-06,Pahang,56,13,43,2024
2024-01-07,Pahang,91,16,75,2024
2024-01-08,Pahang,20,0,20,2024
2024-01-09,Pahang,22,1,21,2024
2024-01-10,Pahang,98,39,59,2024
2024-01-11,Pahang,121,38,83,2024
2024-01-12,Pahang,37,1,36,2024
2024-01-13,Pahang,69,14,55,2024
2024-01-14,Pahang,86,10,76,2024
2024-01-15,Pahang,87,14,73,2024
2024-01-16,Pahang,56,32,24,2024
2024-01-17,Pahang,164,68,96,2024
2024-01-18,Pahang,13,0,13,2024
2024-01-19,Pahang,16,0,16,2024
2024-01-20,Pahang,66,20,46,2024
2024-01-21,Pahang,224,33,191,2024
2024-01-22,Pahang,33,12,21,2024
2024-01-23,Pahang,51,11,40,2024
2024-01-24,Pahang,16,1,15,2024
2024-01-25,Pahang,87,20,67,2024
2024-01-26,Pahang,20,0,20,2024
2024-01-27,Pahang,125,108,17,2024
2024-01-28,Pahang,106,13,93,2024
2024-01-29,Pahang,18,2,16,2024
2024-01-30,Pahang,53,8,45,2024
2024-01-31,Pahang,66,15,51,2024
2024-02-01,Pahang,11,1,10,2024
2024-02-02,Pahang,17,1,16,2024
2006-01-01,Perak,0,0,0,2006
2006-01-02,Perak,0,0,0,2006
2006-01-03,Perak,0,0,0,2006
2006-01-04,Perak,0,0,0,2006
2006-01-05,Perak,1,0,1,2006
2006-01-06,Perak,0,0,0,2006
2006-01-07,Perak,0,0,0,2006
2006-01-08,Perak,0,0,0,2006
2006-01-09,Perak,0,0,0,2006
2006-01-10,Perak,0,0,0,2006
2006-01-11,Perak,0,0,0,2006
2006-01-12,Perak,0,0,0,2006
2006-01-13,Perak,0,0,0,2006
2006-01-14,Perak,0,0,0,2006
2006-01-15,Perak,0,0,0,2006
2006-01-16,Perak,0,0,0,2006
2006-01-17,Perak,0,0,0,2006
2006-01-18,Perak,0,0,0,2006
2006-01-19,Perak,0,0,0,2006
2006-01-20,Perak,0,0,0,2006
2006-01-21,Perak,0,0,0,2006
2006-01-22,Perak,1,1,0,2006
2006-01-23,Perak,0,0,0,2006
2006-01-24,Perak,0,0,0,2006
2006-01-25,Perak,0,0,0,2006
2006-01-26,Perak,0,0,0,2006
2006-01-27,Perak,0,0,0,2006
2006-01-28,Perak,0,0,0,2006
2006-01-29,Perak,0,0,0,2006
2006-01-30,Perak,0,0,0,2006
2006-01-31,Perak,0,0,0,2006
2006-02-01,Perak,0,0,0,2006
2006-02-02,Perak,0,0,0,2006
2006-02-03,Perak,0,0,0,2006
2006-02-04,Perak,0,0,0,2006
2006-02-05,Perak,0,0,0,2006
2006-02-06,Perak,0,0,0,2006
2006-02-07,Perak,0,0,0,2006
2006-02-08,Perak,1,0,1,2006
2006-02-09,Perak,0,0,0,2006
2006-02-10,Perak,0,0,0,2006
2006-02-11,Perak,0,0,0,2006
2006-02-12,Perak,0,0,0,2006
2006-02-13,Perak,0,0,0,2006
2006-02-14,Perak,0,0,0,2006
2006-02-15,Perak,1,0,1,2006
2006-02-16,Perak,0,0,0,2006
2006-02-17,Perak,0,0,0,2006
2006-02-18,Perak,0,0,0,2006
2006-02-19,Perak,0,0,0,2006
2006-02-20,Perak,0,0,0,2006
2006-02-21,Perak,0,0,0,2006
2006-02-22,Perak,0,0,0,2006
2006-02-23,Perak,0,0,0,2006
2006-02-24,Perak,0,0,0,2006
2006-02-25,Perak,0,0,0,2006
2006-02-26,Perak,0,0,0,2006
2006-02-27,Perak,0,0,0,2006
2006-02-28,Perak,0,0,0,2006
2006-03-01,Perak,0,0,0,2006
2006-03-02,Perak,0,0,0,2006
2006-03-03,Perak,0,0,0,2006
2006-03-04,Perak,0,0,0,2006
2006-03-05,Perak,0,0,0,2006
2006-03-06,Perak,0,0,0,2006
2006-03-07,Perak,0,0,0,2006
2006-03-08,Perak,0,0,0,2006
2006-03-09,Perak,0,0,0,2006
2006-03-10,Perak,0,0,0,2006
2006-03-11,Perak,0,0,0,2006
2006-03-12,Perak,0,0,0,2006
2006-03-13,Perak,0,0,0,2006
2006-03-14,Perak,0,0,0,2006
2006-03-15,Perak,0,0,0,2006
2006-03-16,Perak,0,0,0,2006
2006-03-17,Perak,0,0,0,2006
2006-03-18,Perak,0,0,0,2006
2006-03-19,Perak,0,0,0,2006
2006-03-20,Perak,1,1,0,2006
2006-03-21,Perak,0,0,0,2006
2006-03-22,Perak,0,0,0,2006
2006-03-23,Perak,0,0,0,2006
2006-03-24,Perak,0,0,0,2006
2006-03-25,Perak,0,0,0,2006
2006-03-26,Perak,0,0,0,2006
2006-03-27,Perak,0,0,0,2006
2006-03-28,Perak,0,0,0,2006
2006-03-29,Perak,0,0,0,2006
2006-03-30,Perak,0,0,0,2006
2006-03-31,Perak,0,0,0,2006
2006-04-01,Perak,0,0,0,2006
2006-04-02,Perak,0,0,0,2006
2006-04-03,Perak,1,0,1,2006
2006-04-04,Perak,0,0,0,2006
2006-04-05,Perak,0,0,0,2006
2006-04-06,Perak,0,0,0,2006
2006-04-07,Perak,0,0,0,2006
2006-04-08,Perak,1,1,0,2006
2006-04-09,Perak,0,0,0,2006
2006-04-10,Perak,0,0,0,2006
2006-04-11,Perak,0,0,0,2006
2006-04-12,Perak,0,0,0,2006
2006-04-13,Perak,0,0,0,2006
2006-04-14,Perak,0,0,0,2006
2006-04-15,Perak,0,0,0,2006
2006-04-16,Perak,0,0,0,2006
2006-04-17,Perak,0,0,0,2006
2006-04-18,Perak,1,0,1,2006
2006-04-19,Perak,0,0,0,2006
2006-04-20,Perak,0,0,0,2006
2006-04-21,Perak,0,0,0,2006
2006-04-22,Perak,1,1,0,2006
2006-04-23,Perak,0,0,0,2006
2006-04-24,Perak,0,0,0,2006
2006-04-25,Perak,0,0,0,2006
2006-04-26,Perak,0,0,0,2006
2006-04-27,Perak,0,0,0,2006
2006-04-28,Perak,0,0,0,2006
2006-04-29,Perak,0,0,0,2006
2006-04-30,Perak,0,0,0,2006
2006-05-01,Perak,0,0,0,2006
2006-05-02,Perak,0,0,0,2006
2006-05-03,Perak,1,1,0,2006
2006-05-04,Perak,0,0,0,2006
2006-05-05,Perak,0,0,0,2006
2006-05-06,Perak,0,0,0,2006
2006-05-07,Perak,0,0,0,2006
2006-05-08,Perak,0,0,0,2006
2006-05-09,Perak,0,0,0,2006
2006-05-10,Perak,0,0,0,2006
2006-05-11,Perak,0,0,0,2006
2006-05-12,Perak,0,0,0,2006
2006-05-13,Perak,0,0,0,2006
2006-05-14,Perak,0,0,0,2006
2006-05-15,Perak,0,0,0,2006
2006-05-16,Perak,0,0,0,2006
2006-05-17,Perak,0,0,0,2006
2006-05-18,Perak,0,0,0,2006
2006-05-19,Perak,0,0,0,2006
2006-05-20,Perak,0,0,0,2006
2006-05-21,Perak,0,0,0,2006
2006-05-22,Perak,0,0,0,2006
2006-05-23,Perak,0,0,0,2006
2006-05-24,Perak,0,0,0,2006
2006-05-25,Perak,0,0,0,2006
2006-05-26,Perak,0,0,0,2006
2006-05-27,Perak,0,0,0,2006
2006-05-28,Perak,0,0,0,2006
2006-05-29,Perak,0,0,0,2006
2006-05-30,Perak,0,0,0,2006
2006-05-31,Perak,0,0,0,2006
2006-06-01,Perak,0,0,0,2006
2006-06-02,Perak,1,0,1,2006
2006-06-03,Perak,0,0,0,2006
2006-06-04,Perak,0,0,0,2006
2006-06-05,Perak,0,0,0,2006
2006-06-06,Perak,0,0,0,2006
2006-06-07,Perak,0,0,0,2006
2006-06-08,Perak,3,3,0,2006
2006-06-09,Perak,0,0,0,2006
2006-06-10,Perak,0,0,0,2006
2006-06-11,Perak,0,0,0,2006
2006-06-12,Perak,0,0,0,2006
2006-06-13,Perak,0,0,0,2006
2006-06-14,Perak,0,0,0,2006
2006-06-15,Perak,0,0,0,2006
2006-06-16,Perak,0,0,0,2006
2006-06-17,Perak,0,0,0,2006
2006-06-18,Perak,0,0,0,2006
2006-06-19,Perak,0,0,0,2006
2006-06-20,Perak,1,0,1,2006
2006-06-21,Perak,0,0,0,2006
2006-06-22,Perak,0,0,0,2006
2006-06-23,Perak,0,0,0,2006
2006-06-24,Perak,0,0,0,2006
2006-06-25,Perak,0,0,0,2006
2006-06-26,Perak,0,0,0,2006
2006-06-27,Perak,0,0,0,2006
2006-06-28,Perak,0,0,0,2006
2006-06-29,Perak,0,0,0,2006
2006-06-30,Perak,0,0,0,2006
2006-07-01,Perak,0,0,0,2006
2006-07-02,Perak,0,0,0,2006
2006-07-03,Perak,0,0,0,2006
2006-07-04,Perak,0,0,0,2006
2006-07-05,Perak,0,0,0,2006
2006-07-06,Perak,0,0,0,2006
2006-07-07,Perak,1,1,0,2006
2006-07-08,Perak,0,0,0,2006
2006-07-09,Perak,0,0,0,2006
2006-07-10,Perak,2,2,0,2006
2006-07-11,Perak,0,0,0,2006
2006-07-12,Perak,0,0,0,2006
2006-07-13,Perak,0,0,0,2006
2006-07-14,Perak,0,0,0,2006
2006-07-15,Perak,0,0,0,2006
2006-07-16,Perak,0,0,0,2006
2006-07-17,Perak,0,0,0,2006
2006-07-18,Perak,0,0,0,2006
2006-07-19,Perak,0,0,0,2006
2006-07-20,Perak,0,0,0,2006
2006-07-21,Perak,0,0,0,2006
2006-07-22,Perak,0,0,0,2006
2006-07-23,Perak,0,0,0,2006
2006-07-24,Perak,1,1,0,2006
2006-07-25,Perak,0,0,0,2006
2006-07-26,Perak,0,0,0,2006
2006-07-27,Perak,0,0,0,2006
2006-07-28,Perak,0,0,0,2006
2006-07-29,Perak,0,0,0,2006
2006-07-30,Perak,0,0,0,2006
2006-07-31,Perak,0,0,0,2006
2006-08-01,Perak,0,0,0,2006
2006-08-02,Perak,1,0,1,2006
2006-08-03,Perak,0,0,0,2006
2006-08-04,Perak,0,0,0,2006
2006-08-05,Perak,1,1,0,2006
2006-08-06,Perak,0,0,0,2006
2006-08-07,Perak,0,0,0,2006
2006-08-08,Perak,0,0,0,2006
2006-08-09,Perak,0,0,0,2006
2006-08-10,Perak,0,0,0,2006
2006-08-11,Perak,0,0,0,2006
2006-08-12,Perak,4,4,0,2006
2006-08-13,Perak,0,0,0,2006
2006-08-14,Perak,1,1,0,2006
2006-08-15,Perak,0,0,0,2006
2006-08-16,Perak,0,0,0,2006
2006-08-17,Perak,0,0,0,2006
2006-08-18,Perak,0,0,0,2006
2006-08-19,Perak,0,0,0,2006
2006-08-20,Perak,0,0,0,2006
2006-08-21,Perak,0,0,0,2006
2006-08-22,Perak,0,0,0,2006
2006-08-23,Perak,0,0,0,2006
2006-08-24,Perak,4,4,0,2006
2006-08-25,Perak,0,0,0,2006
2006-08-26,Perak,5,5,0,2006
2006-08-27,Perak,0,0,0,2006
2006-08-28,Perak,0,0,0,2006
2006-08-29,Perak,0,0,0,2006
2006-08-30,Perak,0,0,0,2006
2006-08-31,Perak,0,0,0,2006
2006-09-01,Perak,0,0,0,2006
2006-09-02,Perak,0,0,0,2006
2006-09-03,Perak,1,1,0,2006
2006-09-04,Perak,0,0,0,2006
2006-09-05,Perak,0,0,0,2006
2006-09-06,Perak,0,0,0,2006
2006-09-07,Perak,0,0,0,2006
2006-09-08,Perak,0,0,0,2006
2006-09-09,Perak,0,0,0,2006
2006-09-10,Perak,0,0,0,2006
2006-09-11,Perak,1,0,1,2006
2006-09-12,Perak,0,0,0,2006
2006-09-13,Perak,0,0,0,2006
2006-09-14,Perak,1,1,0,2006
2006-09-15,Perak,0,0,0,2006
2006-09-16,Perak,0,0,0,2006
2006-09-17,Perak,0,0,0,2006
2006-09-18,Perak,1,1,0,2006
2006-09-19,Perak,0,0,0,2006
2006-09-20,Perak,0,0,0,2006
2006-09-21,Perak,2,2,0,2006
2006-09-22,Perak,0,0,0,2006
2006-09-23,Perak,0,0,0,2006
2006-09-24,Perak,0,0,0,2006
2006-09-25,Perak,0,0,0,2006
2006-09-26,Perak,0,0,0,2006
2006-09-27,Perak,0,0,0,2006
2006-09-28,Perak,0,0,0,2006
2006-09-29,Perak,0,0,0,2006
2006-09-30,Perak,0,0,0,2006
2006-10-01,Perak,0,0,0,2006
2006-10-02,Perak,0,0,0,2006
2006-10-03,Perak,0,0,0,2006
2006-10-04,Perak,0,0,0,2006
2006-10-05,Perak,0,0,0,2006
2006-10-06,Perak,0,0,0,2006
2006-10-07,Perak,0,0,0,2006
2006-10-08,Perak,1,1,0,2006
2006-10-09,Perak,0,0,0,2006
2006-10-10,Perak,0,0,0,2006
2006-10-11,Perak,0,0,0,2006
2006-10-12,Perak,0,0,0,2006
2006-10-13,Perak,0,0,0,2006
2006-10-14,Perak,0,0,0,2006
2006-10-15,Perak,1,1,0,2006
2006-10-16,Perak,0,0,0,2006
2006-10-17,Perak,0,0,0,2006
2006-10-18,Perak,2,1,1,2006
2006-10-19,Perak,0,0,0,2006
2006-10-20,Perak,2,2,0,2006
2006-10-21,Perak,0,0,0,2006
2006-10-22,Perak,0,0,0,2006
2006-10-23,Perak,0,0,0,2006
2006-10-24,Perak,0,0,0,2006
2006-10-25,Perak,0,0,0,2006
2006-10-26,Perak,0,0,0,2006
2006-10-27,Perak,0,0,0,2006
2006-10-28,Perak,0,0,0,2006
2006-10-29,Perak,0,0,0,2006
2006-10-30,Perak,0,0,0,2006
2006-10-31,Perak,0,0,0,2006
2006-11-01,Perak,0,0,0,2006
2006-11-02,Perak,0,0,0,2006
2006-11-03,Perak,0,0,0,2006
2006-11-04,Perak,0,0,0,2006
2006-11-05,Perak,0,0,0,2006
2006-11-06,Perak,0,0,0,2006
2006-11-07,Perak,0,0,0,2006
2006-11-08,Perak,0,0,0,2006
2006-11-09,Perak,0,0,0,2006
2006-11-10,Perak,0,0,0,2006
2006-11-11,Perak,0,0,0,2006
2006-11-12,Perak,0,0,0,2006
2006-11-13,Perak,0,0,0,2006
2006-11-14,Perak,0,0,0,2006
2006-11-15,Perak,0,0,0,2006
2006-11-16,Perak,0,0,0,2006
2006-11-17,Perak,0,0,0,2006
2006-11-18,Perak,0,0,0,2006
2006-11-19,Perak,2,2,0,2006
2006-11-20,Perak,1,0,1,2006
2006-11-21,Perak,0,0,0,2006
2006-11-22,Perak,0,0,0,2006
2006-11-23,Perak,1,0,1,2006
2006-11-24,Perak,0,0,0,2006
2006-11-25,Perak,0,0,0,2006
2006-11-26,Perak,0,0,0,2006
2006-11-27,Perak,0,0,0,2006
2006-11-28,Perak,0,0,0,2006
2006-11-29,Perak,0,0,0,2006
2006-11-30,Perak,0,0,0,2006
2006-12-01,Perak,0,0,0,2006
2006-12-02,Perak,0,0,0,2006
2006-12-03,Perak,0,0,0,2006
2006-12-04,Perak,0,0,0,2006
2006-12-05,Perak,0,0,0,2006
2006-12-06,Perak,1,0,1,2006
2006-12-07,Perak,0,0,0,2006
2006-12-08,Perak,0,0,0,2006
2006-12-09,Perak,0,0,0,2006
2006-12-10,Perak,0,0,0,2006
2006-12-11,Perak,0,0,0,2006
2006-12-12,Perak,0,0,0,2006
2006-12-13,Perak,0,0,0,2006
2006-12-14,Perak,0,0,0,2006
2006-12-15,Perak,0,0,0,2006
2006-12-16,Perak,0,0,0,2006
2006-12-17,Perak,1,1,0,2006
2006-12-18,Perak,0,0,0,2006
2006-12-19,Perak,0,0,0,2006
2006-12-20,Perak,0,0,0,2006
2006-12-21,Perak,0,0,0,2006
2006-12-22,Perak,0,0,0,2006
2006-12-23,Perak,0,0,0,2006
2006-12-24,Perak,0,0,0,2006
2006-12-25,Perak,0,0,0,2006
2006-12-26,Perak,0,0,0,2006
2006-12-27,Perak,0,0,0,2006
2006-12-28,Perak,0,0,0,2006
2006-12-29,Perak,0,0,0,2006
2006-12-30,Perak,0,0,0,2006
2006-12-31,Perak,0,0,0,2006
2007-01-01,Perak,0,0,0,2007
2007-01-02,Perak,0,0,0,2007
2007-01-03,Perak,1,0,1,2007
2007-01-04,Perak,0,0,0,2007
2007-01-05,Perak,0,0,0,2007
2007-01-06,Perak,0,0,0,2007
2007-01-07,Perak,0,0,0,2007
2007-01-08,Perak,0,0,0,2007
2007-01-09,Perak,0,0,0,2007
2007-01-10,Perak,0,0,0,2007
2007-01-11,Perak,1,1,0,2007
2007-01-12,Perak,0,0,0,2007
2007-01-13,Perak,0,0,0,2007
2007-01-14,Perak,0,0,0,2007
2007-01-15,Perak,0,0,0,2007
2007-01-16,Perak,0,0,0,2007
2007-01-17,Perak,0,0,0,2007
2007-01-18,Perak,0,0,0,2007
2007-01-19,Perak,0,0,0,2007
2007-01-20,Perak,0,0,0,2007
2007-01-21,Perak,0,0,0,2007
2007-01-22,Perak,0,0,0,2007
2007-01-23,Perak,0,0,0,2007
2007-01-24,Perak,0,0,0,2007
2007-01-25,Perak,0,0,0,2007
2007-01-26,Perak,0,0,0,2007
2007-01-27,Perak,0,0,0,2007
2007-01-28,Perak,0,0,0,2007
2007-01-29,Perak,0,0,0,2007
2007-01-30,Perak,0,0,0,2007
2007-01-31,Perak,0,0,0,2007
2007-02-01,Perak,0,0,0,2007
2007-02-02,Perak,0,0,0,2007
2007-02-03,Perak,0,0,0,2007
2007-02-04,Perak,0,0,0,2007
2007-02-05,Perak,0,0,0,2007
2007-02-06,Perak,0,0,0,2007
2007-02-07,Perak,0,0,0,2007
2007-02-08,Perak,0,0,0,2007
2007-02-09,Perak,0,0,0,2007
2007-02-10,Perak,0,0,0,2007
2007-02-11,Perak,0,0,0,2007
2007-02-12,Perak,0,0,0,2007
2007-02-13,Perak,0,0,0,2007
2007-02-14,Perak,0,0,0,2007
2007-02-15,Perak,0,0,0,2007
2007-02-16,Perak,0,0,0,2007
2007-02-17,Perak,0,0,0,2007
2007-02-18,Perak,0,0,0,2007
2007-02-19,Perak,0,0,0,2007
2007-02-20,Perak,0,0,0,2007
2007-02-21,Perak,0,0,0,2007
2007-02-22,Perak,0,0,0,2007
2007-02-23,Perak,1,1,0,2007
2007-02-24,Perak,0,0,0,2007
2007-02-25,Perak,0,0,0,2007
2007-02-26,Perak,0,0,0,2007
2007-02-27,Perak,0,0,0,2007
2007-02-28,Perak,0,0,0,2007
2007-03-01,Perak,0,0,0,2007
2007-03-02,Perak,0,0,0,2007
2007-03-03,Perak,0,0,0,2007
2007-03-04,Perak,0,0,0,2007
2007-03-05,Perak,0,0,0,2007
2007-03-06,Perak,0,0,0,2007
2007-03-07,Perak,0,0,0,2007
2007-03-08,Perak,0,0,0,2007
2007-03-09,Perak,0,0,0,2007
2007-03-10,Perak,0,0,0,2007
2007-03-11,Perak,0,0,0,2007
2007-03-12,Perak,0,0,0,2007
2007-03-13,Perak,0,0,0,2007
2007-03-14,Perak,1,0,1,2007
2007-03-15,Perak,0,0,0,2007
2007-03-16,Perak,0,0,0,2007
2007-03-17,Perak,1,1,0,2007
2007-03-18,Perak,0,0,0,2007
2007-03-19,Perak,1,0,1,2007
2007-03-20,Perak,0,0,0,2007
2007-03-21,Perak,0,0,0,2007
2007-03-22,Perak,0,0,0,2007
2007-03-23,Perak,0,0,0,2007
2007-03-24,Perak,0,0,0,2007
2007-03-25,Perak,0,0,0,2007
2007-03-26,Perak,0,0,0,2007
2007-03-27,Perak,0,0,0,2007
2007-03-28,Perak,0,0,0,2007
2007-03-29,Perak,0,0,0,2007
2007-03-30,Perak,0,0,0,2007
2007-03-31,Perak,0,0,0,2007
2007-04-01,Perak,0,0,0,2007
2007-04-02,Perak,0,0,0,2007
2007-04-03,Perak,0,0,0,2007
2007-04-04,Perak,0,0,0,2007
2007-04-05,Perak,0,0,0,2007
2007-04-06,Perak,0,0,0,2007
2007-04-07,Perak,0,0,0,2007
2007-04-08,Perak,0,0,0,2007
2007-04-09,Perak,0,0,0,2007
2007-04-10,Perak,0,0,0,2007
2007-04-11,Perak,0,0,0,2007
2007-04-12,Perak,0,0,0,2007
2007-04-13,Perak,0,0,0,2007
2007-04-14,Perak,0,0,0,2007
2007-04-15,Perak,0,0,0,2007
2007-04-16,Perak,0,0,0,2007
2007-04-17,Perak,0,0,0,2007
2007-04-18,Perak,0,0,0,2007
2007-04-19,Perak,0,0,0,2007
2007-04-20,Perak,0,0,0,2007
2007-04-21,Perak,0,0,0,2007
2007-04-22,Perak,0,0,0,2007
2007-04-23,Perak,0,0,0,2007
2007-04-24,Perak,0,0,0,2007
2007-04-25,Perak,0,0,0,2007
2007-04-26,Perak,0,0,0,2007
2007-04-27,Perak,0,0,0,2007
2007-04-28,Perak,0,0,0,2007
2007-04-29,Perak,0,0,0,2007
2007-04-30,Perak,0,0,0,2007
2007-05-01,Perak,0,0,0,2007
2007-05-02,Perak,0,0,0,2007
2007-05-03,Perak,0,0,0,2007
2007-05-04,Perak,0,0,0,2007
2007-05-05,Perak,0,0,0,2007
2007-05-06,Perak,0,0,0,2007
2007-05-07,Perak,0,0,0,2007
2007-05-08,Perak,0,0,0,2007
2007-05-09,Perak,0,0,0,2007
2007-05-10,Perak,0,0,0,2007
2007-05-11,Perak,0,0,0,2007
2007-05-12,Perak,0,0,0,2007
2007-05-13,Perak,0,0,0,2007
2007-05-14,Perak,0,0,0,2007
2007-05-15,Perak,0,0,0,2007
2007-05-16,Perak,0,0,0,2007
2007-05-17,Perak,0,0,0,2007
2007-05-18,Perak,0,0,0,2007
2007-05-19,Perak,0,0,0,2007
2007-05-20,Perak,0,0,0,2007
2007-05-21,Perak,0,0,0,2007
2007-05-22,Perak,0,0,0,2007
2007-05-23,Perak,0,0,0,2007
2007-05-24,Perak,0,0,0,2007
2007-05-25,Perak,0,0,0,2007
2007-05-26,Perak,0,0,0,2007
2007-05-27,Perak,0,0,0,2007
2007-05-28,Perak,0,0,0,2007
2007-05-29,Perak,0,0,0,2007
2007-05-30,Perak,0,0,0,2007
2007-05-31,Perak,0,0,0,2007
2007-06-01,Perak,0,0,0,2007
2007-06-02,Perak,0,0,0,2007
2007-06-03,Perak,0,0,0,2007
2007-06-04,Perak,0,0,0,2007
2007-06-05,Perak,0,0,0,2007
2007-06-06,Perak,0,0,0,2007
2007-06-07,Perak,0,0,0,2007
2007-06-08,Perak,1,0,1,2007
2007-06-09,Perak,0,0,0,2007
2007-06-10,Perak,0,0,0,2007
2007-06-11,Perak,0,0,0,2007
2007-06-12,Perak,0,0,0,2007
2007-06-13,Perak,0,0,0,2007
2007-06-14,Perak,0,0,0,2007
2007-06-15,Perak,0,0,0,2007
2007-06-16,Perak,0,0,0,2007
2007-06-17,Perak,0,0,0,2007
2007-06-18,Perak,0,0,0,2007
2007-06-19,Perak,0,0,0,2007
2007-06-20,Perak,0,0,0,2007
2007-06-21,Perak,0,0,0,2007
2007-06-22,Perak,0,0,0,2007
2007-06-23,Perak,1,1,0,2007
2007-06-24,Perak,0,0,0,2007
2007-06-25,Perak,0,0,0,2007
2007-06-26,Perak,0,0,0,2007
2007-06-27,Perak,0,0,0,2007
2007-06-28,Perak,1,0,1,2007
2007-06-29,Perak,2,2,0,2007
2007-06-30,Perak,0,0,0,2007
2007-07-01,Perak,0,0,0,2007
2007-07-02,Perak,1,1,0,2007
2007-07-03,Perak,0,0,0,2007
2007-07-04,Perak,0,0,0,2007
2007-07-05,Perak,0,0,0,2007
2007-07-06,Perak,0,0,0,2007
2007-07-07,Perak,0,0,0,2007
2007-07-08,Perak,0,0,0,2007
2007-07-09,Perak,3,3,0,2007
2007-07-10,Perak,0,0,0,2007
2007-07-11,Perak,0,0,0,2007
2007-07-12,Perak,0,0,0,2007
2007-07-13,Perak,0,0,0,2007
2007-07-14,Perak,0,0,0,2007
2007-07-15,Perak,0,0,0,2007
2007-07-16,Perak,0,0,0,2007
2007-07-17,Perak,0,0,0,2007
2007-07-18,Perak,0,0,0,2007
2007-07-19,Perak,0,0,0,2007
2007-07-20,Perak,0,0,0,2007
2007-07-21,Perak,0,0,0,2007
2007-07-22,Perak,0,0,0,2007
2007-07-23,Perak,0,0,0,2007
2007-07-24,Perak,1,1,0,2007
2007-07-25,Perak,0,0,0,2007
2007-07-26,Perak,1,1,0,2007
2007-07-27,Perak,1,1,0,2007
2007-07-28,Perak,0,0,0,2007
2007-07-29,Perak,0,0,0,2007
2007-07-30,Perak,0,0,0,2007
2007-07-31,Perak,0,0,0,2007
2007-08-01,Perak,2,2,0,2007
2007-08-02,Perak,0,0,0,2007
2007-08-03,Perak,0,0,0,2007
2007-08-04,Perak,0,0,0,2007
2007-08-05,Perak,0,0,0,2007
2007-08-06,Perak,1,1,0,2007
2007-08-07,Perak,0,0,0,2007
2007-08-08,Perak,0,0,0,2007
2007-08-09,Perak,1,1,0,2007
2007-08-10,Perak,0,0,0,2007
2007-08-11,Perak,0,0,0,2007
2007-08-12,Perak,0,0,0,2007
2007-08-13,Perak,1,1,0,2007
2007-08-14,Perak,0,0,0,2007
2007-08-15,Perak,0,0,0,2007
2007-08-16,Perak,0,0,0,2007
2007-08-17,Perak,0,0,0,2007
2007-08-18,Perak,1,1,0,2007
2007-08-19,Perak,0,0,0,2007
2007-08-20,Perak,0,0,0,2007
2007-08-21,Perak,0,0,0,2007
2007-08-22,Perak,0,0,0,2007
2007-08-23,Perak,0,0,0,2007
2007-08-24,Perak,0,0,0,2007
2007-08-25,Perak,0,0,0,2007
2007-08-26,Perak,0,0,0,2007
2007-08-27,Perak,0,0,0,2007
2007-08-28,Perak,0,0,0,2007
2007-08-29,Perak,0,0,0,2007
2007-08-30,Perak,1,0,1,2007
2007-08-31,Perak,0,0,0,2007
2007-09-01,Perak,0,0,0,2007
2007-09-02,Perak,0,0,0,2007
2007-09-03,Perak,0,0,0,2007
2007-09-04,Perak,0,0,0,2007
2007-09-05,Perak,0,0,0,2007
2007-09-06,Perak,0,0,0,2007
2007-09-07,Perak,0,0,0,2007
2007-09-08,Perak,0,0,0,2007
2007-09-09,Perak,0,0,0,2007
2007-09-10,Perak,0,0,0,2007
2007-09-11,Perak,0,0,0,2007
2007-09-12,Perak,0,0,0,2007
2007-09-13,Perak,0,0,0,2007
2007-09-14,Perak,0,0,0,2007
2007-09-15,Perak,0,0,0,2007
2007-09-16,Perak,0,0,0,2007
2007-09-17,Perak,0,0,0,2007
2007-09-18,Perak,0,0,0,2007
2007-09-19,Perak,0,0,0,2007
2007-09-20,Perak,0,0,0,2007
2007-09-21,Perak,0,0,0,2007
2007-09-22,Perak,0,0,0,2007
2007-09-23,Perak,0,0,0,2007
2007-09-24,Perak,0,0,0,2007
2007-09-25,Perak,0,0,0,2007
2007-09-26,Perak,0,0,0,2007
2007-09-27,Perak,0,0,0,2007
2007-09-28,Perak,0,0,0,2007
2007-09-29,Perak,0,0,0,2007
2007-09-30,Perak,1,1,0,2007
2007-10-01,Perak,0,0,0,2007
2007-10-02,Perak,0,0,0,2007
2007-10-03,Perak,0,0,0,2007
2007-10-04,Perak,2,2,0,2007
2007-10-05,Perak,0,0,0,2007
2007-10-06,Perak,1,1,0,2007
2007-10-07,Perak,1,1,0,2007
2007-10-08,Perak,0,0,0,2007
2007-10-09,Perak,1,0,1,2007
2007-10-10,Perak,0,0,0,2007
2007-10-11,Perak,2,1,1,2007
2007-10-12,Perak,0,0,0,2007
2007-10-13,Perak,0,0,0,2007
2007-10-14,Perak,0,0,0,2007
2007-10-15,Perak,0,0,0,2007
2007-10-16,Perak,0,0,0,2007
2007-10-17,Perak,0,0,0,2007
2007-10-18,Perak,2,1,1,2007
2007-10-19,Perak,0,0,0,2007
2007-10-20,Perak,0,0,0,2007
2007-10-21,Perak,1,0,1,2007
2007-10-22,Perak,0,0,0,2007
2007-10-23,Perak,0,0,0,2007
2007-10-24,Perak,0,0,0,2007
2007-10-25,Perak,0,0,0,2007
2007-10-26,Perak,0,0,0,2007
2007-10-27,Perak,0,0,0,2007
2007-10-28,Perak,0,0,0,2007
2007-10-29,Perak,0,0,0,2007
2007-10-30,Perak,0,0,0,2007
2007-10-31,Perak,0,0,0,2007
2007-11-01,Perak,0,0,0,2007
2007-11-02,Perak,2,2,0,2007
2007-11-03,Perak,0,0,0,2007
2007-11-04,Perak,1,1,0,2007
2007-11-05,Perak,0,0,0,2007
2007-11-06,Perak,0,0,0,2007
2007-11-07,Perak,0,0,0,2007
2007-11-08,Perak,0,0,0,2007
2007-11-09,Perak,0,0,0,2007
2007-11-10,Perak,0,0,0,2007
2007-11-11,Perak,0,0,0,2007
2007-11-12,Perak,0,0,0,2007
2007-11-13,Perak,0,0,0,2007
2007-11-14,Perak,0,0,0,2007
2007-11-15,Perak,0,0,0,2007
2007-11-16,Perak,0,0,0,2007
2007-11-17,Perak,0,0,0,2007
2007-11-18,Perak,3,3,0,2007
2007-11-19,Perak,0,0,0,2007
2007-11-20,Perak,0,0,0,2007
2007-11-21,Perak,1,1,0,2007
2007-11-22,Perak,0,0,0,2007
2007-11-23,Perak,0,0,0,2007
2007-11-24,Perak,0,0,0,2007
2007-11-25,Perak,0,0,0,2007
2007-11-26,Perak,0,0,0,2007
2007-11-27,Perak,1,1,0,2007
2007-11-28,Perak,0,0,0,2007
2007-11-29,Perak,1,1,0,2007
2007-11-30,Perak,2,1,1,2007
2007-12-01,Perak,0,0,0,2007
2007-12-02,Perak,1,1,0,2007
2007-12-03,Perak,0,0,0,2007
2007-12-04,Perak,0,0,0,2007
2007-12-05,Perak,0,0,0,2007
2007-12-06,Perak,0,0,0,2007
2007-12-07,Perak,0,0,0,2007
2007-12-08,Perak,0,0,0,2007
2007-12-09,Perak,1,1,0,2007
2007-12-10,Perak,0,0,0,2007
2007-12-11,Perak,0,0,0,2007
2007-12-12,Perak,0,0,0,2007
2007-12-13,Perak,2,1,1,2007
2007-12-14,Perak,0,0,0,2007
2007-12-15,Perak,0,0,0,2007
2007-12-16,Perak,0,0,0,2007
2007-12-17,Perak,0,0,0,2007
2007-12-18,Perak,0,0,0,2007
2007-12-19,Perak,1,0,1,2007
2007-12-20,Perak,0,0,0,2007
2007-12-21,Perak,0,0,0,2007
2007-12-22,Perak,0,0,0,2007
2007-12-23,Perak,0,0,0,2007
2007-12-24,Perak,0,0,0,2007
2007-12-25,Perak,0,0,0,2007
2007-12-26,Perak,0,0,0,2007
2007-12-27,Perak,0,0,0,2007
2007-12-28,Perak,0,0,0,2007
2007-12-29,Perak,0,0,0,2007
2007-12-30,Perak,0,0,0,2007
2007-12-31,Perak,1,0,1,2007
2008-01-01,Perak,72,69,3,2008
2008-01-02,Perak,10,10,0,2008
2008-01-03,Perak,46,45,1,2008
2008-01-04,Perak,42,40,2,2008
2008-01-05,Perak,34,28,6,2008
2008-01-06,Perak,76,70,6,2008
2008-01-07,Perak,26,26,0,2008
2008-01-08,Perak,130,127,3,2008
2008-01-09,Perak,15,11,4,2008
2008-01-10,Perak,55,49,6,2008
2008-01-11,Perak,68,36,32,2008
2008-01-12,Perak,40,27,13,2008
2008-01-13,Perak,46,33,13,2008
2008-01-14,Perak,12,10,2,2008
2008-01-15,Perak,67,64,3,2008
2008-01-16,Perak,146,141,5,2008
2008-01-17,Perak,57,56,1,2008
2008-01-18,Perak,14,13,1,2008
2008-01-19,Perak,20,18,2,2008
2008-01-20,Perak,40,35,5,2008
2008-01-21,Perak,25,25,0,2008
2008-01-22,Perak,93,88,5,2008
2008-01-23,Perak,79,75,4,2008
2008-01-24,Perak,102,99,3,2008
2008-01-25,Perak,31,29,2,2008
2008-01-26,Perak,116,109,7,2008
2008-01-27,Perak,263,251,12,2008
2008-01-28,Perak,33,33,0,2008
2008-01-29,Perak,206,194,12,2008
2008-01-30,Perak,192,186,6,2008
2008-01-31,Perak,102,95,7,2008
2008-02-01,Perak,401,382,19,2008
2008-02-02,Perak,20,20,0,2008
2008-02-03,Perak,18,18,0,2008
2008-02-04,Perak,43,41,2,2008
2008-02-05,Perak,71,65,6,2008
2008-02-06,Perak,94,82,12,2008
2008-02-07,Perak,1,1,0,2008
2008-02-08,Perak,0,0,0,2008
2008-02-09,Perak,0,0,0,2008
2008-02-10,Perak,23,18,5,2008
2008-02-11,Perak,22,21,1,2008
2008-02-12,Perak,20,18,2,2008
2008-02-13,Perak,54,52,2,2008
2008-02-14,Perak,53,49,4,2008
2008-02-15,Perak,1,0,1,2008
2008-02-16,Perak,86,86,0,2008
2008-02-17,Perak,23,23,0,2008
2008-02-18,Perak,25,20,5,2008
2008-02-19,Perak,63,59,4,2008
2008-02-20,Perak,76,68,8,2008
2008-02-21,Perak,74,57,17,2008
2008-02-22,Perak,13,12,1,2008
2008-02-23,Perak,325,318,7,2008
2008-02-24,Perak,24,24,0,2008
2008-02-25,Perak,35,24,11,2008
2008-02-26,Perak,77,73,4,2008
2008-02-27,Perak,54,49,5,2008
2008-02-28,Perak,93,87,6,2008
2008-02-29,Perak,18,17,1,2008
2008-03-01,Perak,43,41,2,2008
2008-03-02,Perak,57,53,4,2008
2008-03-03,Perak,74,74,0,2008
2008-03-04,Perak,52,52,0,2008
2008-03-05,Perak,105,99,6,2008
2008-03-06,Perak,144,133,11,2008
2008-03-07,Perak,93,88,5,2008
2008-03-08,Perak,0,0,0,2008
2008-03-09,Perak,0,0,0,2008
2008-03-10,Perak,67,63,4,2008
2008-03-11,Perak,12,8,4,2008
2008-03-12,Perak,46,45,1,2008
2008-03-13,Perak,104,97,7,2008
2008-03-14,Perak,43,40,3,2008
2008-03-15,Perak,24,24,0,2008
2008-03-16,Perak,254,251,3,2008
2008-03-17,Perak,20,17,3,2008
2008-03-18,Perak,183,172,11,2008
2008-03-19,Perak,42,40,2,2008
2008-03-20,Perak,2,2,0,2008
2008-03-21,Perak,25,20,5,2008
2008-03-22,Perak,0,0,0,2008
2008-03-23,Perak,0,0,0,2008
2008-03-24,Perak,55,43,12,2008
2008-03-25,Perak,61,55,6,2008
2008-03-26,Perak,89,87,2,2008
2008-03-27,Perak,138,134,4,2008
2008-03-28,Perak,51,46,5,2008
2008-03-29,Perak,3,2,1,2008
2008-03-30,Perak,2,1,1,2008
2008-03-31,Perak,25,19,6,2008
2008-04-01,Perak,36,35,1,2008
2008-04-02,Perak,210,196,14,2008
2008-04-03,Perak,14,13,1,2008
2008-04-04,Perak,6,4,2,2008
2008-04-05,Perak,130,114,16,2008
2008-04-06,Perak,88,81,7,2008
2008-04-07,Perak,13,11,2,2008
2008-04-08,Perak,41,34,7,2008
2008-04-09,Perak,39,33,6,2008
2008-04-10,Perak,7,3,4,2008
2008-04-11,Perak,75,60,15,2008
2008-04-12,Perak,39,33,6,2008
2008-04-13,Perak,201,184,17,2008
2008-04-14,Perak,63,41,22,2008
2008-04-15,Perak,87,68,19,2008
2008-04-16,Perak,249,228,21,2008
2008-04-17,Perak,17,11,6,2008
2008-04-18,Perak,9,4,5,2008
2008-04-19,Perak,53,46,7,2008
2008-04-20,Perak,129,119,10,2008
2008-04-21,Perak,14,8,6,2008
2008-04-22,Perak,35,30,5,2008
2008-04-23,Perak,28,24,4,2008
2008-04-24,Perak,37,32,5,2008
2008-04-25,Perak,111,100,11,2008
2008-04-26,Perak,0,0,0,2008
2008-04-27,Perak,21,21,0,2008
2008-04-28,Perak,19,12,7,2008
2008-04-29,Perak,21,10,11,2008
2008-04-30,Perak,13,11,2,2008
2008-05-01,Perak,133,121,12,2008
2008-05-02,Perak,19,10,9,2008
2008-05-03,Perak,2,2,0,2008
2008-05-04,Perak,2,2,0,2008
2008-05-05,Perak,54,33,21,2008
2008-05-06,Perak,126,67,59,2008
2008-05-07,Perak,104,81,23,2008
2008-05-08,Perak,87,74,13,2008
2008-05-09,Perak,8,5,3,2008
2008-05-10,Perak,42,32,10,2008
2008-05-11,Perak,0,0,0,2008
2008-05-12,Perak,36,23,13,2008
2008-05-13,Perak,9,4,5,2008
2008-05-14,Perak,14,7,7,2008
2008-05-15,Perak,66,60,6,2008
2008-05-16,Perak,24,19,5,2008
2008-05-17,Perak,153,143,10,2008
2008-05-18,Perak,174,106,68,2008
2008-05-19,Perak,44,39,5,2008
2008-05-20,Perak,28,14,14,2008
2008-05-21,Perak,18,10,8,2008
2008-05-22,Perak,17,12,5,2008
2008-05-23,Perak,17,9,8,2008
2008-05-24,Perak,128,123,5,2008
2008-05-25,Perak,34,32,2,2008
2008-05-26,Perak,107,79,28,2008
2008-05-27,Perak,100,67,33,2008
2008-05-28,Perak,88,65,23,2008
2008-05-29,Perak,72,43,29,2008
2008-05-30,Perak,9,1,8,2008
2008-05-31,Perak,84,82,2,2008
2008-06-01,Perak,35,32,3,2008
2008-06-02,Perak,15,6,9,2008
2008-06-03,Perak,23,14,9,2008
2008-06-04,Perak,16,2,14,2008
2008-06-05,Perak,24,11,13,2008
2008-06-06,Perak,32,21,11,2008
2008-06-07,Perak,126,107,19,2008
2008-06-08,Perak,55,50,5,2008
2008-06-09,Perak,20,9,11,2008
2008-06-10,Perak,60,47,13,2008
2008-06-11,Perak,51,39,12,2008
2008-06-12,Perak,94,87,7,2008
2008-06-13,Perak,20,7,13,2008
2008-06-14,Perak,38,34,4,2008
2008-06-15,Perak,37,36,1,2008
2008-06-16,Perak,69,52,17,2008
2008-06-17,Perak,27,11,16,2008
2008-06-18,Perak,45,32,13,2008
2008-06-19,Perak,21,12,9,2008
2008-06-20,Perak,15,6,9,2008
2008-06-21,Perak,18,7,11,2008
2008-06-22,Perak,223,190,33,2008
2008-06-23,Perak,44,30,14,2008
2008-06-24,Perak,76,67,9,2008
2008-06-25,Perak,64,48,16,2008
2008-06-26,Perak,54,22,32,2008
2008-06-27,Perak,23,13,10,2008
2008-06-28,Perak,61,59,2,2008
2008-06-29,Perak,42,33,9,2008
2008-06-30,Perak,74,68,6,2008
2008-07-01,Perak,93,79,14,2008
2008-07-02,Perak,81,40,41,2008
2008-07-03,Perak,16,11,5,2008
2008-07-04,Perak,56,46,10,2008
2008-07-05,Perak,0,0,0,2008
2008-07-06,Perak,120,106,14,2008
2008-07-07,Perak,67,43,24,2008
2008-07-08,Perak,159,138,21,2008
2008-07-09,Perak,120,94,26,2008
2008-07-10,Perak,117,97,20,2008
2008-07-11,Perak,39,32,7,2008
2008-07-12,Perak,167,152,15,2008
2008-07-13,Perak,217,99,118,2008
2008-07-14,Perak,16,5,11,2008
2008-07-15,Perak,98,66,32,2008
2008-07-16,Perak,107,70,37,2008
2008-07-17,Perak,61,39,22,2008
2008-07-18,Perak,16,7,9,2008
2008-07-19,Perak,55,43,12,2008
2008-07-20,Perak,32,21,11,2008
2008-07-21,Perak,126,91,35,2008
2008-07-22,Perak,124,97,27,2008
2008-07-23,Perak,47,38,9,2008
2008-07-24,Perak,32,26,6,2008
2008-07-25,Perak,11,7,4,2008
2008-07-26,Perak,25,22,3,2008
2008-07-27,Perak,92,70,22,2008
2008-07-28,Perak,64,60,4,2008
2008-07-29,Perak,21,11,10,2008
2008-07-30,Perak,224,210,14,2008
2008-07-31,Perak,53,32,21,2008
2008-08-01,Perak,13,7,6,2008
2008-08-02,Perak,171,132,39,2008
2008-08-03,Perak,151,114,37,2008
2008-08-04,Perak,161,129,32,2008
2008-08-05,Perak,165,117,48,2008
2008-08-06,Perak,113,76,37,2008
2008-08-07,Perak,116,105,11,2008
2008-08-08,Perak,51,40,11,2008
2008-08-09,Perak,38,32,6,2008
2008-08-10,Perak,130,91,39,2008
2008-08-11,Perak,22,13,9,2008
2008-08-12,Perak,182,162,20,2008
2008-08-13,Perak,103,81,22,2008
2008-08-14,Perak,102,47,55,2008
2008-08-15,Perak,18,8,10,2008
2008-08-16,Perak,170,164,6,2008
2008-08-17,Perak,191,122,69,2008
2008-08-18,Perak,11,6,5,2008
2008-08-19,Perak,15,8,7,2008
2008-08-20,Perak,63,47,16,2008
2008-08-21,Perak,152,140,12,2008
2008-08-22,Perak,12,6,6,2008
2008-08-23,Perak,157,130,27,2008
2008-08-24,Perak,130,89,41,2008
2008-08-25,Perak,123,99,24,2008
2008-08-26,Perak,123,102,21,2008
2008-08-27,Perak,170,136,34,2008
2008-08-28,Perak,301,249,52,2008
2008-08-29,Perak,47,32,15,2008
2008-08-30,Perak,97,75,22,2008
2008-08-31,Perak,106,89,17,2008
2008-09-01,Perak,0,0,0,2008
2008-09-02,Perak,51,42,9,2008
2008-09-03,Perak,4,2,2,2008
2008-09-04,Perak,97,92,5,2008
2008-09-05,Perak,90,80,10,2008
2008-09-06,Perak,20,18,2,2008
2008-09-07,Perak,218,186,32,2008
2008-09-08,Perak,16,6,10,2008
2008-09-09,Perak,7,3,4,2008
2008-09-10,Perak,36,26,10,2008
2008-09-11,Perak,13,4,9,2008
2008-09-12,Perak,12,9,3,2008
2008-09-13,Perak,44,42,2,2008
2008-09-14,Perak,102,36,66,2008
2008-09-15,Perak,11,3,8,2008
2008-09-16,Perak,15,4,11,2008
2008-09-17,Perak,0,0,0,2008
2008-09-18,Perak,36,29,7,2008
2008-09-19,Perak,5,1,4,2008
2008-09-20,Perak,2,2,0,2008
2008-09-21,Perak,99,91,8,2008
2008-09-22,Perak,16,9,7,2008
2008-09-23,Perak,35,29,6,2008
2008-09-24,Perak,12,3,9,2008
2008-09-25,Perak,74,67,7,2008
2008-09-26,Perak,10,3,7,2008
2008-09-27,Perak,57,49,8,2008
2008-09-28,Perak,162,135,27,2008
2008-09-29,Perak,40,22,18,2008
2008-09-30,Perak,37,24,13,2008
2008-10-01,Perak,12,7,5,2008
2008-10-02,Perak,13,8,5,2008
2008-10-03,Perak,31,21,10,2008
2008-10-04,Perak,41,31,10,2008
2008-10-05,Perak,108,90,18,2008
2008-10-06,Perak,21,7,14,2008
2008-10-07,Perak,150,134,16,2008
2008-10-08,Perak,114,47,67,2008
2008-10-09,Perak,96,62,34,2008
2008-10-10,Perak,19,6,13,2008
2008-10-11,Perak,0,0,0,2008
2008-10-12,Perak,97,86,11,2008
2008-10-13,Perak,42,13,29,2008
2008-10-14,Perak,65,36,29,2008
2008-10-15,Perak,34,32,2,2008
2008-10-16,Perak,169,116,53,2008
2008-10-17,Perak,20,8,12,2008
2008-10-18,Perak,33,15,18,2008
2008-10-19,Perak,89,89,0,2008
2008-10-20,Perak,49,19,30,2008
2008-10-21,Perak,113,96,17,2008
2008-10-22,Perak,67,38,29,2008
2008-10-23,Perak,226,154,72,2008
2008-10-24,Perak,22,9,13,2008
2008-10-25,Perak,63,61,2,2008
2008-10-26,Perak,122,73,49,2008
2008-10-27,Perak,0,0,0,2008
2008-10-28,Perak,21,6,15,2008
2008-10-29,Perak,60,38,22,2008
2008-10-30,Perak,21,10,11,2008
2008-10-31,Perak,18,12,6,2008
2008-11-01,Perak,17,13,4,2008
2008-11-02,Perak,294,233,61,2008
2008-11-03,Perak,22,6,16,2008
2008-11-04,Perak,19,3,16,2008
2008-11-05,Perak,51,29,22,2008
2008-11-06,Perak,14,4,10,2008
2008-11-07,Perak,27,7,20,2008
2008-11-08,Perak,103,85,18,2008
2008-11-09,Perak,153,109,44,2008
2008-11-10,Perak,15,4,11,2008
2008-11-11,Perak,98,60,38,2008
2008-11-12,Perak,187,100,87,2008
2008-11-13,Perak,86,45,41,2008
2008-11-14,Perak,107,71,36,2008
2008-11-15,Perak,16,10,6,2008
2008-11-16,Perak,243,89,154,2008
2008-11-17,Perak,16,5,11,2008
2008-11-18,Perak,26,12,14,2008
2008-11-19,Perak,66,45,21,2008
2008-11-20,Perak,53,35,18,2008
2008-11-21,Perak,13,4,9,2008
2008-11-22,Perak,9,8,1,2008
2008-11-23,Perak,94,69,25,2008
2008-11-24,Perak,83,59,24,2008
2008-11-25,Perak,142,76,66,2008
2008-11-26,Perak,90,36,54,2008
2008-11-27,Perak,138,66,72,2008
2008-11-28,Perak,14,6,8,2008
2008-11-29,Perak,0,0,0,2008
2008-11-30,Perak,35,31,4,2008
2008-12-01,Perak,17,9,8,2008
2008-12-02,Perak,21,9,12,2008
2008-12-03,Perak,18,5,13,2008
2008-12-04,Perak,47,32,15,2008
2008-12-05,Perak,64,35,29,2008
2008-12-06,Perak,31,21,10,2008
2008-12-07,Perak,77,50,27,2008
2008-12-08,Perak,0,0,0,2008
2008-12-09,Perak,18,6,12,2008
2008-12-10,Perak,29,17,12,2008
2008-12-11,Perak,43,21,22,2008
2008-12-12,Perak,55,35,20,2008
2008-12-13,Perak,53,48,5,2008
2008-12-14,Perak,232,98,134,2008
2008-12-15,Perak,48,14,34,2008
2008-12-16,Perak,120,89,31,2008
2008-12-17,Perak,106,76,30,2008
2008-12-18,Perak,53,31,22,2008
2008-12-19,Perak,42,24,18,2008
2008-12-20,Perak,0,0,0,2008
2008-12-21,Perak,73,46,27,2008
2008-12-22,Perak,29,12,17,2008
2008-12-23,Perak,52,30,22,2008
2008-12-24,Perak,37,22,15,2008
2008-12-25,Perak,0,0,0,2008
2008-12-26,Perak,10,1,9,2008
2008-12-27,Perak,17,12,5,2008
2008-12-28,Perak,10,5,5,2008
2008-12-29,Perak,0,0,0,2008
2008-12-30,Perak,31,9,22,2008
2008-12-31,Perak,48,30,18,2008
2009-01-01,Perak,117,76,41,2009
2009-01-02,Perak,24,12,12,2009
2009-01-03,Perak,0,0,0,2009
2009-01-04,Perak,31,26,5,2009
2009-01-05,Perak,56,28,28,2009
2009-01-06,Perak,174,71,103,2009
2009-01-07,Perak,58,34,24,2009
2009-01-08,Perak,57,41,16,2009
2009-01-09,Perak,91,66,25,2009
2009-01-10,Perak,179,116,63,2009
2009-01-11,Perak,261,185,76,2009
2009-01-12,Perak,98,61,37,2009
2009-01-13,Perak,168,121,47,2009
2009-01-14,Perak,136,72,64,2009
2009-01-15,Perak,210,127,83,2009
2009-01-16,Perak,186,124,62,2009
2009-01-17,Perak,14,14,0,2009
2009-01-18,Perak,1,0,1,2009
2009-01-19,Perak,53,17,36,2009
2009-01-20,Perak,84,45,39,2009
2009-01-21,Perak,41,26,15,2009
2009-01-22,Perak,154,101,53,2009
2009-01-23,Perak,26,7,19,2009
2009-01-24,Perak,57,43,14,2009
2009-01-25,Perak,26,15,11,2009
2009-01-26,Perak,0,0,0,2009
2009-01-27,Perak,0,0,0,2009
2009-01-28,Perak,34,11,23,2009
2009-01-29,Perak,92,31,61,2009
2009-01-30,Perak,24,10,14,2009
2009-01-31,Perak,134,128,6,2009
2009-02-01,Perak,1,0,1,2009
2009-02-02,Perak,72,24,48,2009
2009-02-03,Perak,0,0,0,2009
2009-02-04,Perak,143,66,77,2009
2009-02-05,Perak,99,50,49,2009
2009-02-06,Perak,48,27,21,2009
2009-02-07,Perak,0,0,0,2009
2009-02-08,Perak,108,74,34,2009
2009-02-09,Perak,18,13,5,2009
2009-02-10,Perak,54,22,32,2009
2009-02-11,Perak,98,44,54,2009
2009-02-12,Perak,80,32,48,2009
2009-02-13,Perak,25,5,20,2009
2009-02-14,Perak,143,107,36,2009
2009-02-15,Perak,123,91,32,2009
2009-02-16,Perak,25,5,20,2009
2009-02-17,Perak,156,125,31,2009
2009-02-18,Perak,146,90,56,2009
2009-02-19,Perak,28,9,19,2009
2009-02-20,Perak,74,52,22,2009
2009-02-21,Perak,374,354,20,2009
2009-02-22,Perak,1,0,1,2009
2009-02-23,Perak,26,8,18,2009
2009-02-24,Perak,218,167,51,2009
2009-02-25,Perak,256,178,78,2009
2009-02-26,Perak,302,210,92,2009
2009-02-27,Perak,20,3,17,2009
2009-02-28,Perak,61,42,19,2009
2009-03-01,Perak,29,21,8,2009
2009-03-02,Perak,23,5,18,2009
2009-03-03,Perak,162,94,68,2009
2009-03-04,Perak,65,27,38,2009
2009-03-05,Perak,63,37,26,2009
2009-03-06,Perak,35,9,26,2009
2009-03-07,Perak,0,0,0,2009
2009-03-08,Perak,185,111,74,2009
2009-03-09,Perak,132,81,51,2009
2009-03-10,Perak,21,4,17,2009
2009-03-11,Perak,20,4,16,2009
2009-03-12,Perak,94,67,27,2009
2009-03-13,Perak,16,4,12,2009
2009-03-14,Perak,31,14,17,2009
2009-03-15,Perak,17,9,8,2009
2009-03-16,Perak,45,18,27,2009
2009-03-17,Perak,59,22,37,2009
2009-03-18,Perak,17,3,14,2009
2009-03-19,Perak,86,47,39,2009
2009-03-20,Perak,75,57,18,2009
2009-03-21,Perak,0,0,0,2009
2009-03-22,Perak,113,66,47,2009
2009-03-23,Perak,28,8,20,2009
2009-03-24,Perak,102,23,79,2009
2009-03-25,Perak,155,80,75,2009
2009-03-26,Perak,136,54,82,2009
2009-03-27,Perak,12,2,10,2009
2009-03-28,Perak,1,1,0,2009
2009-03-29,Perak,357,115,242,2009
2009-03-30,Perak,77,32,45,2009
2009-03-31,Perak,146,107,39,2009
2009-04-01,Perak,24,8,16,2009
2009-04-02,Perak,54,18,36,2009
2009-04-03,Perak,28,7,21,2009
2009-04-04,Perak,73,57,16,2009
2009-04-05,Perak,0,0,0,2009
2009-04-06,Perak,19,4,15,2009
2009-04-07,Perak,32,15,17,2009
2009-04-08,Perak,45,13,32,2009
2009-04-09,Perak,12,2,10,2009
2009-04-10,Perak,42,19,23,2009
2009-04-11,Perak,137,105,32,2009
2009-04-12,Perak,110,23,87,2009
2009-04-13,Perak,34,15,19,2009
2009-04-14,Perak,83,49,34,2009
2009-04-15,Perak,34,23,11,2009
2009-04-16,Perak,72,39,33,2009
2009-04-17,Perak,43,19,24,2009
2009-04-18,Perak,19,13,6,2009
2009-04-19,Perak,56,20,36,2009
2009-04-20,Perak,0,0,0,2009
2009-04-21,Perak,46,13,33,2009
2009-04-22,Perak,44,16,28,2009
2009-04-23,Perak,57,23,34,2009
2009-04-24,Perak,86,53,33,2009
2009-04-25,Perak,24,20,4,2009
2009-04-26,Perak,49,42,7,2009
2009-04-27,Perak,72,56,16,2009
2009-04-28,Perak,104,57,47,2009
2009-04-29,Perak,175,137,38,2009
2009-04-30,Perak,53,36,17,2009
2009-05-01,Perak,119,94,25,2009
2009-05-02,Perak,0,0,0,2009
2009-05-03,Perak,34,20,14,2009
2009-05-04,Perak,31,3,28,2009
2009-05-05,Perak,23,7,16,2009
2009-05-06,Perak,56,16,40,2009
2009-05-07,Perak,18,4,14,2009
2009-05-08,Perak,36,16,20,2009
2009-05-09,Perak,198,123,75,2009
2009-05-10,Perak,80,42,38,2009
2009-05-11,Perak,18,3,15,2009
2009-05-12,Perak,23,5,18,2009
2009-05-13,Perak,65,30,35,2009
2009-05-14,Perak,20,2,18,2009
2009-05-15,Perak,82,26,56,2009
2009-05-16,Perak,97,63,34,2009
2009-05-17,Perak,233,154,79,2009
2009-05-18,Perak,32,7,25,2009
2009-05-19,Perak,75,40,35,2009
2009-05-20,Perak,89,26,63,2009
2009-05-21,Perak,67,11,56,2009
2009-05-22,Perak,17,5,12,2009
2009-05-23,Perak,107,102,5,2009
2009-05-24,Perak,0,0,0,2009
2009-05-25,Perak,39,19,20,2009
2009-05-26,Perak,60,39,21,2009
2009-05-27,Perak,76,37,39,2009
2009-05-28,Perak,22,19,3,2009
2009-05-29,Perak,15,4,11,2009
2009-05-30,Perak,213,199,14,2009
2009-05-31,Perak,131,125,6,2009
2009-06-01,Perak,100,43,57,2009
2009-06-02,Perak,231,121,110,2009
2009-06-03,Perak,121,51,70,2009
2009-06-04,Perak,208,116,92,2009
2009-06-05,Perak,165,91,74,2009
2009-06-06,Perak,67,35,32,2009
2009-06-07,Perak,153,64,89,2009
2009-06-08,Perak,53,30,23,2009
2009-06-09,Perak,106,64,42,2009
2009-06-10,Perak,14,2,12,2009
2009-06-11,Perak,77,35,42,2009
2009-06-12,Perak,79,30,49,2009
2009-06-13,Perak,44,38,6,2009
2009-06-14,Perak,106,64,42,2009
2009-06-15,Perak,16,4,12,2009
2009-06-16,Perak,16,5,11,2009
2009-06-17,Perak,97,47,50,2009
2009-06-18,Perak,80,37,43,2009
2009-06-19,Perak,67,51,16,2009
2009-06-20,Perak,72,61,11,2009
2009-06-21,Perak,140,90,50,2009
2009-06-22,Perak,41,28,13,2009
2009-06-23,Perak,140,106,34,2009
2009-06-24,Perak,19,5,14,2009
2009-06-25,Perak,200,131,69,2009
2009-06-26,Perak,40,25,15,2009
2009-06-27,Perak,55,48,7,2009
2009-06-28,Perak,101,52,49,2009
2009-06-29,Perak,17,5,12,2009
2009-06-30,Perak,74,51,23,2009
2009-07-01,Perak,121,88,33,2009
2009-07-02,Perak,111,70,41,2009
2009-07-03,Perak,26,9,17,2009
2009-07-04,Perak,1,0,1,2009
2009-07-05,Perak,41,13,28,2009
2009-07-06,Perak,23,3,20,2009
2009-07-07,Perak,108,47,61,2009
2009-07-08,Perak,40,22,18,2009
2009-07-09,Perak,64,45,19,2009
2009-07-10,Perak,125,106,19,2009
2009-07-11,Perak,25,18,7,2009
2009-07-12,Perak,161,71,90,2009
2009-07-13,Perak,28,7,21,2009
2009-07-14,Perak,94,47,47,2009
2009-07-15,Perak,75,47,28,2009
2009-07-16,Perak,223,118,105,2009
2009-07-17,Perak,12,2,10,2009
2009-07-18,Perak,125,107,18,2009
2009-07-19,Perak,319,183,136,2009
2009-07-20,Perak,18,3,15,2009
2009-07-21,Perak,89,33,56,2009
2009-07-22,Perak,215,118,97,2009
2009-07-23,Perak,92,34,58,2009
2009-07-24,Perak,23,13,10,2009
2009-07-25,Perak,37,16,21,2009
2009-07-26,Perak,243,61,182,2009
2009-07-27,Perak,114,85,29,2009
2009-07-28,Perak,25,4,21,2009
2009-07-29,Perak,237,117,120,2009
2009-07-30,Perak,173,87,86,2009
2009-07-31,Perak,68,34,34,2009
2009-08-01,Perak,52,35,17,2009
2009-08-02,Perak,85,29,56,2009
2009-08-03,Perak,18,1,17,2009
2009-08-04,Perak,130,62,68,2009
2009-08-05,Perak,57,45,12,2009
2009-08-06,Perak,35,22,13,2009
2009-08-07,Perak,74,47,27,2009
2009-08-08,Perak,62,56,6,2009
2009-08-09,Perak,23,20,3,2009
2009-08-10,Perak,10,3,7,2009
2009-08-11,Perak,30,9,21,2009
2009-08-12,Perak,24,9,15,2009
2009-08-13,Perak,10,4,6,2009
2009-08-14,Perak,67,34,33,2009
2009-08-15,Perak,128,84,44,2009
2009-08-16,Perak,158,104,54,2009
2009-08-17,Perak,60,49,11,2009
2009-08-18,Perak,89,47,42,2009
2009-08-19,Perak,277,144,133,2009
2009-08-20,Perak,37,17,20,2009
2009-08-21,Perak,92,56,36,2009
2009-08-22,Perak,0,0,0,2009
2009-08-23,Perak,120,42,78,2009
2009-08-24,Perak,6,1,5,2009
2009-08-25,Perak,7,2,5,2009
2009-08-26,Perak,6,3,3,2009
2009-08-27,Perak,78,41,37,2009
2009-08-28,Perak,11,1,10,2009
2009-08-29,Perak,24,11,13,2009
2009-08-30,Perak,113,84,29,2009
2009-08-31,Perak,68,46,22,2009
2009-09-01,Perak,17,9,8,2009
2009-09-02,Perak,8,1,7,2009
2009-09-03,Perak,41,14,27,2009
2009-09-04,Perak,13,2,11,2009
2009-09-05,Perak,36,21,15,2009
2009-09-06,Perak,198,67,131,2009
2009-09-07,Perak,1,0,1,2009
2009-09-08,Perak,41,16,25,2009
2009-09-09,Perak,62,25,37,2009
2009-09-10,Perak,25,7,18,2009
2009-09-11,Perak,9,0,9,2009
2009-09-12,Perak,57,33,24,2009
2009-09-13,Perak,222,106,116,2009
2009-09-14,Perak,20,2,18,2009
2009-09-15,Perak,21,8,13,2009
2009-09-16,Perak,38,16,22,2009
2009-09-17,Perak,75,59,16,2009
2009-09-18,Perak,9,2,7,2009
2009-09-19,Perak,45,21,24,2009
2009-09-20,Perak,0,0,0,2009
2009-09-21,Perak,2,2,0,2009
2009-09-22,Perak,0,0,0,2009
2009-09-23,Perak,25,9,16,2009
2009-09-24,Perak,16,6,10,2009
2009-09-25,Perak,27,3,24,2009
2009-09-26,Perak,61,24,37,2009
2009-09-27,Perak,161,82,79,2009
2009-09-28,Perak,22,2,20,2009
2009-09-29,Perak,62,25,37,2009
2009-09-30,Perak,63,45,18,2009
2009-10-01,Perak,84,43,41,2009
2009-10-02,Perak,9,2,7,2009
2009-10-03,Perak,27,18,9,2009
2009-10-04,Perak,98,57,41,2009
2009-10-05,Perak,23,3,20,2009
2009-10-06,Perak,39,7,32,2009
2009-10-07,Perak,22,12,10,2009
2009-10-08,Perak,66,43,23,2009
2009-10-09,Perak,42,7,35,2009
2009-10-10,Perak,135,81,54,2009
2009-10-11,Perak,59,35,24,2009
2009-10-12,Perak,24,1,23,2009
2009-10-13,Perak,140,60,80,2009
2009-10-14,Perak,107,58,49,2009
2009-10-15,Perak,157,72,85,2009
2009-10-16,Perak,50,28,22,2009
2009-10-17,Perak,33,28,5,2009
2009-10-18,Perak,22,6,16,2009
2009-10-19,Perak,22,4,18,2009
2009-10-20,Perak,31,7,24,2009
2009-10-21,Perak,65,22,43,2009
2009-10-22,Perak,55,21,34,2009
2009-10-23,Perak,86,35,51,2009
2009-10-24,Perak,105,65,40,2009
2009-10-25,Perak,114,34,80,2009
2009-10-26,Perak,68,37,31,2009
2009-10-27,Perak,18,3,15,2009
2009-10-28,Perak,65,41,24,2009
2009-10-29,Perak,113,78,35,2009
2009-10-30,Perak,98,87,11,2009
2009-10-31,Perak,197,138,59,2009
2009-11-01,Perak,66,28,38,2009
2009-11-02,Perak,20,7,13,2009
2009-11-03,Perak,20,6,14,2009
2009-11-04,Perak,42,18,24,2009
2009-11-05,Perak,42,27,15,2009
2009-11-06,Perak,74,35,39,2009
2009-11-07,Perak,66,44,22,2009
2009-11-08,Perak,166,69,97,2009
2009-11-09,Perak,42,21,21,2009
2009-11-10,Perak,84,63,21,2009
2009-11-11,Perak,59,32,27,2009
2009-11-12,Perak,23,4,19,2009
2009-11-13,Perak,37,23,14,2009
2009-11-14,Perak,2,2,0,2009
2009-11-15,Perak,159,73,86,2009
2009-11-16,Perak,51,29,22,2009
2009-11-17,Perak,32,8,24,2009
2009-11-18,Perak,38,22,16,2009
2009-11-19,Perak,10,5,5,2009
2009-11-20,Perak,15,0,15,2009
2009-11-21,Perak,0,0,0,2009
2009-11-22,Perak,236,57,179,2009
2009-11-23,Perak,69,21,48,2009
2009-11-24,Perak,119,43,76,2009
2009-11-25,Perak,50,13,37,2009
2009-11-26,Perak,98,28,70,2009
2009-11-27,Perak,0,0,0,2009
2009-11-28,Perak,0,0,0,2009
2009-11-29,Perak,46,36,10,2009
2009-11-30,Perak,45,16,29,2009
2009-12-01,Perak,28,9,19,2009
2009-12-02,Perak,23,6,17,2009
2009-12-03,Perak,73,38,35,2009
2009-12-04,Perak,12,2,10,2009
2009-12-05,Perak,0,0,0,2009
2009-12-06,Perak,167,48,119,2009
2009-12-07,Perak,23,5,18,2009
2009-12-08,Perak,56,23,33,2009
2009-12-09,Perak,57,28,29,2009
2009-12-10,Perak,63,33,30,2009
2009-12-11,Perak,16,0,16,2009
2009-12-12,Perak,96,49,47,2009
2009-12-13,Perak,166,48,118,2009
2009-12-14,Perak,26,4,22,2009
2009-12-15,Perak,58,21,37,2009
2009-12-16,Perak,31,10,21,2009
2009-12-17,Perak,97,67,30,2009
2009-12-18,Perak,155,84,71,2009
2009-12-19,Perak,56,30,26,2009
2009-12-20,Perak,86,37,49,2009
2009-12-21,Perak,35,2,33,2009
2009-12-22,Perak,29,6,23,2009
2009-12-23,Perak,16,6,10,2009
2009-12-24,Perak,22,5,17,2009
2009-12-25,Perak,0,0,0,2009
2009-12-26,Perak,90,51,39,2009
2009-12-27,Perak,40,23,17,2009
2009-12-28,Perak,57,30,27,2009
2009-12-29,Perak,66,27,39,2009
2009-12-30,Perak,23,9,14,2009
2009-12-31,Perak,167,102,65,2009
2010-01-01,Perak,38,29,9,2010
2010-01-02,Perak,21,20,1,2010
2010-01-03,Perak,35,25,10,2010
2010-01-04,Perak,36,6,30,2010
2010-01-05,Perak,175,74,101,2010
2010-01-06,Perak,41,10,31,2010
2010-01-07,Perak,45,15,30,2010
2010-01-08,Perak,58,48,10,2010
2010-01-09,Perak,109,61,48,2010
2010-01-10,Perak,167,92,75,2010
2010-01-11,Perak,91,48,43,2010
2010-01-12,Perak,171,79,92,2010
2010-01-13,Perak,176,73,103,2010
2010-01-14,Perak,86,49,37,2010
2010-01-15,Perak,67,26,41,2010
2010-01-16,Perak,358,232,126,2010
2010-01-17,Perak,53,41,12,2010
2010-01-18,Perak,184,72,112,2010
2010-01-19,Perak,195,116,79,2010
2010-01-20,Perak,306,187,119,2010
2010-01-21,Perak,348,190,158,2010
2010-01-22,Perak,271,133,138,2010
2010-01-23,Perak,90,57,33,2010
2010-01-24,Perak,97,53,44,2010
2010-01-25,Perak,16,3,13,2010
2010-01-26,Perak,32,15,17,2010
2010-01-27,Perak,92,37,55,2010
2010-01-28,Perak,99,68,31,2010
2010-01-29,Perak,97,66,31,2010
2010-01-30,Perak,54,26,28,2010
2010-01-31,Perak,2,0,2,2010
2010-02-01,Perak,38,8,30,2010
2010-02-02,Perak,68,31,37,2010
2010-02-03,Perak,284,162,122,2010
2010-02-04,Perak,284,169,115,2010
2010-02-05,Perak,191,147,44,2010
2010-02-06,Perak,109,75,34,2010
2010-02-07,Perak,61,30,31,2010
2010-02-08,Perak,54,30,24,2010
2010-02-09,Perak,103,79,24,2010
2010-02-10,Perak,45,28,17,2010
2010-02-11,Perak,36,27,9,2010
2010-02-12,Perak,77,25,52,2010
2010-02-13,Perak,0,0,0,2010
2010-02-14,Perak,12,11,1,2010
2010-02-15,Perak,0,0,0,2010
2010-02-16,Perak,0,0,0,2010
2010-02-17,Perak,44,17,27,2010
2010-02-18,Perak,62,21,41,2010
2010-02-19,Perak,38,16,22,2010
2010-02-20,Perak,169,159,10,2010
2010-02-21,Perak,1,0,1,2010
2010-02-22,Perak,174,82,92,2010
2010-02-23,Perak,214,92,122,2010
2010-02-24,Perak,171,99,72,2010
2010-02-25,Perak,72,30,42,2010
2010-02-26,Perak,0,0,0,2010
2010-02-27,Perak,254,244,10,2010
2010-02-28,Perak,20,5,15,2010
2010-03-01,Perak,12,2,10,2010
2010-03-02,Perak,162,143,19,2010
2010-03-03,Perak,134,49,85,2010
2010-03-04,Perak,17,7,10,2010
2010-03-05,Perak,82,73,9,2010
2010-03-06,Perak,63,27,36,2010
2010-03-07,Perak,67,25,42,2010
2010-03-08,Perak,79,32,47,2010
2010-03-09,Perak,98,39,59,2010
2010-03-10,Perak,130,88,42,2010
2010-03-11,Perak,18,5,13,2010
2010-03-12,Perak,14,1,13,2010
2010-03-13,Perak,34,25,9,2010
2010-03-14,Perak,343,78,265,2010
2010-03-15,Perak,54,20,34,2010
2010-03-16,Perak,50,31,19,2010
2010-03-17,Perak,79,23,56,2010
2010-03-18,Perak,60,20,40,2010
2010-03-19,Perak,20,3,17,2010
2010-03-20,Perak,2,2,0,2010
2010-03-21,Perak,139,44,95,2010
2010-03-22,Perak,23,5,18,2010
2010-03-23,Perak,84,38,46,2010
2010-03-24,Perak,11,0,11,2010
2010-03-25,Perak,14,1,13,2010
2010-03-26,Perak,77,41,36,2010
2010-03-27,Perak,34,29,5,2010
2010-03-28,Perak,25,15,10,2010
2010-03-29,Perak,143,88,55,2010
2010-03-30,Perak,43,19,24,2010
2010-03-31,Perak,72,53,19,2010
2010-04-01,Perak,98,41,57,2010
2010-04-02,Perak,12,2,10,2010
2010-04-03,Perak,74,47,27,2010
2010-04-04,Perak,156,45,111,2010
2010-04-05,Perak,27,7,20,2010
2010-04-06,Perak,21,2,19,2010
2010-04-07,Perak,69,49,20,2010
2010-04-08,Perak,253,155,98,2010
2010-04-09,Perak,36,15,21,2010
2010-04-10,Perak,0,0,0,2010
2010-04-11,Perak,129,40,89,2010
2010-04-12,Perak,114,31,83,2010
2010-04-13,Perak,22,3,19,2010
2010-04-14,Perak,115,78,37,2010
2010-04-15,Perak,68,36,32,2010
2010-04-16,Perak,9,1,8,2010
2010-04-17,Perak,0,0,0,2010
2010-04-18,Perak,55,42,13,2010
2010-04-19,Perak,10,9,1,2010
2010-04-20,Perak,34,7,27,2010
2010-04-21,Perak,115,37,78,2010
2010-04-22,Perak,152,51,101,2010
2010-04-23,Perak,102,29,73,2010
2010-04-24,Perak,87,53,34,2010
2010-04-25,Perak,115,28,87,2010
2010-04-26,Perak,27,1,26,2010
2010-04-27,Perak,43,26,17,2010
2010-04-28,Perak,54,24,30,2010
2010-04-29,Perak,23,3,20,2010
2010-04-30,Perak,7,2,5,2010
2010-05-01,Perak,67,29,38,2010
2010-05-02,Perak,111,65,46,2010
2010-05-03,Perak,62,25,37,2010
2010-05-04,Perak,17,2,15,2010
2010-05-05,Perak,42,23,19,2010
2010-05-06,Perak,120,47,73,2010
2010-05-07,Perak,14,4,10,2010
2010-05-08,Perak,113,81,32,2010
2010-05-09,Perak,112,43,69,2010
2010-05-10,Perak,19,1,18,2010
2010-05-11,Perak,22,3,19,2010
2010-05-12,Perak,18,10,8,2010
2010-05-13,Perak,13,4,9,2010
2010-05-14,Perak,18,0,18,2010
2010-05-15,Perak,64,32,32,2010
2010-05-16,Perak,135,54,81,2010
2010-05-17,Perak,28,2,26,2010
2010-05-18,Perak,59,36,23,2010
2010-05-19,Perak,82,33,49,2010
2010-05-20,Perak,82,43,39,2010
2010-05-21,Perak,10,0,10,2010
2010-05-22,Perak,287,276,11,2010
2010-05-23,Perak,92,86,6,2010
2010-05-24,Perak,626,548,78,2010
2010-05-25,Perak,13,0,13,2010
2010-05-26,Perak,79,44,35,2010
2010-05-27,Perak,49,25,24,2010
2010-05-28,Perak,180,84,96,2010
2010-05-29,Perak,96,88,8,2010
2010-05-30,Perak,0,0,0,2010
2010-05-31,Perak,146,48,98,2010
2010-06-01,Perak,153,54,99,2010
2010-06-02,Perak,173,116,57,2010
2010-06-03,Perak,204,97,107,2010
2010-06-04,Perak,237,123,114,2010
2010-06-05,Perak,0,0,0,2010
2010-06-06,Perak,111,43,68,2010
2010-06-07,Perak,15,3,12,2010
2010-06-08,Perak,11,2,9,2010
2010-06-09,Perak,7,1,6,2010
2010-06-10,Perak,53,23,30,2010
2010-06-11,Perak,15,5,10,2010
2010-06-12,Perak,60,37,23,2010
2010-06-13,Perak,114,29,85,2010
2010-06-14,Perak,53,17,36,2010
2010-06-15,Perak,18,2,16,2010
2010-06-16,Perak,190,140,50,2010
2010-06-17,Perak,5,1,4,2010
2010-06-18,Perak,27,2,25,2010
2010-06-19,Perak,71,24,47,2010
2010-06-20,Perak,125,69,56,2010
2010-06-21,Perak,57,29,28,2010
2010-06-22,Perak,22,4,18,2010
2010-06-23,Perak,96,40,56,2010
2010-06-24,Perak,83,58,25,2010
2010-06-25,Perak,13,1,12,2010
2010-06-26,Perak,0,0,0,2010
2010-06-27,Perak,0,0,0,2010
2010-06-28,Perak,106,80,26,2010
2010-06-29,Perak,74,43,31,2010
2010-06-30,Perak,31,20,11,2010
2010-07-01,Perak,41,10,31,2010
2010-07-02,Perak,23,1,22,2010
2010-07-03,Perak,35,28,7,2010
2010-07-04,Perak,199,105,94,2010
2010-07-05,Perak,22,2,20,2010
2010-07-06,Perak,65,21,44,2010
2010-07-07,Perak,158,42,116,2010
2010-07-08,Perak,81,29,52,2010
2010-07-09,Perak,15,2,13,2010
2010-07-10,Perak,73,23,50,2010
2010-07-11,Perak,0,0,0,2010
2010-07-12,Perak,13,1,12,2010
2010-07-13,Perak,109,43,66,2010
2010-07-14,Perak,29,5,24,2010
2010-07-15,Perak,24,5,19,2010
2010-07-16,Perak,187,99,88,2010
2010-07-17,Perak,110,102,8,2010
2010-07-18,Perak,251,43,208,2010
2010-07-19,Perak,25,4,21,2010
2010-07-20,Perak,67,14,53,2010
2010-07-21,Perak,77,40,37,2010
2010-07-22,Perak,227,101,126,2010
2010-07-23,Perak,96,39,57,2010
2010-07-24,Perak,140,108,32,2010
2010-07-25,Perak,171,64,107,2010
2010-07-26,Perak,2,1,1,2010
2010-07-27,Perak,62,36,26,2010
2010-07-28,Perak,71,63,8,2010
2010-07-29,Perak,154,96,58,2010
2010-07-30,Perak,68,22,46,2010
2010-07-31,Perak,164,146,18,2010
2010-08-01,Perak,90,24,66,2010
2010-08-02,Perak,25,5,20,2010
2010-08-03,Perak,161,98,63,2010
2010-08-04,Perak,102,54,48,2010
2010-08-05,Perak,63,24,39,2010
2010-08-06,Perak,13,1,12,2010
2010-08-07,Perak,74,31,43,2010
2010-08-08,Perak,149,81,68,2010
2010-08-09,Perak,65,38,27,2010
2010-08-10,Perak,78,59,19,2010
2010-08-11,Perak,35,25,10,2010
2010-08-12,Perak,56,44,12,2010
2010-08-13,Perak,5,1,4,2010
2010-08-14,Perak,19,14,5,2010
2010-08-15,Perak,276,70,206,2010
2010-08-16,Perak,17,1,16,2010
2010-08-17,Perak,8,1,7,2010
2010-08-18,Perak,42,21,21,2010
2010-08-19,Perak,40,13,27,2010
2010-08-20,Perak,22,12,10,2010
2010-08-21,Perak,126,65,61,2010
2010-08-22,Perak,113,23,90,2010
2010-08-23,Perak,21,3,18,2010
2010-08-24,Perak,82,61,21,2010
2010-08-25,Perak,25,3,22,2010
2010-08-26,Perak,33,11,22,2010
2010-08-27,Perak,4,1,3,2010
2010-08-28,Perak,1,0,1,2010
2010-08-29,Perak,102,52,50,2010
2010-08-30,Perak,15,2,13,2010
2010-08-31,Perak,35,13,22,2010
2010-09-01,Perak,90,64,26,2010
2010-09-02,Perak,89,70,19,2010
2010-09-03,Perak,97,46,51,2010
2010-09-04,Perak,1,0,1,2010
2010-09-05,Perak,66,14,52,2010
2010-09-06,Perak,25,9,16,2010
2010-09-07,Perak,63,25,38,2010
2010-09-08,Perak,57,25,32,2010
2010-09-09,Perak,19,7,12,2010
2010-09-10,Perak,0,0,0,2010
2010-09-11,Perak,0,0,0,2010
2010-09-12,Perak,1,0,1,2010
2010-09-13,Perak,35,10,25,2010
2010-09-14,Perak,43,12,31,2010
2010-09-15,Perak,45,10,35,2010
2010-09-16,Perak,85,45,40,2010
2010-09-17,Perak,71,33,38,2010
2010-09-18,Perak,23,12,11,2010
2010-09-19,Perak,67,36,31,2010
2010-09-20,Perak,70,43,27,2010
2010-09-21,Perak,71,33,38,2010
2010-09-22,Perak,70,20,50,2010
2010-09-23,Perak,112,55,57,2010
2010-09-24,Perak,27,6,21,2010
2010-09-25,Perak,80,50,30,2010
2010-09-26,Perak,264,115,149,2010
2010-09-27,Perak,66,29,37,2010
2010-09-28,Perak,98,49,49,2010
2010-09-29,Perak,130,65,65,2010
2010-09-30,Perak,43,14,29,2010
2010-10-01,Perak,28,14,14,2010
2010-10-02,Perak,64,33,31,2010
2010-10-03,Perak,275,101,174,2010
2010-10-04,Perak,33,7,26,2010
2010-10-05,Perak,119,52,67,2010
2010-10-06,Perak,99,58,41,2010
2010-10-07,Perak,33,7,26,2010
2010-10-08,Perak,62,39,23,2010
2010-10-09,Perak,102,65,37,2010
2010-10-10,Perak,65,23,42,2010
2010-10-11,Perak,43,14,29,2010
2010-10-12,Perak,33,11,22,2010
2010-10-13,Perak,29,10,19,2010
2010-10-14,Perak,106,52,54,2010
2010-10-15,Perak,37,8,29,2010
2010-10-16,Perak,54,40,14,2010
2010-10-17,Perak,156,69,87,2010
2010-10-18,Perak,149,86,63,2010
2010-10-19,Perak,48,7,41,2010
2010-10-20,Perak,34,6,28,2010
2010-10-21,Perak,106,23,83,2010
2010-10-22,Perak,19,3,16,2010
2010-10-23,Perak,22,12,10,2010
2010-10-24,Perak,110,51,59,2010
2010-10-25,Perak,43,6,37,2010
2010-10-26,Perak,107,91,16,2010
2010-10-27,Perak,34,15,19,2010
2010-10-28,Perak,75,27,48,2010
2010-10-29,Perak,71,21,50,2010
2010-10-30,Perak,28,12,16,2010
2010-10-31,Perak,58,21,37,2010
2010-11-01,Perak,54,25,29,2010
2010-11-02,Perak,47,15,32,2010
2010-11-03,Perak,52,17,35,2010
2010-11-04,Perak,84,31,53,2010
2010-11-05,Perak,0,0,0,2010
2010-11-06,Perak,83,38,45,2010
2010-11-07,Perak,89,44,45,2010
2010-11-08,Perak,83,37,46,2010
2010-11-09,Perak,57,34,23,2010
2010-11-10,Perak,64,30,34,2010
2010-11-11,Perak,51,22,29,2010
2010-11-12,Perak,27,7,20,2010
2010-11-13,Perak,84,50,34,2010
2010-11-14,Perak,42,15,27,2010
2010-11-15,Perak,45,32,13,2010
2010-11-16,Perak,34,21,13,2010
2010-11-17,Perak,0,0,0,2010
2010-11-18,Perak,78,36,42,2010
2010-11-19,Perak,53,24,29,2010
2010-11-20,Perak,27,25,2,2010
2010-11-21,Perak,239,36,203,2010
2010-11-22,Perak,10,0,10,2010
2010-11-23,Perak,159,71,88,2010
2010-11-24,Perak,80,32,48,2010
2010-11-25,Perak,272,234,38,2010
2010-11-26,Perak,18,4,14,2010
2010-11-27,Perak,94,43,51,2010
2010-11-28,Perak,58,45,13,2010
2010-11-29,Perak,86,27,59,2010
2010-11-30,Perak,24,13,11,2010
2010-12-01,Perak,32,14,18,2010
2010-12-02,Perak,95,63,32,2010
2010-12-03,Perak,24,8,16,2010
2010-12-04,Perak,79,30,49,2010
2010-12-05,Perak,118,27,91,2010
2010-12-06,Perak,30,9,21,2010
2010-12-07,Perak,92,42,50,2010
2010-12-08,Perak,301,138,163,2010
2010-12-09,Perak,59,22,37,2010
2010-12-10,Perak,18,2,16,2010
2010-12-11,Perak,68,28,40,2010
2010-12-12,Perak,194,62,132,2010
2010-12-13,Perak,62,43,19,2010
2010-12-14,Perak,16,0,16,2010
2010-12-15,Perak,15,5,10,2010
2010-12-16,Perak,16,4,12,2010
2010-12-17,Perak,58,25,33,2010
2010-12-18,Perak,59,44,15,2010
2010-12-19,Perak,172,54,118,2010
2010-12-20,Perak,78,33,45,2010
2010-12-21,Perak,169,60,109,2010
2010-12-22,Perak,36,9,27,2010
2010-12-23,Perak,37,5,32,2010
2010-12-24,Perak,36,10,26,2010
2010-12-25,Perak,9,7,2,2010
2010-12-26,Perak,42,9,33,2010
2010-12-27,Perak,39,15,24,2010
2010-12-28,Perak,31,12,19,2010
2010-12-29,Perak,31,4,27,2010
2010-12-30,Perak,115,48,67,2010
2010-12-31,Perak,8,3,5,2010
2011-01-01,Perak,78,34,44,2011
2011-01-02,Perak,75,30,45,2011
2011-01-03,Perak,29,8,21,2011
2011-01-04,Perak,26,2,24,2011
2011-01-05,Perak,242,61,181,2011
2011-01-06,Perak,28,2,26,2011
2011-01-07,Perak,43,19,24,2011
2011-01-08,Perak,109,51,58,2011
2011-01-09,Perak,161,79,82,2011
2011-01-10,Perak,16,3,13,2011
2011-01-11,Perak,115,50,65,2011
2011-01-12,Perak,91,50,41,2011
2011-01-13,Perak,98,60,38,2011
2011-01-14,Perak,16,1,15,2011
2011-01-15,Perak,97,83,14,2011
2011-01-16,Perak,42,11,31,2011
2011-01-17,Perak,244,101,143,2011
2011-01-18,Perak,350,106,244,2011
2011-01-19,Perak,378,131,247,2011
2011-01-20,Perak,103,73,30,2011
2011-01-21,Perak,312,126,186,2011
2011-01-22,Perak,70,49,21,2011
2011-01-23,Perak,41,26,15,2011
2011-01-24,Perak,101,49,52,2011
2011-01-25,Perak,37,16,21,2011
2011-01-26,Perak,19,1,18,2011
2011-01-27,Perak,156,72,84,2011
2011-01-28,Perak,49,25,24,2011
2011-01-29,Perak,39,32,7,2011
2011-01-30,Perak,69,42,27,2011
2011-01-31,Perak,90,63,27,2011
2011-02-01,Perak,40,15,25,2011
2011-02-02,Perak,44,13,31,2011
2011-02-03,Perak,0,0,0,2011
2011-02-04,Perak,0,0,0,2011
2011-02-05,Perak,0,0,0,2011
2011-02-06,Perak,0,0,0,2011
2011-02-07,Perak,98,62,36,2011
2011-02-08,Perak,40,15,25,2011
2011-02-09,Perak,41,14,27,2011
2011-02-10,Perak,71,20,51,2011
2011-02-11,Perak,89,47,42,2011
2011-02-12,Perak,150,120,30,2011
2011-02-13,Perak,29,18,11,2011
2011-02-14,Perak,105,31,74,2011
2011-02-15,Perak,30,16,14,2011
2011-02-16,Perak,116,35,81,2011
2011-02-17,Perak,68,19,49,2011
2011-02-18,Perak,120,51,69,2011
2011-02-19,Perak,64,39,25,2011
2011-02-20,Perak,166,86,80,2011
2011-02-21,Perak,113,30,83,2011
2011-02-22,Perak,81,26,55,2011
2011-02-23,Perak,18,5,13,2011
2011-02-24,Perak,96,44,52,2011
2011-02-25,Perak,75,43,32,2011
2011-02-26,Perak,266,176,90,2011
2011-02-27,Perak,214,105,109,2011
2011-02-28,Perak,99,53,46,2011
2011-03-01,Perak,47,14,33,2011
2011-03-02,Perak,29,6,23,2011
2011-03-03,Perak,15,4,11,2011
2011-03-04,Perak,42,21,21,2011
2011-03-05,Perak,335,318,17,2011
2011-03-06,Perak,219,196,23,2011
2011-03-07,Perak,211,109,102,2011
2011-03-08,Perak,97,51,46,2011
2011-03-09,Perak,232,138,94,2011
2011-03-10,Perak,153,104,49,2011
2011-03-11,Perak,76,53,23,2011
2011-03-12,Perak,39,16,23,2011
2011-03-13,Perak,73,16,57,2011
2011-03-14,Perak,45,11,34,2011
2011-03-15,Perak,114,61,53,2011
2011-03-16,Perak,65,38,27,2011
2011-03-17,Perak,62,33,29,2011
2011-03-18,Perak,11,1,10,2011
2011-03-19,Perak,0,0,0,2011
2011-03-20,Perak,325,45,280,2011
2011-03-21,Perak,65,27,38,2011
2011-03-22,Perak,103,51,52,2011
2011-03-23,Perak,201,95,106,2011
2011-03-24,Perak,205,94,111,2011
2011-03-25,Perak,119,65,54,2011
2011-03-26,Perak,49,32,17,2011
2011-03-27,Perak,156,71,85,2011
2011-03-28,Perak,52,22,30,2011
2011-03-29,Perak,53,13,40,2011
2011-03-30,Perak,103,32,71,2011
2011-03-31,Perak,177,67,110,2011
2011-04-01,Perak,71,45,26,2011
2011-04-02,Perak,210,113,97,2011
2011-04-03,Perak,168,17,151,2011
2011-04-04,Perak,21,1,20,2011
2011-04-05,Perak,94,50,44,2011
2011-04-06,Perak,43,25,18,2011
2011-04-07,Perak,183,76,107,2011
2011-04-08,Perak,46,10,36,2011
2011-04-09,Perak,71,47,24,2011
2011-04-10,Perak,187,46,141,2011
2011-04-11,Perak,24,5,19,2011
2011-04-12,Perak,43,23,20,2011
2011-04-13,Perak,124,68,56,2011
2011-04-14,Perak,31,7,24,2011
2011-04-15,Perak,45,17,28,2011
2011-04-16,Perak,5,2,3,2011
2011-04-17,Perak,38,3,35,2011
2011-04-18,Perak,14,1,13,2011
2011-04-19,Perak,72,47,25,2011
2011-04-20,Perak,107,59,48,2011
2011-04-21,Perak,87,33,54,2011
2011-04-22,Perak,57,22,35,2011
2011-04-23,Perak,93,38,55,2011
2011-04-24,Perak,60,25,35,2011
2011-04-25,Perak,19,5,14,2011
2011-04-26,Perak,202,104,98,2011
2011-04-27,Perak,54,8,46,2011
2011-04-28,Perak,20,2,18,2011
2011-04-29,Perak,82,12,70,2011
2011-04-30,Perak,37,24,13,2011
2011-05-01,Perak,46,20,26,2011
2011-05-02,Perak,39,14,25,2011
2011-05-03,Perak,20,3,17,2011
2011-05-04,Perak,22,1,21,2011
2011-05-05,Perak,36,9,27,2011
2011-05-06,Perak,46,32,14,2011
2011-05-07,Perak,18,11,7,2011
2011-05-08,Perak,38,23,15,2011
2011-05-09,Perak,17,1,16,2011
2011-05-10,Perak,13,1,12,2011
2011-05-11,Perak,55,22,33,2011
2011-05-12,Perak,59,20,39,2011
2011-05-13,Perak,68,35,33,2011
2011-05-14,Perak,115,69,46,2011
2011-05-15,Perak,158,48,110,2011
2011-05-16,Perak,86,37,49,2011
2011-05-17,Perak,146,38,108,2011
2011-05-18,Perak,44,18,26,2011
2011-05-19,Perak,68,7,61,2011
2011-05-20,Perak,16,3,13,2011
2011-05-21,Perak,19,16,3,2011
2011-05-22,Perak,119,23,96,2011
2011-05-23,Perak,12,2,10,2011
2011-05-24,Perak,151,55,96,2011
2011-05-25,Perak,154,61,93,2011
2011-05-26,Perak,33,19,14,2011
2011-05-27,Perak,351,296,55,2011
2011-05-28,Perak,48,13,35,2011
2011-05-29,Perak,93,38,55,2011
2011-05-30,Perak,114,31,83,2011
2011-05-31,Perak,184,43,141,2011
2011-06-01,Perak,228,63,165,2011
2011-06-02,Perak,323,109,214,2011
2011-06-03,Perak,230,96,134,2011
2011-06-04,Perak,8,3,5,2011
2011-06-05,Perak,50,32,18,2011
2011-06-06,Perak,33,9,24,2011
2011-06-07,Perak,21,4,17,2011
2011-06-08,Perak,26,12,14,2011
2011-06-09,Perak,106,37,69,2011
2011-06-10,Perak,60,20,40,2011
2011-06-11,Perak,86,39,47,2011
2011-06-12,Perak,153,32,121,2011
2011-06-13,Perak,51,10,41,2011
2011-06-14,Perak,130,58,72,2011
2011-06-15,Perak,168,82,86,2011
2011-06-16,Perak,104,64,40,2011
2011-06-17,Perak,20,3,17,2011
2011-06-18,Perak,105,56,49,2011
2011-06-19,Perak,82,43,39,2011
2011-06-20,Perak,40,9,31,2011
2011-06-21,Perak,50,31,19,2011
2011-06-22,Perak,64,17,47,2011
2011-06-23,Perak,84,22,62,2011
2011-06-24,Perak,16,1,15,2011
2011-06-25,Perak,102,73,29,2011
2011-06-26,Perak,262,115,147,2011
2011-06-27,Perak,47,7,40,2011
2011-06-28,Perak,142,75,67,2011
2011-06-29,Perak,87,28,59,2011
2011-06-30,Perak,131,70,61,2011
2011-07-01,Perak,49,27,22,2011
2011-07-02,Perak,42,27,15,2011
2011-07-03,Perak,87,46,41,2011
2011-07-04,Perak,32,9,23,2011
2011-07-05,Perak,169,48,121,2011
2011-07-06,Perak,102,40,62,2011
2011-07-07,Perak,132,46,86,2011
2011-07-08,Perak,24,3,21,2011
2011-07-09,Perak,201,182,19,2011
2011-07-10,Perak,84,79,5,2011
2011-07-11,Perak,20,3,17,2011
2011-07-12,Perak,17,2,15,2011
2011-07-13,Perak,24,8,16,2011
2011-07-14,Perak,43,22,21,2011
2011-07-15,Perak,104,88,16,2011
2011-07-16,Perak,25,19,6,2011
2011-07-17,Perak,278,43,235,2011
2011-07-18,Perak,47,3,44,2011
2011-07-19,Perak,193,92,101,2011
2011-07-20,Perak,176,102,74,2011
2011-07-21,Perak,63,27,36,2011
2011-07-22,Perak,45,18,27,2011
2011-07-23,Perak,102,80,22,2011
2011-07-24,Perak,226,44,182,2011
2011-07-25,Perak,98,66,32,2011
2011-07-26,Perak,236,143,93,2011
2011-07-27,Perak,196,137,59,2011
2011-07-28,Perak,190,144,46,2011
2011-07-29,Perak,91,35,56,2011
2011-07-30,Perak,183,91,92,2011
2011-07-31,Perak,217,104,113,2011
2011-08-01,Perak,14,2,12,2011
2011-08-02,Perak,73,39,34,2011
2011-08-03,Perak,94,17,77,2011
2011-08-04,Perak,30,6,24,2011
2011-08-05,Perak,11,3,8,2011
2011-08-06,Perak,78,37,41,2011
2011-08-07,Perak,252,50,202,2011
2011-08-08,Perak,17,4,13,2011
2011-08-09,Perak,57,21,36,2011
2011-08-10,Perak,23,3,20,2011
2011-08-11,Perak,287,187,100,2011
2011-08-12,Perak,17,5,12,2011
2011-08-13,Perak,293,190,103,2011
2011-08-14,Perak,183,94,89,2011
2011-08-15,Perak,15,1,14,2011
2011-08-16,Perak,96,35,61,2011
2011-08-17,Perak,59,42,17,2011
2011-08-18,Perak,146,103,43,2011
2011-08-19,Perak,72,55,17,2011
2011-08-20,Perak,97,36,61,2011
2011-08-21,Perak,142,22,120,2011
2011-08-22,Perak,62,49,13,2011
2011-08-23,Perak,18,5,13,2011
2011-08-24,Perak,65,19,46,2011
2011-08-25,Perak,95,52,43,2011
2011-08-26,Perak,30,16,14,2011
2011-08-27,Perak,27,21,6,2011
2011-08-28,Perak,150,70,80,2011
2011-08-29,Perak,21,3,18,2011
2011-08-30,Perak,0,0,0,2011
2011-08-31,Perak,22,9,13,2011
2011-09-01,Perak,0,0,0,2011
2011-09-02,Perak,20,1,19,2011
2011-09-03,Perak,57,28,29,2011
2011-09-04,Perak,41,15,26,2011
2011-09-05,Perak,23,4,19,2011
2011-09-06,Perak,38,8,30,2011
2011-09-07,Perak,80,34,46,2011
2011-09-08,Perak,109,43,66,2011
2011-09-09,Perak,83,33,50,2011
2011-09-10,Perak,56,41,15,2011
2011-09-11,Perak,59,25,34,2011
2011-09-12,Perak,38,10,28,2011
2011-09-13,Perak,107,61,46,2011
2011-09-14,Perak,140,89,51,2011
2011-09-15,Perak,40,8,32,2011
2011-09-16,Perak,36,14,22,2011
2011-09-17,Perak,40,22,18,2011
2011-09-18,Perak,55,36,19,2011
2011-09-19,Perak,76,9,67,2011
2011-09-20,Perak,102,30,72,2011
2011-09-21,Perak,50,6,44,2011
2011-09-22,Perak,45,10,35,2011
2011-09-23,Perak,124,47,77,2011
2011-09-24,Perak,0,0,0,2011
2011-09-25,Perak,134,42,92,2011
2011-09-26,Perak,38,4,34,2011
2011-09-27,Perak,56,16,40,2011
2011-09-28,Perak,105,53,52,2011
2011-09-29,Perak,105,28,77,2011
2011-09-30,Perak,36,9,27,2011
2011-10-01,Perak,86,58,28,2011
2011-10-02,Perak,194,36,158,2011
2011-10-03,Perak,72,21,51,2011
2011-10-04,Perak,23,7,16,2011
2011-10-05,Perak,48,27,21,2011
2011-10-06,Perak,30,4,26,2011
2011-10-07,Perak,58,20,38,2011
2011-10-08,Perak,34,19,15,2011
2011-10-09,Perak,85,27,58,2011
2011-10-10,Perak,24,4,20,2011
2011-10-11,Perak,29,6,23,2011
2011-10-12,Perak,55,33,22,2011
2011-10-13,Perak,63,16,47,2011
2011-10-14,Perak,110,55,55,2011
2011-10-15,Perak,102,81,21,2011
2011-10-16,Perak,77,20,57,2011
2011-10-17,Perak,159,55,104,2011
2011-10-18,Perak,346,135,211,2011
2011-10-19,Perak,252,97,155,2011
2011-10-20,Perak,266,101,165,2011
2011-10-21,Perak,225,109,116,2011
2011-10-22,Perak,50,22,28,2011
2011-10-23,Perak,189,74,115,2011
2011-10-24,Perak,23,1,22,2011
2011-10-25,Perak,177,56,121,2011
2011-10-26,Perak,52,28,24,2011
2011-10-27,Perak,55,28,27,2011
2011-10-28,Perak,46,21,25,2011
2011-10-29,Perak,2,0,2,2011
2011-10-30,Perak,84,29,55,2011
2011-10-31,Perak,17,3,14,2011
2011-11-01,Perak,41,11,30,2011
2011-11-02,Perak,19,2,17,2011
2011-11-03,Perak,87,55,32,2011
2011-11-04,Perak,16,5,11,2011
2011-11-05,Perak,0,0,0,2011
2011-11-06,Perak,0,0,0,2011
2011-11-07,Perak,4,0,4,2011
2011-11-08,Perak,31,11,20,2011
2011-11-09,Perak,54,18,36,2011
2011-11-10,Perak,50,10,40,2011
2011-11-11,Perak,33,5,28,2011
2011-11-12,Perak,100,89,11,2011
2011-11-13,Perak,209,76,133,2011
2011-11-14,Perak,42,12,30,2011
2011-11-15,Perak,54,15,39,2011
2011-11-16,Perak,207,136,71,2011
2011-11-17,Perak,18,3,15,2011
2011-11-18,Perak,47,11,36,2011
2011-11-19,Perak,102,65,37,2011
2011-11-20,Perak,314,60,254,2011
2011-11-21,Perak,97,79,18,2011
2011-11-22,Perak,43,20,23,2011
2011-11-23,Perak,115,38,77,2011
2011-11-24,Perak,81,24,57,2011
2011-11-25,Perak,23,4,19,2011
2011-11-26,Perak,21,15,6,2011
2011-11-27,Perak,65,44,21,2011
2011-11-28,Perak,0,0,0,2011
2011-11-29,Perak,20,3,17,2011
2011-11-30,Perak,36,13,23,2011
2011-12-01,Perak,20,6,14,2011
2011-12-02,Perak,33,11,22,2011
2011-12-03,Perak,57,21,36,2011
2011-12-04,Perak,258,54,204,2011
2011-12-05,Perak,98,36,62,2011
2011-12-06,Perak,65,20,45,2011
2011-12-07,Perak,134,57,77,2011
2011-12-08,Perak,51,23,28,2011
2011-12-09,Perak,84,30,54,2011
2011-12-10,Perak,83,51,32,2011
2011-12-11,Perak,201,35,166,2011
2011-12-12,Perak,67,25,42,2011
2011-12-13,Perak,73,29,44,2011
2011-12-14,Perak,127,64,63,2011
2011-12-15,Perak,183,81,102,2011
2011-12-16,Perak,63,23,40,2011
2011-12-17,Perak,45,24,21,2011
2011-12-18,Perak,20,11,9,2011
2011-12-19,Perak,69,22,47,2011
2011-12-20,Perak,114,34,80,2011
2011-12-21,Perak,32,4,28,2011
2011-12-22,Perak,125,17,108,2011
2011-12-23,Perak,42,17,25,2011
2011-12-24,Perak,20,15,5,2011
2011-12-25,Perak,22,7,15,2011
2011-12-26,Perak,0,0,0,2011
2011-12-27,Perak,75,31,44,2011
2011-12-28,Perak,55,15,40,2011
2011-12-29,Perak,69,23,46,2011
2011-12-30,Perak,98,33,65,2011
2011-12-31,Perak,110,66,44,2011
2012-01-01,Perak,11,8,3,2012
2012-01-02,Perak,32,11,21,2012
2012-01-03,Perak,43,7,36,2012
2012-01-04,Perak,150,24,126,2012
2012-01-05,Perak,185,40,145,2012
2012-01-06,Perak,78,31,47,2012
2012-01-07,Perak,171,118,53,2012
2012-01-08,Perak,88,44,44,2012
2012-01-09,Perak,80,31,49,2012
2012-01-10,Perak,117,52,65,2012
2012-01-11,Perak,81,38,43,2012
2012-01-12,Perak,142,67,75,2012
2012-01-13,Perak,147,88,59,2012
2012-01-14,Perak,70,31,39,2012
2012-01-15,Perak,110,44,66,2012
2012-01-16,Perak,207,35,172,2012
2012-01-17,Perak,247,54,193,2012
2012-01-18,Perak,238,53,185,2012
2012-01-19,Perak,226,80,146,2012
2012-01-20,Perak,98,17,81,2012
2012-01-21,Perak,3,0,3,2012
2012-01-22,Perak,0,0,0,2012
2012-01-23,Perak,0,0,0,2012
2012-01-24,Perak,27,20,7,2012
2012-01-25,Perak,91,22,69,2012
2012-01-26,Perak,134,88,46,2012
2012-01-27,Perak,71,25,46,2012
2012-01-28,Perak,139,93,46,2012
2012-01-29,Perak,52,22,30,2012
2012-01-30,Perak,70,34,36,2012
2012-01-31,Perak,96,30,66,2012
2012-02-01,Perak,14,2,12,2012
2012-02-02,Perak,102,74,28,2012
2012-02-03,Perak,28,4,24,2012
2012-02-04,Perak,25,15,10,2012
2012-02-05,Perak,0,0,0,2012
2012-02-06,Perak,0,0,0,2012
2012-02-07,Perak,208,108,100,2012
2012-02-08,Perak,203,169,34,2012
2012-02-09,Perak,106,56,50,2012
2012-02-10,Perak,27,3,24,2012
2012-02-11,Perak,169,69,100,2012
2012-02-12,Perak,162,43,119,2012
2012-02-13,Perak,40,19,21,2012
2012-02-14,Perak,140,77,63,2012
2012-02-15,Perak,124,44,80,2012
2012-02-16,Perak,29,5,24,2012
2012-02-17,Perak,94,36,58,2012
2012-02-18,Perak,122,46,76,2012
2012-02-19,Perak,9,5,4,2012
2012-02-20,Perak,93,69,24,2012
2012-02-21,Perak,92,64,28,2012
2012-02-22,Perak,98,60,38,2012
2012-02-23,Perak,124,65,59,2012
2012-02-24,Perak,106,78,28,2012
2012-02-25,Perak,255,232,23,2012
2012-02-26,Perak,82,43,39,2012
2012-02-27,Perak,33,7,26,2012
2012-02-28,Perak,57,18,39,2012
2012-02-29,Perak,88,30,58,2012
2012-03-01,Perak,59,33,26,2012
2012-03-02,Perak,61,30,31,2012
2012-03-03,Perak,161,144,17,2012
2012-03-04,Perak,151,45,106,2012
2012-03-05,Perak,42,14,28,2012
2012-03-06,Perak,76,20,56,2012
2012-03-07,Perak,111,37,74,2012
2012-03-08,Perak,112,28,84,2012
2012-03-09,Perak,19,3,16,2012
2012-03-10,Perak,94,66,28,2012
2012-03-11,Perak,1,1,0,2012
2012-03-12,Perak,19,2,17,2012
2012-03-13,Perak,621,413,208,2012
2012-03-14,Perak,10,0,10,2012
2012-03-15,Perak,51,20,31,2012
2012-03-16,Perak,17,0,17,2012
2012-03-17,Perak,134,63,71,2012
2012-03-18,Perak,398,73,325,2012
2012-03-19,Perak,36,7,29,2012
2012-03-20,Perak,90,46,44,2012
2012-03-21,Perak,16,1,15,2012
2012-03-22,Perak,55,26,29,2012
2012-03-23,Perak,99,40,59,2012
2012-03-24,Perak,230,124,106,2012
2012-03-25,Perak,132,34,98,2012
2012-03-26,Perak,21,3,18,2012
2012-03-27,Perak,92,27,65,2012
2012-03-28,Perak,61,22,39,2012
2012-03-29,Perak,109,34,75,2012
2012-03-30,Perak,78,33,45,2012
2012-03-31,Perak,140,73,67,2012
2012-04-01,Perak,223,29,194,2012
2012-04-02,Perak,85,27,58,2012
2012-04-03,Perak,47,21,26,2012
2012-04-04,Perak,77,24,53,2012
2012-04-05,Perak,135,42,93,2012
2012-04-06,Perak,27,4,23,2012
2012-04-07,Perak,37,24,13,2012
2012-04-08,Perak,93,35,58,2012
2012-04-09,Perak,62,13,49,2012
2012-04-10,Perak,61,11,50,2012
2012-04-11,Perak,31,12,19,2012
2012-04-12,Perak,118,55,63,2012
2012-04-13,Perak,29,7,22,2012
2012-04-14,Perak,110,51,59,2012
2012-04-15,Perak,230,39,191,2012
2012-04-16,Perak,45,8,37,2012
2012-04-17,Perak,44,11,33,2012
2012-04-18,Perak,22,5,17,2012
2012-04-19,Perak,1,0,1,2012
2012-04-20,Perak,17,2,15,2012
2012-04-21,Perak,106,66,40,2012
2012-04-22,Perak,76,26,50,2012
2012-04-23,Perak,65,20,45,2012
2012-04-24,Perak,61,34,27,2012
2012-04-25,Perak,23,2,21,2012
2012-04-26,Perak,42,3,39,2012
2012-04-27,Perak,19,4,15,2012
2012-04-28,Perak,3,1,2,2012
2012-04-29,Perak,99,40,59,2012
2012-04-30,Perak,28,6,22,2012
2012-05-01,Perak,20,9,11,2012
2012-05-02,Perak,79,41,38,2012
2012-05-03,Perak,40,20,20,2012
2012-05-04,Perak,31,4,27,2012
2012-05-05,Perak,162,43,119,2012
2012-05-06,Perak,54,27,27,2012
2012-05-07,Perak,32,4,28,2012
2012-05-08,Perak,40,26,14,2012
2012-05-09,Perak,61,13,48,2012
2012-05-10,Perak,186,61,125,2012
2012-05-11,Perak,24,2,22,2012
2012-05-12,Perak,46,23,23,2012
2012-05-13,Perak,143,56,87,2012
2012-05-14,Perak,26,6,20,2012
2012-05-15,Perak,78,25,53,2012
2012-05-16,Perak,116,72,44,2012
2012-05-17,Perak,95,60,35,2012
2012-05-18,Perak,73,34,39,2012
2012-05-19,Perak,35,21,14,2012
2012-05-20,Perak,51,30,21,2012
2012-05-21,Perak,61,15,46,2012
2012-05-22,Perak,27,4,23,2012
2012-05-23,Perak,36,14,22,2012
2012-05-24,Perak,95,28,67,2012
2012-05-25,Perak,312,250,62,2012
2012-05-26,Perak,48,19,29,2012
2012-05-27,Perak,42,19,23,2012
2012-05-28,Perak,199,52,147,2012
2012-05-29,Perak,255,59,196,2012
2012-05-30,Perak,300,75,225,2012
2012-05-31,Perak,243,62,181,2012
2012-06-01,Perak,202,50,152,2012
2012-06-02,Perak,0,0,0,2012
2012-06-03,Perak,49,17,32,2012
2012-06-04,Perak,17,1,16,2012
2012-06-05,Perak,18,2,16,2012
2012-06-06,Perak,139,60,79,2012
2012-06-07,Perak,49,11,38,2012
2012-06-08,Perak,18,5,13,2012
2012-06-09,Perak,178,128,50,2012
2012-06-10,Perak,141,25,116,2012
2012-06-11,Perak,26,2,24,2012
2012-06-12,Perak,13,0,13,2012
2012-06-13,Perak,49,14,35,2012
2012-06-14,Perak,174,73,101,2012
2012-06-15,Perak,35,7,28,2012
2012-06-16,Perak,77,46,31,2012
2012-06-17,Perak,42,16,26,2012
2012-06-18,Perak,27,1,26,2012
2012-06-19,Perak,9,1,8,2012
2012-06-20,Perak,47,21,26,2012
2012-06-21,Perak,210,87,123,2012
2012-06-22,Perak,67,25,42,2012
2012-06-23,Perak,234,180,54,2012
2012-06-24,Perak,91,34,57,2012
2012-06-25,Perak,61,31,30,2012
2012-06-26,Perak,70,36,34,2012
2012-06-27,Perak,210,82,128,2012
2012-06-28,Perak,75,22,53,2012
2012-06-29,Perak,100,42,58,2012
2012-06-30,Perak,37,21,16,2012
2012-07-01,Perak,59,23,36,2012
2012-07-02,Perak,77,42,35,2012
2012-07-03,Perak,149,111,38,2012
2012-07-04,Perak,179,100,79,2012
2012-07-05,Perak,59,38,21,2012
2012-07-06,Perak,49,14,35,2012
2012-07-07,Perak,210,112,98,2012
2012-07-08,Perak,169,44,125,2012
2012-07-09,Perak,63,19,44,2012
2012-07-10,Perak,59,24,35,2012
2012-07-11,Perak,101,35,66,2012
2012-07-12,Perak,75,24,51,2012
2012-07-13,Perak,66,26,40,2012
2012-07-14,Perak,110,41,69,2012
2012-07-15,Perak,506,168,338,2012
2012-07-16,Perak,124,53,71,2012
2012-07-17,Perak,272,124,148,2012
2012-07-18,Perak,296,169,127,2012
2012-07-19,Perak,176,66,110,2012
2012-07-20,Perak,128,40,88,2012
2012-07-21,Perak,0,0,0,2012
2012-07-22,Perak,144,35,109,2012
2012-07-23,Perak,71,61,10,2012
2012-07-24,Perak,67,19,48,2012
2012-07-25,Perak,225,135,90,2012
2012-07-26,Perak,210,125,85,2012
2012-07-27,Perak,19,3,16,2012
2012-07-28,Perak,0,0,0,2012
2012-07-29,Perak,201,53,148,2012
2012-07-30,Perak,22,4,18,2012
2012-07-31,Perak,113,83,30,2012
2012-08-01,Perak,19,2,17,2012
2012-08-02,Perak,32,7,25,2012
2012-08-03,Perak,95,72,23,2012
2012-08-04,Perak,103,35,68,2012
2012-08-05,Perak,193,38,155,2012
2012-08-06,Perak,0,0,0,2012
2012-08-07,Perak,133,95,38,2012
2012-08-08,Perak,42,24,18,2012
2012-08-09,Perak,121,79,42,2012
2012-08-10,Perak,72,49,23,2012
2012-08-11,Perak,32,10,22,2012
2012-08-12,Perak,117,22,95,2012
2012-08-13,Perak,94,34,60,2012
2012-08-14,Perak,29,4,25,2012
2012-08-15,Perak,94,75,19,2012
2012-08-16,Perak,150,95,55,2012
2012-08-17,Perak,23,4,19,2012
2012-08-18,Perak,0,0,0,2012
2012-08-19,Perak,1,1,0,2012
2012-08-20,Perak,5,0,5,2012
2012-08-21,Perak,56,33,23,2012
2012-08-22,Perak,24,2,22,2012
2012-08-23,Perak,29,4,25,2012
2012-08-24,Perak,115,42,73,2012
2012-08-25,Perak,111,29,82,2012
2012-08-26,Perak,55,7,48,2012
2012-08-27,Perak,38,9,29,2012
2012-08-28,Perak,89,33,56,2012
2012-08-29,Perak,102,61,41,2012
2012-08-30,Perak,44,10,34,2012
2012-08-31,Perak,73,36,37,2012
2012-09-01,Perak,19,7,12,2012
2012-09-02,Perak,145,78,67,2012
2012-09-03,Perak,81,11,70,2012
2012-09-04,Perak,35,8,27,2012
2012-09-05,Perak,126,89,37,2012
2012-09-06,Perak,109,36,73,2012
2012-09-07,Perak,58,25,33,2012
2012-09-08,Perak,25,15,10,2012
2012-09-09,Perak,128,61,67,2012
2012-09-10,Perak,29,7,22,2012
2012-09-11,Perak,1014,720,294,2012
2012-09-12,Perak,21,4,17,2012
2012-09-13,Perak,47,11,36,2012
2012-09-14,Perak,28,2,26,2012
2012-09-15,Perak,32,15,17,2012
2012-09-16,Perak,68,33,35,2012
2012-09-17,Perak,0,0,0,2012
2012-09-18,Perak,50,10,40,2012
2012-09-19,Perak,162,81,81,2012
2012-09-20,Perak,30,6,24,2012
2012-09-21,Perak,43,25,18,2012
2012-09-22,Perak,97,39,58,2012
2012-09-23,Perak,44,14,30,2012
2012-09-24,Perak,57,22,35,2012
2012-09-25,Perak,64,26,38,2012
2012-09-26,Perak,49,6,43,2012
2012-09-27,Perak,24,4,20,2012
2012-09-28,Perak,96,28,68,2012
2012-09-29,Perak,88,36,52,2012
2012-09-30,Perak,85,44,41,2012
2012-10-01,Perak,30,4,26,2012
2012-10-02,Perak,91,33,58,2012
2012-10-03,Perak,63,7,56,2012
2012-10-04,Perak,227,93,134,2012
2012-10-05,Perak,39,14,25,2012
2012-10-06,Perak,81,46,35,2012
2012-10-07,Perak,375,168,207,2012
2012-10-08,Perak,40,3,37,2012
2012-10-09,Perak,74,36,38,2012
2012-10-10,Perak,80,26,54,2012
2012-10-11,Perak,25,4,21,2012
2012-10-12,Perak,55,11,44,2012
2012-10-13,Perak,121,60,61,2012
2012-10-14,Perak,157,32,125,2012
2012-10-15,Perak,85,19,66,2012
2012-10-16,Perak,100,34,66,2012
2012-10-17,Perak,51,17,34,2012
2012-10-18,Perak,73,31,42,2012
2012-10-19,Perak,36,10,26,2012
2012-10-20,Perak,24,11,13,2012
2012-10-21,Perak,51,11,40,2012
2012-10-22,Perak,165,47,118,2012
2012-10-23,Perak,238,67,171,2012
2012-10-24,Perak,291,126,165,2012
2012-10-25,Perak,212,71,141,2012
2012-10-26,Perak,0,0,0,2012
2012-10-27,Perak,0,0,0,2012
2012-10-28,Perak,36,6,30,2012
2012-10-29,Perak,33,5,28,2012
2012-10-30,Perak,35,6,29,2012
2012-10-31,Perak,120,39,81,2012
2012-11-01,Perak,29,10,19,2012
2012-11-02,Perak,29,11,18,2012
2012-11-03,Perak,17,7,10,2012
2012-11-04,Perak,270,113,157,2012
2012-11-05,Perak,83,17,66,2012
2012-11-06,Perak,66,19,47,2012
2012-11-07,Perak,145,55,90,2012
2012-11-08,Perak,50,17,33,2012
2012-11-09,Perak,14,1,13,2012
2012-11-10,Perak,191,159,32,2012
2012-11-11,Perak,125,53,72,2012
2012-11-12,Perak,21,4,17,2012
2012-11-13,Perak,22,11,11,2012
2012-11-14,Perak,27,4,23,2012
2012-11-15,Perak,13,10,3,2012
2012-11-16,Perak,32,9,23,2012
2012-11-17,Perak,0,0,0,2012
2012-11-18,Perak,387,82,305,2012
2012-11-19,Perak,18,1,17,2012
2012-11-20,Perak,28,7,21,2012
2012-11-21,Perak,40,18,22,2012
2012-11-22,Perak,79,8,71,2012
2012-11-23,Perak,46,16,30,2012
2012-11-24,Perak,315,262,53,2012
2012-11-25,Perak,2,1,1,2012
2012-11-26,Perak,65,27,38,2012
2012-11-27,Perak,40,10,30,2012
2012-11-28,Perak,46,19,27,2012
2012-11-29,Perak,153,74,79,2012
2012-11-30,Perak,40,11,29,2012
2012-12-01,Perak,70,40,30,2012
2012-12-02,Perak,348,75,273,2012
2012-12-03,Perak,76,17,59,2012
2012-12-04,Perak,107,45,62,2012
2012-12-05,Perak,56,17,39,2012
2012-12-06,Perak,119,51,68,2012
2012-12-07,Perak,136,56,80,2012
2012-12-08,Perak,36,17,19,2012
2012-12-09,Perak,110,32,78,2012
2012-12-10,Perak,20,10,10,2012
2012-12-11,Perak,25,7,18,2012
2012-12-12,Perak,87,52,35,2012
2012-12-13,Perak,51,27,24,2012
2012-12-14,Perak,27,5,22,2012
2012-12-15,Perak,81,54,27,2012
2012-12-16,Perak,126,20,106,2012
2012-12-17,Perak,32,3,29,2012
2012-12-18,Perak,137,48,89,2012
2012-12-19,Perak,87,26,61,2012
2012-12-20,Perak,82,37,45,2012
2012-12-21,Perak,147,43,104,2012
2012-12-22,Perak,57,28,29,2012
2012-12-23,Perak,87,41,46,2012
2012-12-24,Perak,58,30,28,2012
2012-12-25,Perak,39,22,17,2012
2012-12-26,Perak,37,6,31,2012
2012-12-27,Perak,113,32,81,2012
2012-12-28,Perak,68,13,55,2012
2012-12-29,Perak,52,11,41,2012
2012-12-30,Perak,105,28,77,2012
2012-12-31,Perak,62,18,44,2012
2013-01-01,Perak,76,41,35,2013
2013-01-02,Perak,54,12,42,2013
2013-01-03,Perak,77,35,42,2013
2013-01-04,Perak,88,46,42,2013
2013-01-05,Perak,108,89,19,2013
2013-01-06,Perak,146,61,85,2013
2013-01-07,Perak,13,1,12,2013
2013-01-08,Perak,133,80,53,2013
2013-01-09,Perak,91,47,44,2013
2013-01-10,Perak,122,82,40,2013
2013-01-11,Perak,106,44,62,2013
2013-01-12,Perak,41,17,24,2013
2013-01-13,Perak,1,1,0,2013
2013-01-14,Perak,183,37,146,2013
2013-01-15,Perak,299,69,230,2013
2013-01-16,Perak,263,81,182,2013
2013-01-17,Perak,257,81,176,2013
2013-01-18,Perak,207,70,137,2013
2013-01-19,Perak,71,36,35,2013
2013-01-20,Perak,68,33,35,2013
2013-01-21,Perak,97,30,67,2013
2013-01-22,Perak,270,102,168,2013
2013-01-23,Perak,164,69,95,2013
2013-01-24,Perak,53,13,40,2013
2013-01-25,Perak,77,31,46,2013
2013-01-26,Perak,28,13,15,2013
2013-01-27,Perak,204,84,120,2013
2013-01-28,Perak,20,6,14,2013
2013-01-29,Perak,97,27,70,2013
2013-01-30,Perak,101,49,52,2013
2013-01-31,Perak,64,12,52,2013
2013-02-01,Perak,27,7,20,2013
2013-02-02,Perak,121,58,63,2013
2013-02-03,Perak,77,44,33,2013
2013-02-04,Perak,218,107,111,2013
2013-02-05,Perak,128,39,89,2013
2013-02-06,Perak,135,79,56,2013
2013-02-07,Perak,255,130,125,2013
2013-02-08,Perak,124,48,76,2013
2013-02-09,Perak,0,0,0,2013
2013-02-10,Perak,45,22,23,2013
2013-02-11,Perak,0,0,0,2013
2013-02-12,Perak,2,2,0,2013
2013-02-13,Perak,133,65,68,2013
2013-02-14,Perak,139,65,74,2013
2013-02-15,Perak,141,93,48,2013
2013-02-16,Perak,136,125,11,2013
2013-02-17,Perak,122,82,40,2013
2013-02-18,Perak,69,26,43,2013
2013-02-19,Perak,152,84,68,2013
2013-02-20,Perak,185,119,66,2013
2013-02-21,Perak,190,99,91,2013
2013-02-22,Perak,40,20,20,2013
2013-02-23,Perak,242,220,22,2013
2013-02-24,Perak,42,27,15,2013
2013-02-25,Perak,59,25,34,2013
2013-02-26,Perak,39,22,17,2013
2013-02-27,Perak,127,45,82,2013
2013-02-28,Perak,113,66,47,2013
2013-03-01,Perak,23,0,23,2013
2013-03-02,Perak,338,322,16,2013
2013-03-03,Perak,16,13,3,2013
2013-03-04,Perak,50,20,30,2013
2013-03-05,Perak,190,82,108,2013
2013-03-06,Perak,178,97,81,2013
2013-03-07,Perak,174,64,110,2013
2013-03-08,Perak,26,7,19,2013
2013-03-09,Perak,79,39,40,2013
2013-03-10,Perak,123,37,86,2013
2013-03-11,Perak,53,15,38,2013
2013-03-12,Perak,67,23,44,2013
2013-03-13,Perak,144,62,82,2013
2013-03-14,Perak,62,32,30,2013
2013-03-15,Perak,45,17,28,2013
2013-03-16,Perak,198,97,101,2013
2013-03-17,Perak,596,146,450,2013
2013-03-18,Perak,79,31,48,2013
2013-03-19,Perak,140,51,89,2013
2013-03-20,Perak,130,47,83,2013
2013-03-21,Perak,165,115,50,2013
2013-03-22,Perak,39,9,30,2013
2013-03-23,Perak,97,39,58,2013
2013-03-24,Perak,53,35,18,2013
2013-03-25,Perak,69,21,48,2013
2013-03-26,Perak,77,46,31,2013
2013-03-27,Perak,72,38,34,2013
2013-03-28,Perak,85,19,66,2013
2013-03-29,Perak,60,25,35,2013
2013-03-30,Perak,76,43,33,2013
2013-03-31,Perak,61,6,55,2013
2013-04-01,Perak,98,60,38,2013
2013-04-02,Perak,150,55,95,2013
2013-04-03,Perak,68,18,50,2013
2013-04-04,Perak,23,4,19,2013
2013-04-05,Perak,110,70,40,2013
2013-04-06,Perak,349,169,180,2013
2013-04-07,Perak,214,88,126,2013
2013-04-08,Perak,187,75,112,2013
2013-04-09,Perak,116,58,58,2013
2013-04-10,Perak,99,45,54,2013
2013-04-11,Perak,48,15,33,2013
2013-04-12,Perak,76,24,52,2013
2013-04-13,Perak,40,25,15,2013
2013-04-14,Perak,81,34,47,2013
2013-04-15,Perak,39,20,19,2013
2013-04-16,Perak,124,85,39,2013
2013-04-17,Perak,56,21,35,2013
2013-04-18,Perak,180,67,113,2013
2013-04-19,Perak,63,23,40,2013
2013-04-20,Perak,68,40,28,2013
2013-04-21,Perak,68,27,41,2013
2013-04-22,Perak,64,17,47,2013
2013-04-23,Perak,101,55,46,2013
2013-04-24,Perak,74,39,35,2013
2013-04-25,Perak,42,14,28,2013
2013-04-26,Perak,36,6,30,2013
2013-04-27,Perak,118,96,22,2013
2013-04-28,Perak,104,31,73,2013
2013-04-29,Perak,50,38,12,2013
2013-04-30,Perak,151,96,55,2013
2013-05-01,Perak,54,22,32,2013
2013-05-02,Perak,54,32,22,2013
2013-05-03,Perak,121,53,68,2013
2013-05-04,Perak,41,19,22,2013
2013-05-05,Perak,0,0,0,2013
2013-05-06,Perak,24,12,12,2013
2013-05-07,Perak,37,7,30,2013
2013-05-08,Perak,72,37,35,2013
2013-05-09,Perak,148,68,80,2013
2013-05-10,Perak,21,4,17,2013
2013-05-11,Perak,150,135,15,2013
2013-05-12,Perak,192,117,75,2013
2013-05-13,Perak,179,62,117,2013
2013-05-14,Perak,207,82,125,2013
2013-05-15,Perak,184,81,103,2013
2013-05-16,Perak,147,98,49,2013
2013-05-17,Perak,75,37,38,2013
2013-05-18,Perak,108,89,19,2013
2013-05-19,Perak,221,77,144,2013
2013-05-20,Perak,44,16,28,2013
2013-05-21,Perak,65,21,44,2013
2013-05-22,Perak,44,21,23,2013
2013-05-23,Perak,149,68,81,2013
2013-05-24,Perak,109,32,77,2013
2013-05-25,Perak,185,172,13,2013
2013-05-26,Perak,63,55,8,2013
2013-05-27,Perak,202,48,154,2013
2013-05-28,Perak,213,55,158,2013
2013-05-29,Perak,240,73,167,2013
2013-05-30,Perak,352,142,210,2013
2013-05-31,Perak,292,118,174,2013
2013-06-01,Perak,44,27,17,2013
2013-06-02,Perak,39,16,23,2013
2013-06-03,Perak,38,7,31,2013
2013-06-04,Perak,116,45,71,2013
2013-06-05,Perak,114,51,63,2013
2013-06-06,Perak,62,12,50,2013
2013-06-07,Perak,20,3,17,2013
2013-06-08,Perak,0,0,0,2013
2013-06-09,Perak,176,67,109,2013
2013-06-10,Perak,36,8,28,2013
2013-06-11,Perak,79,47,32,2013
2013-06-12,Perak,98,66,32,2013
2013-06-13,Perak,100,41,59,2013
2013-06-14,Perak,52,15,37,2013
2013-06-15,Perak,108,47,61,2013
2013-06-16,Perak,90,48,42,2013
2013-06-17,Perak,38,9,29,2013
2013-06-18,Perak,107,50,57,2013
2013-06-19,Perak,144,62,82,2013
2013-06-20,Perak,93,62,31,2013
2013-06-21,Perak,31,4,27,2013
2013-06-22,Perak,29,16,13,2013
2013-06-23,Perak,341,76,265,2013
2013-06-24,Perak,102,38,64,2013
2013-06-25,Perak,113,85,28,2013
2013-06-26,Perak,133,73,60,2013
2013-06-27,Perak,72,42,30,2013
2013-06-28,Perak,93,21,72,2013
2013-06-29,Perak,251,126,125,2013
2013-06-30,Perak,261,140,121,2013
2013-07-01,Perak,178,49,129,2013
2013-07-02,Perak,255,136,119,2013
2013-07-03,Perak,142,86,56,2013
2013-07-04,Perak,136,65,71,2013
2013-07-05,Perak,118,60,58,2013
2013-07-06,Perak,163,82,81,2013
2013-07-07,Perak,342,117,225,2013
2013-07-08,Perak,219,117,102,2013
2013-07-09,Perak,101,55,46,2013
2013-07-10,Perak,80,51,29,2013
2013-07-11,Perak,81,41,40,2013
2013-07-12,Perak,35,22,13,2013
2013-07-13,Perak,12,10,2,2013
2013-07-14,Perak,453,77,376,2013
2013-07-15,Perak,26,16,10,2013
2013-07-16,Perak,58,25,33,2013
2013-07-17,Perak,130,55,75,2013
2013-07-18,Perak,124,68,56,2013
2013-07-19,Perak,6,0,6,2013
2013-07-20,Perak,78,42,36,2013
2013-07-21,Perak,220,74,146,2013
2013-07-22,Perak,17,13,4,2013
2013-07-23,Perak,66,32,34,2013
2013-07-24,Perak,329,214,115,2013
2013-07-25,Perak,51,28,23,2013
2013-07-26,Perak,0,0,0,2013
2013-07-27,Perak,21,4,17,2013
2013-07-28,Perak,172,83,89,2013
2013-07-29,Perak,14,1,13,2013
2013-07-30,Perak,106,42,64,2013
2013-07-31,Perak,109,93,16,2013
2013-08-01,Perak,51,28,23,2013
2013-08-02,Perak,101,84,17,2013
2013-08-03,Perak,171,70,101,2013
2013-08-04,Perak,199,98,101,2013
2013-08-05,Perak,22,10,12,2013
2013-08-06,Perak,66,23,43,2013
2013-08-07,Perak,23,9,14,2013
2013-08-08,Perak,0,0,0,2013
2013-08-09,Perak,0,0,0,2013
2013-08-10,Perak,0,0,0,2013
2013-08-11,Perak,86,29,57,2013
2013-08-12,Perak,23,13,10,2013
2013-08-13,Perak,15,5,10,2013
2013-08-14,Perak,105,52,53,2013
2013-08-15,Perak,91,40,51,2013
2013-08-16,Perak,25,6,19,2013
2013-08-17,Perak,112,46,66,2013
2013-08-18,Perak,169,77,92,2013
2013-08-19,Perak,19,3,16,2013
2013-08-20,Perak,74,39,35,2013
2013-08-21,Perak,68,55,13,2013
2013-08-22,Perak,96,67,29,2013
2013-08-23,Perak,28,27,1,2013
2013-08-24,Perak,24,8,16,2013
2013-08-25,Perak,72,44,28,2013
2013-08-26,Perak,53,33,20,2013
2013-08-27,Perak,95,47,48,2013
2013-08-28,Perak,157,101,56,2013
2013-08-29,Perak,74,52,22,2013
2013-08-30,Perak,28,13,15,2013
2013-08-31,Perak,100,58,42,2013
2013-09-01,Perak,0,0,0,2013
2013-09-02,Perak,19,8,11,2013
2013-09-03,Perak,75,30,45,2013
2013-09-04,Perak,70,34,36,2013
2013-09-05,Perak,122,42,80,2013
2013-09-06,Perak,20,2,18,2013
2013-09-07,Perak,44,18,26,2013
2013-09-08,Perak,84,28,56,2013
2013-09-09,Perak,30,9,21,2013
2013-09-10,Perak,39,12,27,2013
2013-09-11,Perak,94,34,60,2013
2013-09-12,Perak,185,133,52,2013
2013-09-13,Perak,21,9,12,2013
2013-09-14,Perak,132,107,25,2013
2013-09-15,Perak,93,31,62,2013
2013-09-16,Perak,107,59,48,2013
2013-09-17,Perak,63,34,29,2013
2013-09-18,Perak,205,89,116,2013
2013-09-19,Perak,245,151,94,2013
2013-09-20,Perak,115,37,78,2013
2013-09-21,Perak,5,1,4,2013
2013-09-22,Perak,82,32,50,2013
2013-09-23,Perak,95,83,12,2013
2013-09-24,Perak,247,128,119,2013
2013-09-25,Perak,75,32,43,2013
2013-09-26,Perak,178,69,109,2013
2013-09-27,Perak,83,35,48,2013
2013-09-28,Perak,149,69,80,2013
2013-09-29,Perak,77,23,54,2013
2013-09-30,Perak,94,55,39,2013
2013-10-01,Perak,76,25,51,2013
2013-10-02,Perak,76,28,48,2013
2013-10-03,Perak,83,31,52,2013
2013-10-04,Perak,26,7,19,2013
2013-10-05,Perak,36,20,16,2013
2013-10-06,Perak,108,23,85,2013
2013-10-07,Perak,125,64,61,2013
2013-10-08,Perak,166,112,54,2013
2013-10-09,Perak,205,168,37,2013
2013-10-10,Perak,192,75,117,2013
2013-10-11,Perak,16,4,12,2013
2013-10-12,Perak,139,118,21,2013
2013-10-13,Perak,89,45,44,2013
2013-10-14,Perak,55,10,45,2013
2013-10-15,Perak,0,0,0,2013
2013-10-16,Perak,29,7,22,2013
2013-10-17,Perak,93,40,53,2013
2013-10-18,Perak,50,9,41,2013
2013-10-19,Perak,120,64,56,2013
2013-10-20,Perak,117,70,47,2013
2013-10-21,Perak,362,162,200,2013
2013-10-22,Perak,230,99,131,2013
2013-10-23,Perak,390,212,178,2013
2013-10-24,Perak,203,93,110,2013
2013-10-25,Perak,309,156,153,2013
2013-10-26,Perak,61,30,31,2013
2013-10-27,Perak,107,54,53,2013
2013-10-28,Perak,31,8,23,2013
2013-10-29,Perak,31,4,27,2013
2013-10-30,Perak,73,39,34,2013
2013-10-31,Perak,117,72,45,2013
2013-11-01,Perak,65,30,35,2013
2013-11-02,Perak,1,1,0,2013
2013-11-03,Perak,138,50,88,2013
2013-11-04,Perak,36,4,32,2013
2013-11-05,Perak,83,39,44,2013
2013-11-06,Perak,58,14,44,2013
2013-11-07,Perak,78,26,52,2013
2013-11-08,Perak,25,4,21,2013
2013-11-09,Perak,0,0,0,2013
2013-11-10,Perak,292,43,249,2013
2013-11-11,Perak,83,25,58,2013
2013-11-12,Perak,81,30,51,2013
2013-11-13,Perak,91,35,56,2013
2013-11-14,Perak,165,44,121,2013
2013-11-15,Perak,35,10,25,2013
2013-11-16,Perak,182,52,130,2013
2013-11-17,Perak,0,0,0,2013
2013-11-18,Perak,135,74,61,2013
2013-11-19,Perak,45,7,38,2013
2013-11-20,Perak,133,39,94,2013
2013-11-21,Perak,199,92,107,2013
2013-11-22,Perak,19,2,17,2013
2013-11-23,Perak,117,36,81,2013
2013-11-24,Perak,417,79,338,2013
2013-11-25,Perak,48,6,42,2013
2013-11-26,Perak,24,1,23,2013
2013-11-27,Perak,73,28,45,2013
2013-11-28,Perak,66,21,45,2013
2013-11-29,Perak,54,31,23,2013
2013-11-30,Perak,219,59,160,2013
2013-12-01,Perak,145,72,73,2013
2013-12-02,Perak,60,7,53,2013
2013-12-03,Perak,71,16,55,2013
2013-12-04,Perak,75,15,60,2013
2013-12-05,Perak,81,27,54,2013
2013-12-06,Perak,73,27,46,2013
2013-12-07,Perak,80,31,49,2013
2013-12-08,Perak,112,27,85,2013
2013-12-09,Perak,51,18,33,2013
2013-12-10,Perak,63,21,42,2013
2013-12-11,Perak,158,63,95,2013
2013-12-12,Perak,163,56,107,2013
2013-12-13,Perak,68,20,48,2013
2013-12-14,Perak,69,21,48,2013
2013-12-15,Perak,126,18,108,2013
2013-12-16,Perak,94,25,69,2013
2013-12-17,Perak,156,66,90,2013
2013-12-18,Perak,113,43,70,2013
2013-12-19,Perak,145,77,68,2013
2013-12-20,Perak,30,4,26,2013
2013-12-21,Perak,75,36,39,2013
2013-12-22,Perak,188,80,108,2013
2013-12-23,Perak,30,11,19,2013
2013-12-24,Perak,45,8,37,2013
2013-12-25,Perak,131,56,75,2013
2013-12-26,Perak,91,18,73,2013
2013-12-27,Perak,22,1,21,2013
2013-12-28,Perak,42,19,23,2013
2013-12-29,Perak,57,29,28,2013
2013-12-30,Perak,57,10,47,2013
2013-12-31,Perak,155,57,98,2013
2014-01-01,Perak,96,45,51,2014
2014-01-02,Perak,42,8,34,2014
2014-01-03,Perak,32,4,28,2014
2014-01-04,Perak,71,31,40,2014
2014-01-05,Perak,94,38,56,2014
2014-01-06,Perak,53,17,36,2014
2014-01-07,Perak,90,22,68,2014
2014-01-08,Perak,153,70,83,2014
2014-01-09,Perak,144,83,61,2014
2014-01-10,Perak,124,92,32,2014
2014-01-11,Perak,152,106,46,2014
2014-01-12,Perak,203,28,175,2014
2014-01-13,Perak,38,7,31,2014
2014-01-14,Perak,67,32,35,2014
2014-01-15,Perak,141,62,79,2014
2014-01-16,Perak,91,42,49,2014
2014-01-17,Perak,222,101,121,2014
2014-01-18,Perak,74,43,31,2014
2014-01-19,Perak,128,54,74,2014
2014-01-20,Perak,258,62,196,2014
2014-01-21,Perak,307,88,219,2014
2014-01-22,Perak,319,100,219,2014
2014-01-23,Perak,272,106,166,2014
2014-01-24,Perak,201,72,129,2014
2014-01-25,Perak,109,48,61,2014
2014-01-26,Perak,104,35,69,2014
2014-01-27,Perak,45,6,39,2014
2014-01-28,Perak,79,21,58,2014
2014-01-29,Perak,173,123,50,2014
2014-01-30,Perak,44,8,36,2014
2014-01-31,Perak,1,0,1,2014
2014-02-01,Perak,5,4,1,2014
2014-02-02,Perak,13,6,7,2014
2014-02-03,Perak,57,12,45,2014
2014-02-04,Perak,51,10,41,2014
2014-02-05,Perak,96,30,66,2014
2014-02-06,Perak,324,176,148,2014
2014-02-07,Perak,27,5,22,2014
2014-02-08,Perak,1,1,0,2014
2014-02-09,Perak,149,59,90,2014
2014-02-10,Perak,129,43,86,2014
2014-02-11,Perak,179,72,107,2014
2014-02-12,Perak,149,61,88,2014
2014-02-13,Perak,69,27,42,2014
2014-02-14,Perak,66,10,56,2014
2014-02-15,Perak,135,123,12,2014
2014-02-16,Perak,136,48,88,2014
2014-02-17,Perak,26,3,23,2014
2014-02-18,Perak,132,49,83,2014
2014-02-19,Perak,25,6,19,2014
2014-02-20,Perak,20,5,15,2014
2014-02-21,Perak,121,70,51,2014
2014-02-22,Perak,165,133,32,2014
2014-02-23,Perak,13,5,8,2014
2014-02-24,Perak,89,32,57,2014
2014-02-25,Perak,125,46,79,2014
2014-02-26,Perak,143,50,93,2014
2014-02-27,Perak,88,48,40,2014
2014-02-28,Perak,98,37,61,2014
2014-03-01,Perak,3,2,1,2014
2014-03-02,Perak,133,39,94,2014
2014-03-03,Perak,26,7,19,2014
2014-03-04,Perak,72,17,55,2014
2014-03-05,Perak,180,103,77,2014
2014-03-06,Perak,83,33,50,2014
2014-03-07,Perak,77,21,56,2014
2014-03-08,Perak,95,87,8,2014
2014-03-09,Perak,61,28,33,2014
2014-03-10,Perak,43,9,34,2014
2014-03-11,Perak,69,30,39,2014
2014-03-12,Perak,71,26,45,2014
2014-03-13,Perak,37,6,31,2014
2014-03-14,Perak,42,16,26,2014
2014-03-15,Perak,125,92,33,2014
2014-03-16,Perak,354,39,315,2014
2014-03-17,Perak,29,3,26,2014
2014-03-18,Perak,86,35,51,2014
2014-03-19,Perak,33,3,30,2014
2014-03-20,Perak,119,35,84,2014
2014-03-21,Perak,41,8,33,2014
2014-03-22,Perak,10,5,5,2014
2014-03-23,Perak,164,67,97,2014
2014-03-24,Perak,30,7,23,2014
2014-03-25,Perak,35,7,28,2014
2014-03-26,Perak,205,120,85,2014
2014-03-27,Perak,36,9,27,2014
2014-03-28,Perak,13,2,11,2014
2014-03-29,Perak,0,0,0,2014
2014-03-30,Perak,45,40,5,2014
2014-03-31,Perak,45,9,36,2014
2014-04-01,Perak,209,79,130,2014
2014-04-02,Perak,88,27,61,2014
2014-04-03,Perak,42,10,32,2014
2014-04-04,Perak,27,4,23,2014
2014-04-05,Perak,77,29,48,2014
2014-04-06,Perak,75,26,49,2014
2014-04-07,Perak,60,19,41,2014
2014-04-08,Perak,70,36,34,2014
2014-04-09,Perak,29,2,27,2014
2014-04-10,Perak,79,20,59,2014
2014-04-11,Perak,23,3,20,2014
2014-04-12,Perak,223,70,153,2014
2014-04-13,Perak,50,22,28,2014
2014-04-14,Perak,121,54,67,2014
2014-04-15,Perak,69,18,51,2014
2014-04-16,Perak,30,14,16,2014
2014-04-17,Perak,205,117,88,2014
2014-04-18,Perak,30,3,27,2014
2014-04-19,Perak,92,44,48,2014
2014-04-20,Perak,145,61,84,2014
2014-04-21,Perak,50,12,38,2014
2014-04-22,Perak,104,25,79,2014
2014-04-23,Perak,184,52,132,2014
2014-04-24,Perak,26,5,21,2014
2014-04-25,Perak,29,4,25,2014
2014-04-26,Perak,49,28,21,2014
2014-04-27,Perak,68,18,50,2014
2014-04-28,Perak,27,0,27,2014
2014-04-29,Perak,64,31,33,2014
2014-04-30,Perak,56,5,51,2014
2014-05-01,Perak,77,30,47,2014
2014-05-02,Perak,23,1,22,2014
2014-05-03,Perak,40,13,27,2014
2014-05-04,Perak,90,48,42,2014
2014-05-05,Perak,50,19,31,2014
2014-05-06,Perak,86,15,71,2014
2014-05-07,Perak,60,13,47,2014
2014-05-08,Perak,68,25,43,2014
2014-05-09,Perak,68,11,57,2014
2014-05-10,Perak,52,23,29,2014
2014-05-11,Perak,133,33,100,2014
2014-05-12,Perak,88,39,49,2014
2014-05-13,Perak,182,64,118,2014
2014-05-14,Perak,51,9,42,2014
2014-05-15,Perak,114,30,84,2014
2014-05-16,Perak,32,11,21,2014
2014-05-17,Perak,36,7,29,2014
2014-05-18,Perak,134,58,76,2014
2014-05-19,Perak,50,13,37,2014
2014-05-20,Perak,62,20,42,2014
2014-05-21,Perak,197,88,109,2014
2014-05-22,Perak,71,38,33,2014
2014-05-23,Perak,52,24,28,2014
2014-05-24,Perak,16,13,3,2014
2014-05-25,Perak,62,38,24,2014
2014-05-26,Perak,115,36,79,2014
2014-05-27,Perak,257,77,180,2014
2014-05-28,Perak,314,132,182,2014
2014-05-29,Perak,88,47,41,2014
2014-05-30,Perak,73,20,53,2014
2014-05-31,Perak,14,1,13,2014
2014-06-01,Perak,129,47,82,2014
2014-06-02,Perak,133,59,74,2014
2014-06-03,Perak,130,58,72,2014
2014-06-04,Perak,160,69,91,2014
2014-06-05,Perak,38,9,29,2014
2014-06-06,Perak,25,3,22,2014
2014-06-07,Perak,479,240,239,2014
2014-06-08,Perak,31,4,27,2014
2014-06-09,Perak,29,8,21,2014
2014-06-10,Perak,92,39,53,2014
2014-06-11,Perak,63,21,42,2014
2014-06-12,Perak,211,101,110,2014
2014-06-13,Perak,29,4,25,2014
2014-06-14,Perak,144,135,9,2014
2014-06-15,Perak,127,37,90,2014
2014-06-16,Perak,164,74,90,2014
2014-06-17,Perak,62,33,29,2014
2014-06-18,Perak,245,160,85,2014
2014-06-19,Perak,116,82,34,2014
2014-06-20,Perak,44,9,35,2014
2014-06-21,Perak,523,287,236,2014
2014-06-22,Perak,250,89,161,2014
2014-06-23,Perak,67,14,53,2014
2014-06-24,Perak,36,3,33,2014
2014-06-25,Perak,68,24,44,2014
2014-06-26,Perak,226,105,121,2014
2014-06-27,Perak,101,17,84,2014
2014-06-28,Perak,253,78,175,2014
2014-06-29,Perak,200,63,137,2014
2014-06-30,Perak,16,4,12,2014
2014-07-01,Perak,44,9,35,2014
2014-07-02,Perak,173,126,47,2014
2014-07-03,Perak,70,34,36,2014
2014-07-04,Perak,46,14,32,2014
2014-07-05,Perak,10,4,6,2014
2014-07-06,Perak,490,78,412,2014
2014-07-07,Perak,134,54,80,2014
2014-07-08,Perak,82,51,31,2014
2014-07-09,Perak,290,131,159,2014
2014-07-10,Perak,49,14,35,2014
2014-07-11,Perak,71,47,24,2014
2014-07-12,Perak,71,18,53,2014
2014-07-13,Perak,259,66,193,2014
2014-07-14,Perak,23,8,15,2014
2014-07-15,Perak,0,0,0,2014
2014-07-16,Perak,154,123,31,2014
2014-07-17,Perak,90,52,38,2014
2014-07-18,Perak,18,3,15,2014
2014-07-19,Perak,12,7,5,2014
2014-07-20,Perak,86,24,62,2014
2014-07-21,Perak,59,29,30,2014
2014-07-22,Perak,87,29,58,2014
2014-07-23,Perak,118,49,69,2014
2014-07-24,Perak,63,13,50,2014
2014-07-25,Perak,17,2,15,2014
2014-07-26,Perak,79,31,48,2014
2014-07-27,Perak,183,61,122,2014
2014-07-28,Perak,0,0,0,2014
2014-07-29,Perak,0,0,0,2014
2014-07-30,Perak,27,3,24,2014
2014-07-31,Perak,116,55,61,2014
2014-08-01,Perak,115,42,73,2014
2014-08-02,Perak,44,21,23,2014
2014-08-03,Perak,176,66,110,2014
2014-08-04,Perak,34,6,28,2014
2014-08-05,Perak,78,30,48,2014
2014-08-06,Perak,162,71,91,2014
2014-08-07,Perak,114,43,71,2014
2014-08-08,Perak,81,51,30,2014
2014-08-09,Perak,81,39,42,2014
2014-08-10,Perak,215,92,123,2014
2014-08-11,Perak,62,18,44,2014
2014-08-12,Perak,113,60,53,2014
2014-08-13,Perak,32,2,30,2014
2014-08-14,Perak,173,115,58,2014
2014-08-15,Perak,101,49,52,2014
2014-08-16,Perak,127,55,72,2014
2014-08-17,Perak,139,55,84,2014
2014-08-18,Perak,36,6,30,2014
2014-08-19,Perak,105,66,39,2014
2014-08-20,Perak,278,165,113,2014
2014-08-21,Perak,63,11,52,2014
2014-08-22,Perak,103,53,50,2014
2014-08-23,Perak,95,50,45,2014
2014-08-24,Perak,107,44,63,2014
2014-08-25,Perak,20,1,19,2014
2014-08-26,Perak,92,23,69,2014
2014-08-27,Perak,119,43,76,2014
2014-08-28,Perak,100,43,57,2014
2014-08-29,Perak,162,83,79,2014
2014-08-30,Perak,34,10,24,2014
2014-08-31,Perak,252,86,166,2014
2014-09-01,Perak,144,67,77,2014
2014-09-02,Perak,45,6,39,2014
2014-09-03,Perak,133,69,64,2014
2014-09-04,Perak,63,15,48,2014
2014-09-05,Perak,191,81,110,2014
2014-09-06,Perak,125,88,37,2014
2014-09-07,Perak,98,35,63,2014
2014-09-08,Perak,28,2,26,2014
2014-09-09,Perak,171,108,63,2014
2014-09-10,Perak,90,21,69,2014
2014-09-11,Perak,63,23,40,2014
2014-09-12,Perak,33,8,25,2014
2014-09-13,Perak,17,6,11,2014
2014-09-14,Perak,46,23,23,2014
2014-09-15,Perak,37,3,34,2014
2014-09-16,Perak,72,39,33,2014
2014-09-17,Perak,66,26,40,2014
2014-09-18,Perak,102,37,65,2014
2014-09-19,Perak,68,28,40,2014
2014-09-20,Perak,166,63,103,2014
2014-09-21,Perak,91,46,45,2014
2014-09-22,Perak,145,60,85,2014
2014-09-23,Perak,127,46,81,2014
2014-09-24,Perak,286,122,164,2014
2014-09-25,Perak,311,162,149,2014
2014-09-26,Perak,145,43,102,2014
2014-09-27,Perak,112,64,48,2014
2014-09-28,Perak,93,50,43,2014
2014-09-29,Perak,90,23,67,2014
2014-09-30,Perak,202,62,140,2014
2014-10-01,Perak,109,50,59,2014
2014-10-02,Perak,47,22,25,2014
2014-10-03,Perak,22,12,10,2014
2014-10-04,Perak,52,19,33,2014
2014-10-05,Perak,0,0,0,2014
2014-10-06,Perak,52,17,35,2014
2014-10-07,Perak,142,35,107,2014
2014-10-08,Perak,126,27,99,2014
2014-10-09,Perak,124,54,70,2014
2014-10-10,Perak,107,33,74,2014
2014-10-11,Perak,175,154,21,2014
2014-10-12,Perak,85,17,68,2014
2014-10-13,Perak,220,59,161,2014
2014-10-14,Perak,353,117,236,2014
2014-10-15,Perak,392,158,234,2014
2014-10-16,Perak,239,94,145,2014
2014-10-17,Perak,299,133,166,2014
2014-10-18,Perak,97,74,23,2014
2014-10-19,Perak,281,116,165,2014
2014-10-20,Perak,35,13,22,2014
2014-10-21,Perak,156,79,77,2014
2014-10-22,Perak,14,7,7,2014
2014-10-23,Perak,33,6,27,2014
2014-10-24,Perak,54,19,35,2014
2014-10-25,Perak,127,51,76,2014
2014-10-26,Perak,73,22,51,2014
2014-10-27,Perak,116,48,68,2014
2014-10-28,Perak,167,109,58,2014
2014-10-29,Perak,52,18,34,2014
2014-10-30,Perak,79,39,40,2014
2014-10-31,Perak,35,6,29,2014
2014-11-01,Perak,51,21,30,2014
2014-11-02,Perak,103,23,80,2014
2014-11-03,Perak,71,14,57,2014
2014-11-04,Perak,93,26,67,2014
2014-11-05,Perak,226,64,162,2014
2014-11-06,Perak,42,19,23,2014
2014-11-07,Perak,94,21,73,2014
2014-11-08,Perak,72,33,39,2014
2014-11-09,Perak,403,122,281,2014
2014-11-10,Perak,88,32,56,2014
2014-11-11,Perak,110,49,61,2014
2014-11-12,Perak,198,72,126,2014
2014-11-13,Perak,30,8,22,2014
2014-11-14,Perak,91,19,72,2014
2014-11-15,Perak,60,31,29,2014
2014-11-16,Perak,356,38,318,2014
2014-11-17,Perak,45,4,41,2014
2014-11-18,Perak,74,20,54,2014
2014-11-19,Perak,181,71,110,2014
2014-11-20,Perak,161,78,83,2014
2014-11-21,Perak,100,58,42,2014
2014-11-22,Perak,16,3,13,2014
2014-11-23,Perak,90,21,69,2014
2014-11-24,Perak,114,56,58,2014
2014-11-25,Perak,143,55,88,2014
2014-11-26,Perak,81,23,58,2014
2014-11-27,Perak,72,20,52,2014
2014-11-28,Perak,94,36,58,2014
2014-11-29,Perak,58,21,37,2014
2014-11-30,Perak,72,33,39,2014
2014-12-01,Perak,100,46,54,2014
2014-12-02,Perak,194,96,98,2014
2014-12-03,Perak,141,74,67,2014
2014-12-04,Perak,170,90,80,2014
2014-12-05,Perak,123,44,79,2014
2014-12-06,Perak,27,10,17,2014
2014-12-07,Perak,58,35,23,2014
2014-12-08,Perak,73,11,62,2014
2014-12-09,Perak,97,30,67,2014
2014-12-10,Perak,154,42,112,2014
2014-12-11,Perak,139,82,57,2014
2014-12-12,Perak,39,17,22,2014
2014-12-13,Perak,47,14,33,2014
2014-12-14,Perak,128,13,115,2014
2014-12-15,Perak,62,13,49,2014
2014-12-16,Perak,110,31,79,2014
2014-12-17,Perak,75,31,44,2014
2014-12-18,Perak,93,34,59,2014
2014-12-19,Perak,50,18,32,2014
2014-12-20,Perak,113,54,59,2014
2014-12-21,Perak,107,28,79,2014
2014-12-22,Perak,58,10,48,2014
2014-12-23,Perak,55,1,54,2014
2014-12-24,Perak,74,28,46,2014
2014-12-25,Perak,151,61,90,2014
2014-12-26,Perak,100,34,66,2014
2014-12-27,Perak,106,35,71,2014
2014-12-28,Perak,365,113,252,2014
2014-12-29,Perak,32,6,26,2014
2014-12-30,Perak,76,12,64,2014
2014-12-31,Perak,125,84,41,2014
2015-01-01,Perak,53,26,27,2015
2015-01-02,Perak,99,28,71,2015
2015-01-03,Perak,224,99,125,2015
2015-01-04,Perak,77,34,43,2015
2015-01-05,Perak,94,30,64,2015
2015-01-06,Perak,77,28,49,2015
2015-01-07,Perak,168,69,99,2015
2015-01-08,Perak,116,47,69,2015
2015-01-09,Perak,60,21,39,2015
2015-01-10,Perak,81,29,52,2015
2015-01-11,Perak,72,17,55,2015
2015-01-12,Perak,118,33,85,2015
2015-01-13,Perak,205,38,167,2015
2015-01-14,Perak,271,71,200,2015
2015-01-15,Perak,245,65,180,2015
2015-01-16,Perak,300,110,190,2015
2015-01-17,Perak,182,150,32,2015
2015-01-18,Perak,80,26,54,2015
2015-01-19,Perak,30,9,21,2015
2015-01-20,Perak,98,45,53,2015
2015-01-21,Perak,75,35,40,2015
2015-01-22,Perak,132,53,79,2015
2015-01-23,Perak,55,38,17,2015
2015-01-24,Perak,282,261,21,2015
2015-01-25,Perak,47,32,15,2015
2015-01-26,Perak,53,26,27,2015
2015-01-27,Perak,109,45,64,2015
2015-01-28,Perak,177,62,115,2015
2015-01-29,Perak,35,8,27,2015
2015-01-30,Perak,20,1,19,2015
2015-01-31,Perak,55,16,39,2015
2015-02-01,Perak,113,45,68,2015
2015-02-02,Perak,18,7,11,2015
2015-02-03,Perak,144,59,85,2015
2015-02-04,Perak,54,24,30,2015
2015-02-05,Perak,104,29,75,2015
2015-02-06,Perak,91,31,60,2015
2015-02-07,Perak,142,57,85,2015
2015-02-08,Perak,58,20,38,2015
2015-02-09,Perak,147,47,100,2015
2015-02-10,Perak,146,50,96,2015
2015-02-11,Perak,140,52,88,2015
2015-02-12,Perak,171,78,93,2015
2015-02-13,Perak,115,43,72,2015
2015-02-14,Perak,44,21,23,2015
2015-02-15,Perak,148,61,87,2015
2015-02-16,Perak,97,35,62,2015
2015-02-17,Perak,152,63,89,2015
2015-02-18,Perak,172,90,82,2015
2015-02-19,Perak,24,9,15,2015
2015-02-20,Perak,23,12,11,2015
2015-02-21,Perak,102,46,56,2015
2015-02-22,Perak,63,23,40,2015
2015-02-23,Perak,83,17,66,2015
2015-02-24,Perak,64,11,53,2015
2015-02-25,Perak,106,45,61,2015
2015-02-26,Perak,190,106,84,2015
2015-02-27,Perak,50,13,37,2015
2015-02-28,Perak,79,55,24,2015
2015-03-01,Perak,150,86,64,2015
2015-03-02,Perak,63,27,36,2015
2015-03-03,Perak,28,6,22,2015
2015-03-04,Perak,104,75,29,2015
2015-03-05,Perak,69,25,44,2015
2015-03-06,Perak,178,87,91,2015
2015-03-07,Perak,107,59,48,2015
2015-03-08,Perak,171,21,150,2015
2015-03-09,Perak,97,56,41,2015
2015-03-10,Perak,57,14,43,2015
2015-03-11,Perak,65,28,37,2015
2015-03-12,Perak,37,7,30,2015
2015-03-13,Perak,52,9,43,2015
2015-03-14,Perak,6,3,3,2015
2015-03-15,Perak,483,67,416,2015
2015-03-16,Perak,89,32,57,2015
2015-03-17,Perak,76,21,55,2015
2015-03-18,Perak,42,9,33,2015
2015-03-19,Perak,75,29,46,2015
2015-03-20,Perak,60,18,42,2015
2015-03-21,Perak,94,28,66,2015
2015-03-22,Perak,65,24,41,2015
2015-03-23,Perak,125,67,58,2015
2015-03-24,Perak,192,93,99,2015
2015-03-25,Perak,133,73,60,2015
2015-03-26,Perak,57,8,49,2015
2015-03-27,Perak,22,5,17,2015
2015-03-28,Perak,26,14,12,2015
2015-03-29,Perak,104,39,65,2015
2015-03-30,Perak,70,13,57,2015
2015-03-31,Perak,50,14,36,2015
2015-04-01,Perak,259,158,101,2015
2015-04-02,Perak,87,42,45,2015
2015-04-03,Perak,81,22,59,2015
2015-04-04,Perak,229,72,157,2015
2015-04-05,Perak,82,30,52,2015
2015-04-06,Perak,107,29,78,2015
2015-04-07,Perak,98,27,71,2015
2015-04-08,Perak,114,33,81,2015
2015-04-09,Perak,104,55,49,2015
2015-04-10,Perak,45,11,34,2015
2015-04-11,Perak,79,38,41,2015
2015-04-12,Perak,147,31,116,2015
2015-04-13,Perak,55,12,43,2015
2015-04-14,Perak,70,16,54,2015
2015-04-15,Perak,108,25,83,2015
2015-04-16,Perak,19,6,13,2015
2015-04-17,Perak,94,28,66,2015
2015-04-18,Perak,127,54,73,2015
2015-04-19,Perak,215,47,168,2015
2015-04-20,Perak,66,14,52,2015
2015-04-21,Perak,162,47,115,2015
2015-04-22,Perak,141,58,83,2015
2015-04-23,Perak,83,29,54,2015
2015-04-24,Perak,80,32,48,2015
2015-04-25,Perak,73,28,45,2015
2015-04-26,Perak,17,7,10,2015
2015-04-27,Perak,48,10,38,2015
2015-04-28,Perak,91,25,66,2015
2015-04-29,Perak,80,28,52,2015
2015-04-30,Perak,57,14,43,2015
2015-05-01,Perak,169,55,114,2015
2015-05-02,Perak,178,48,130,2015
2015-05-03,Perak,208,78,130,2015
2015-05-04,Perak,91,38,53,2015
2015-05-05,Perak,79,24,55,2015
2015-05-06,Perak,94,39,55,2015
2015-05-07,Perak,51,17,34,2015
2015-05-08,Perak,93,63,30,2015
2015-05-09,Perak,71,31,40,2015
2015-05-10,Perak,113,13,100,2015
2015-05-11,Perak,60,18,42,2015
2015-05-12,Perak,63,20,43,2015
2015-05-13,Perak,65,28,37,2015
2015-05-14,Perak,92,37,55,2015
2015-05-15,Perak,51,27,24,2015
2015-05-16,Perak,171,82,89,2015
2015-05-17,Perak,103,33,70,2015
2015-05-18,Perak,113,32,81,2015
2015-05-19,Perak,122,31,91,2015
2015-05-20,Perak,86,35,51,2015
2015-05-21,Perak,317,189,128,2015
2015-05-22,Perak,65,13,52,2015
2015-05-23,Perak,67,29,38,2015
2015-05-24,Perak,107,19,88,2015
2015-05-25,Perak,54,19,35,2015
2015-05-26,Perak,143,63,80,2015
2015-05-27,Perak,69,25,44,2015
2015-05-28,Perak,116,64,52,2015
2015-05-29,Perak,105,29,76,2015
2015-05-30,Perak,99,33,66,2015
2015-05-31,Perak,109,28,81,2015
2015-06-01,Perak,68,12,56,2015
2015-06-02,Perak,56,16,40,2015
2015-06-03,Perak,163,33,130,2015
2015-06-04,Perak,39,12,27,2015
2015-06-05,Perak,33,7,26,2015
2015-06-06,Perak,43,11,32,2015
2015-06-07,Perak,211,79,132,2015
2015-06-08,Perak,147,30,117,2015
2015-06-09,Perak,199,37,162,2015
2015-06-10,Perak,289,88,201,2015
2015-06-11,Perak,308,89,219,2015
2015-06-12,Perak,282,107,175,2015
2015-06-13,Perak,367,134,233,2015
2015-06-14,Perak,294,91,203,2015
2015-06-15,Perak,40,2,38,2015
2015-06-16,Perak,130,56,74,2015
2015-06-17,Perak,71,18,53,2015
2015-06-18,Perak,10,2,8,2015
2015-06-19,Perak,58,27,31,2015
2015-06-20,Perak,0,0,0,2015
2015-06-21,Perak,184,52,132,2015
2015-06-22,Perak,16,3,13,2015
2015-06-23,Perak,31,6,25,2015
2015-06-24,Perak,204,131,73,2015
2015-06-25,Perak,20,4,16,2015
2015-06-26,Perak,54,12,42,2015
2015-06-27,Perak,69,31,38,2015
2015-06-28,Perak,203,58,145,2015
2015-06-29,Perak,145,105,40,2015
2015-06-30,Perak,38,5,33,2015
2015-07-01,Perak,153,111,42,2015
2015-07-02,Perak,95,62,33,2015
2015-07-03,Perak,23,1,22,2015
2015-07-04,Perak,73,35,38,2015
2015-07-05,Perak,384,40,344,2015
2015-07-06,Perak,46,12,34,2015
2015-07-07,Perak,144,43,101,2015
2015-07-08,Perak,90,39,51,2015
2015-07-09,Perak,179,101,78,2015
2015-07-10,Perak,115,67,48,2015
2015-07-11,Perak,59,14,45,2015
2015-07-12,Perak,227,50,177,2015
2015-07-13,Perak,45,10,35,2015
2015-07-14,Perak,291,213,78,2015
2015-07-15,Perak,23,6,17,2015
2015-07-16,Perak,25,4,21,2015
2015-07-17,Perak,0,0,0,2015
2015-07-18,Perak,0,0,0,2015
2015-07-19,Perak,37,14,23,2015
2015-07-20,Perak,76,32,44,2015
2015-07-21,Perak,143,63,80,2015
2015-07-22,Perak,61,15,46,2015
2015-07-23,Perak,81,23,58,2015
2015-07-24,Perak,28,5,23,2015
2015-07-25,Perak,119,34,85,2015
2015-07-26,Perak,247,60,187,2015
2015-07-27,Perak,42,9,33,2015
2015-07-28,Perak,89,22,67,2015
2015-07-29,Perak,115,47,68,2015
2015-07-30,Perak,123,76,47,2015
2015-07-31,Perak,31,6,25,2015
2015-08-01,Perak,5,2,3,2015
2015-08-02,Perak,200,47,153,2015
2015-08-03,Perak,113,58,55,2015
2015-08-04,Perak,109,68,41,2015
2015-08-05,Perak,151,99,52,2015
2015-08-06,Perak,198,143,55,2015
2015-08-07,Perak,44,12,32,2015
2015-08-08,Perak,16,7,9,2015
2015-08-09,Perak,165,54,111,2015
2015-08-10,Perak,66,11,55,2015
2015-08-11,Perak,97,42,55,2015
2015-08-12,Perak,599,344,255,2015
2015-08-13,Perak,18,1,17,2015
2015-08-14,Perak,45,12,33,2015
2015-08-15,Perak,136,55,81,2015
2015-08-16,Perak,168,56,112,2015
2015-08-17,Perak,69,15,54,2015
2015-08-18,Perak,71,30,41,2015
2015-08-19,Perak,274,119,155,2015
2015-08-20,Perak,51,11,40,2015
2015-08-21,Perak,99,63,36,2015
2015-08-22,Perak,109,23,86,2015
2015-08-23,Perak,262,157,105,2015
2015-08-24,Perak,29,6,23,2015
2015-08-25,Perak,48,8,40,2015
2015-08-26,Perak,252,163,89,2015
2015-08-27,Perak,120,78,42,2015
2015-08-28,Perak,95,21,74,2015
2015-08-29,Perak,175,56,119,2015
2015-08-30,Perak,292,86,206,2015
2015-08-31,Perak,343,99,244,2015
2015-09-01,Perak,52,20,32,2015
2015-09-02,Perak,69,19,50,2015
2015-09-03,Perak,113,59,54,2015
2015-09-04,Perak,55,14,41,2015
2015-09-05,Perak,141,62,79,2015
2015-09-06,Perak,110,31,79,2015
2015-09-07,Perak,29,4,25,2015
2015-09-08,Perak,164,93,71,2015
2015-09-09,Perak,92,32,60,2015
2015-09-10,Perak,101,29,72,2015
2015-09-11,Perak,65,27,38,2015
2015-09-12,Perak,19,4,15,2015
2015-09-13,Perak,83,32,51,2015
2015-09-14,Perak,34,5,29,2015
2015-09-15,Perak,224,117,107,2015
2015-09-16,Perak,166,48,118,2015
2015-09-17,Perak,31,4,27,2015
2015-09-18,Perak,31,5,26,2015
2015-09-19,Perak,81,26,55,2015
2015-09-20,Perak,48,26,22,2015
2015-09-21,Perak,133,32,101,2015
2015-09-22,Perak,149,46,103,2015
2015-09-23,Perak,74,26,48,2015
2015-09-24,Perak,0,0,0,2015
2015-09-25,Perak,34,7,27,2015
2015-09-26,Perak,43,11,32,2015
2015-09-27,Perak,74,31,43,2015
2015-09-28,Perak,21,1,20,2015
2015-09-29,Perak,26,3,23,2015
2015-09-30,Perak,134,35,99,2015
2015-10-01,Perak,76,15,61,2015
2015-10-02,Perak,34,6,28,2015
2015-10-03,Perak,111,42,69,2015
2015-10-04,Perak,116,45,71,2015
2015-10-05,Perak,42,5,37,2015
2015-10-06,Perak,38,9,29,2015
2015-10-07,Perak,98,34,64,2015
2015-10-08,Perak,342,150,192,2015
2015-10-09,Perak,66,19,47,2015
2015-10-10,Perak,39,31,8,2015
2015-10-11,Perak,199,49,150,2015
2015-10-12,Perak,60,31,29,2015
2015-10-13,Perak,41,10,31,2015
2015-10-14,Perak,43,29,14,2015
2015-10-15,Perak,64,25,39,2015
2015-10-16,Perak,71,30,41,2015
2015-10-17,Perak,37,12,25,2015
2015-10-18,Perak,96,34,62,2015
2015-10-19,Perak,67,19,48,2015
2015-10-20,Perak,116,63,53,2015
2015-10-21,Perak,156,70,86,2015
2015-10-22,Perak,201,50,151,2015
2015-10-23,Perak,128,50,78,2015
2015-10-24,Perak,93,26,67,2015
2015-10-25,Perak,42,11,31,2015
2015-10-26,Perak,223,74,149,2015
2015-10-27,Perak,242,82,160,2015
2015-10-28,Perak,262,102,160,2015
2015-10-29,Perak,297,132,165,2015
2015-10-30,Perak,309,143,166,2015
2015-10-31,Perak,70,33,37,2015
2015-11-01,Perak,302,74,228,2015
2015-11-02,Perak,23,4,19,2015
2015-11-03,Perak,96,24,72,2015
2015-11-04,Perak,77,28,49,2015
2015-11-05,Perak,212,78,134,2015
2015-11-06,Perak,29,6,23,2015
2015-11-07,Perak,50,18,32,2015
2015-11-08,Perak,126,32,94,2015
2015-11-09,Perak,109,63,46,2015
2015-11-10,Perak,167,54,113,2015
2015-11-11,Perak,84,32,52,2015
2015-11-12,Perak,114,36,78,2015
2015-11-13,Perak,61,23,38,2015
2015-11-14,Perak,63,23,40,2015
2015-11-15,Perak,159,91,68,2015
2015-11-16,Perak,78,25,53,2015
2015-11-17,Perak,157,71,86,2015
2015-11-18,Perak,119,47,72,2015
2015-11-19,Perak,136,49,87,2015
2015-11-20,Perak,50,14,36,2015
2015-11-21,Perak,25,2,23,2015
2015-11-22,Perak,438,70,368,2015
2015-11-23,Perak,62,9,53,2015
2015-11-24,Perak,88,38,50,2015
2015-11-25,Perak,73,48,25,2015
2015-11-26,Perak,59,23,36,2015
2015-11-27,Perak,52,13,39,2015
2015-11-28,Perak,45,17,28,2015
2015-11-29,Perak,97,27,70,2015
2015-11-30,Perak,33,4,29,2015
2015-12-01,Perak,104,39,65,2015
2015-12-02,Perak,77,24,53,2015
2015-12-03,Perak,78,33,45,2015
2015-12-04,Perak,51,9,42,2015
2015-12-05,Perak,57,24,33,2015
2015-12-06,Perak,166,43,123,2015
2015-12-07,Perak,57,23,34,2015
2015-12-08,Perak,129,53,76,2015
2015-12-09,Perak,166,88,78,2015
2015-12-10,Perak,180,100,80,2015
2015-12-11,Perak,57,10,47,2015
2015-12-12,Perak,65,31,34,2015
2015-12-13,Perak,240,49,191,2015
2015-12-14,Perak,77,24,53,2015
2015-12-15,Perak,109,35,74,2015
2015-12-16,Perak,103,24,79,2015
2015-12-17,Perak,100,63,37,2015
2015-12-18,Perak,79,17,62,2015
2015-12-19,Perak,5,3,2,2015
2015-12-20,Perak,75,19,56,2015
2015-12-21,Perak,111,42,69,2015
2015-12-22,Perak,121,22,99,2015
2015-12-23,Perak,143,71,72,2015
2015-12-24,Perak,105,34,71,2015
2015-12-25,Perak,86,29,57,2015
2015-12-26,Perak,59,11,48,2015
2015-12-27,Perak,210,78,132,2015
2015-12-28,Perak,193,81,112,2015
2015-12-29,Perak,92,19,73,2015
2015-12-30,Perak,78,18,60,2015
2015-12-31,Perak,97,34,63,2015
2016-01-01,Perak,211,63,148,2016
2016-01-02,Perak,109,71,38,2016
2016-01-03,Perak,135,46,89,2016
2016-01-04,Perak,76,19,57,2016
2016-01-05,Perak,64,25,39,2016
2016-01-06,Perak,96,27,69,2016
2016-01-07,Perak,79,40,39,2016
2016-01-08,Perak,31,3,28,2016
2016-01-09,Perak,77,11,66,2016
2016-01-10,Perak,45,20,25,2016
2016-01-11,Perak,120,46,74,2016
2016-01-12,Perak,63,29,34,2016
2016-01-13,Perak,64,24,40,2016
2016-01-14,Perak,190,135,55,2016
2016-01-15,Perak,119,65,54,2016
2016-01-16,Perak,76,32,44,2016
2016-01-17,Perak,98,44,54,2016
2016-01-18,Perak,275,78,197,2016
2016-01-19,Perak,383,112,271,2016
2016-01-20,Perak,366,134,232,2016
2016-01-21,Perak,288,98,190,2016
2016-01-22,Perak,368,123,245,2016
2016-01-23,Perak,23,9,14,2016
2016-01-24,Perak,141,42,99,2016
2016-01-25,Perak,4,1,3,2016
2016-01-26,Perak,135,61,74,2016
2016-01-27,Perak,117,32,85,2016
2016-01-28,Perak,39,12,27,2016
2016-01-29,Perak,34,7,27,2016
2016-01-30,Perak,163,70,93,2016
2016-01-31,Perak,225,87,138,2016
2016-02-01,Perak,102,69,33,2016
2016-02-02,Perak,148,89,59,2016
2016-02-03,Perak,177,88,89,2016
2016-02-04,Perak,147,58,89,2016
2016-02-05,Perak,53,7,46,2016
2016-02-06,Perak,54,19,35,2016
2016-02-07,Perak,90,32,58,2016
2016-02-08,Perak,95,33,62,2016
2016-02-09,Perak,100,35,65,2016
2016-02-10,Perak,54,8,46,2016
2016-02-11,Perak,90,24,66,2016
2016-02-12,Perak,118,47,71,2016
2016-02-13,Perak,183,108,75,2016
2016-02-14,Perak,47,13,34,2016
2016-02-15,Perak,89,26,63,2016
2016-02-16,Perak,72,23,49,2016
2016-02-17,Perak,99,33,66,2016
2016-02-18,Perak,365,225,140,2016
2016-02-19,Perak,69,22,47,2016
2016-02-20,Perak,47,10,37,2016
2016-02-21,Perak,228,83,145,2016
2016-02-22,Perak,196,115,81,2016
2016-02-23,Perak,233,158,75,2016
2016-02-24,Perak,186,90,96,2016
2016-02-25,Perak,55,11,44,2016
2016-02-26,Perak,57,19,38,2016
2016-02-27,Perak,20,4,16,2016
2016-02-28,Perak,102,37,65,2016
2016-02-29,Perak,46,6,40,2016
2016-03-01,Perak,29,2,27,2016
2016-03-02,Perak,45,10,35,2016
2016-03-03,Perak,119,14,105,2016
2016-03-04,Perak,69,13,56,2016
2016-03-05,Perak,56,21,35,2016
2016-03-06,Perak,187,37,150,2016
2016-03-07,Perak,87,24,63,2016
2016-03-08,Perak,77,16,61,2016
2016-03-09,Perak,124,36,88,2016
2016-03-10,Perak,160,82,78,2016
2016-03-11,Perak,24,5,19,2016
2016-03-12,Perak,15,7,8,2016
2016-03-13,Perak,446,42,404,2016
2016-03-14,Perak,158,50,108,2016
2016-03-15,Perak,202,80,122,2016
2016-03-16,Perak,125,49,76,2016
2016-03-17,Perak,188,66,122,2016
2016-03-18,Perak,73,34,39,2016
2016-03-19,Perak,91,62,29,2016
2016-03-20,Perak,222,47,175,2016
2016-03-21,Perak,9,0,9,2016
2016-03-22,Perak,68,32,36,2016
2016-03-23,Perak,194,77,117,2016
2016-03-24,Perak,64,27,37,2016
2016-03-25,Perak,58,13,45,2016
2016-03-26,Perak,73,33,40,2016
2016-03-27,Perak,88,30,58,2016
2016-03-28,Perak,111,41,70,2016
2016-03-29,Perak,125,41,84,2016
2016-03-30,Perak,81,21,60,2016
2016-03-31,Perak,251,110,141,2016
2016-04-01,Perak,46,12,34,2016
2016-04-02,Perak,309,108,201,2016
2016-04-03,Perak,188,82,106,2016
2016-04-04,Perak,71,20,51,2016
2016-04-05,Perak,27,3,24,2016
2016-04-06,Perak,77,22,55,2016
2016-04-07,Perak,94,43,51,2016
2016-04-08,Perak,73,19,54,2016
2016-04-09,Perak,66,18,48,2016
2016-04-10,Perak,177,34,143,2016
2016-04-11,Perak,23,3,20,2016
2016-04-12,Perak,57,13,44,2016
2016-04-13,Perak,105,46,59,2016
2016-04-14,Perak,58,14,44,2016
2016-04-15,Perak,60,17,43,2016
2016-04-16,Perak,135,52,83,2016
2016-04-17,Perak,216,71,145,2016
2016-04-18,Perak,29,4,25,2016
2016-04-19,Perak,73,23,50,2016
2016-04-20,Perak,258,130,128,2016
2016-04-21,Perak,175,56,119,2016
2016-04-22,Perak,44,14,30,2016
2016-04-23,Perak,136,62,74,2016
2016-04-24,Perak,133,27,106,2016
2016-04-25,Perak,168,102,66,2016
2016-04-26,Perak,166,73,93,2016
2016-04-27,Perak,91,29,62,2016
2016-04-28,Perak,139,70,69,2016
2016-04-29,Perak,148,106,42,2016
2016-04-30,Perak,63,19,44,2016
2016-05-01,Perak,136,41,95,2016
2016-05-02,Perak,146,40,106,2016
2016-05-03,Perak,70,9,61,2016
2016-05-04,Perak,64,16,48,2016
2016-05-05,Perak,149,67,82,2016
2016-05-06,Perak,69,19,50,2016
2016-05-07,Perak,209,82,127,2016
2016-05-08,Perak,179,37,142,2016
2016-05-09,Perak,11,0,11,2016
2016-05-10,Perak,95,13,82,2016
2016-05-11,Perak,79,12,67,2016
2016-05-12,Perak,216,68,148,2016
2016-05-13,Perak,61,39,22,2016
2016-05-14,Perak,79,42,37,2016
2016-05-15,Perak,147,67,80,2016
2016-05-16,Perak,10,0,10,2016
2016-05-17,Perak,190,39,151,2016
2016-05-18,Perak,106,49,57,2016
2016-05-19,Perak,157,54,103,2016
2016-05-20,Perak,54,16,38,2016
2016-05-21,Perak,185,56,129,2016
2016-05-22,Perak,47,18,29,2016
2016-05-23,Perak,82,20,62,2016
2016-05-24,Perak,57,12,45,2016
2016-05-25,Perak,181,88,93,2016
2016-05-26,Perak,154,84,70,2016
2016-05-27,Perak,80,36,44,2016
2016-05-28,Perak,32,10,22,2016
2016-05-29,Perak,101,26,75,2016
2016-05-30,Perak,186,30,156,2016
2016-05-31,Perak,265,53,212,2016
2016-06-01,Perak,294,53,241,2016
2016-06-02,Perak,360,129,231,2016
2016-06-03,Perak,267,63,204,2016
2016-06-04,Perak,171,59,112,2016
2016-06-05,Perak,128,34,94,2016
2016-06-06,Perak,19,2,17,2016
2016-06-07,Perak,10,0,10,2016
2016-06-08,Perak,26,12,14,2016
2016-06-09,Perak,15,2,13,2016
2016-06-10,Perak,14,2,12,2016
2016-06-11,Perak,43,20,23,2016
2016-06-12,Perak,185,51,134,2016
2016-06-13,Perak,53,22,31,2016
2016-06-14,Perak,43,9,34,2016
2016-06-15,Perak,208,120,88,2016
2016-06-16,Perak,174,99,75,2016
2016-06-17,Perak,15,2,13,2016
2016-06-18,Perak,116,39,77,2016
2016-06-19,Perak,105,28,77,2016
2016-06-20,Perak,47,21,26,2016
2016-06-21,Perak,85,42,43,2016
2016-06-22,Perak,42,12,30,2016
2016-06-23,Perak,160,88,72,2016
2016-06-24,Perak,15,2,13,2016
2016-06-25,Perak,13,2,11,2016
2016-06-26,Perak,245,59,186,2016
2016-06-27,Perak,67,46,21,2016
2016-06-28,Perak,64,41,23,2016
2016-06-29,Perak,177,130,47,2016
2016-06-30,Perak,116,59,57,2016
2016-07-01,Perak,36,9,27,2016
2016-07-02,Perak,28,11,17,2016
2016-07-03,Perak,187,52,135,2016
2016-07-04,Perak,38,14,24,2016
2016-07-05,Perak,23,4,19,2016
2016-07-06,Perak,0,0,0,2016
2016-07-07,Perak,0,0,0,2016
2016-07-08,Perak,37,7,30,2016
2016-07-09,Perak,35,12,23,2016
2016-07-10,Perak,535,75,460,2016
2016-07-11,Perak,85,20,65,2016
2016-07-12,Perak,62,16,46,2016
2016-07-13,Perak,62,17,45,2016
2016-07-14,Perak,93,31,62,2016
2016-07-15,Perak,26,3,23,2016
2016-07-16,Perak,333,134,199,2016
2016-07-17,Perak,384,118,266,2016
2016-07-18,Perak,46,7,39,2016
2016-07-19,Perak,216,109,107,2016
2016-07-20,Perak,124,67,57,2016
2016-07-21,Perak,180,58,122,2016
2016-07-22,Perak,36,6,30,2016
2016-07-23,Perak,166,84,82,2016
2016-07-24,Perak,158,46,112,2016
2016-07-25,Perak,100,51,49,2016
2016-07-26,Perak,140,59,81,2016
2016-07-27,Perak,172,85,87,2016
2016-07-28,Perak,95,43,52,2016
2016-07-29,Perak,54,20,34,2016
2016-07-30,Perak,63,29,34,2016
2016-07-31,Perak,182,24,158,2016
2016-08-01,Perak,52,21,31,2016
2016-08-02,Perak,106,68,38,2016
2016-08-03,Perak,178,115,63,2016
2016-08-04,Perak,164,100,64,2016
2016-08-05,Perak,35,14,21,2016
2016-08-06,Perak,202,87,115,2016
2016-08-07,Perak,134,56,78,2016
2016-08-08,Perak,33,3,30,2016
2016-08-09,Perak,60,8,52,2016
2016-08-10,Perak,45,8,37,2016
2016-08-11,Perak,106,48,58,2016
2016-08-12,Perak,29,5,24,2016
2016-08-13,Perak,174,33,141,2016
2016-08-14,Perak,64,20,44,2016
2016-08-15,Perak,68,44,24,2016
2016-08-16,Perak,358,215,143,2016
2016-08-17,Perak,75,18,57,2016
2016-08-18,Perak,112,22,90,2016
2016-08-19,Perak,33,6,27,2016
2016-08-20,Perak,192,76,116,2016
2016-08-21,Perak,164,43,121,2016
2016-08-22,Perak,46,11,35,2016
2016-08-23,Perak,120,33,87,2016
2016-08-24,Perak,128,60,68,2016
2016-08-25,Perak,117,59,58,2016
2016-08-26,Perak,80,20,60,2016
2016-08-27,Perak,86,22,64,2016
2016-08-28,Perak,159,73,86,2016
2016-08-29,Perak,125,43,82,2016
2016-08-30,Perak,54,7,47,2016
2016-08-31,Perak,213,58,155,2016
2016-09-01,Perak,183,81,102,2016
2016-09-02,Perak,31,6,25,2016
2016-09-03,Perak,157,48,109,2016
2016-09-04,Perak,203,62,141,2016
2016-09-05,Perak,62,12,50,2016
2016-09-06,Perak,125,54,71,2016
2016-09-07,Perak,52,17,35,2016
2016-09-08,Perak,135,30,105,2016
2016-09-09,Perak,125,45,80,2016
2016-09-10,Perak,95,31,64,2016
2016-09-11,Perak,136,33,103,2016
2016-09-12,Perak,0,0,0,2016
2016-09-13,Perak,28,1,27,2016
2016-09-14,Perak,67,13,54,2016
2016-09-15,Perak,23,1,22,2016
2016-09-16,Perak,315,167,148,2016
2016-09-17,Perak,23,3,20,2016
2016-09-18,Perak,283,83,200,2016
2016-09-19,Perak,93,30,63,2016
2016-09-20,Perak,82,18,64,2016
2016-09-21,Perak,110,24,86,2016
2016-09-22,Perak,38,8,30,2016
2016-09-23,Perak,34,9,25,2016
2016-09-24,Perak,23,6,17,2016
2016-09-25,Perak,150,58,92,2016
2016-09-26,Perak,24,4,20,2016
2016-09-27,Perak,221,75,146,2016
2016-09-28,Perak,129,57,72,2016
2016-09-29,Perak,219,90,129,2016
2016-09-30,Perak,35,5,30,2016
2016-10-01,Perak,57,20,37,2016
2016-10-02,Perak,72,16,56,2016
2016-10-03,Perak,65,25,40,2016
2016-10-04,Perak,224,70,154,2016
2016-10-05,Perak,94,37,57,2016
2016-10-06,Perak,35,16,19,2016
2016-10-07,Perak,26,3,23,2016
2016-10-08,Perak,76,35,41,2016
2016-10-09,Perak,58,9,49,2016
2016-10-10,Perak,55,10,45,2016
2016-10-11,Perak,23,5,18,2016
2016-10-12,Perak,156,66,90,2016
2016-10-13,Perak,80,23,57,2016
2016-10-14,Perak,74,27,47,2016
2016-10-15,Perak,58,25,33,2016
2016-10-16,Perak,207,59,148,2016
2016-10-17,Perak,212,53,159,2016
2016-10-18,Perak,240,65,175,2016
2016-10-19,Perak,390,163,227,2016
2016-10-20,Perak,289,107,182,2016
2016-10-21,Perak,296,129,167,2016
2016-10-22,Perak,58,29,29,2016
2016-10-23,Perak,86,15,71,2016
2016-10-24,Perak,54,18,36,2016
2016-10-25,Perak,79,21,58,2016
2016-10-26,Perak,142,48,94,2016
2016-10-27,Perak,74,16,58,2016
2016-10-28,Perak,69,34,35,2016
2016-10-29,Perak,87,39,48,2016
2016-10-30,Perak,134,73,61,2016
2016-10-31,Perak,30,1,29,2016
2016-11-01,Perak,201,57,144,2016
2016-11-02,Perak,172,86,86,2016
2016-11-03,Perak,122,46,76,2016
2016-11-04,Perak,58,15,43,2016
2016-11-05,Perak,8,1,7,2016
2016-11-06,Perak,152,12,140,2016
2016-11-07,Perak,27,4,23,2016
2016-11-08,Perak,39,7,32,2016
2016-11-09,Perak,33,14,19,2016
2016-11-10,Perak,60,6,54,2016
2016-11-11,Perak,79,45,34,2016
2016-11-12,Perak,127,56,71,2016
2016-11-13,Perak,97,26,71,2016
2016-11-14,Perak,27,2,25,2016
2016-11-15,Perak,139,65,74,2016
2016-11-16,Perak,113,22,91,2016
2016-11-17,Perak,112,44,68,2016
2016-11-18,Perak,65,19,46,2016
2016-11-19,Perak,95,22,73,2016
2016-11-20,Perak,424,50,374,2016
2016-11-21,Perak,40,8,32,2016
2016-11-22,Perak,77,20,57,2016
2016-11-23,Perak,107,44,63,2016
2016-11-24,Perak,72,24,48,2016
2016-11-25,Perak,95,27,68,2016
2016-11-26,Perak,101,33,68,2016
2016-11-27,Perak,188,60,128,2016
2016-11-28,Perak,49,11,38,2016
2016-11-29,Perak,23,5,18,2016
2016-11-30,Perak,130,89,41,2016
2016-12-01,Perak,140,10,130,2016
2016-12-02,Perak,56,16,40,2016
2016-12-03,Perak,129,41,88,2016
2016-12-04,Perak,147,33,114,2016
2016-12-05,Perak,74,17,57,2016
2016-12-06,Perak,30,5,25,2016
2016-12-07,Perak,84,28,56,2016
2016-12-08,Perak,95,28,67,2016
2016-12-09,Perak,139,28,111,2016
2016-12-10,Perak,94,43,51,2016
2016-12-11,Perak,120,34,86,2016
2016-12-12,Perak,39,13,26,2016
2016-12-13,Perak,96,31,65,2016
2016-12-14,Perak,58,18,40,2016
2016-12-15,Perak,200,66,134,2016
2016-12-16,Perak,123,55,68,2016
2016-12-17,Perak,175,51,124,2016
2016-12-18,Perak,194,92,102,2016
2016-12-19,Perak,40,13,27,2016
2016-12-20,Perak,127,49,78,2016
2016-12-21,Perak,178,80,98,2016
2016-12-22,Perak,125,76,49,2016
2016-12-23,Perak,62,7,55,2016
2016-12-24,Perak,121,35,86,2016
2016-12-25,Perak,202,69,133,2016
2016-12-26,Perak,206,53,153,2016
2016-12-27,Perak,69,15,54,2016
2016-12-28,Perak,81,19,62,2016
2016-12-29,Perak,78,22,56,2016
2016-12-30,Perak,78,18,60,2016
2016-12-31,Perak,13,4,9,2016
2017-01-01,Perak,92,27,65,2017
2017-01-02,Perak,72,24,48,2017
2017-01-03,Perak,33,4,29,2017
2017-01-04,Perak,195,58,137,2017
2017-01-05,Perak,148,47,101,2017
2017-01-06,Perak,63,45,18,2017
2017-01-07,Perak,141,46,95,2017
2017-01-08,Perak,148,33,115,2017
2017-01-09,Perak,65,20,45,2017
2017-01-10,Perak,101,17,84,2017
2017-01-11,Perak,153,36,117,2017
2017-01-12,Perak,140,74,66,2017
2017-01-13,Perak,35,15,20,2017
2017-01-14,Perak,129,39,90,2017
2017-01-15,Perak,112,30,82,2017
2017-01-16,Perak,213,33,180,2017
2017-01-17,Perak,309,59,250,2017
2017-01-18,Perak,364,106,258,2017
2017-01-19,Perak,356,104,252,2017
2017-01-20,Perak,339,90,249,2017
2017-01-21,Perak,99,40,59,2017
2017-01-22,Perak,248,91,157,2017
2017-01-23,Perak,145,68,77,2017
2017-01-24,Perak,95,48,47,2017
2017-01-25,Perak,75,24,51,2017
2017-01-26,Perak,79,20,59,2017
2017-01-27,Perak,33,6,27,2017
2017-01-28,Perak,148,57,91,2017
2017-01-29,Perak,92,28,64,2017
2017-01-30,Perak,44,19,25,2017
2017-01-31,Perak,41,9,32,2017
2017-02-01,Perak,114,23,91,2017
2017-02-02,Perak,91,38,53,2017
2017-02-03,Perak,13,2,11,2017
2017-02-04,Perak,70,19,51,2017
2017-02-05,Perak,37,9,28,2017
2017-02-06,Perak,25,5,20,2017
2017-02-07,Perak,81,40,41,2017
2017-02-08,Perak,188,125,63,2017
2017-02-09,Perak,179,79,100,2017
2017-02-10,Perak,99,33,66,2017
2017-02-11,Perak,58,16,42,2017
2017-02-12,Perak,265,86,179,2017
2017-02-13,Perak,32,1,31,2017
2017-02-14,Perak,140,49,91,2017
2017-02-15,Perak,273,112,161,2017
2017-02-16,Perak,179,117,62,2017
2017-02-17,Perak,21,3,18,2017
2017-02-18,Perak,104,50,54,2017
2017-02-19,Perak,103,34,69,2017
2017-02-20,Perak,187,112,75,2017
2017-02-21,Perak,211,120,91,2017
2017-02-22,Perak,124,36,88,2017
2017-02-23,Perak,60,17,43,2017
2017-02-24,Perak,108,46,62,2017
2017-02-25,Perak,42,10,32,2017
2017-02-26,Perak,9,3,6,2017
2017-02-27,Perak,32,5,27,2017
2017-02-28,Perak,193,62,131,2017
2017-03-01,Perak,198,68,130,2017
2017-03-02,Perak,32,4,28,2017
2017-03-03,Perak,122,37,85,2017
2017-03-04,Perak,118,41,77,2017
2017-03-05,Perak,190,28,162,2017
2017-03-06,Perak,76,10,66,2017
2017-03-07,Perak,59,24,35,2017
2017-03-08,Perak,150,70,80,2017
2017-03-09,Perak,107,40,67,2017
2017-03-10,Perak,221,79,142,2017
2017-03-11,Perak,100,19,81,2017
2017-03-12,Perak,210,46,164,2017
2017-03-13,Perak,27,6,21,2017
2017-03-14,Perak,58,5,53,2017
2017-03-15,Perak,165,56,109,2017
2017-03-16,Perak,94,53,41,2017
2017-03-17,Perak,28,5,23,2017
2017-03-18,Perak,198,63,135,2017
2017-03-19,Perak,263,84,179,2017
2017-03-20,Perak,38,6,32,2017
2017-03-21,Perak,89,18,71,2017
2017-03-22,Perak,152,37,115,2017
2017-03-23,Perak,104,42,62,2017
2017-03-24,Perak,27,2,25,2017
2017-03-25,Perak,128,45,83,2017
2017-03-26,Perak,384,35,349,2017
2017-03-27,Perak,82,16,66,2017
2017-03-28,Perak,96,30,66,2017
2017-03-29,Perak,90,37,53,2017
2017-03-30,Perak,200,65,135,2017
2017-03-31,Perak,48,11,37,2017
2017-04-01,Perak,283,73,210,2017
2017-04-02,Perak,64,19,45,2017
2017-04-03,Perak,103,15,88,2017
2017-04-04,Perak,98,11,87,2017
2017-04-05,Perak,135,51,84,2017
2017-04-06,Perak,191,86,105,2017
2017-04-07,Perak,58,21,37,2017
2017-04-08,Perak,100,45,55,2017
2017-04-09,Perak,264,83,181,2017
2017-04-10,Perak,45,12,33,2017
2017-04-11,Perak,163,62,101,2017
2017-04-12,Perak,175,72,103,2017
2017-04-13,Perak,50,13,37,2017
2017-04-14,Perak,88,28,60,2017
2017-04-15,Perak,203,67,136,2017
2017-04-16,Perak,218,44,174,2017
2017-04-17,Perak,13,1,12,2017
2017-04-18,Perak,37,14,23,2017
2017-04-19,Perak,129,37,92,2017
2017-04-20,Perak,85,35,50,2017
2017-04-21,Perak,57,7,50,2017
2017-04-22,Perak,142,76,66,2017
2017-04-23,Perak,232,72,160,2017
2017-04-24,Perak,41,23,18,2017
2017-04-25,Perak,29,4,25,2017
2017-04-26,Perak,22,1,21,2017
2017-04-27,Perak,101,30,71,2017
2017-04-28,Perak,24,1,23,2017
2017-04-29,Perak,114,28,86,2017
2017-04-30,Perak,147,37,110,2017
2017-05-01,Perak,148,47,101,2017
2017-05-02,Perak,41,8,33,2017
2017-05-03,Perak,30,4,26,2017
2017-05-04,Perak,114,55,59,2017
2017-05-05,Perak,26,4,22,2017
2017-05-06,Perak,164,62,102,2017
2017-05-07,Perak,216,58,158,2017
2017-05-08,Perak,19,4,15,2017
2017-05-09,Perak,160,62,98,2017
2017-05-10,Perak,196,47,149,2017
2017-05-11,Perak,43,14,29,2017
2017-05-12,Perak,41,16,25,2017
2017-05-13,Perak,143,63,80,2017
2017-05-14,Perak,240,62,178,2017
2017-05-15,Perak,52,23,29,2017
2017-05-16,Perak,51,7,44,2017
2017-05-17,Perak,35,2,33,2017
2017-05-18,Perak,126,29,97,2017
2017-05-19,Perak,71,19,52,2017
2017-05-20,Perak,138,48,90,2017
2017-05-21,Perak,197,50,147,2017
2017-05-22,Perak,66,16,50,2017
2017-05-23,Perak,150,43,107,2017
2017-05-24,Perak,23,3,20,2017
2017-05-25,Perak,46,11,35,2017
2017-05-26,Perak,169,85,84,2017
2017-05-27,Perak,0,0,0,2017
2017-05-28,Perak,144,25,119,2017
2017-05-29,Perak,169,28,141,2017
2017-05-30,Perak,270,53,217,2017
2017-05-31,Perak,293,54,239,2017
2017-06-01,Perak,247,52,195,2017
2017-06-02,Perak,256,65,191,2017
2017-06-03,Perak,25,8,17,2017
2017-06-04,Perak,85,24,61,2017
2017-06-05,Perak,11,3,8,2017
2017-06-06,Perak,67,15,52,2017
2017-06-07,Perak,36,15,21,2017
2017-06-08,Perak,45,7,38,2017
2017-06-09,Perak,67,29,38,2017
2017-06-10,Perak,56,18,38,2017
2017-06-11,Perak,172,35,137,2017
2017-06-12,Perak,0,0,0,2017
2017-06-13,Perak,182,106,76,2017
2017-06-14,Perak,161,82,79,2017
2017-06-15,Perak,169,67,102,2017
2017-06-16,Perak,29,7,22,2017
2017-06-17,Perak,58,14,44,2017
2017-06-18,Perak,203,45,158,2017
2017-06-19,Perak,72,46,26,2017
2017-06-20,Perak,217,144,73,2017
2017-06-21,Perak,147,73,74,2017
2017-06-22,Perak,134,67,67,2017
2017-06-23,Perak,41,23,18,2017
2017-06-24,Perak,0,0,0,2017
2017-06-25,Perak,0,0,0,2017
2017-06-26,Perak,0,0,0,2017
2017-06-27,Perak,44,10,34,2017
2017-06-28,Perak,63,14,49,2017
2017-06-29,Perak,79,20,59,2017
2017-06-30,Perak,67,43,24,2017
2017-07-01,Perak,111,31,80,2017
2017-07-02,Perak,132,44,88,2017
2017-07-03,Perak,40,10,30,2017
2017-07-04,Perak,41,9,32,2017
2017-07-05,Perak,41,7,34,2017
2017-07-06,Perak,225,100,125,2017
2017-07-07,Perak,73,22,51,2017
2017-07-08,Perak,57,23,34,2017
2017-07-09,Perak,249,44,205,2017
2017-07-10,Perak,44,9,35,2017
2017-07-11,Perak,80,22,58,2017
2017-07-12,Perak,143,67,76,2017
2017-07-13,Perak,131,68,63,2017
2017-07-14,Perak,86,44,42,2017
2017-07-15,Perak,108,53,55,2017
2017-07-16,Perak,107,28,79,2017
2017-07-17,Perak,78,18,60,2017
2017-07-18,Perak,105,34,71,2017
2017-07-19,Perak,260,165,95,2017
2017-07-20,Perak,106,23,83,2017
2017-07-21,Perak,24,2,22,2017
2017-07-22,Perak,165,84,81,2017
2017-07-23,Perak,428,38,390,2017
2017-07-24,Perak,45,6,39,2017
2017-07-25,Perak,297,180,117,2017
2017-07-26,Perak,228,138,90,2017
2017-07-27,Perak,135,49,86,2017
2017-07-28,Perak,36,5,31,2017
2017-07-29,Perak,187,40,147,2017
2017-07-30,Perak,162,33,129,2017
2017-07-31,Perak,89,38,51,2017
2017-08-01,Perak,62,13,49,2017
2017-08-02,Perak,84,36,48,2017
2017-08-03,Perak,66,13,53,2017
2017-08-04,Perak,53,16,37,2017
2017-08-05,Perak,165,43,122,2017
2017-08-06,Perak,324,116,208,2017
2017-08-07,Perak,119,41,78,2017
2017-08-08,Perak,49,16,33,2017
2017-08-09,Perak,80,43,37,2017
2017-08-10,Perak,33,5,28,2017
2017-08-11,Perak,39,5,34,2017
2017-08-12,Perak,159,66,93,2017
2017-08-13,Perak,182,49,133,2017
2017-08-14,Perak,60,12,48,2017
2017-08-15,Perak,92,26,66,2017
2017-08-16,Perak,91,38,53,2017
2017-08-17,Perak,34,7,27,2017
2017-08-18,Perak,187,111,76,2017
2017-08-19,Perak,98,31,67,2017
2017-08-20,Perak,251,74,177,2017
2017-08-21,Perak,128,25,103,2017
2017-08-22,Perak,73,16,57,2017
2017-08-23,Perak,166,103,63,2017
2017-08-24,Perak,156,48,108,2017
2017-08-25,Perak,19,1,18,2017
2017-08-26,Perak,100,31,69,2017
2017-08-27,Perak,68,9,59,2017
2017-08-28,Perak,277,125,152,2017
2017-08-29,Perak,90,14,76,2017
2017-08-30,Perak,41,15,26,2017
2017-08-31,Perak,310,92,218,2017
2017-09-01,Perak,0,0,0,2017
2017-09-02,Perak,48,18,30,2017
2017-09-03,Perak,61,24,37,2017
2017-09-04,Perak,41,9,32,2017
2017-09-05,Perak,40,5,35,2017
2017-09-06,Perak,205,104,101,2017
2017-09-07,Perak,57,3,54,2017
2017-09-08,Perak,17,1,16,2017
2017-09-09,Perak,97,42,55,2017
2017-09-10,Perak,280,62,218,2017
2017-09-11,Perak,22,5,17,2017
2017-09-12,Perak,190,145,45,2017
2017-09-13,Perak,146,66,80,2017
2017-09-14,Perak,112,40,72,2017
2017-09-15,Perak,22,2,20,2017
2017-09-16,Perak,391,121,270,2017
2017-09-17,Perak,325,126,199,2017
2017-09-18,Perak,64,13,51,2017
2017-09-19,Perak,89,39,50,2017
2017-09-20,Perak,55,21,34,2017
2017-09-21,Perak,154,47,107,2017
2017-09-22,Perak,0,0,0,2017
2017-09-23,Perak,66,14,52,2017
2017-09-24,Perak,173,36,137,2017
2017-09-25,Perak,49,27,22,2017
2017-09-26,Perak,105,69,36,2017
2017-09-27,Perak,118,81,37,2017
2017-09-28,Perak,156,108,48,2017
2017-09-29,Perak,97,48,49,2017
2017-09-30,Perak,77,35,42,2017
2017-10-01,Perak,89,32,57,2017
2017-10-02,Perak,102,12,90,2017
2017-10-03,Perak,25,3,22,2017
2017-10-04,Perak,31,7,24,2017
2017-10-05,Perak,93,56,37,2017
2017-10-06,Perak,125,67,58,2017
2017-10-07,Perak,52,12,40,2017
2017-10-08,Perak,187,63,124,2017
2017-10-09,Perak,154,85,69,2017
2017-10-10,Perak,27,2,25,2017
2017-10-11,Perak,101,25,76,2017
2017-10-12,Perak,40,20,20,2017
2017-10-13,Perak,24,5,19,2017
2017-10-14,Perak,87,21,66,2017
2017-10-15,Perak,129,73,56,2017
2017-10-16,Perak,165,40,125,2017
2017-10-17,Perak,305,99,206,2017
2017-10-18,Perak,90,27,63,2017
2017-10-19,Perak,268,72,196,2017
2017-10-20,Perak,272,77,195,2017
2017-10-21,Perak,35,11,24,2017
2017-10-22,Perak,147,31,116,2017
2017-10-23,Perak,65,22,43,2017
2017-10-24,Perak,67,30,37,2017
2017-10-25,Perak,104,37,67,2017
2017-10-26,Perak,116,27,89,2017
2017-10-27,Perak,26,4,22,2017
2017-10-28,Perak,253,83,170,2017
2017-10-29,Perak,138,23,115,2017
2017-10-30,Perak,29,1,28,2017
2017-10-31,Perak,26,8,18,2017
2017-11-01,Perak,109,24,85,2017
2017-11-02,Perak,25,2,23,2017
2017-11-03,Perak,107,42,65,2017
2017-11-04,Perak,151,54,97,2017
2017-11-05,Perak,265,50,215,2017
2017-11-06,Perak,29,5,24,2017
2017-11-07,Perak,57,9,48,2017
2017-11-08,Perak,43,13,30,2017
2017-11-09,Perak,68,19,49,2017
2017-11-10,Perak,79,18,61,2017
2017-11-11,Perak,186,75,111,2017
2017-11-12,Perak,183,42,141,2017
2017-11-13,Perak,45,5,40,2017
2017-11-14,Perak,42,7,35,2017
2017-11-15,Perak,73,30,43,2017
2017-11-16,Perak,104,39,65,2017
2017-11-17,Perak,84,18,66,2017
2017-11-18,Perak,120,78,42,2017
2017-11-19,Perak,411,38,373,2017
2017-11-20,Perak,15,0,15,2017
2017-11-21,Perak,193,98,95,2017
2017-11-22,Perak,118,53,65,2017
2017-11-23,Perak,95,29,66,2017
2017-11-24,Perak,60,9,51,2017
2017-11-25,Perak,57,22,35,2017
2017-11-26,Perak,153,51,102,2017
2017-11-27,Perak,38,10,28,2017
2017-11-28,Perak,69,17,52,2017
2017-11-29,Perak,165,69,96,2017
2017-11-30,Perak,59,13,46,2017
2017-12-01,Perak,52,18,34,2017
2017-12-02,Perak,81,25,56,2017
2017-12-03,Perak,117,30,87,2017
2017-12-04,Perak,25,2,23,2017
2017-12-05,Perak,111,41,70,2017
2017-12-06,Perak,303,154,149,2017
2017-12-07,Perak,291,165,126,2017
2017-12-08,Perak,77,26,51,2017
2017-12-09,Perak,166,41,125,2017
2017-12-10,Perak,244,56,188,2017
2017-12-11,Perak,102,43,59,2017
2017-12-12,Perak,109,25,84,2017
2017-12-13,Perak,142,45,97,2017
2017-12-14,Perak,34,12,22,2017
2017-12-15,Perak,30,1,29,2017
2017-12-16,Perak,171,89,82,2017
2017-12-17,Perak,190,24,166,2017
2017-12-18,Perak,33,4,29,2017
2017-12-19,Perak,126,60,66,2017
2017-12-20,Perak,125,57,68,2017
2017-12-21,Perak,72,42,30,2017
2017-12-22,Perak,57,26,31,2017
2017-12-23,Perak,127,32,95,2017
2017-12-24,Perak,106,32,74,2017
2017-12-25,Perak,89,23,66,2017
2017-12-26,Perak,49,7,42,2017
2017-12-27,Perak,99,44,55,2017
2017-12-28,Perak,88,17,71,2017
2017-12-29,Perak,43,3,40,2017
2017-12-30,Perak,154,32,122,2017
2017-12-31,Perak,137,32,105,2017
2018-01-01,Perak,210,59,151,2018
2018-01-02,Perak,33,3,30,2018
2018-01-03,Perak,153,91,62,2018
2018-01-04,Perak,53,11,42,2018
2018-01-05,Perak,18,0,18,2018
2018-01-06,Perak,103,38,65,2018
2018-01-07,Perak,96,23,73,2018
2018-01-08,Perak,49,14,35,2018
2018-01-09,Perak,52,12,40,2018
2018-01-10,Perak,79,19,60,2018
2018-01-11,Perak,86,41,45,2018
2018-01-12,Perak,117,45,72,2018
2018-01-13,Perak,67,17,50,2018
2018-01-14,Perak,175,50,125,2018
2018-01-15,Perak,214,30,184,2018
2018-01-16,Perak,289,58,231,2018
2018-01-17,Perak,312,74,238,2018
2018-01-18,Perak,342,94,248,2018
2018-01-19,Perak,260,59,201,2018
2018-01-20,Perak,81,33,48,2018
2018-01-21,Perak,165,44,121,2018
2018-01-22,Perak,104,65,39,2018
2018-01-23,Perak,102,16,86,2018
2018-01-24,Perak,202,90,112,2018
2018-01-25,Perak,208,100,108,2018
2018-01-26,Perak,98,22,76,2018
2018-01-27,Perak,121,23,98,2018
2018-01-28,Perak,181,62,119,2018
2018-01-29,Perak,61,12,49,2018
2018-01-30,Perak,57,6,51,2018
2018-01-31,Perak,230,77,153,2018
2018-02-01,Perak,20,4,16,2018
2018-02-02,Perak,33,5,28,2018
2018-02-03,Perak,87,27,60,2018
2018-02-04,Perak,66,21,45,2018
2018-02-05,Perak,36,6,30,2018
2018-02-06,Perak,172,87,85,2018
2018-02-07,Perak,60,10,50,2018
2018-02-08,Perak,137,71,66,2018
2018-02-09,Perak,41,13,28,2018
2018-02-10,Perak,163,86,77,2018
2018-02-11,Perak,194,71,123,2018
2018-02-12,Perak,105,46,59,2018
2018-02-13,Perak,142,59,83,2018
2018-02-14,Perak,138,50,88,2018
2018-02-15,Perak,86,14,72,2018
2018-02-16,Perak,74,18,56,2018
2018-02-17,Perak,96,28,68,2018
2018-02-18,Perak,174,75,99,2018
2018-02-19,Perak,98,24,74,2018
2018-02-20,Perak,75,19,56,2018
2018-02-21,Perak,75,15,60,2018
2018-02-22,Perak,241,117,124,2018
2018-02-23,Perak,55,13,42,2018
2018-02-24,Perak,146,92,54,2018
2018-02-25,Perak,189,57,132,2018
2018-02-26,Perak,26,3,23,2018
2018-02-27,Perak,146,37,109,2018
2018-02-28,Perak,75,13,62,2018
2018-03-01,Perak,30,4,26,2018
2018-03-02,Perak,77,19,58,2018
2018-03-03,Perak,118,41,77,2018
2018-03-04,Perak,188,47,141,2018
2018-03-05,Perak,35,5,30,2018
2018-03-06,Perak,88,41,47,2018
2018-03-07,Perak,83,38,45,2018
2018-03-08,Perak,308,175,133,2018
2018-03-09,Perak,79,23,56,2018
2018-03-10,Perak,158,73,85,2018
2018-03-11,Perak,192,43,149,2018
2018-03-12,Perak,80,13,67,2018
2018-03-13,Perak,48,6,42,2018
2018-03-14,Perak,204,62,142,2018
2018-03-15,Perak,137,38,99,2018
2018-03-16,Perak,20,4,16,2018
2018-03-17,Perak,173,51,122,2018
2018-03-18,Perak,323,83,240,2018
2018-03-19,Perak,47,7,40,2018
2018-03-20,Perak,53,10,43,2018
2018-03-21,Perak,131,28,103,2018
2018-03-22,Perak,81,22,59,2018
2018-03-23,Perak,105,40,65,2018
2018-03-24,Perak,77,29,48,2018
2018-03-25,Perak,479,61,418,2018
2018-03-26,Perak,23,4,19,2018
2018-03-27,Perak,188,41,147,2018
2018-03-28,Perak,23,4,19,2018
2018-03-29,Perak,170,53,117,2018
2018-03-30,Perak,103,28,75,2018
2018-03-31,Perak,28,8,20,2018
2018-04-01,Perak,168,32,136,2018
2018-04-02,Perak,45,7,38,2018
2018-04-03,Perak,101,49,52,2018
2018-04-04,Perak,40,2,38,2018
2018-04-05,Perak,54,4,50,2018
2018-04-06,Perak,32,5,27,2018
2018-04-07,Perak,280,78,202,2018
2018-04-08,Perak,125,32,93,2018
2018-04-09,Perak,75,29,46,2018
2018-04-10,Perak,24,3,21,2018
2018-04-11,Perak,22,1,21,2018
2018-04-12,Perak,63,18,45,2018
2018-04-13,Perak,99,42,57,2018
2018-04-14,Perak,141,45,96,2018
2018-04-15,Perak,165,93,72,2018
2018-04-16,Perak,78,26,52,2018
2018-04-17,Perak,95,35,60,2018
2018-04-18,Perak,47,14,33,2018
2018-04-19,Perak,54,15,39,2018
2018-04-20,Perak,29,8,21,2018
2018-04-21,Perak,201,56,145,2018
2018-04-22,Perak,285,75,210,2018
2018-04-23,Perak,120,40,80,2018
2018-04-24,Perak,37,25,12,2018
2018-04-25,Perak,134,62,72,2018
2018-04-26,Perak,88,51,37,2018
2018-04-27,Perak,102,32,70,2018
2018-04-28,Perak,198,71,127,2018
2018-04-29,Perak,183,47,136,2018
2018-04-30,Perak,25,7,18,2018
2018-05-01,Perak,224,60,164,2018
2018-05-02,Perak,114,40,74,2018
2018-05-03,Perak,86,25,61,2018
2018-05-04,Perak,32,8,24,2018
2018-05-05,Perak,158,52,106,2018
2018-05-06,Perak,101,30,71,2018
2018-05-07,Perak,69,21,48,2018
2018-05-08,Perak,110,24,86,2018
2018-05-09,Perak,0,0,0,2018
2018-05-10,Perak,70,22,48,2018
2018-05-11,Perak,52,14,38,2018
2018-05-12,Perak,178,65,113,2018
2018-05-13,Perak,282,86,196,2018
2018-05-14,Perak,306,113,193,2018
2018-05-15,Perak,282,131,151,2018
2018-05-16,Perak,71,22,49,2018
2018-05-17,Perak,42,8,34,2018
2018-05-18,Perak,24,10,14,2018
2018-05-19,Perak,73,33,40,2018
2018-05-20,Perak,153,25,128,2018
2018-05-21,Perak,27,10,17,2018
2018-05-22,Perak,70,27,43,2018
2018-05-23,Perak,40,7,33,2018
2018-05-24,Perak,108,52,56,2018
2018-05-25,Perak,46,17,29,2018
2018-05-26,Perak,96,36,60,2018
2018-05-27,Perak,239,54,185,2018
2018-05-28,Perak,118,15,103,2018
2018-05-29,Perak,171,36,135,2018
2018-05-30,Perak,418,78,340,2018
2018-05-31,Perak,125,21,104,2018
2018-06-01,Perak,45,10,35,2018
2018-06-02,Perak,287,72,215,2018
2018-06-03,Perak,188,56,132,2018
2018-06-04,Perak,81,58,23,2018
2018-06-05,Perak,228,104,124,2018
2018-06-06,Perak,228,124,104,2018
2018-06-07,Perak,161,101,60,2018
2018-06-08,Perak,69,16,53,2018
2018-06-09,Perak,43,10,33,2018
2018-06-10,Perak,114,34,80,2018
2018-06-11,Perak,80,38,42,2018
2018-06-12,Perak,59,15,44,2018
2018-06-13,Perak,66,17,49,2018
2018-06-14,Perak,43,11,32,2018
2018-06-15,Perak,0,0,0,2018
2018-06-16,Perak,0,0,0,2018
2018-06-17,Perak,34,7,27,2018
2018-06-18,Perak,69,17,52,2018
2018-06-19,Perak,54,10,44,2018
2018-06-20,Perak,97,20,77,2018
2018-06-21,Perak,96,25,71,2018
2018-06-22,Perak,44,5,39,2018
2018-06-23,Perak,120,30,90,2018
2018-06-24,Perak,213,37,176,2018
2018-06-25,Perak,74,9,65,2018
2018-06-26,Perak,101,19,82,2018
2018-06-27,Perak,201,81,120,2018
2018-06-28,Perak,136,75,61,2018
2018-06-29,Perak,47,23,24,2018
2018-06-30,Perak,23,6,17,2018
2018-07-01,Perak,146,47,99,2018
2018-07-02,Perak,110,64,46,2018
2018-07-03,Perak,195,98,97,2018
2018-07-04,Perak,208,114,94,2018
2018-07-05,Perak,111,63,48,2018
2018-07-06,Perak,93,48,45,2018
2018-07-07,Perak,80,18,62,2018
2018-07-08,Perak,131,26,105,2018
2018-07-09,Perak,70,21,49,2018
2018-07-10,Perak,132,14,118,2018
2018-07-11,Perak,65,12,53,2018
2018-07-12,Perak,24,3,21,2018
2018-07-13,Perak,54,19,35,2018
2018-07-14,Perak,184,66,118,2018
2018-07-15,Perak,482,66,416,2018
2018-07-16,Perak,165,67,98,2018
2018-07-17,Perak,118,43,75,2018
2018-07-18,Perak,157,37,120,2018
2018-07-19,Perak,157,62,95,2018
2018-07-20,Perak,101,45,56,2018
2018-07-21,Perak,174,40,134,2018
2018-07-22,Perak,243,38,205,2018
2018-07-23,Perak,308,101,207,2018
2018-07-24,Perak,60,10,50,2018
2018-07-25,Perak,156,88,68,2018
2018-07-26,Perak,383,208,175,2018
2018-07-27,Perak,86,46,40,2018
2018-07-28,Perak,34,6,28,2018
2018-07-29,Perak,275,56,219,2018
2018-07-30,Perak,154,68,86,2018
2018-07-31,Perak,151,104,47,2018
2018-08-01,Perak,170,53,117,2018
2018-08-02,Perak,146,108,38,2018
2018-08-03,Perak,44,9,35,2018
2018-08-04,Perak,45,9,36,2018
2018-08-05,Perak,169,52,117,2018
2018-08-06,Perak,119,45,74,2018
2018-08-07,Perak,119,58,61,2018
2018-08-08,Perak,86,33,53,2018
2018-08-09,Perak,123,73,50,2018
2018-08-10,Perak,22,1,21,2018
2018-08-11,Perak,430,105,325,2018
2018-08-12,Perak,454,144,310,2018
2018-08-13,Perak,16,4,12,2018
2018-08-14,Perak,77,20,57,2018
2018-08-15,Perak,113,66,47,2018
2018-08-16,Perak,62,13,49,2018
2018-08-17,Perak,7,1,6,2018
2018-08-18,Perak,326,106,220,2018
2018-08-19,Perak,426,130,296,2018
2018-08-20,Perak,116,36,80,2018
2018-08-21,Perak,15,0,15,2018
2018-08-22,Perak,0,0,0,2018
2018-08-23,Perak,49,14,35,2018
2018-08-24,Perak,38,8,30,2018
2018-08-25,Perak,119,30,89,2018
2018-08-26,Perak,202,47,155,2018
2018-08-27,Perak,11,0,11,2018
2018-08-28,Perak,118,78,40,2018
2018-08-29,Perak,128,50,78,2018
2018-08-30,Perak,78,35,43,2018
2018-08-31,Perak,485,145,340,2018
2018-09-01,Perak,35,12,23,2018
2018-09-02,Perak,86,18,68,2018
2018-09-03,Perak,38,4,34,2018
2018-09-04,Perak,85,26,59,2018
2018-09-05,Perak,85,48,37,2018
2018-09-06,Perak,93,23,70,2018
2018-09-07,Perak,18,4,14,2018
2018-09-08,Perak,64,17,47,2018
2018-09-09,Perak,235,51,184,2018
2018-09-10,Perak,66,18,48,2018
2018-09-11,Perak,177,83,94,2018
2018-09-12,Perak,39,10,29,2018
2018-09-13,Perak,52,4,48,2018
2018-09-14,Perak,60,21,39,2018
2018-09-15,Perak,62,13,49,2018
2018-09-16,Perak,187,61,126,2018
2018-09-17,Perak,115,30,85,2018
2018-09-18,Perak,43,13,30,2018
2018-09-19,Perak,186,67,119,2018
2018-09-20,Perak,62,9,53,2018
2018-09-21,Perak,116,48,68,2018
2018-09-22,Perak,45,19,26,2018
2018-09-23,Perak,96,13,83,2018
2018-09-24,Perak,185,64,121,2018
2018-09-25,Perak,27,3,24,2018
2018-09-26,Perak,139,85,54,2018
2018-09-27,Perak,147,67,80,2018
2018-09-28,Perak,22,2,20,2018
2018-09-29,Perak,113,26,87,2018
2018-09-30,Perak,154,32,122,2018
2018-10-01,Perak,35,3,32,2018
2018-10-02,Perak,147,87,60,2018
2018-10-03,Perak,128,59,69,2018
2018-10-04,Perak,79,24,55,2018
2018-10-05,Perak,83,18,65,2018
2018-10-06,Perak,150,40,110,2018
2018-10-07,Perak,84,22,62,2018
2018-10-08,Perak,88,15,73,2018
2018-10-09,Perak,74,18,56,2018
2018-10-10,Perak,140,64,76,2018
2018-10-11,Perak,23,3,20,2018
2018-10-12,Perak,34,6,28,2018
2018-10-13,Perak,172,49,123,2018
2018-10-14,Perak,100,23,77,2018
2018-10-15,Perak,9,1,8,2018
2018-10-16,Perak,91,24,67,2018
2018-10-17,Perak,115,40,75,2018
2018-10-18,Perak,176,46,130,2018
2018-10-19,Perak,39,13,26,2018
2018-10-20,Perak,58,12,46,2018
2018-10-21,Perak,88,26,62,2018
2018-10-22,Perak,215,50,165,2018
2018-10-23,Perak,273,79,194,2018
2018-10-24,Perak,276,94,182,2018
2018-10-25,Perak,284,94,190,2018
2018-10-26,Perak,292,137,155,2018
2018-10-27,Perak,100,20,80,2018
2018-10-28,Perak,265,63,202,2018
2018-10-29,Perak,0,0,0,2018
2018-10-30,Perak,203,67,136,2018
2018-10-31,Perak,145,31,114,2018
2018-11-01,Perak,151,32,119,2018
2018-11-02,Perak,103,28,75,2018
2018-11-03,Perak,88,22,66,2018
2018-11-04,Perak,132,31,101,2018
2018-11-05,Perak,76,14,62,2018
2018-11-06,Perak,116,33,83,2018
2018-11-07,Perak,59,15,44,2018
2018-11-08,Perak,41,7,34,2018
2018-11-09,Perak,36,5,31,2018
2018-11-10,Perak,150,45,105,2018
2018-11-11,Perak,264,38,226,2018
2018-11-12,Perak,17,1,16,2018
2018-11-13,Perak,85,23,62,2018
2018-11-14,Perak,108,47,61,2018
2018-11-15,Perak,150,60,90,2018
2018-11-16,Perak,56,29,27,2018
2018-11-17,Perak,131,53,78,2018
2018-11-18,Perak,598,61,537,2018
2018-11-19,Perak,84,31,53,2018
2018-11-20,Perak,43,10,33,2018
2018-11-21,Perak,44,20,24,2018
2018-11-22,Perak,161,64,97,2018
2018-11-23,Perak,77,16,61,2018
2018-11-24,Perak,172,113,59,2018
2018-11-25,Perak,192,33,159,2018
2018-11-26,Perak,128,59,69,2018
2018-11-27,Perak,57,23,34,2018
2018-11-28,Perak,110,37,73,2018
2018-11-29,Perak,65,26,39,2018
2018-11-30,Perak,85,40,45,2018
2018-12-01,Perak,191,73,118,2018
2018-12-02,Perak,242,47,195,2018
2018-12-03,Perak,114,47,67,2018
2018-12-04,Perak,192,87,105,2018
2018-12-05,Perak,139,66,73,2018
2018-12-06,Perak,185,88,97,2018
2018-12-07,Perak,12,0,12,2018
2018-12-08,Perak,93,15,78,2018
2018-12-09,Perak,105,17,88,2018
2018-12-10,Perak,46,14,32,2018
2018-12-11,Perak,116,59,57,2018
2018-12-12,Perak,114,39,75,2018
2018-12-13,Perak,90,12,78,2018
2018-12-14,Perak,131,39,92,2018
2018-12-15,Perak,117,23,94,2018
2018-12-16,Perak,151,15,136,2018
2018-12-17,Perak,50,18,32,2018
2018-12-18,Perak,82,16,66,2018
2018-12-19,Perak,50,17,33,2018
2018-12-20,Perak,87,26,61,2018
2018-12-21,Perak,66,15,51,2018
2018-12-22,Perak,95,26,69,2018
2018-12-23,Perak,225,71,154,2018
2018-12-24,Perak,127,26,101,2018
2018-12-25,Perak,158,33,125,2018
2018-12-26,Perak,49,13,36,2018
2018-12-27,Perak,51,12,39,2018
2018-12-28,Perak,64,13,51,2018
2018-12-29,Perak,136,75,61,2018
2018-12-30,Perak,120,31,89,2018
2018-12-31,Perak,54,10,44,2018
2019-01-01,Perak,109,26,83,2019
2019-01-02,Perak,12,0,12,2019
2019-01-03,Perak,98,19,79,2019
2019-01-04,Perak,32,3,29,2019
2019-01-05,Perak,107,37,70,2019
2019-01-06,Perak,164,48,116,2019
2019-01-07,Perak,45,8,37,2019
2019-01-08,Perak,135,18,117,2019
2019-01-09,Perak,123,43,80,2019
2019-01-10,Perak,130,43,87,2019
2019-01-11,Perak,105,31,74,2019
2019-01-12,Perak,130,28,102,2019
2019-01-13,Perak,146,47,99,2019
2019-01-14,Perak,61,9,52,2019
2019-01-15,Perak,160,65,95,2019
2019-01-16,Perak,388,181,207,2019
2019-01-17,Perak,95,53,42,2019
2019-01-18,Perak,200,98,102,2019
2019-01-19,Perak,144,44,100,2019
2019-01-20,Perak,292,71,221,2019
2019-01-21,Perak,162,38,124,2019
2019-01-22,Perak,81,22,59,2019
2019-01-23,Perak,144,50,94,2019
2019-01-24,Perak,147,16,131,2019
2019-01-25,Perak,62,8,54,2019
2019-01-26,Perak,118,47,71,2019
2019-01-27,Perak,66,26,40,2019
2019-01-28,Perak,290,57,233,2019
2019-01-29,Perak,347,95,252,2019
2019-01-30,Perak,337,111,226,2019
2019-01-31,Perak,315,93,222,2019
2019-02-01,Perak,43,5,38,2019
2019-02-02,Perak,65,29,36,2019
2019-02-03,Perak,128,35,93,2019
2019-02-04,Perak,51,12,39,2019
2019-02-05,Perak,98,25,73,2019
2019-02-06,Perak,201,72,129,2019
2019-02-07,Perak,50,3,47,2019
2019-02-08,Perak,56,13,43,2019
2019-02-09,Perak,116,44,72,2019
2019-02-10,Perak,161,49,112,2019
2019-02-11,Perak,34,7,27,2019
2019-02-12,Perak,105,20,85,2019
2019-02-13,Perak,236,98,138,2019
2019-02-14,Perak,181,110,71,2019
2019-02-15,Perak,76,35,41,2019
2019-02-16,Perak,150,37,113,2019
2019-02-17,Perak,90,29,61,2019
2019-02-18,Perak,48,14,34,2019
2019-02-19,Perak,31,1,30,2019
2019-02-20,Perak,247,102,145,2019
2019-02-21,Perak,158,47,111,2019
2019-02-22,Perak,55,16,39,2019
2019-02-23,Perak,86,25,61,2019
2019-02-24,Perak,168,19,149,2019
2019-02-25,Perak,63,17,46,2019
2019-02-26,Perak,201,74,127,2019
2019-02-27,Perak,177,81,96,2019
2019-02-28,Perak,18,4,14,2019
2019-03-01,Perak,32,5,27,2019
2019-03-02,Perak,57,9,48,2019
2019-03-03,Perak,256,55,201,2019
2019-03-04,Perak,28,0,28,2019
2019-03-05,Perak,129,52,77,2019
2019-03-06,Perak,120,67,53,2019
2019-03-07,Perak,76,32,44,2019
2019-03-08,Perak,28,3,25,2019
2019-03-09,Perak,50,11,39,2019
2019-03-10,Perak,453,58,395,2019
2019-03-11,Perak,123,44,79,2019
2019-03-12,Perak,103,66,37,2019
2019-03-13,Perak,151,70,81,2019
2019-03-14,Perak,78,10,68,2019
2019-03-15,Perak,52,20,32,2019
2019-03-16,Perak,127,40,87,2019
2019-03-17,Perak,121,29,92,2019
2019-03-18,Perak,169,79,90,2019
2019-03-19,Perak,158,54,104,2019
2019-03-20,Perak,83,21,62,2019
2019-03-21,Perak,99,29,70,2019
2019-03-22,Perak,78,23,55,2019
2019-03-23,Perak,98,12,86,2019
2019-03-24,Perak,148,36,112,2019
2019-03-25,Perak,94,30,64,2019
2019-03-26,Perak,71,10,61,2019
2019-03-27,Perak,159,65,94,2019
2019-03-28,Perak,86,47,39,2019
2019-03-29,Perak,100,49,51,2019
2019-03-30,Perak,160,41,119,2019
2019-03-31,Perak,125,30,95,2019
2019-04-01,Perak,17,1,16,2019
2019-04-02,Perak,41,6,35,2019
2019-04-03,Perak,67,16,51,2019
2019-04-04,Perak,31,4,27,2019
2019-04-05,Perak,62,18,44,2019
2019-04-06,Perak,90,19,71,2019
2019-04-07,Perak,164,27,137,2019
2019-04-08,Perak,72,5,67,2019
2019-04-09,Perak,237,70,167,2019
2019-04-10,Perak,65,10,55,2019
2019-04-11,Perak,180,82,98,2019
2019-04-12,Perak,64,19,45,2019
2019-04-13,Perak,73,18,55,2019
2019-04-14,Perak,301,56,245,2019
2019-04-15,Perak,108,14,94,2019
2019-04-16,Perak,126,34,92,2019
2019-04-17,Perak,96,24,72,2019
2019-04-18,Perak,97,26,71,2019
2019-04-19,Perak,36,14,22,2019
2019-04-20,Perak,97,26,71,2019
2019-04-21,Perak,292,57,235,2019
2019-04-22,Perak,58,9,49,2019
2019-04-23,Perak,74,11,63,2019
2019-04-24,Perak,121,40,81,2019
2019-04-25,Perak,50,21,29,2019
2019-04-26,Perak,13,2,11,2019
2019-04-27,Perak,106,21,85,2019
2019-04-28,Perak,214,50,164,2019
2019-04-29,Perak,97,25,72,2019
2019-04-30,Perak,18,1,17,2019
2019-05-01,Perak,147,27,120,2019
2019-05-02,Perak,85,19,66,2019
2019-05-03,Perak,59,9,50,2019
2019-05-04,Perak,68,19,49,2019
2019-05-05,Perak,115,21,94,2019
2019-05-06,Perak,10,0,10,2019
2019-05-07,Perak,46,22,24,2019
2019-05-08,Perak,52,17,35,2019
2019-05-09,Perak,61,28,33,2019
2019-05-10,Perak,13,0,13,2019
2019-05-11,Perak,75,15,60,2019
2019-05-12,Perak,197,37,160,2019
2019-05-13,Perak,20,5,15,2019
2019-05-14,Perak,40,10,30,2019
2019-05-15,Perak,27,6,21,2019
2019-05-16,Perak,47,14,33,2019
2019-05-17,Perak,14,2,12,2019
2019-05-18,Perak,42,9,33,2019
2019-05-19,Perak,190,39,151,2019
2019-05-20,Perak,25,5,20,2019
2019-05-21,Perak,30,9,21,2019
2019-05-22,Perak,19,3,16,2019
2019-05-23,Perak,135,77,58,2019
2019-05-24,Perak,16,3,13,2019
2019-05-25,Perak,61,20,41,2019
2019-05-26,Perak,169,43,126,2019
2019-05-27,Perak,26,6,20,2019
2019-05-28,Perak,36,7,29,2019
2019-05-29,Perak,15,2,13,2019
2019-05-30,Perak,42,17,25,2019
2019-05-31,Perak,7,1,6,2019
2019-06-01,Perak,103,23,80,2019
2019-06-02,Perak,154,27,127,2019
2019-06-03,Perak,36,7,29,2019
2019-06-04,Perak,24,2,22,2019
2019-06-05,Perak,0,0,0,2019
2019-06-06,Perak,0,0,0,2019
2019-06-07,Perak,32,8,24,2019
2019-06-08,Perak,74,18,56,2019
2019-06-09,Perak,37,18,19,2019
2019-06-10,Perak,31,4,27,2019
2019-06-11,Perak,250,45,205,2019
2019-06-12,Perak,343,107,236,2019
2019-06-13,Perak,278,56,222,2019
2019-06-14,Perak,349,101,248,2019
2019-06-15,Perak,30,5,25,2019
2019-06-16,Perak,135,38,97,2019
2019-06-17,Perak,34,5,29,2019
2019-06-18,Perak,114,28,86,2019
2019-06-19,Perak,122,58,64,2019
2019-06-20,Perak,74,16,58,2019
2019-06-21,Perak,19,1,18,2019
2019-06-22,Perak,117,33,84,2019
2019-06-23,Perak,203,34,169,2019
2019-06-24,Perak,28,0,28,2019
2019-06-25,Perak,28,12,16,2019
2019-06-26,Perak,113,31,82,2019
2019-06-27,Perak,27,1,26,2019
2019-06-28,Perak,25,2,23,2019
2019-06-29,Perak,91,17,74,2019
2019-06-30,Perak,91,28,63,2019
2019-07-01,Perak,64,11,53,2019
2019-07-02,Perak,11,0,11,2019
2019-07-03,Perak,178,111,67,2019
2019-07-04,Perak,22,4,18,2019
2019-07-05,Perak,72,32,40,2019
2019-07-06,Perak,173,107,66,2019
2019-07-07,Perak,233,68,165,2019
2019-07-08,Perak,79,11,68,2019
2019-07-09,Perak,20,3,17,2019
2019-07-10,Perak,254,157,97,2019
2019-07-11,Perak,93,23,70,2019
2019-07-12,Perak,154,49,105,2019
2019-07-13,Perak,106,35,71,2019
2019-07-14,Perak,197,48,149,2019
2019-07-15,Perak,68,17,51,2019
2019-07-16,Perak,184,86,98,2019
2019-07-17,Perak,104,52,52,2019
2019-07-18,Perak,175,76,99,2019
2019-07-19,Perak,94,32,62,2019
2019-07-20,Perak,153,46,107,2019
2019-07-21,Perak,346,87,259,2019
2019-07-22,Perak,161,82,79,2019
2019-07-23,Perak,173,102,71,2019
2019-07-24,Perak,203,105,98,2019
2019-07-25,Perak,187,106,81,2019
2019-07-26,Perak,33,13,20,2019
2019-07-27,Perak,121,40,81,2019
2019-07-28,Perak,625,106,519,2019
2019-07-29,Perak,66,14,52,2019
2019-07-30,Perak,183,45,138,2019
2019-07-31,Perak,27,1,26,2019
2019-08-01,Perak,252,112,140,2019
2019-08-02,Perak,34,3,31,2019
2019-08-03,Perak,231,44,187,2019
2019-08-04,Perak,130,24,106,2019
2019-08-05,Perak,72,6,66,2019
2019-08-06,Perak,68,30,38,2019
2019-08-07,Perak,216,71,145,2019
2019-08-08,Perak,70,12,58,2019
2019-08-09,Perak,97,56,41,2019
2019-08-10,Perak,63,11,52,2019
2019-08-11,Perak,0,0,0,2019
2019-08-12,Perak,72,11,61,2019
2019-08-13,Perak,23,2,21,2019
2019-08-14,Perak,86,52,34,2019
2019-08-15,Perak,270,192,78,2019
2019-08-16,Perak,73,41,32,2019
2019-08-17,Perak,86,14,72,2019
2019-08-18,Perak,220,51,169,2019
2019-08-19,Perak,31,2,29,2019
2019-08-20,Perak,63,15,48,2019
2019-08-21,Perak,50,13,37,2019
2019-08-22,Perak,87,21,66,2019
2019-08-23,Perak,100,20,80,2019
2019-08-24,Perak,385,84,301,2019
2019-08-25,Perak,581,134,447,2019
2019-08-26,Perak,26,3,23,2019
2019-08-27,Perak,84,12,72,2019
2019-08-28,Perak,84,22,62,2019
2019-08-29,Perak,106,27,79,2019
2019-08-30,Perak,28,3,25,2019
2019-08-31,Perak,370,87,283,2019
2019-09-01,Perak,247,53,194,2019
2019-09-02,Perak,57,10,47,2019
2019-09-03,Perak,24,3,21,2019
2019-09-04,Perak,130,15,115,2019
2019-09-05,Perak,91,28,63,2019
2019-09-06,Perak,36,1,35,2019
2019-09-07,Perak,58,15,43,2019
2019-09-08,Perak,120,24,96,2019
2019-09-09,Perak,114,35,79,2019
2019-09-10,Perak,30,2,28,2019
2019-09-11,Perak,176,106,70,2019
2019-09-12,Perak,119,52,67,2019
2019-09-13,Perak,31,5,26,2019
2019-09-14,Perak,52,25,27,2019
2019-09-15,Perak,113,29,84,2019
2019-09-16,Perak,168,34,134,2019
2019-09-17,Perak,39,4,35,2019
2019-09-18,Perak,37,6,31,2019
2019-09-19,Perak,241,58,183,2019
2019-09-20,Perak,58,24,34,2019
2019-09-21,Perak,100,22,78,2019
2019-09-22,Perak,285,59,226,2019
2019-09-23,Perak,143,60,83,2019
2019-09-24,Perak,88,35,53,2019
2019-09-25,Perak,29,3,26,2019
2019-09-26,Perak,92,13,79,2019
2019-09-27,Perak,92,21,71,2019
2019-09-28,Perak,102,38,64,2019
2019-09-29,Perak,216,64,152,2019
2019-09-30,Perak,33,0,33,2019
2019-10-01,Perak,28,5,23,2019
2019-10-02,Perak,127,41,86,2019
2019-10-03,Perak,207,72,135,2019
2019-10-04,Perak,42,6,36,2019
2019-10-05,Perak,152,37,115,2019
2019-10-06,Perak,200,37,163,2019
2019-10-07,Perak,22,3,19,2019
2019-10-08,Perak,61,18,43,2019
2019-10-09,Perak,28,3,25,2019
2019-10-10,Perak,132,45,87,2019
2019-10-11,Perak,48,10,38,2019
2019-10-12,Perak,130,29,101,2019
2019-10-13,Perak,139,39,100,2019
2019-10-14,Perak,30,6,24,2019
2019-10-15,Perak,56,11,45,2019
2019-10-16,Perak,69,25,44,2019
2019-10-17,Perak,200,62,138,2019
2019-10-18,Perak,43,9,34,2019
2019-10-19,Perak,125,33,92,2019
2019-10-20,Perak,164,54,110,2019
2019-10-21,Perak,162,17,145,2019
2019-10-22,Perak,181,33,148,2019
2019-10-23,Perak,251,87,164,2019
2019-10-24,Perak,226,68,158,2019
2019-10-25,Perak,263,129,134,2019
2019-10-26,Perak,28,3,25,2019
2019-10-27,Perak,127,7,120,2019
2019-10-28,Perak,64,17,47,2019
2019-10-29,Perak,99,8,91,2019
2019-10-30,Perak,42,15,27,2019
2019-10-31,Perak,92,45,47,2019
2019-11-01,Perak,90,13,77,2019
2019-11-02,Perak,86,21,65,2019
2019-11-03,Perak,130,22,108,2019
2019-11-04,Perak,63,16,47,2019
2019-11-05,Perak,93,28,65,2019
2019-11-06,Perak,180,79,101,2019
2019-11-07,Perak,81,27,54,2019
2019-11-08,Perak,40,3,37,2019
2019-11-09,Perak,107,37,70,2019
2019-11-10,Perak,399,49,350,2019
2019-11-11,Perak,31,3,28,2019
2019-11-12,Perak,55,21,34,2019
2019-11-13,Perak,80,40,40,2019
2019-11-14,Perak,176,46,130,2019
2019-11-15,Perak,26,3,23,2019
2019-11-16,Perak,25,9,16,2019
2019-11-17,Perak,308,49,259,2019
2019-11-18,Perak,26,2,24,2019
2019-11-19,Perak,68,25,43,2019
2019-11-20,Perak,107,16,91,2019
2019-11-21,Perak,146,47,99,2019
2019-11-22,Perak,43,4,39,2019
2019-11-23,Perak,183,45,138,2019
2019-11-24,Perak,160,30,130,2019
2019-11-25,Perak,54,16,38,2019
2019-11-26,Perak,102,30,72,2019
2019-11-27,Perak,67,24,43,2019
2019-11-28,Perak,32,6,26,2019
2019-11-29,Perak,82,20,62,2019
2019-11-30,Perak,141,47,94,2019
2019-12-01,Perak,197,33,164,2019
2019-12-02,Perak,63,26,37,2019
2019-12-03,Perak,121,29,92,2019
2019-12-04,Perak,114,26,88,2019
2019-12-05,Perak,56,26,30,2019
2019-12-06,Perak,27,1,26,2019
2019-12-07,Perak,166,31,135,2019
2019-12-08,Perak,75,10,65,2019
2019-12-09,Perak,25,3,22,2019
2019-12-10,Perak,97,14,83,2019
2019-12-11,Perak,201,56,145,2019
2019-12-12,Perak,176,56,120,2019
2019-12-13,Perak,138,50,88,2019
2019-12-14,Perak,92,30,62,2019
2019-12-15,Perak,245,34,211,2019
2019-12-16,Perak,96,16,80,2019
2019-12-17,Perak,125,45,80,2019
2019-12-18,Perak,114,45,69,2019
2019-12-19,Perak,64,17,47,2019
2019-12-20,Perak,36,2,34,2019
2019-12-21,Perak,50,9,41,2019
2019-12-22,Perak,140,41,99,2019
2019-12-23,Perak,37,3,34,2019
2019-12-24,Perak,68,11,57,2019
2019-12-25,Perak,182,28,154,2019
2019-12-26,Perak,65,10,55,2019
2019-12-27,Perak,69,13,56,2019
2019-12-28,Perak,89,20,69,2019
2019-12-29,Perak,137,24,113,2019
2019-12-30,Perak,66,3,63,2019
2019-12-31,Perak,76,13,63,2019
2020-01-01,Perak,155,59,96,2020
2020-01-02,Perak,52,15,37,2020
2020-01-03,Perak,48,8,40,2020
2020-01-04,Perak,130,28,102,2020
2020-01-05,Perak,193,41,152,2020
2020-01-06,Perak,37,8,29,2020
2020-01-07,Perak,28,1,27,2020
2020-01-08,Perak,74,30,44,2020
2020-01-09,Perak,44,10,34,2020
2020-01-10,Perak,22,0,22,2020
2020-01-11,Perak,70,18,52,2020
2020-01-12,Perak,240,48,192,2020
2020-01-13,Perak,34,3,31,2020
2020-01-14,Perak,84,36,48,2020
2020-01-15,Perak,109,25,84,2020
2020-01-16,Perak,136,39,97,2020
2020-01-17,Perak,48,5,43,2020
2020-01-18,Perak,175,34,141,2020
2020-01-19,Perak,151,36,115,2020
2020-01-20,Perak,256,43,213,2020
2020-01-21,Perak,338,88,250,2020
2020-01-22,Perak,311,118,193,2020
2020-01-23,Perak,66,25,41,2020
2020-01-24,Perak,57,12,45,2020
2020-01-25,Perak,87,23,64,2020
2020-01-26,Perak,138,43,95,2020
2020-01-27,Perak,77,15,62,2020
2020-01-28,Perak,52,13,39,2020
2020-01-29,Perak,142,18,124,2020
2020-01-30,Perak,22,2,20,2020
2020-01-31,Perak,23,0,23,2020
2020-02-01,Perak,94,14,80,2020
2020-02-02,Perak,112,41,71,2020
2020-02-03,Perak,66,11,55,2020
2020-02-04,Perak,80,23,57,2020
2020-02-05,Perak,121,43,78,2020
2020-02-06,Perak,131,38,93,2020
2020-02-07,Perak,47,4,43,2020
2020-02-08,Perak,244,47,197,2020
2020-02-09,Perak,184,40,144,2020
2020-02-10,Perak,47,12,35,2020
2020-02-11,Perak,88,13,75,2020
2020-02-12,Perak,215,79,136,2020
2020-02-13,Perak,184,74,110,2020
2020-02-14,Perak,54,8,46,2020
2020-02-15,Perak,75,15,60,2020
2020-02-16,Perak,209,64,145,2020
2020-02-17,Perak,145,46,99,2020
2020-02-18,Perak,72,15,57,2020
2020-02-19,Perak,113,19,94,2020
2020-02-20,Perak,216,73,143,2020
2020-02-21,Perak,51,8,43,2020
2020-02-22,Perak,119,20,99,2020
2020-02-23,Perak,254,31,223,2020
2020-02-24,Perak,103,42,61,2020
2020-02-25,Perak,75,14,61,2020
2020-02-26,Perak,182,33,149,2020
2020-02-27,Perak,56,2,54,2020
2020-02-28,Perak,33,3,30,2020
2020-02-29,Perak,104,20,84,2020
2020-03-01,Perak,135,15,120,2020
2020-03-02,Perak,95,29,66,2020
2020-03-03,Perak,182,79,103,2020
2020-03-04,Perak,213,110,103,2020
2020-03-05,Perak,97,12,85,2020
2020-03-06,Perak,60,26,34,2020
2020-03-07,Perak,92,21,71,2020
2020-03-08,Perak,170,27,143,2020
2020-03-09,Perak,50,11,39,2020
2020-03-10,Perak,141,34,107,2020
2020-03-11,Perak,41,10,31,2020
2020-03-12,Perak,225,121,104,2020
2020-03-13,Perak,62,11,51,2020
2020-03-14,Perak,134,30,104,2020
2020-03-15,Perak,94,21,73,2020
2020-03-16,Perak,58,16,42,2020
2020-03-17,Perak,55,15,40,2020
2020-03-18,Perak,39,11,28,2020
2020-03-19,Perak,24,4,20,2020
2020-03-20,Perak,145,39,106,2020
2020-03-21,Perak,38,10,28,2020
2020-03-22,Perak,28,5,23,2020
2020-03-23,Perak,65,10,55,2020
2020-03-24,Perak,81,5,76,2020
2020-03-25,Perak,86,10,76,2020
2020-03-26,Perak,105,20,85,2020
2020-03-27,Perak,75,10,65,2020
2020-03-28,Perak,65,11,54,2020
2020-03-29,Perak,58,13,45,2020
2020-03-30,Perak,78,13,65,2020
2020-03-31,Perak,89,17,72,2020
2020-04-01,Perak,82,18,64,2020
2020-04-02,Perak,61,12,49,2020
2020-04-03,Perak,64,7,57,2020
2020-04-04,Perak,40,5,35,2020
2020-04-05,Perak,45,10,35,2020
2020-04-06,Perak,59,8,51,2020
2020-04-07,Perak,78,14,64,2020
2020-04-08,Perak,52,8,44,2020
2020-04-09,Perak,45,6,39,2020
2020-04-10,Perak,116,25,91,2020
2020-04-11,Perak,38,8,30,2020
2020-04-12,Perak,32,6,26,2020
2020-04-13,Perak,87,12,75,2020
2020-04-14,Perak,75,13,62,2020
2020-04-15,Perak,112,25,87,2020
2020-04-16,Perak,140,46,94,2020
2020-04-17,Perak,119,29,90,2020
2020-04-18,Perak,58,11,47,2020
2020-04-19,Perak,36,10,26,2020
2020-04-20,Perak,86,12,74,2020
2020-04-21,Perak,198,72,126,2020
2020-04-22,Perak,175,49,126,2020
2020-04-23,Perak,103,16,87,2020
2020-04-24,Perak,30,0,30,2020
2020-04-25,Perak,48,7,41,2020
2020-04-26,Perak,96,17,79,2020
2020-04-27,Perak,60,5,55,2020
2020-04-28,Perak,101,16,85,2020
2020-04-29,Perak,77,6,71,2020
2020-04-30,Perak,98,15,83,2020
2020-05-01,Perak,98,14,84,2020
2020-05-02,Perak,62,11,51,2020
2020-05-03,Perak,183,47,136,2020
2020-05-04,Perak,71,9,62,2020
2020-05-05,Perak,62,13,49,2020
2020-05-06,Perak,70,15,55,2020
2020-05-07,Perak,68,15,53,2020
2020-05-08,Perak,69,19,50,2020
2020-05-09,Perak,48,8,40,2020
2020-05-10,Perak,165,22,143,2020
2020-05-11,Perak,40,9,31,2020
2020-05-12,Perak,85,16,69,2020
2020-05-13,Perak,167,69,98,2020
2020-05-14,Perak,141,57,84,2020
2020-05-15,Perak,68,12,56,2020
2020-05-16,Perak,74,11,63,2020
2020-05-17,Perak,187,59,128,2020
2020-05-18,Perak,47,5,42,2020
2020-05-19,Perak,111,21,90,2020
2020-05-20,Perak,242,51,191,2020
2020-05-21,Perak,157,44,113,2020
2020-05-22,Perak,99,15,84,2020
2020-05-23,Perak,0,0,0,2020
2020-05-24,Perak,0,0,0,2020
2020-05-25,Perak,101,11,90,2020
2020-05-26,Perak,139,34,105,2020
2020-05-27,Perak,134,15,119,2020
2020-05-28,Perak,83,13,70,2020
2020-05-29,Perak,132,28,104,2020
2020-05-30,Perak,187,47,140,2020
2020-05-31,Perak,172,29,143,2020
2020-06-01,Perak,139,23,116,2020
2020-06-02,Perak,127,27,100,2020
2020-06-03,Perak,226,57,169,2020
2020-06-04,Perak,101,24,77,2020
2020-06-05,Perak,138,47,91,2020
2020-06-06,Perak,363,83,280,2020
2020-06-07,Perak,295,70,225,2020
2020-06-08,Perak,152,38,114,2020
2020-06-09,Perak,121,24,97,2020
2020-06-10,Perak,103,29,74,2020
2020-06-11,Perak,96,18,78,2020
2020-06-12,Perak,61,6,55,2020
2020-06-13,Perak,128,39,89,2020
2020-06-14,Perak,246,43,203,2020
2020-06-15,Perak,66,19,47,2020
2020-06-16,Perak,75,6,69,2020
2020-06-17,Perak,133,41,92,2020
2020-06-18,Perak,112,38,74,2020
2020-06-19,Perak,74,17,57,2020
2020-06-20,Perak,70,28,42,2020
2020-06-21,Perak,216,55,161,2020
2020-06-22,Perak,61,10,51,2020
2020-06-23,Perak,50,12,38,2020
2020-06-24,Perak,98,18,80,2020
2020-06-25,Perak,97,20,77,2020
2020-06-26,Perak,30,6,24,2020
2020-06-27,Perak,131,18,113,2020
2020-06-28,Perak,248,99,149,2020
2020-06-29,Perak,77,18,59,2020
2020-06-30,Perak,55,5,50,2020
2020-07-01,Perak,55,11,44,2020
2020-07-02,Perak,71,9,62,2020
2020-07-03,Perak,63,8,55,2020
2020-07-04,Perak,132,27,105,2020
2020-07-05,Perak,168,25,143,2020
2020-07-06,Perak,59,10,49,2020
2020-07-07,Perak,53,4,49,2020
2020-07-08,Perak,75,13,62,2020
2020-07-09,Perak,60,8,52,2020
2020-07-10,Perak,90,35,55,2020
2020-07-11,Perak,141,29,112,2020
2020-07-12,Perak,133,32,101,2020
2020-07-13,Perak,79,22,57,2020
2020-07-14,Perak,85,27,58,2020
2020-07-15,Perak,118,35,83,2020
2020-07-16,Perak,94,10,84,2020
2020-07-17,Perak,49,12,37,2020
2020-07-18,Perak,115,26,89,2020
2020-07-19,Perak,192,44,148,2020
2020-07-20,Perak,49,13,36,2020
2020-07-21,Perak,70,7,63,2020
2020-07-22,Perak,65,17,48,2020
2020-07-23,Perak,68,12,56,2020
2020-07-24,Perak,149,13,136,2020
2020-07-25,Perak,67,18,49,2020
2020-07-26,Perak,183,34,149,2020
2020-07-27,Perak,62,11,51,2020
2020-07-28,Perak,118,25,93,2020
2020-07-29,Perak,192,61,131,2020
2020-07-30,Perak,55,6,49,2020
2020-07-31,Perak,0,0,0,2020
2020-08-01,Perak,63,14,49,2020
2020-08-02,Perak,145,29,116,2020
2020-08-03,Perak,68,7,61,2020
2020-08-04,Perak,86,15,71,2020
2020-08-05,Perak,126,27,99,2020
2020-08-06,Perak,65,16,49,2020
2020-08-07,Perak,83,21,62,2020
2020-08-08,Perak,157,42,115,2020
2020-08-09,Perak,196,63,133,2020
2020-08-10,Perak,76,14,62,2020
2020-08-11,Perak,130,27,103,2020
2020-08-12,Perak,108,39,69,2020
2020-08-13,Perak,154,45,109,2020
2020-08-14,Perak,86,21,65,2020
2020-08-15,Perak,140,25,115,2020
2020-08-16,Perak,293,45,248,2020
2020-08-17,Perak,36,5,31,2020
2020-08-18,Perak,88,18,70,2020
2020-08-19,Perak,149,40,109,2020
2020-08-20,Perak,210,45,165,2020
2020-08-21,Perak,62,11,51,2020
2020-08-22,Perak,96,17,79,2020
2020-08-23,Perak,189,34,155,2020
2020-08-24,Perak,44,7,37,2020
2020-08-25,Perak,115,54,61,2020
2020-08-26,Perak,132,32,100,2020
2020-08-27,Perak,120,18,102,2020
2020-08-28,Perak,74,4,70,2020
2020-08-29,Perak,121,21,100,2020
2020-08-30,Perak,79,14,65,2020
2020-08-31,Perak,388,71,317,2020
2020-09-01,Perak,53,6,47,2020
2020-09-02,Perak,53,9,44,2020
2020-09-03,Perak,44,5,39,2020
2020-09-04,Perak,57,7,50,2020
2020-09-05,Perak,79,18,61,2020
2020-09-06,Perak,251,38,213,2020
2020-09-07,Perak,80,11,69,2020
2020-09-08,Perak,112,34,78,2020
2020-09-09,Perak,80,28,52,2020
2020-09-10,Perak,94,18,76,2020
2020-09-11,Perak,83,20,63,2020
2020-09-12,Perak,122,20,102,2020
2020-09-13,Perak,170,37,133,2020
2020-09-14,Perak,110,31,79,2020
2020-09-15,Perak,64,6,58,2020
2020-09-16,Perak,337,83,254,2020
2020-09-17,Perak,75,7,68,2020
2020-09-18,Perak,29,2,27,2020
2020-09-19,Perak,217,49,168,2020
2020-09-20,Perak,222,20,202,2020
2020-09-21,Perak,49,10,39,2020
2020-09-22,Perak,119,40,79,2020
2020-09-23,Perak,51,6,45,2020
2020-09-24,Perak,54,7,47,2020
2020-09-25,Perak,58,7,51,2020
2020-09-26,Perak,149,29,120,2020
2020-09-27,Perak,309,89,220,2020
2020-09-28,Perak,38,6,32,2020
2020-09-29,Perak,81,9,72,2020
2020-09-30,Perak,133,65,68,2020
2020-10-01,Perak,58,11,47,2020
2020-10-02,Perak,152,55,97,2020
2020-10-03,Perak,158,49,109,2020
2020-10-04,Perak,203,39,164,2020
2020-10-05,Perak,50,3,47,2020
2020-10-06,Perak,36,4,32,2020
2020-10-07,Perak,111,25,86,2020
2020-10-08,Perak,50,10,40,2020
2020-10-09,Perak,77,19,58,2020
2020-10-10,Perak,125,30,95,2020
2020-10-11,Perak,61,8,53,2020
2020-10-12,Perak,48,4,44,2020
2020-10-13,Perak,51,12,39,2020
2020-10-14,Perak,132,37,95,2020
2020-10-15,Perak,180,67,113,2020
2020-10-16,Perak,195,57,138,2020
2020-10-17,Perak,199,35,164,2020
2020-10-18,Perak,236,40,196,2020
2020-10-19,Perak,75,7,68,2020
2020-10-20,Perak,83,16,67,2020
2020-10-21,Perak,135,16,119,2020
2020-10-22,Perak,37,3,34,2020
2020-10-23,Perak,69,10,59,2020
2020-10-24,Perak,223,38,185,2020
2020-10-25,Perak,329,60,269,2020
2020-10-26,Perak,58,12,46,2020
2020-10-27,Perak,61,13,48,2020
2020-10-28,Perak,130,39,91,2020
2020-10-29,Perak,181,43,138,2020
2020-10-30,Perak,89,11,78,2020
2020-10-31,Perak,139,33,106,2020
2020-11-01,Perak,198,32,166,2020
2020-11-02,Perak,87,14,73,2020
2020-11-03,Perak,51,4,47,2020
2020-11-04,Perak,104,15,89,2020
2020-11-05,Perak,90,15,75,2020
2020-11-06,Perak,121,19,102,2020
2020-11-07,Perak,102,17,85,2020
2020-11-08,Perak,110,24,86,2020
2020-11-09,Perak,30,1,29,2020
2020-11-10,Perak,66,11,55,2020
2020-11-11,Perak,78,15,63,2020
2020-11-12,Perak,79,10,69,2020
2020-11-13,Perak,102,10,92,2020
2020-11-14,Perak,270,59,211,2020
2020-11-15,Perak,335,59,276,2020
2020-11-16,Perak,52,5,47,2020
2020-11-17,Perak,188,50,138,2020
2020-11-18,Perak,40,4,36,2020
2020-11-19,Perak,60,5,55,2020
2020-11-20,Perak,113,25,88,2020
2020-11-21,Perak,134,69,65,2020
2020-11-22,Perak,153,20,133,2020
2020-11-23,Perak,39,3,36,2020
2020-11-24,Perak,62,11,51,2020
2020-11-25,Perak,80,19,61,2020
2020-11-26,Perak,55,10,45,2020
2020-11-27,Perak,66,9,57,2020
2020-11-28,Perak,83,13,70,2020
2020-11-29,Perak,243,67,176,2020
2020-11-30,Perak,64,11,53,2020
2020-12-01,Perak,77,13,64,2020
2020-12-02,Perak,106,22,84,2020
2020-12-03,Perak,86,12,74,2020
2020-12-04,Perak,89,19,70,2020
2020-12-05,Perak,169,33,136,2020
2020-12-06,Perak,229,31,198,2020
2020-12-07,Perak,41,3,38,2020
2020-12-08,Perak,40,3,37,2020
2020-12-09,Perak,132,48,84,2020
2020-12-10,Perak,93,34,59,2020
2020-12-11,Perak,80,13,67,2020
2020-12-12,Perak,139,23,116,2020
2020-12-13,Perak,223,39,184,2020
2020-12-14,Perak,75,11,64,2020
2020-12-15,Perak,99,15,84,2020
2020-12-16,Perak,110,32,78,2020
2020-12-17,Perak,171,69,102,2020
2020-12-18,Perak,98,15,83,2020
2020-12-19,Perak,125,17,108,2020
2020-12-20,Perak,265,38,227,2020
2020-12-21,Perak,97,13,84,2020
2020-12-22,Perak,72,7,65,2020
2020-12-23,Perak,128,21,107,2020
2020-12-24,Perak,94,14,80,2020
2020-12-25,Perak,144,30,114,2020
2020-12-26,Perak,80,4,76,2020
2020-12-27,Perak,214,28,186,2020
2020-12-28,Perak,51,3,48,2020
2020-12-29,Perak,59,9,50,2020
2020-12-30,Perak,141,22,119,2020
2020-12-31,Perak,96,14,82,2020
2021-01-01,Perak,135,16,119,2021
2021-01-02,Perak,53,11,42,2021
2021-01-03,Perak,155,36,119,2021
2021-01-04,Perak,29,3,26,2021
2021-01-05,Perak,51,3,48,2021
2021-01-06,Perak,75,8,67,2021
2021-01-07,Perak,58,5,53,2021
2021-01-08,Perak,75,6,69,2021
2021-01-09,Perak,133,16,117,2021
2021-01-10,Perak,165,22,143,2021
2021-01-11,Perak,39,7,32,2021
2021-01-12,Perak,81,20,61,2021
2021-01-13,Perak,74,6,68,2021
2021-01-14,Perak,110,14,96,2021
2021-01-15,Perak,64,8,56,2021
2021-01-16,Perak,311,100,211,2021
2021-01-17,Perak,387,109,278,2021
2021-01-18,Perak,43,3,40,2021
2021-01-19,Perak,70,9,61,2021
2021-01-20,Perak,43,6,37,2021
2021-01-21,Perak,84,11,73,2021
2021-01-22,Perak,54,1,53,2021
2021-01-23,Perak,59,8,51,2021
2021-01-24,Perak,190,23,167,2021
2021-01-25,Perak,42,5,37,2021
2021-01-26,Perak,87,10,77,2021
2021-01-27,Perak,77,5,72,2021
2021-01-28,Perak,214,34,180,2021
2021-01-29,Perak,146,22,124,2021
2021-01-30,Perak,140,18,122,2021
2021-01-31,Perak,237,50,187,2021
2021-02-01,Perak,46,2,44,2021
2021-02-02,Perak,95,19,76,2021
2021-02-03,Perak,87,20,67,2021
2021-02-04,Perak,105,21,84,2021
2021-02-05,Perak,81,8,73,2021
2021-02-06,Perak,176,46,130,2021
2021-02-07,Perak,151,22,129,2021
2021-02-08,Perak,62,3,59,2021
2021-02-09,Perak,83,12,71,2021
2021-02-10,Perak,135,24,111,2021
2021-02-11,Perak,113,16,97,2021
2021-02-12,Perak,160,22,138,2021
2021-02-13,Perak,239,49,190,2021
2021-02-14,Perak,183,43,140,2021
2021-02-15,Perak,87,4,83,2021
2021-02-16,Perak,92,14,78,2021
2021-02-17,Perak,102,21,81,2021
2021-02-18,Perak,171,42,129,2021
2021-02-19,Perak,90,9,81,2021
2021-02-20,Perak,122,23,99,2021
2021-02-21,Perak,208,35,173,2021
2021-02-22,Perak,73,11,62,2021
2021-02-23,Perak,124,14,110,2021
2021-02-24,Perak,127,33,94,2021
2021-02-25,Perak,91,12,79,2021
2021-02-26,Perak,93,13,80,2021
2021-02-27,Perak,181,28,153,2021
2021-02-28,Perak,345,60,285,2021
2021-03-01,Perak,54,10,44,2021
2021-03-02,Perak,214,55,159,2021
2021-03-03,Perak,87,13,74,2021
2021-03-04,Perak,309,133,176,2021
2021-03-05,Perak,69,9,60,2021
2021-03-06,Perak,239,42,197,2021
2021-03-07,Perak,113,16,97,2021
2021-03-08,Perak,39,3,36,2021
2021-03-09,Perak,82,12,70,2021
2021-03-10,Perak,32,3,29,2021
2021-03-11,Perak,112,28,84,2021
2021-03-12,Perak,53,1,52,2021
2021-03-13,Perak,216,49,167,2021
2021-03-14,Perak,220,33,187,2021
2021-03-15,Perak,50,7,43,2021
2021-03-16,Perak,90,17,73,2021
2021-03-17,Perak,53,8,45,2021
2021-03-18,Perak,147,76,71,2021
2021-03-19,Perak,68,9,59,2021
2021-03-20,Perak,188,32,156,2021
2021-03-21,Perak,201,30,171,2021
2021-03-22,Perak,63,6,57,2021
2021-03-23,Perak,65,8,57,2021
2021-03-24,Perak,61,9,52,2021
2021-03-25,Perak,245,152,93,2021
2021-03-26,Perak,66,11,55,2021
2021-03-27,Perak,166,46,120,2021
2021-03-28,Perak,277,39,238,2021
2021-03-29,Perak,102,32,70,2021
2021-03-30,Perak,116,12,104,2021
2021-03-31,Perak,137,16,121,2021
2021-04-01,Perak,104,26,78,2021
2021-04-02,Perak,84,16,68,2021
2021-04-03,Perak,162,51,111,2021
2021-04-04,Perak,16,7,9,2021
2021-04-05,Perak,47,6,41,2021
2021-04-06,Perak,90,12,78,2021
2021-04-07,Perak,80,12,68,2021
2021-04-08,Perak,111,20,91,2021
2021-04-09,Perak,63,11,52,2021
2021-04-10,Perak,180,27,153,2021
2021-04-11,Perak,339,50,289,2021
2021-04-12,Perak,197,68,129,2021
2021-04-13,Perak,28,5,23,2021
2021-04-14,Perak,63,18,45,2021
2021-04-15,Perak,43,5,38,2021
2021-04-16,Perak,51,6,45,2021
2021-04-17,Perak,65,11,54,2021
2021-04-18,Perak,259,52,207,2021
2021-04-19,Perak,34,2,32,2021
2021-04-20,Perak,52,7,45,2021
2021-04-21,Perak,137,18,119,2021
2021-04-22,Perak,51,6,45,2021
2021-04-23,Perak,74,19,55,2021
2021-04-24,Perak,109,20,89,2021
2021-04-25,Perak,233,32,201,2021
2021-04-26,Perak,75,21,54,2021
2021-04-27,Perak,103,22,81,2021
2021-04-28,Perak,156,49,107,2021
2021-04-29,Perak,134,45,89,2021
2021-04-30,Perak,60,6,54,2021
2021-05-01,Perak,185,35,150,2021
2021-05-02,Perak,135,20,115,2021
2021-05-03,Perak,38,4,34,2021
2021-05-04,Perak,60,6,54,2021
2021-05-05,Perak,157,57,100,2021
2021-05-06,Perak,89,21,68,2021
2021-05-07,Perak,53,11,42,2021
2021-05-08,Perak,136,32,104,2021
2021-05-09,Perak,216,39,177,2021
2021-05-10,Perak,82,7,75,2021
2021-05-11,Perak,114,13,101,2021
2021-05-12,Perak,35,2,33,2021
2021-05-13,Perak,0,0,0,2021
2021-05-14,Perak,106,4,102,2021
2021-05-15,Perak,169,29,140,2021
2021-05-16,Perak,92,13,79,2021
2021-05-17,Perak,128,14,114,2021
2021-05-18,Perak,100,6,94,2021
2021-05-19,Perak,112,15,97,2021
2021-05-20,Perak,122,16,106,2021
2021-05-21,Perak,85,18,67,2021
2021-05-22,Perak,125,20,105,2021
2021-05-23,Perak,205,42,163,2021
2021-05-24,Perak,67,10,57,2021
2021-05-25,Perak,159,38,121,2021
2021-05-26,Perak,159,23,136,2021
2021-05-27,Perak,82,14,68,2021
2021-05-28,Perak,102,9,93,2021
2021-05-29,Perak,124,22,102,2021
2021-05-30,Perak,86,11,75,2021
2021-05-31,Perak,83,11,72,2021
2021-06-01,Perak,79,8,71,2021
2021-06-02,Perak,105,14,91,2021
2021-06-03,Perak,136,18,118,2021
2021-06-04,Perak,112,9,103,2021
2021-06-05,Perak,175,26,149,2021
2021-06-06,Perak,137,27,110,2021
2021-06-07,Perak,154,29,125,2021
2021-06-08,Perak,66,5,61,2021
2021-06-09,Perak,231,81,150,2021
2021-06-10,Perak,123,27,96,2021
2021-06-11,Perak,90,14,76,2021
2021-06-12,Perak,131,24,107,2021
2021-06-13,Perak,174,25,149,2021
2021-06-14,Perak,222,32,190,2021
2021-06-15,Perak,84,8,76,2021
2021-06-16,Perak,135,20,115,2021
2021-06-17,Perak,177,29,148,2021
2021-06-18,Perak,132,14,118,2021
2021-06-19,Perak,148,28,120,2021
2021-06-20,Perak,261,42,219,2021
2021-06-21,Perak,63,8,55,2021
2021-06-22,Perak,68,10,58,2021
2021-06-23,Perak,102,17,85,2021
2021-06-24,Perak,159,31,128,2021
2021-06-25,Perak,106,15,91,2021
2021-06-26,Perak,121,15,106,2021
2021-06-27,Perak,129,30,99,2021
2021-06-28,Perak,47,3,44,2021
2021-06-29,Perak,50,5,45,2021
2021-06-30,Perak,109,15,94,2021
2021-07-01,Perak,111,20,91,2021
2021-07-02,Perak,60,6,54,2021
2021-07-03,Perak,159,27,132,2021
2021-07-04,Perak,205,25,180,2021
2021-07-05,Perak,59,9,50,2021
2021-07-06,Perak,83,10,73,2021
2021-07-07,Perak,108,20,88,2021
2021-07-08,Perak,190,52,138,2021
2021-07-09,Perak,66,9,57,2021
2021-07-10,Perak,151,27,124,2021
2021-07-11,Perak,143,14,129,2021
2021-07-12,Perak,52,5,47,2021
2021-07-13,Perak,78,11,67,2021
2021-07-14,Perak,78,3,75,2021
2021-07-15,Perak,107,12,95,2021
2021-07-16,Perak,90,7,83,2021
2021-07-17,Perak,145,25,120,2021
2021-07-18,Perak,177,34,143,2021
2021-07-19,Perak,47,10,37,2021
2021-07-20,Perak,0,0,0,2021
2021-07-21,Perak,82,16,66,2021
2021-07-22,Perak,99,15,84,2021
2021-07-23,Perak,238,64,174,2021
2021-07-24,Perak,167,25,142,2021
2021-07-25,Perak,214,23,191,2021
2021-07-26,Perak,46,4,42,2021
2021-07-27,Perak,80,16,64,2021
2021-07-28,Perak,47,10,37,2021
2021-07-29,Perak,83,15,68,2021
2021-07-30,Perak,64,9,55,2021
2021-07-31,Perak,100,17,83,2021
2021-08-01,Perak,119,29,90,2021
2021-08-02,Perak,66,3,63,2021
2021-08-03,Perak,94,13,81,2021
2021-08-04,Perak,72,9,63,2021
2021-08-05,Perak,71,13,58,2021
2021-08-06,Perak,127,25,102,2021
2021-08-07,Perak,195,44,151,2021
2021-08-08,Perak,149,30,119,2021
2021-08-09,Perak,50,7,43,2021
2021-08-10,Perak,122,29,93,2021
2021-08-11,Perak,58,9,49,2021
2021-08-12,Perak,132,35,97,2021
2021-08-13,Perak,82,14,68,2021
2021-08-14,Perak,143,34,109,2021
2021-08-15,Perak,130,26,104,2021
2021-08-16,Perak,90,23,67,2021
2021-08-17,Perak,75,9,66,2021
2021-08-18,Perak,52,6,46,2021
2021-08-19,Perak,79,9,70,2021
2021-08-20,Perak,68,7,61,2021
2021-08-21,Perak,110,18,92,2021
2021-08-22,Perak,154,31,123,2021
2021-08-23,Perak,34,4,30,2021
2021-08-24,Perak,47,6,41,2021
2021-08-25,Perak,104,18,86,2021
2021-08-26,Perak,136,30,106,2021
2021-08-27,Perak,156,35,121,2021
2021-08-28,Perak,245,55,190,2021
2021-08-29,Perak,341,95,246,2021
2021-08-30,Perak,117,25,92,2021
2021-08-31,Perak,354,73,281,2021
2021-09-01,Perak,95,20,75,2021
2021-09-02,Perak,188,70,118,2021
2021-09-03,Perak,103,24,79,2021
2021-09-04,Perak,120,22,98,2021
2021-09-05,Perak,183,30,153,2021
2021-09-06,Perak,81,16,65,2021
2021-09-07,Perak,75,15,60,2021
2021-09-08,Perak,90,17,73,2021
2021-09-09,Perak,67,7,60,2021
2021-09-10,Perak,109,22,87,2021
2021-09-11,Perak,233,74,159,2021
2021-09-12,Perak,158,34,124,2021
2021-09-13,Perak,56,6,50,2021
2021-09-14,Perak,67,9,58,2021
2021-09-15,Perak,229,49,180,2021
2021-09-16,Perak,298,49,249,2021
2021-09-17,Perak,88,17,71,2021
2021-09-18,Perak,111,30,81,2021
2021-09-19,Perak,155,41,114,2021
2021-09-20,Perak,58,7,51,2021
2021-09-21,Perak,74,15,59,2021
2021-09-22,Perak,84,18,66,2021
2021-09-23,Perak,100,32,68,2021
2021-09-24,Perak,66,13,53,2021
2021-09-25,Perak,161,26,135,2021
2021-09-26,Perak,183,24,159,2021
2021-09-27,Perak,41,4,37,2021
2021-09-28,Perak,123,17,106,2021
2021-09-29,Perak,269,115,154,2021
2021-09-30,Perak,84,10,74,2021
2021-10-01,Perak,33,1,32,2021
2021-10-02,Perak,193,43,150,2021
2021-10-03,Perak,268,58,210,2021
2021-10-04,Perak,53,7,46,2021
2021-10-05,Perak,101,21,80,2021
2021-10-06,Perak,53,4,49,2021
2021-10-07,Perak,87,21,66,2021
2021-10-08,Perak,60,9,51,2021
2021-10-09,Perak,103,10,93,2021
2021-10-10,Perak,220,28,192,2021
2021-10-11,Perak,57,22,35,2021
2021-10-12,Perak,94,22,72,2021
2021-10-13,Perak,75,10,65,2021
2021-10-14,Perak,76,10,66,2021
2021-10-15,Perak,56,5,51,2021
2021-10-16,Perak,125,29,96,2021
2021-10-17,Perak,167,30,137,2021
2021-10-18,Perak,65,6,59,2021
2021-10-19,Perak,136,15,121,2021
2021-10-20,Perak,51,6,45,2021
2021-10-21,Perak,129,20,109,2021
2021-10-22,Perak,74,17,57,2021
2021-10-23,Perak,158,31,127,2021
2021-10-24,Perak,211,29,182,2021
2021-10-25,Perak,69,8,61,2021
2021-10-26,Perak,71,13,58,2021
2021-10-27,Perak,89,9,80,2021
2021-10-28,Perak,80,7,73,2021
2021-10-29,Perak,94,18,76,2021
2021-10-30,Perak,59,9,50,2021
2021-10-31,Perak,185,27,158,2021
2021-11-01,Perak,85,31,54,2021
2021-11-02,Perak,77,12,65,2021
2021-11-03,Perak,82,11,71,2021
2021-11-04,Perak,131,28,103,2021
2021-11-05,Perak,76,19,57,2021
2021-11-06,Perak,87,11,76,2021
2021-11-07,Perak,161,23,138,2021
2021-11-08,Perak,47,6,41,2021
2021-11-09,Perak,62,10,52,2021
2021-11-10,Perak,74,12,62,2021
2021-11-11,Perak,85,12,73,2021
2021-11-12,Perak,102,9,93,2021
2021-11-13,Perak,248,88,160,2021
2021-11-14,Perak,229,22,207,2021
2021-11-15,Perak,75,11,64,2021
2021-11-16,Perak,116,44,72,2021
2021-11-17,Perak,83,13,70,2021
2021-11-18,Perak,91,8,83,2021
2021-11-19,Perak,104,14,90,2021
2021-11-20,Perak,178,42,136,2021
2021-11-21,Perak,187,38,149,2021
2021-11-22,Perak,70,7,63,2021
2021-11-23,Perak,80,10,70,2021
2021-11-24,Perak,189,59,130,2021
2021-11-25,Perak,123,19,104,2021
2021-11-26,Perak,109,14,95,2021
2021-11-27,Perak,87,15,72,2021
2021-11-28,Perak,300,39,261,2021
2021-11-29,Perak,45,2,43,2021
2021-11-30,Perak,150,42,108,2021
2021-12-01,Perak,169,93,76,2021
2021-12-02,Perak,140,89,51,2021
2021-12-03,Perak,123,27,96,2021
2021-12-04,Perak,173,31,142,2021
2021-12-05,Perak,268,35,233,2021
2021-12-06,Perak,44,1,43,2021
2021-12-07,Perak,134,31,103,2021
2021-12-08,Perak,76,26,50,2021
2021-12-09,Perak,125,35,90,2021
2021-12-10,Perak,63,6,57,2021
2021-12-11,Perak,129,13,116,2021
2021-12-12,Perak,224,28,196,2021
2021-12-13,Perak,59,2,57,2021
2021-12-14,Perak,57,9,48,2021
2021-12-15,Perak,176,57,119,2021
2021-12-16,Perak,158,24,134,2021
2021-12-17,Perak,68,7,61,2021
2021-12-18,Perak,130,18,112,2021
2021-12-19,Perak,340,41,299,2021
2021-12-20,Perak,32,5,27,2021
2021-12-21,Perak,89,8,81,2021
2021-12-22,Perak,87,9,78,2021
2021-12-23,Perak,124,16,108,2021
2021-12-24,Perak,95,34,61,2021
2021-12-25,Perak,277,38,239,2021
2021-12-26,Perak,222,41,181,2021
2021-12-27,Perak,67,3,64,2021
2021-12-28,Perak,81,14,67,2021
2021-12-29,Perak,92,21,71,2021
2021-12-30,Perak,73,13,60,2021
2021-12-31,Perak,112,23,89,2021
2022-01-01,Perak,277,24,253,2022
2022-01-02,Perak,158,28,130,2022
2022-01-03,Perak,55,5,50,2022
2022-01-04,Perak,72,8,64,2022
2022-01-05,Perak,144,22,122,2022
2022-01-06,Perak,82,11,71,2022
2022-01-07,Perak,76,7,69,2022
2022-01-08,Perak,110,20,90,2022
2022-01-09,Perak,131,29,102,2022
2022-01-10,Perak,53,7,46,2022
2022-01-11,Perak,112,24,88,2022
2022-01-12,Perak,138,33,105,2022
2022-01-13,Perak,135,46,89,2022
2022-01-14,Perak,76,24,52,2022
2022-01-15,Perak,235,95,140,2022
2022-01-16,Perak,151,26,125,2022
2022-01-17,Perak,61,3,58,2022
2022-01-18,Perak,224,33,191,2022
2022-01-19,Perak,66,11,55,2022
2022-01-20,Perak,87,20,67,2022
2022-01-21,Perak,66,27,39,2022
2022-01-22,Perak,155,37,118,2022
2022-01-23,Perak,160,15,145,2022
2022-01-24,Perak,79,19,60,2022
2022-01-25,Perak,112,16,96,2022
2022-01-26,Perak,131,34,97,2022
2022-01-27,Perak,126,26,100,2022
2022-01-28,Perak,84,5,79,2022
2022-01-29,Perak,159,42,117,2022
2022-01-30,Perak,171,38,133,2022
2022-01-31,Perak,103,14,89,2022
2022-02-01,Perak,124,26,98,2022
2022-02-02,Perak,108,25,83,2022
2022-02-03,Perak,76,11,65,2022
2022-02-04,Perak,115,13,102,2022
2022-02-05,Perak,170,24,146,2022
2022-02-06,Perak,164,19,145,2022
2022-02-07,Perak,52,9,43,2022
2022-02-08,Perak,123,36,87,2022
2022-02-09,Perak,73,15,58,2022
2022-02-10,Perak,69,10,59,2022
2022-02-11,Perak,70,12,58,2022
2022-02-12,Perak,129,20,109,2022
2022-02-13,Perak,217,40,177,2022
2022-02-14,Perak,45,5,40,2022
2022-02-15,Perak,96,20,76,2022
2022-02-16,Perak,79,12,67,2022
2022-02-17,Perak,69,11,58,2022
2022-02-18,Perak,132,27,105,2022
2022-02-19,Perak,209,54,155,2022
2022-02-20,Perak,289,53,236,2022
2022-02-21,Perak,54,5,49,2022
2022-02-22,Perak,97,23,74,2022
2022-02-23,Perak,78,18,60,2022
2022-02-24,Perak,119,29,90,2022
2022-02-25,Perak,64,10,54,2022
2022-02-26,Perak,153,21,132,2022
2022-02-27,Perak,244,44,200,2022
2022-02-28,Perak,91,10,81,2022
2022-03-01,Perak,115,17,98,2022
2022-03-02,Perak,120,26,94,2022
2022-03-03,Perak,81,20,61,2022
2022-03-04,Perak,80,7,73,2022
2022-03-05,Perak,128,17,111,2022
2022-03-06,Perak,260,39,221,2022
2022-03-07,Perak,59,11,48,2022
2022-03-08,Perak,85,10,75,2022
2022-03-09,Perak,76,14,62,2022
2022-03-10,Perak,108,20,88,2022
2022-03-11,Perak,68,5,63,2022
2022-03-12,Perak,170,28,142,2022
2022-03-13,Perak,214,31,183,2022
2022-03-14,Perak,67,13,54,2022
2022-03-15,Perak,241,89,152,2022
2022-03-16,Perak,66,6,60,2022
2022-03-17,Perak,173,56,117,2022
2022-03-18,Perak,80,5,75,2022
2022-03-19,Perak,109,12,97,2022
2022-03-20,Perak,197,21,176,2022
2022-03-21,Perak,69,14,55,2022
2022-03-22,Perak,96,21,75,2022
2022-03-23,Perak,93,33,60,2022
2022-03-24,Perak,127,32,95,2022
2022-03-25,Perak,97,23,74,2022
2022-03-26,Perak,169,27,142,2022
2022-03-27,Perak,241,45,196,2022
2022-03-28,Perak,151,21,130,2022
2022-03-29,Perak,95,16,79,2022
2022-03-30,Perak,206,53,153,2022
2022-03-31,Perak,181,60,121,2022
2022-04-01,Perak,253,158,95,2022
2022-04-02,Perak,208,47,161,2022
2022-04-03,Perak,117,27,90,2022
2022-04-04,Perak,30,9,21,2022
2022-04-05,Perak,121,35,86,2022
2022-04-06,Perak,164,64,100,2022
2022-04-07,Perak,157,58,99,2022
2022-04-08,Perak,158,54,104,2022
2022-04-09,Perak,114,17,97,2022
2022-04-10,Perak,262,46,216,2022
2022-04-11,Perak,41,4,37,2022
2022-04-12,Perak,75,12,63,2022
2022-04-13,Perak,60,14,46,2022
2022-04-14,Perak,87,7,80,2022
2022-04-15,Perak,88,15,73,2022
2022-04-16,Perak,72,8,64,2022
2022-04-17,Perak,163,34,129,2022
2022-04-18,Perak,71,9,62,2022
2022-04-19,Perak,127,21,106,2022
2022-04-20,Perak,68,5,63,2022
2022-04-21,Perak,170,54,116,2022
2022-04-22,Perak,92,14,78,2022
2022-04-23,Perak,106,22,84,2022
2022-04-24,Perak,268,43,225,2022
2022-04-25,Perak,204,71,133,2022
2022-04-26,Perak,112,19,93,2022
2022-04-27,Perak,99,12,87,2022
2022-04-28,Perak,105,12,93,2022
2022-04-29,Perak,56,4,52,2022
2022-04-30,Perak,251,170,81,2022
2022-05-01,Perak,276,54,222,2022
2022-05-02,Perak,0,0,0,2022
2022-05-03,Perak,3,0,3,2022
2022-05-04,Perak,21,1,20,2022
2022-05-05,Perak,56,9,47,2022
2022-05-06,Perak,83,13,70,2022
2022-05-07,Perak,134,33,101,2022
2022-05-08,Perak,230,33,197,2022
2022-05-09,Perak,39,5,34,2022
2022-05-10,Perak,214,114,100,2022
2022-05-11,Perak,154,53,101,2022
2022-05-12,Perak,105,13,92,2022
2022-05-13,Perak,16,0,16,2022
2022-05-14,Perak,116,34,82,2022
2022-05-15,Perak,199,39,160,2022
2022-05-16,Perak,97,21,76,2022
2022-05-17,Perak,85,9,76,2022
2022-05-18,Perak,108,18,90,2022
2022-05-19,Perak,111,28,83,2022
2022-05-20,Perak,77,25,52,2022
2022-05-21,Perak,162,51,111,2022
2022-05-22,Perak,295,92,203,2022
2022-05-23,Perak,204,56,148,2022
2022-05-24,Perak,118,29,89,2022
2022-05-25,Perak,170,43,127,2022
2022-05-26,Perak,116,47,69,2022
2022-05-27,Perak,107,47,60,2022
2022-05-28,Perak,101,16,85,2022
2022-05-29,Perak,183,32,151,2022
2022-05-30,Perak,59,5,54,2022
2022-05-31,Perak,150,38,112,2022
2022-06-01,Perak,186,91,95,2022
2022-06-02,Perak,162,62,100,2022
2022-06-03,Perak,87,30,57,2022
2022-06-04,Perak,124,18,106,2022
2022-06-05,Perak,321,68,253,2022
2022-06-06,Perak,205,47,158,2022
2022-06-07,Perak,54,8,46,2022
2022-06-08,Perak,142,28,114,2022
2022-06-09,Perak,128,30,98,2022
2022-06-10,Perak,123,26,97,2022
2022-06-11,Perak,96,15,81,2022
2022-06-12,Perak,236,39,197,2022
2022-06-13,Perak,60,6,54,2022
2022-06-14,Perak,253,38,215,2022
2022-06-15,Perak,124,27,97,2022
2022-06-16,Perak,159,41,118,2022
2022-06-17,Perak,81,6,75,2022
2022-06-18,Perak,98,28,70,2022
2022-06-19,Perak,284,77,207,2022
2022-06-20,Perak,91,33,58,2022
2022-06-21,Perak,163,49,114,2022
2022-06-22,Perak,166,59,107,2022
2022-06-23,Perak,190,76,114,2022
2022-06-24,Perak,54,11,43,2022
2022-06-25,Perak,144,28,116,2022
2022-06-26,Perak,310,53,257,2022
2022-06-27,Perak,104,42,62,2022
2022-06-28,Perak,74,8,66,2022
2022-06-29,Perak,142,36,106,2022
2022-06-30,Perak,76,20,56,2022
2022-07-01,Perak,70,9,61,2022
2022-07-02,Perak,101,16,85,2022
2022-07-03,Perak,326,42,284,2022
2022-07-04,Perak,71,16,55,2022
2022-07-05,Perak,144,18,126,2022
2022-07-06,Perak,182,43,139,2022
2022-07-07,Perak,91,18,73,2022
2022-07-08,Perak,132,55,77,2022
2022-07-09,Perak,56,6,50,2022
2022-07-10,Perak,0,0,0,2022
2022-07-11,Perak,52,5,47,2022
2022-07-12,Perak,88,17,71,2022
2022-07-13,Perak,116,32,84,2022
2022-07-14,Perak,195,123,72,2022
2022-07-15,Perak,125,64,61,2022
2022-07-16,Perak,139,15,124,2022
2022-07-17,Perak,439,75,364,2022
2022-07-18,Perak,92,18,74,2022
2022-07-19,Perak,235,79,156,2022
2022-07-20,Perak,136,60,76,2022
2022-07-21,Perak,178,51,127,2022
2022-07-22,Perak,62,4,58,2022
2022-07-23,Perak,129,20,109,2022
2022-07-24,Perak,289,75,214,2022
2022-07-25,Perak,50,15,35,2022
2022-07-26,Perak,186,61,125,2022
2022-07-27,Perak,159,81,78,2022
2022-07-28,Perak,146,76,70,2022
2022-07-29,Perak,30,3,27,2022
2022-07-30,Perak,174,30,144,2022
2022-07-31,Perak,213,48,165,2022
2022-08-01,Perak,45,1,44,2022
2022-08-02,Perak,49,10,39,2022
2022-08-03,Perak,72,6,66,2022
2022-08-04,Perak,128,28,100,2022
2022-08-05,Perak,66,18,48,2022
2022-08-06,Perak,94,20,74,2022
2022-08-07,Perak,239,83,156,2022
2022-08-08,Perak,50,9,41,2022
2022-08-09,Perak,51,8,43,2022
2022-08-10,Perak,88,41,47,2022
2022-08-11,Perak,147,27,120,2022
2022-08-12,Perak,68,9,59,2022
2022-08-13,Perak,11,9,2,2022
2022-08-14,Perak,207,45,162,2022
2022-08-15,Perak,36,4,32,2022
2022-08-16,Perak,230,102,128,2022
2022-08-17,Perak,124,79,45,2022
2022-08-18,Perak,138,81,57,2022
2022-08-19,Perak,44,1,43,2022
2022-08-20,Perak,188,49,139,2022
2022-08-21,Perak,254,48,206,2022
2022-08-22,Perak,40,4,36,2022
2022-08-23,Perak,178,50,128,2022
2022-08-24,Perak,89,30,59,2022
2022-08-25,Perak,145,61,84,2022
2022-08-26,Perak,56,19,37,2022
2022-08-27,Perak,198,54,144,2022
2022-08-28,Perak,194,35,159,2022
2022-08-29,Perak,68,8,60,2022
2022-08-30,Perak,65,8,57,2022
2022-08-31,Perak,349,59,290,2022
2022-09-01,Perak,50,9,41,2022
2022-09-02,Perak,130,42,88,2022
2022-09-03,Perak,114,24,90,2022
2022-09-04,Perak,133,29,104,2022
2022-09-05,Perak,74,8,66,2022
2022-09-06,Perak,125,41,84,2022
2022-09-07,Perak,116,18,98,2022
2022-09-08,Perak,67,6,61,2022
2022-09-09,Perak,55,9,46,2022
2022-09-10,Perak,139,33,106,2022
2022-09-11,Perak,189,40,149,2022
2022-09-12,Perak,119,43,76,2022
2022-09-13,Perak,88,12,76,2022
2022-09-14,Perak,75,6,69,2022
2022-09-15,Perak,126,89,37,2022
2022-09-16,Perak,253,97,156,2022
2022-09-17,Perak,269,52,217,2022
2022-09-18,Perak,327,61,266,2022
2022-09-19,Perak,46,4,42,2022
2022-09-20,Perak,61,12,49,2022
2022-09-21,Perak,139,78,61,2022
2022-09-22,Perak,145,27,118,2022
2022-09-23,Perak,64,8,56,2022
2022-09-24,Perak,89,43,46,2022
2022-09-25,Perak,217,45,172,2022
2022-09-26,Perak,81,1,80,2022
2022-09-27,Perak,125,12,113,2022
2022-09-28,Perak,182,131,51,2022
2022-09-29,Perak,137,30,107,2022
2022-09-30,Perak,67,19,48,2022
2022-10-01,Perak,157,64,93,2022
2022-10-02,Perak,226,29,197,2022
2022-10-03,Perak,102,10,92,2022
2022-10-04,Perak,176,54,122,2022
2022-10-05,Perak,98,32,66,2022
2022-10-06,Perak,219,84,135,2022
2022-10-07,Perak,78,7,71,2022
2022-10-08,Perak,147,29,118,2022
2022-10-09,Perak,128,23,105,2022
2022-10-10,Perak,76,15,61,2022
2022-10-11,Perak,107,39,68,2022
2022-10-12,Perak,120,25,95,2022
2022-10-13,Perak,140,35,105,2022
2022-10-14,Perak,124,44,80,2022
2022-10-15,Perak,142,42,100,2022
2022-10-16,Perak,212,27,185,2022
2022-10-17,Perak,83,8,75,2022
2022-10-18,Perak,96,17,79,2022
2022-10-19,Perak,90,10,80,2022
2022-10-20,Perak,181,37,144,2022
2022-10-21,Perak,45,3,42,2022
2022-10-22,Perak,165,16,149,2022
2022-10-23,Perak,291,45,246,2022
2022-10-24,Perak,95,12,83,2022
2022-10-25,Perak,168,46,122,2022
2022-10-26,Perak,126,20,106,2022
2022-10-27,Perak,62,5,57,2022
2022-10-28,Perak,70,10,60,2022
2022-10-29,Perak,122,30,92,2022
2022-10-30,Perak,166,16,150,2022
2022-10-31,Perak,25,2,23,2022
2022-11-01,Perak,129,41,88,2022
2022-11-02,Perak,181,65,116,2022
2022-11-03,Perak,179,56,123,2022
2022-11-04,Perak,131,23,108,2022
2022-11-05,Perak,76,17,59,2022
2022-11-06,Perak,182,19,163,2022
2022-11-07,Perak,123,30,93,2022
2022-11-08,Perak,124,21,103,2022
2022-11-09,Perak,47,4,43,2022
2022-11-10,Perak,128,37,91,2022
2022-11-11,Perak,126,55,71,2022
2022-11-12,Perak,116,17,99,2022
2022-11-13,Perak,169,14,155,2022
2022-11-14,Perak,91,19,72,2022
2022-11-15,Perak,120,16,104,2022
2022-11-16,Perak,55,12,43,2022
2022-11-17,Perak,88,11,77,2022
2022-11-18,Perak,87,13,74,2022
2022-11-19,Perak,0,0,0,2022
2022-11-20,Perak,126,30,96,2022
2022-11-21,Perak,90,10,80,2022
2022-11-22,Perak,79,13,66,2022
2022-11-23,Perak,92,18,74,2022
2022-11-24,Perak,51,9,42,2022
2022-11-25,Perak,62,5,57,2022
2022-11-26,Perak,124,33,91,2022
2022-11-27,Perak,162,23,139,2022
2022-11-28,Perak,120,22,98,2022
2022-11-29,Perak,83,16,67,2022
2022-11-30,Perak,54,4,50,2022
2022-12-01,Perak,75,11,64,2022
2022-12-02,Perak,58,8,50,2022
2022-12-03,Perak,124,21,103,2022
2022-12-04,Perak,268,47,221,2022
2022-12-05,Perak,61,6,55,2022
2022-12-06,Perak,185,30,155,2022
2022-12-07,Perak,110,20,90,2022
2022-12-08,Perak,88,11,77,2022
2022-12-09,Perak,83,15,68,2022
2022-12-10,Perak,81,13,68,2022
2022-12-11,Perak,278,33,245,2022
2022-12-12,Perak,102,5,97,2022
2022-12-13,Perak,122,51,71,2022
2022-12-14,Perak,78,15,63,2022
2022-12-15,Perak,149,48,101,2022
2022-12-16,Perak,121,17,104,2022
2022-12-17,Perak,149,25,124,2022
2022-12-18,Perak,215,22,193,2022
2022-12-19,Perak,38,3,35,2022
2022-12-20,Perak,374,199,175,2022
2022-12-21,Perak,227,95,132,2022
2022-12-22,Perak,43,5,38,2022
2022-12-23,Perak,55,1,54,2022
2022-12-24,Perak,106,7,99,2022
2022-12-25,Perak,143,30,113,2022
2022-12-26,Perak,162,24,138,2022
2022-12-27,Perak,85,7,78,2022
2022-12-28,Perak,132,20,112,2022
2022-12-29,Perak,118,11,107,2022
2022-12-30,Perak,93,11,82,2022
2022-12-31,Perak,179,28,151,2022
2023-01-01,Perak,220,14,206,2023
2023-01-02,Perak,135,19,116,2023
2023-01-03,Perak,59,9,50,2023
2023-01-04,Perak,83,8,75,2023
2023-01-05,Perak,137,14,123,2023
2023-01-06,Perak,53,2,51,2023
2023-01-07,Perak,157,14,143,2023
2023-01-08,Perak,323,38,285,2023
2023-01-09,Perak,52,8,44,2023
2023-01-10,Perak,102,21,81,2023
2023-01-11,Perak,76,7,69,2023
2023-01-12,Perak,58,13,45,2023
2023-01-13,Perak,103,14,89,2023
2023-01-14,Perak,265,31,234,2023
2023-01-15,Perak,238,29,209,2023
2023-01-16,Perak,55,7,48,2023
2023-01-17,Perak,73,10,63,2023
2023-01-18,Perak,98,12,86,2023
2023-01-19,Perak,110,18,92,2023
2023-01-20,Perak,107,12,95,2023
2023-01-21,Perak,146,20,126,2023
2023-01-22,Perak,134,28,106,2023
2023-01-23,Perak,122,23,99,2023
2023-01-24,Perak,140,17,123,2023
2023-01-25,Perak,105,17,88,2023
2023-01-26,Perak,124,29,95,2023
2023-01-27,Perak,80,13,67,2023
2023-01-28,Perak,109,17,92,2023
2023-01-29,Perak,336,85,251,2023
2023-01-30,Perak,80,14,66,2023
2023-01-31,Perak,138,61,77,2023
2023-02-01,Perak,140,69,71,2023
2023-02-02,Perak,166,88,78,2023
2023-02-03,Perak,63,5,58,2023
2023-02-04,Perak,141,18,123,2023
2023-02-05,Perak,297,46,251,2023
2023-02-06,Perak,98,13,85,2023
2023-02-07,Perak,60,5,55,2023
2023-02-08,Perak,95,18,77,2023
2023-02-09,Perak,164,69,95,2023
2023-02-10,Perak,41,7,34,2023
2023-02-11,Perak,125,20,105,2023
2023-02-12,Perak,198,39,159,2023
2023-02-13,Perak,53,2,51,2023
2023-02-14,Perak,179,53,126,2023
2023-02-15,Perak,282,115,167,2023
2023-02-16,Perak,255,101,154,2023
2023-02-17,Perak,256,149,107,2023
2023-02-18,Perak,93,17,76,2023
2023-02-19,Perak,205,28,177,2023
2023-02-20,Perak,51,6,45,2023
2023-02-21,Perak,142,81,61,2023
2023-02-22,Perak,127,39,88,2023
2023-02-23,Perak,226,106,120,2023
2023-02-24,Perak,67,8,59,2023
2023-02-25,Perak,141,19,122,2023
2023-02-26,Perak,242,49,193,2023
2023-02-27,Perak,94,22,72,2023
2023-02-28,Perak,122,57,65,2023
2023-03-01,Perak,56,5,51,2023
2023-03-02,Perak,187,20,167,2023
2023-03-03,Perak,52,4,48,2023
2023-03-04,Perak,111,18,93,2023
2023-03-05,Perak,248,39,209,2023
2023-03-06,Perak,61,8,53,2023
2023-03-07,Perak,119,17,102,2023
2023-03-08,Perak,195,67,128,2023
2023-03-09,Perak,140,32,108,2023
2023-03-10,Perak,65,13,52,2023
2023-03-11,Perak,202,45,157,2023
2023-03-12,Perak,276,35,241,2023
2023-03-13,Perak,58,4,54,2023
2023-03-14,Perak,190,69,121,2023
2023-03-15,Perak,303,96,207,2023
2023-03-16,Perak,259,113,146,2023
2023-03-17,Perak,54,5,49,2023
2023-03-18,Perak,241,46,195,2023
2023-03-19,Perak,321,50,271,2023
2023-03-20,Perak,99,17,82,2023
2023-03-21,Perak,91,30,61,2023
2023-03-22,Perak,182,59,123,2023
2023-03-23,Perak,9,1,8,2023
2023-03-24,Perak,69,8,61,2023
2023-03-25,Perak,254,186,68,2023
2023-03-26,Perak,173,14,159,2023
2023-03-27,Perak,59,12,47,2023
2023-03-28,Perak,88,20,68,2023
2023-03-29,Perak,82,7,75,2023
2023-03-30,Perak,153,39,114,2023
2023-03-31,Perak,70,9,61,2023
2023-04-01,Perak,97,30,67,2023
2023-04-02,Perak,188,44,144,2023
2023-04-03,Perak,52,4,48,2023
2023-04-04,Perak,106,19,87,2023
2023-04-05,Perak,62,8,54,2023
2023-04-06,Perak,100,34,66,2023
2023-04-07,Perak,65,14,51,2023
2023-04-08,Perak,100,19,81,2023
2023-04-09,Perak,359,58,301,2023
2023-04-10,Perak,51,4,47,2023
2023-04-11,Perak,134,32,102,2023
2023-04-12,Perak,118,51,67,2023
2023-04-13,Perak,89,17,72,2023
2023-04-14,Perak,85,11,74,2023
2023-04-15,Perak,65,6,59,2023
2023-04-16,Perak,313,23,290,2023
2023-04-17,Perak,110,18,92,2023
2023-04-18,Perak,71,4,67,2023
2023-04-19,Perak,86,10,76,2023
2023-04-20,Perak,109,12,97,2023
2023-04-21,Perak,4,0,4,2023
2023-04-22,Perak,0,0,0,2023
2023-04-23,Perak,4,0,4,2023
2023-04-24,Perak,10,0,10,2023
2023-04-25,Perak,95,3,92,2023
2023-04-26,Perak,96,3,93,2023
2023-04-27,Perak,170,59,111,2023
2023-04-28,Perak,101,13,88,2023
2023-04-29,Perak,158,28,130,2023
2023-04-30,Perak,257,46,211,2023
2023-05-01,Perak,291,51,240,2023
2023-05-02,Perak,74,4,70,2023
2023-05-03,Perak,62,5,57,2023
2023-05-04,Perak,236,45,191,2023
2023-05-05,Perak,50,7,43,2023
2023-05-06,Perak,104,11,93,2023
2023-05-07,Perak,182,24,158,2023
2023-05-08,Perak,90,19,71,2023
2023-05-09,Perak,86,30,56,2023
2023-05-10,Perak,189,38,151,2023
2023-05-11,Perak,73,18,55,2023
2023-05-12,Perak,27,0,27,2023
2023-05-13,Perak,75,17,58,2023
2023-05-14,Perak,222,37,185,2023
2023-05-15,Perak,57,2,55,2023
2023-05-16,Perak,70,7,63,2023
2023-05-17,Perak,121,33,88,2023
2023-05-18,Perak,83,7,76,2023
2023-05-19,Perak,59,3,56,2023
2023-05-20,Perak,173,32,141,2023
2023-05-21,Perak,321,45,276,2023
2023-05-22,Perak,62,4,58,2023
2023-05-23,Perak,120,22,98,2023
2023-05-24,Perak,161,55,106,2023
2023-05-25,Perak,94,8,86,2023
2023-05-26,Perak,61,5,56,2023
2023-05-27,Perak,173,30,143,2023
2023-05-28,Perak,264,33,231,2023
2023-05-29,Perak,82,8,74,2023
2023-05-30,Perak,91,18,73,2023
2023-05-31,Perak,109,36,73,2023
2023-06-01,Perak,75,8,67,2023
2023-06-02,Perak,78,7,71,2023
2023-06-03,Perak,202,22,180,2023
2023-06-04,Perak,248,44,204,2023
2023-06-05,Perak,225,36,189,2023
2023-06-06,Perak,46,8,38,2023
2023-06-07,Perak,68,14,54,2023
2023-06-08,Perak,94,13,81,2023
2023-06-09,Perak,49,5,44,2023
2023-06-10,Perak,155,35,120,2023
2023-06-11,Perak,264,44,220,2023
2023-06-12,Perak,59,14,45,2023
2023-06-13,Perak,244,51,193,2023
2023-06-14,Perak,500,121,379,2023
2023-06-15,Perak,71,6,65,2023
2023-06-16,Perak,94,13,81,2023
2023-06-17,Perak,199,42,157,2023
2023-06-18,Perak,376,59,317,2023
2023-06-19,Perak,61,4,57,2023
2023-06-20,Perak,68,18,50,2023
2023-06-21,Perak,181,50,131,2023
2023-06-22,Perak,124,24,100,2023
2023-06-23,Perak,67,9,58,2023
2023-06-24,Perak,333,128,205,2023
2023-06-25,Perak,286,59,227,2023
2023-06-26,Perak,125,31,94,2023
2023-06-27,Perak,93,16,77,2023
2023-06-28,Perak,60,8,52,2023
2023-06-29,Perak,0,0,0,2023
2023-06-30,Perak,29,1,28,2023
2023-07-01,Perak,92,19,73,2023
2023-07-02,Perak,256,39,217,2023
2023-07-03,Perak,116,28,88,2023
2023-07-04,Perak,258,93,165,2023
2023-07-05,Perak,210,77,133,2023
2023-07-06,Perak,235,96,139,2023
2023-07-07,Perak,49,5,44,2023
2023-07-08,Perak,213,70,143,2023
2023-07-09,Perak,174,16,158,2023
2023-07-10,Perak,77,9,68,2023
2023-07-11,Perak,60,15,45,2023
2023-07-12,Perak,248,56,192,2023
2023-07-13,Perak,115,28,87,2023
2023-07-14,Perak,51,5,46,2023
2023-07-15,Perak,85,20,65,2023
2023-07-16,Perak,284,33,251,2023
2023-07-17,Perak,77,10,67,2023
2023-07-18,Perak,98,12,86,2023
2023-07-19,Perak,105,25,80,2023
2023-07-20,Perak,46,3,43,2023
2023-07-21,Perak,88,18,70,2023
2023-07-22,Perak,150,34,116,2023
2023-07-23,Perak,132,23,109,2023
2023-07-24,Perak,30,1,29,2023
2023-07-25,Perak,54,15,39,2023
2023-07-26,Perak,147,29,118,2023
2023-07-27,Perak,49,15,34,2023
2023-07-28,Perak,92,19,73,2023
2023-07-29,Perak,100,14,86,2023
2023-07-30,Perak,163,20,143,2023
2023-07-31,Perak,46,5,41,2023
2023-08-01,Perak,54,7,47,2023
2023-08-02,Perak,45,7,38,2023
2023-08-03,Perak,162,54,108,2023
2023-08-04,Perak,145,26,119,2023
2023-08-05,Perak,175,28,147,2023
2023-08-06,Perak,224,33,191,2023
2023-08-07,Perak,43,6,37,2023
2023-08-08,Perak,66,6,60,2023
2023-08-09,Perak,49,3,46,2023
2023-08-10,Perak,49,7,42,2023
2023-08-11,Perak,85,12,73,2023
2023-08-12,Perak,145,13,132,2023
2023-08-13,Perak,335,42,293,2023
2023-08-14,Perak,41,6,35,2023
2023-08-15,Perak,61,10,51,2023
2023-08-16,Perak,149,19,130,2023
2023-08-17,Perak,61,20,41,2023
2023-08-18,Perak,64,9,55,2023
2023-08-19,Perak,179,34,145,2023
2023-08-20,Perak,167,23,144,2023
2023-08-21,Perak,52,8,44,2023
2023-08-22,Perak,119,14,105,2023
2023-08-23,Perak,117,34,83,2023
2023-08-24,Perak,108,46,62,2023
2023-08-25,Perak,96,21,75,2023
2023-08-26,Perak,183,21,162,2023
2023-08-27,Perak,283,37,246,2023
2023-08-28,Perak,106,39,67,2023
2023-08-29,Perak,60,16,44,2023
2023-08-30,Perak,75,32,43,2023
2023-08-31,Perak,407,57,350,2023
2023-09-01,Perak,82,11,71,2023
2023-09-02,Perak,113,15,98,2023
2023-09-03,Perak,208,27,181,2023
2023-09-04,Perak,50,6,44,2023
2023-09-05,Perak,130,59,71,2023
2023-09-06,Perak,169,43,126,2023
2023-09-07,Perak,93,20,73,2023
2023-09-08,Perak,58,5,53,2023
2023-09-09,Perak,133,27,106,2023
2023-09-10,Perak,145,19,126,2023
2023-09-11,Perak,47,6,41,2023
2023-09-12,Perak,108,12,96,2023
2023-09-13,Perak,188,54,134,2023
2023-09-14,Perak,161,29,132,2023
2023-09-15,Perak,75,17,58,2023
2023-09-16,Perak,242,37,205,2023
2023-09-17,Perak,180,18,162,2023
2023-09-18,Perak,178,96,82,2023
2023-09-19,Perak,52,9,43,2023
2023-09-20,Perak,110,32,78,2023
2023-09-21,Perak,87,17,70,2023
2023-09-22,Perak,53,4,49,2023
2023-09-23,Perak,245,66,179,2023
2023-09-24,Perak,223,33,190,2023
2023-09-25,Perak,44,3,41,2023
2023-09-26,Perak,108,48,60,2023
2023-09-27,Perak,151,67,84,2023
2023-09-28,Perak,119,9,110,2023
2023-09-29,Perak,123,37,86,2023
2023-09-30,Perak,157,43,114,2023
2023-10-01,Perak,336,44,292,2023
2023-10-02,Perak,53,7,46,2023
2023-10-03,Perak,131,69,62,2023
2023-10-04,Perak,145,27,118,2023
2023-10-05,Perak,58,7,51,2023
2023-10-06,Perak,56,8,48,2023
2023-10-07,Perak,145,53,92,2023
2023-10-08,Perak,244,34,210,2023
2023-10-09,Perak,108,15,93,2023
2023-10-10,Perak,70,14,56,2023
2023-10-11,Perak,192,82,110,2023
2023-10-12,Perak,129,22,107,2023
2023-10-13,Perak,80,15,65,2023
2023-10-14,Perak,124,14,110,2023
2023-10-15,Perak,224,39,185,2023
2023-10-16,Perak,78,11,67,2023
2023-10-17,Perak,40,1,39,2023
2023-10-18,Perak,94,7,87,2023
2023-10-19,Perak,108,16,92,2023
2023-10-20,Perak,76,18,58,2023
2023-10-21,Perak,197,26,171,2023
2023-10-22,Perak,142,24,118,2023
2023-10-23,Perak,46,7,39,2023
2023-10-24,Perak,41,5,36,2023
2023-10-25,Perak,164,51,113,2023
2023-10-26,Perak,136,24,112,2023
2023-10-27,Perak,89,35,54,2023
2023-10-28,Perak,14,1,13,2023
2023-10-29,Perak,288,43,245,2023
2023-10-30,Perak,59,10,49,2023
2023-10-31,Perak,75,7,68,2023
2023-11-01,Perak,30,2,28,2023
2023-11-02,Perak,55,4,51,2023
2023-11-03,Perak,95,17,78,2023
2023-11-04,Perak,90,14,76,2023
2023-11-05,Perak,270,35,235,2023
2023-11-06,Perak,50,6,44,2023
2023-11-07,Perak,315,241,74,2023
2023-11-08,Perak,63,24,39,2023
2023-11-09,Perak,65,7,58,2023
2023-11-10,Perak,54,9,45,2023
2023-11-11,Perak,148,31,117,2023
2023-11-12,Perak,277,47,230,2023
2023-11-13,Perak,85,12,73,2023
2023-11-14,Perak,94,22,72,2023
2023-11-15,Perak,133,41,92,2023
2023-11-16,Perak,176,51,125,2023
2023-11-17,Perak,140,62,78,2023
2023-11-18,Perak,267,90,177,2023
2023-11-19,Perak,187,25,162,2023
2023-11-20,Perak,175,89,86,2023
2023-11-21,Perak,32,4,28,2023
2023-11-22,Perak,103,12,91,2023
2023-11-23,Perak,102,12,90,2023
2023-11-24,Perak,52,8,44,2023
2023-11-25,Perak,121,22,99,2023
2023-11-26,Perak,223,33,190,2023
2023-11-27,Perak,49,5,44,2023
2023-11-28,Perak,47,16,31,2023
2023-11-29,Perak,19,0,19,2023
2023-11-30,Perak,111,26,85,2023
2023-12-01,Perak,51,3,48,2023
2023-12-02,Perak,113,32,81,2023
2023-12-03,Perak,232,20,212,2023
2023-12-04,Perak,30,0,30,2023
2023-12-05,Perak,110,32,78,2023
2023-12-06,Perak,189,63,126,2023
2023-12-07,Perak,63,5,58,2023
2023-12-08,Perak,36,1,35,2023
2023-12-09,Perak,137,33,104,2023
2023-12-10,Perak,254,40,214,2023
2023-12-11,Perak,93,9,84,2023
2023-12-12,Perak,71,5,66,2023
2023-12-13,Perak,196,47,149,2023
2023-12-14,Perak,109,19,90,2023
2023-12-15,Perak,57,3,54,2023
2023-12-16,Perak,129,15,114,2023
2023-12-17,Perak,280,38,242,2023
2023-12-18,Perak,53,4,49,2023
2023-12-19,Perak,62,10,52,2023
2023-12-20,Perak,80,19,61,2023
2023-12-21,Perak,108,18,90,2023
2023-12-22,Perak,84,6,78,2023
2023-12-23,Perak,137,20,117,2023
2023-12-24,Perak,185,20,165,2023
2023-12-25,Perak,126,12,114,2023
2023-12-26,Perak,83,10,73,2023
2023-12-27,Perak,85,13,72,2023
2023-12-28,Perak,128,24,104,2023
2023-12-29,Perak,92,8,84,2023
2023-12-30,Perak,99,10,89,2023
2023-12-31,Perak,242,33,209,2023
2024-01-01,Perak,140,12,128,2024
2024-01-02,Perak,43,2,41,2024
2024-01-03,Perak,70,14,56,2024
2024-01-04,Perak,66,7,59,2024
2024-01-05,Perak,48,6,42,2024
2024-01-06,Perak,236,76,160,2024
2024-01-07,Perak,284,31,253,2024
2024-01-08,Perak,110,27,83,2024
2024-01-09,Perak,46,7,39,2024
2024-01-10,Perak,144,42,102,2024
2024-01-11,Perak,177,54,123,2024
2024-01-12,Perak,88,7,81,2024
2024-01-13,Perak,147,20,127,2024
2024-01-14,Perak,172,20,152,2024
2024-01-15,Perak,61,7,54,2024
2024-01-16,Perak,78,15,63,2024
2024-01-17,Perak,94,23,71,2024
2024-01-18,Perak,92,10,82,2024
2024-01-19,Perak,114,21,93,2024
2024-01-20,Perak,69,7,62,2024
2024-01-21,Perak,213,22,191,2024
2024-01-22,Perak,159,36,123,2024
2024-01-23,Perak,105,15,90,2024
2024-01-24,Perak,170,42,128,2024
2024-01-25,Perak,181,32,149,2024
2024-01-26,Perak,167,34,133,2024
2024-01-27,Perak,125,26,99,2024
2024-01-28,Perak,300,35,265,2024
2024-01-29,Perak,206,56,150,2024
2024-01-30,Perak,135,26,109,2024
2024-01-31,Perak,129,23,106,2024
2024-02-01,Perak,88,18,70,2024
2024-02-02,Perak,70,12,58,2024
2006-01-01,Pulau Pinang,0,0,0,2006
2006-01-02,Pulau Pinang,0,0,0,2006
2006-01-03,Pulau Pinang,0,0,0,2006
2006-01-04,Pulau Pinang,0,0,0,2006
2006-01-05,Pulau Pinang,0,0,0,2006
2006-01-06,Pulau Pinang,0,0,0,2006
2006-01-07,Pulau Pinang,0,0,0,2006
2006-01-08,Pulau Pinang,0,0,0,2006
2006-01-09,Pulau Pinang,0,0,0,2006
2006-01-10,Pulau Pinang,0,0,0,2006
2006-01-11,Pulau Pinang,0,0,0,2006
2006-01-12,Pulau Pinang,0,0,0,2006
2006-01-13,Pulau Pinang,0,0,0,2006
2006-01-14,Pulau Pinang,0,0,0,2006
2006-01-15,Pulau Pinang,0,0,0,2006
2006-01-16,Pulau Pinang,0,0,0,2006
2006-01-17,Pulau Pinang,0,0,0,2006
2006-01-18,Pulau Pinang,0,0,0,2006
2006-01-19,Pulau Pinang,0,0,0,2006
2006-01-20,Pulau Pinang,0,0,0,2006
2006-01-21,Pulau Pinang,0,0,0,2006
2006-01-22,Pulau Pinang,0,0,0,2006
2006-01-23,Pulau Pinang,0,0,0,2006
2006-01-24,Pulau Pinang,0,0,0,2006
2006-01-25,Pulau Pinang,0,0,0,2006
2006-01-26,Pulau Pinang,0,0,0,2006
2006-01-27,Pulau Pinang,0,0,0,2006
2006-01-28,Pulau Pinang,0,0,0,2006
2006-01-29,Pulau Pinang,0,0,0,2006
2006-01-30,Pulau Pinang,0,0,0,2006
2006-01-31,Pulau Pinang,0,0,0,2006
2006-02-01,Pulau Pinang,0,0,0,2006
2006-02-02,Pulau Pinang,0,0,0,2006
2006-02-03,Pulau Pinang,0,0,0,2006
2006-02-04,Pulau Pinang,0,0,0,2006
2006-02-05,Pulau Pinang,0,0,0,2006
2006-02-06,Pulau Pinang,0,0,0,2006
2006-02-07,Pulau Pinang,0,0,0,2006
2006-02-08,Pulau Pinang,0,0,0,2006
2006-02-09,Pulau Pinang,0,0,0,2006
2006-02-10,Pulau Pinang,0,0,0,2006
2006-02-11,Pulau Pinang,0,0,0,2006
2006-02-12,Pulau Pinang,0,0,0,2006
2006-02-13,Pulau Pinang,0,0,0,2006
2006-02-14,Pulau Pinang,0,0,0,2006
2006-02-15,Pulau Pinang,0,0,0,2006
2006-02-16,Pulau Pinang,0,0,0,2006
2006-02-17,Pulau Pinang,0,0,0,2006
2006-02-18,Pulau Pinang,0,0,0,2006
2006-02-19,Pulau Pinang,0,0,0,2006
2006-02-20,Pulau Pinang,0,0,0,2006
2006-02-21,Pulau Pinang,0,0,0,2006
2006-02-22,Pulau Pinang,0,0,0,2006
2006-02-23,Pulau Pinang,0,0,0,2006
2006-02-24,Pulau Pinang,0,0,0,2006
2006-02-25,Pulau Pinang,0,0,0,2006
2006-02-26,Pulau Pinang,0,0,0,2006
2006-02-27,Pulau Pinang,0,0,0,2006
2006-02-28,Pulau Pinang,0,0,0,2006
2006-03-01,Pulau Pinang,0,0,0,2006
2006-03-02,Pulau Pinang,0,0,0,2006
2006-03-03,Pulau Pinang,0,0,0,2006
2006-03-04,Pulau Pinang,0,0,0,2006
2006-03-05,Pulau Pinang,0,0,0,2006
2006-03-06,Pulau Pinang,0,0,0,2006
2006-03-07,Pulau Pinang,0,0,0,2006
2006-03-08,Pulau Pinang,0,0,0,2006
2006-03-09,Pulau Pinang,0,0,0,2006
2006-03-10,Pulau Pinang,0,0,0,2006
2006-03-11,Pulau Pinang,0,0,0,2006
2006-03-12,Pulau Pinang,0,0,0,2006
2006-03-13,Pulau Pinang,0,0,0,2006
2006-03-14,Pulau Pinang,0,0,0,2006
2006-03-15,Pulau Pinang,0,0,0,2006
2006-03-16,Pulau Pinang,0,0,0,2006
2006-03-17,Pulau Pinang,0,0,0,2006
2006-03-18,Pulau Pinang,0,0,0,2006
2006-03-19,Pulau Pinang,0,0,0,2006
2006-03-20,Pulau Pinang,0,0,0,2006
2006-03-21,Pulau Pinang,0,0,0,2006
2006-03-22,Pulau Pinang,0,0,0,2006
2006-03-23,Pulau Pinang,0,0,0,2006
2006-03-24,Pulau Pinang,0,0,0,2006
2006-03-25,Pulau Pinang,0,0,0,2006
2006-03-26,Pulau Pinang,0,0,0,2006
2006-03-27,Pulau Pinang,0,0,0,2006
2006-03-28,Pulau Pinang,0,0,0,2006
2006-03-29,Pulau Pinang,0,0,0,2006
2006-03-30,Pulau Pinang,0,0,0,2006
2006-03-31,Pulau Pinang,0,0,0,2006
2006-04-01,Pulau Pinang,0,0,0,2006
2006-04-02,Pulau Pinang,0,0,0,2006
2006-04-03,Pulau Pinang,0,0,0,2006
2006-04-04,Pulau Pinang,0,0,0,2006
2006-04-05,Pulau Pinang,0,0,0,2006
2006-04-06,Pulau Pinang,0,0,0,2006
2006-04-07,Pulau Pinang,0,0,0,2006
2006-04-08,Pulau Pinang,0,0,0,2006
2006-04-09,Pulau Pinang,0,0,0,2006
2006-04-10,Pulau Pinang,0,0,0,2006
2006-04-11,Pulau Pinang,0,0,0,2006
2006-04-12,Pulau Pinang,0,0,0,2006
2006-04-13,Pulau Pinang,0,0,0,2006
2006-04-14,Pulau Pinang,0,0,0,2006
2006-04-15,Pulau Pinang,0,0,0,2006
2006-04-16,Pulau Pinang,0,0,0,2006
2006-04-17,Pulau Pinang,0,0,0,2006
2006-04-18,Pulau Pinang,0,0,0,2006
2006-04-19,Pulau Pinang,0,0,0,2006
2006-04-20,Pulau Pinang,0,0,0,2006
2006-04-21,Pulau Pinang,0,0,0,2006
2006-04-22,Pulau Pinang,0,0,0,2006
2006-04-23,Pulau Pinang,0,0,0,2006
2006-04-24,Pulau Pinang,0,0,0,2006
2006-04-25,Pulau Pinang,0,0,0,2006
2006-04-26,Pulau Pinang,0,0,0,2006
2006-04-27,Pulau Pinang,0,0,0,2006
2006-04-28,Pulau Pinang,0,0,0,2006
2006-04-29,Pulau Pinang,0,0,0,2006
2006-04-30,Pulau Pinang,0,0,0,2006
2006-05-01,Pulau Pinang,0,0,0,2006
2006-05-02,Pulau Pinang,0,0,0,2006
2006-05-03,Pulau Pinang,0,0,0,2006
2006-05-04,Pulau Pinang,0,0,0,2006
2006-05-05,Pulau Pinang,0,0,0,2006
2006-05-06,Pulau Pinang,0,0,0,2006
2006-05-07,Pulau Pinang,0,0,0,2006
2006-05-08,Pulau Pinang,0,0,0,2006
2006-05-09,Pulau Pinang,0,0,0,2006
2006-05-10,Pulau Pinang,0,0,0,2006
2006-05-11,Pulau Pinang,0,0,0,2006
2006-05-12,Pulau Pinang,0,0,0,2006
2006-05-13,Pulau Pinang,0,0,0,2006
2006-05-14,Pulau Pinang,0,0,0,2006
2006-05-15,Pulau Pinang,0,0,0,2006
2006-05-16,Pulau Pinang,0,0,0,2006
2006-05-17,Pulau Pinang,0,0,0,2006
2006-05-18,Pulau Pinang,0,0,0,2006
2006-05-19,Pulau Pinang,0,0,0,2006
2006-05-20,Pulau Pinang,0,0,0,2006
2006-05-21,Pulau Pinang,0,0,0,2006
2006-05-22,Pulau Pinang,0,0,0,2006
2006-05-23,Pulau Pinang,0,0,0,2006
2006-05-24,Pulau Pinang,0,0,0,2006
2006-05-25,Pulau Pinang,0,0,0,2006
2006-05-26,Pulau Pinang,0,0,0,2006
2006-05-27,Pulau Pinang,0,0,0,2006
2006-05-28,Pulau Pinang,0,0,0,2006
2006-05-29,Pulau Pinang,0,0,0,2006
2006-05-30,Pulau Pinang,0,0,0,2006
2006-05-31,Pulau Pinang,0,0,0,2006
2006-06-01,Pulau Pinang,0,0,0,2006
2006-06-02,Pulau Pinang,0,0,0,2006
2006-06-03,Pulau Pinang,0,0,0,2006
2006-06-04,Pulau Pinang,0,0,0,2006
2006-06-05,Pulau Pinang,0,0,0,2006
2006-06-06,Pulau Pinang,0,0,0,2006
2006-06-07,Pulau Pinang,0,0,0,2006
2006-06-08,Pulau Pinang,0,0,0,2006
2006-06-09,Pulau Pinang,0,0,0,2006
2006-06-10,Pulau Pinang,0,0,0,2006
2006-06-11,Pulau Pinang,0,0,0,2006
2006-06-12,Pulau Pinang,0,0,0,2006
2006-06-13,Pulau Pinang,0,0,0,2006
2006-06-14,Pulau Pinang,0,0,0,2006
2006-06-15,Pulau Pinang,0,0,0,2006
2006-06-16,Pulau Pinang,0,0,0,2006
2006-06-17,Pulau Pinang,0,0,0,2006
2006-06-18,Pulau Pinang,0,0,0,2006
2006-06-19,Pulau Pinang,0,0,0,2006
2006-06-20,Pulau Pinang,0,0,0,2006
2006-06-21,Pulau Pinang,0,0,0,2006
2006-06-22,Pulau Pinang,0,0,0,2006
2006-06-23,Pulau Pinang,0,0,0,2006
2006-06-24,Pulau Pinang,0,0,0,2006
2006-06-25,Pulau Pinang,0,0,0,2006
2006-06-26,Pulau Pinang,0,0,0,2006
2006-06-27,Pulau Pinang,0,0,0,2006
2006-06-28,Pulau Pinang,0,0,0,2006
2006-06-29,Pulau Pinang,0,0,0,2006
2006-06-30,Pulau Pinang,0,0,0,2006
2006-07-01,Pulau Pinang,0,0,0,2006
2006-07-02,Pulau Pinang,0,0,0,2006
2006-07-03,Pulau Pinang,0,0,0,2006
2006-07-04,Pulau Pinang,0,0,0,2006
2006-07-05,Pulau Pinang,0,0,0,2006
2006-07-06,Pulau Pinang,0,0,0,2006
2006-07-07,Pulau Pinang,0,0,0,2006
2006-07-08,Pulau Pinang,0,0,0,2006
2006-07-09,Pulau Pinang,0,0,0,2006
2006-07-10,Pulau Pinang,0,0,0,2006
2006-07-11,Pulau Pinang,0,0,0,2006
2006-07-12,Pulau Pinang,0,0,0,2006
2006-07-13,Pulau Pinang,0,0,0,2006
2006-07-14,Pulau Pinang,0,0,0,2006
2006-07-15,Pulau Pinang,0,0,0,2006
2006-07-16,Pulau Pinang,0,0,0,2006
2006-07-17,Pulau Pinang,0,0,0,2006
2006-07-18,Pulau Pinang,0,0,0,2006
2006-07-19,Pulau Pinang,0,0,0,2006
2006-07-20,Pulau Pinang,0,0,0,2006
2006-07-21,Pulau Pinang,0,0,0,2006
2006-07-22,Pulau Pinang,0,0,0,2006
2006-07-23,Pulau Pinang,0,0,0,2006
2006-07-24,Pulau Pinang,0,0,0,2006
2006-07-25,Pulau Pinang,0,0,0,2006
2006-07-26,Pulau Pinang,0,0,0,2006
2006-07-27,Pulau Pinang,0,0,0,2006
2006-07-28,Pulau Pinang,0,0,0,2006
2006-07-29,Pulau Pinang,0,0,0,2006
2006-07-30,Pulau Pinang,0,0,0,2006
2006-07-31,Pulau Pinang,0,0,0,2006
2006-08-01,Pulau Pinang,0,0,0,2006
2006-08-02,Pulau Pinang,0,0,0,2006
2006-08-03,Pulau Pinang,0,0,0,2006
2006-08-04,Pulau Pinang,0,0,0,2006
2006-08-05,Pulau Pinang,0,0,0,2006
2006-08-06,Pulau Pinang,0,0,0,2006
2006-08-07,Pulau Pinang,0,0,0,2006
2006-08-08,Pulau Pinang,0,0,0,2006
2006-08-09,Pulau Pinang,0,0,0,2006
2006-08-10,Pulau Pinang,0,0,0,2006
2006-08-11,Pulau Pinang,0,0,0,2006
2006-08-12,Pulau Pinang,0,0,0,2006
2006-08-13,Pulau Pinang,0,0,0,2006
2006-08-14,Pulau Pinang,0,0,0,2006
2006-08-15,Pulau Pinang,0,0,0,2006
2006-08-16,Pulau Pinang,0,0,0,2006
2006-08-17,Pulau Pinang,0,0,0,2006
2006-08-18,Pulau Pinang,0,0,0,2006
2006-08-19,Pulau Pinang,0,0,0,2006
2006-08-20,Pulau Pinang,0,0,0,2006
2006-08-21,Pulau Pinang,0,0,0,2006
2006-08-22,Pulau Pinang,0,0,0,2006
2006-08-23,Pulau Pinang,0,0,0,2006
2006-08-24,Pulau Pinang,0,0,0,2006
2006-08-25,Pulau Pinang,0,0,0,2006
2006-08-26,Pulau Pinang,0,0,0,2006
2006-08-27,Pulau Pinang,0,0,0,2006
2006-08-28,Pulau Pinang,0,0,0,2006
2006-08-29,Pulau Pinang,0,0,0,2006
2006-08-30,Pulau Pinang,0,0,0,2006
2006-08-31,Pulau Pinang,0,0,0,2006
2006-09-01,Pulau Pinang,0,0,0,2006
2006-09-02,Pulau Pinang,0,0,0,2006
2006-09-03,Pulau Pinang,0,0,0,2006
2006-09-04,Pulau Pinang,0,0,0,2006
2006-09-05,Pulau Pinang,0,0,0,2006
2006-09-06,Pulau Pinang,0,0,0,2006
2006-09-07,Pulau Pinang,0,0,0,2006
2006-09-08,Pulau Pinang,0,0,0,2006
2006-09-09,Pulau Pinang,0,0,0,2006
2006-09-10,Pulau Pinang,0,0,0,2006
2006-09-11,Pulau Pinang,0,0,0,2006
2006-09-12,Pulau Pinang,0,0,0,2006
2006-09-13,Pulau Pinang,0,0,0,2006
2006-09-14,Pulau Pinang,0,0,0,2006
2006-09-15,Pulau Pinang,0,0,0,2006
2006-09-16,Pulau Pinang,0,0,0,2006
2006-09-17,Pulau Pinang,0,0,0,2006
2006-09-18,Pulau Pinang,0,0,0,2006
2006-09-19,Pulau Pinang,0,0,0,2006
2006-09-20,Pulau Pinang,0,0,0,2006
2006-09-21,Pulau Pinang,0,0,0,2006
2006-09-22,Pulau Pinang,0,0,0,2006
2006-09-23,Pulau Pinang,0,0,0,2006
2006-09-24,Pulau Pinang,0,0,0,2006
2006-09-25,Pulau Pinang,0,0,0,2006
2006-09-26,Pulau Pinang,0,0,0,2006
2006-09-27,Pulau Pinang,0,0,0,2006
2006-09-28,Pulau Pinang,0,0,0,2006
2006-09-29,Pulau Pinang,0,0,0,2006
2006-09-30,Pulau Pinang,0,0,0,2006
2006-10-01,Pulau Pinang,0,0,0,2006
2006-10-02,Pulau Pinang,0,0,0,2006
2006-10-03,Pulau Pinang,0,0,0,2006
2006-10-04,Pulau Pinang,0,0,0,2006
2006-10-05,Pulau Pinang,0,0,0,2006
2006-10-06,Pulau Pinang,0,0,0,2006
2006-10-07,Pulau Pinang,0,0,0,2006
2006-10-08,Pulau Pinang,0,0,0,2006
2006-10-09,Pulau Pinang,0,0,0,2006
2006-10-10,Pulau Pinang,0,0,0,2006
2006-10-11,Pulau Pinang,0,0,0,2006
2006-10-12,Pulau Pinang,0,0,0,2006
2006-10-13,Pulau Pinang,0,0,0,2006
2006-10-14,Pulau Pinang,0,0,0,2006
2006-10-15,Pulau Pinang,0,0,0,2006
2006-10-16,Pulau Pinang,0,0,0,2006
2006-10-17,Pulau Pinang,0,0,0,2006
2006-10-18,Pulau Pinang,0,0,0,2006
2006-10-19,Pulau Pinang,0,0,0,2006
2006-10-20,Pulau Pinang,0,0,0,2006
2006-10-21,Pulau Pinang,0,0,0,2006
2006-10-22,Pulau Pinang,0,0,0,2006
2006-10-23,Pulau Pinang,0,0,0,2006
2006-10-24,Pulau Pinang,0,0,0,2006
2006-10-25,Pulau Pinang,0,0,0,2006
2006-10-26,Pulau Pinang,0,0,0,2006
2006-10-27,Pulau Pinang,0,0,0,2006
2006-10-28,Pulau Pinang,0,0,0,2006
2006-10-29,Pulau Pinang,0,0,0,2006
2006-10-30,Pulau Pinang,0,0,0,2006
2006-10-31,Pulau Pinang,0,0,0,2006
2006-11-01,Pulau Pinang,0,0,0,2006
2006-11-02,Pulau Pinang,0,0,0,2006
2006-11-03,Pulau Pinang,0,0,0,2006
2006-11-04,Pulau Pinang,0,0,0,2006
2006-11-05,Pulau Pinang,0,0,0,2006
2006-11-06,Pulau Pinang,0,0,0,2006
2006-11-07,Pulau Pinang,0,0,0,2006
2006-11-08,Pulau Pinang,0,0,0,2006
2006-11-09,Pulau Pinang,0,0,0,2006
2006-11-10,Pulau Pinang,0,0,0,2006
2006-11-11,Pulau Pinang,0,0,0,2006
2006-11-12,Pulau Pinang,0,0,0,2006
2006-11-13,Pulau Pinang,0,0,0,2006
2006-11-14,Pulau Pinang,0,0,0,2006
2006-11-15,Pulau Pinang,0,0,0,2006
2006-11-16,Pulau Pinang,0,0,0,2006
2006-11-17,Pulau Pinang,0,0,0,2006
2006-11-18,Pulau Pinang,0,0,0,2006
2006-11-19,Pulau Pinang,0,0,0,2006
2006-11-20,Pulau Pinang,0,0,0,2006
2006-11-21,Pulau Pinang,0,0,0,2006
2006-11-22,Pulau Pinang,0,0,0,2006
2006-11-23,Pulau Pinang,0,0,0,2006
2006-11-24,Pulau Pinang,0,0,0,2006
2006-11-25,Pulau Pinang,0,0,0,2006
2006-11-26,Pulau Pinang,0,0,0,2006
2006-11-27,Pulau Pinang,0,0,0,2006
2006-11-28,Pulau Pinang,0,0,0,2006
2006-11-29,Pulau Pinang,0,0,0,2006
2006-11-30,Pulau Pinang,0,0,0,2006
2006-12-01,Pulau Pinang,0,0,0,2006
2006-12-02,Pulau Pinang,0,0,0,2006
2006-12-03,Pulau Pinang,0,0,0,2006
2006-12-04,Pulau Pinang,0,0,0,2006
2006-12-05,Pulau Pinang,0,0,0,2006
2006-12-06,Pulau Pinang,0,0,0,2006
2006-12-07,Pulau Pinang,0,0,0,2006
2006-12-08,Pulau Pinang,0,0,0,2006
2006-12-09,Pulau Pinang,0,0,0,2006
2006-12-10,Pulau Pinang,0,0,0,2006
2006-12-11,Pulau Pinang,0,0,0,2006
2006-12-12,Pulau Pinang,0,0,0,2006
2006-12-13,Pulau Pinang,0,0,0,2006
2006-12-14,Pulau Pinang,0,0,0,2006
2006-12-15,Pulau Pinang,0,0,0,2006
2006-12-16,Pulau Pinang,0,0,0,2006
2006-12-17,Pulau Pinang,0,0,0,2006
2006-12-18,Pulau Pinang,0,0,0,2006
2006-12-19,Pulau Pinang,0,0,0,2006
2006-12-20,Pulau Pinang,0,0,0,2006
2006-12-21,Pulau Pinang,0,0,0,2006
2006-12-22,Pulau Pinang,0,0,0,2006
2006-12-23,Pulau Pinang,0,0,0,2006
2006-12-24,Pulau Pinang,0,0,0,2006
2006-12-25,Pulau Pinang,0,0,0,2006
2006-12-26,Pulau Pinang,0,0,0,2006
2006-12-27,Pulau Pinang,0,0,0,2006
2006-12-28,Pulau Pinang,0,0,0,2006
2006-12-29,Pulau Pinang,0,0,0,2006
2006-12-30,Pulau Pinang,0,0,0,2006
2006-12-31,Pulau Pinang,0,0,0,2006
2007-01-01,Pulau Pinang,0,0,0,2007
2007-01-02,Pulau Pinang,0,0,0,2007
2007-01-03,Pulau Pinang,0,0,0,2007
2007-01-04,Pulau Pinang,0,0,0,2007
2007-01-05,Pulau Pinang,0,0,0,2007
2007-01-06,Pulau Pinang,0,0,0,2007
2007-01-07,Pulau Pinang,0,0,0,2007
2007-01-08,Pulau Pinang,0,0,0,2007
2007-01-09,Pulau Pinang,0,0,0,2007
2007-01-10,Pulau Pinang,0,0,0,2007
2007-01-11,Pulau Pinang,0,0,0,2007
2007-01-12,Pulau Pinang,0,0,0,2007
2007-01-13,Pulau Pinang,0,0,0,2007
2007-01-14,Pulau Pinang,0,0,0,2007
2007-01-15,Pulau Pinang,0,0,0,2007
2007-01-16,Pulau Pinang,0,0,0,2007
2007-01-17,Pulau Pinang,0,0,0,2007
2007-01-18,Pulau Pinang,0,0,0,2007
2007-01-19,Pulau Pinang,0,0,0,2007
2007-01-20,Pulau Pinang,0,0,0,2007
2007-01-21,Pulau Pinang,0,0,0,2007
2007-01-22,Pulau Pinang,0,0,0,2007
2007-01-23,Pulau Pinang,0,0,0,2007
2007-01-24,Pulau Pinang,0,0,0,2007
2007-01-25,Pulau Pinang,0,0,0,2007
2007-01-26,Pulau Pinang,0,0,0,2007
2007-01-27,Pulau Pinang,0,0,0,2007
2007-01-28,Pulau Pinang,0,0,0,2007
2007-01-29,Pulau Pinang,0,0,0,2007
2007-01-30,Pulau Pinang,0,0,0,2007
2007-01-31,Pulau Pinang,0,0,0,2007
2007-02-01,Pulau Pinang,0,0,0,2007
2007-02-02,Pulau Pinang,0,0,0,2007
2007-02-03,Pulau Pinang,0,0,0,2007
2007-02-04,Pulau Pinang,0,0,0,2007
2007-02-05,Pulau Pinang,0,0,0,2007
2007-02-06,Pulau Pinang,0,0,0,2007
2007-02-07,Pulau Pinang,0,0,0,2007
2007-02-08,Pulau Pinang,0,0,0,2007
2007-02-09,Pulau Pinang,0,0,0,2007
2007-02-10,Pulau Pinang,0,0,0,2007
2007-02-11,Pulau Pinang,0,0,0,2007
2007-02-12,Pulau Pinang,0,0,0,2007
2007-02-13,Pulau Pinang,0,0,0,2007
2007-02-14,Pulau Pinang,0,0,0,2007
2007-02-15,Pulau Pinang,0,0,0,2007
2007-02-16,Pulau Pinang,0,0,0,2007
2007-02-17,Pulau Pinang,0,0,0,2007
2007-02-18,Pulau Pinang,0,0,0,2007
2007-02-19,Pulau Pinang,0,0,0,2007
2007-02-20,Pulau Pinang,0,0,0,2007
2007-02-21,Pulau Pinang,0,0,0,2007
2007-02-22,Pulau Pinang,0,0,0,2007
2007-02-23,Pulau Pinang,0,0,0,2007
2007-02-24,Pulau Pinang,0,0,0,2007
2007-02-25,Pulau Pinang,0,0,0,2007
2007-02-26,Pulau Pinang,0,0,0,2007
2007-02-27,Pulau Pinang,0,0,0,2007
2007-02-28,Pulau Pinang,0,0,0,2007
2007-03-01,Pulau Pinang,0,0,0,2007
2007-03-02,Pulau Pinang,0,0,0,2007
2007-03-03,Pulau Pinang,0,0,0,2007
2007-03-04,Pulau Pinang,0,0,0,2007
2007-03-05,Pulau Pinang,0,0,0,2007
2007-03-06,Pulau Pinang,0,0,0,2007
2007-03-07,Pulau Pinang,0,0,0,2007
2007-03-08,Pulau Pinang,0,0,0,2007
2007-03-09,Pulau Pinang,0,0,0,2007
2007-03-10,Pulau Pinang,0,0,0,2007
2007-03-11,Pulau Pinang,0,0,0,2007
2007-03-12,Pulau Pinang,0,0,0,2007
2007-03-13,Pulau Pinang,0,0,0,2007
2007-03-14,Pulau Pinang,0,0,0,2007
2007-03-15,Pulau Pinang,0,0,0,2007
2007-03-16,Pulau Pinang,0,0,0,2007
2007-03-17,Pulau Pinang,0,0,0,2007
2007-03-18,Pulau Pinang,0,0,0,2007
2007-03-19,Pulau Pinang,0,0,0,2007
2007-03-20,Pulau Pinang,0,0,0,2007
2007-03-21,Pulau Pinang,0,0,0,2007
2007-03-22,Pulau Pinang,0,0,0,2007
2007-03-23,Pulau Pinang,0,0,0,2007
2007-03-24,Pulau Pinang,0,0,0,2007
2007-03-25,Pulau Pinang,0,0,0,2007
2007-03-26,Pulau Pinang,0,0,0,2007
2007-03-27,Pulau Pinang,0,0,0,2007
2007-03-28,Pulau Pinang,0,0,0,2007
2007-03-29,Pulau Pinang,0,0,0,2007
2007-03-30,Pulau Pinang,0,0,0,2007
2007-03-31,Pulau Pinang,0,0,0,2007
2007-04-01,Pulau Pinang,0,0,0,2007
2007-04-02,Pulau Pinang,0,0,0,2007
2007-04-03,Pulau Pinang,0,0,0,2007
2007-04-04,Pulau Pinang,0,0,0,2007
2007-04-05,Pulau Pinang,0,0,0,2007
2007-04-06,Pulau Pinang,0,0,0,2007
2007-04-07,Pulau Pinang,0,0,0,2007
2007-04-08,Pulau Pinang,0,0,0,2007
2007-04-09,Pulau Pinang,0,0,0,2007
2007-04-10,Pulau Pinang,0,0,0,2007
2007-04-11,Pulau Pinang,0,0,0,2007
2007-04-12,Pulau Pinang,0,0,0,2007
2007-04-13,Pulau Pinang,0,0,0,2007
2007-04-14,Pulau Pinang,0,0,0,2007
2007-04-15,Pulau Pinang,0,0,0,2007
2007-04-16,Pulau Pinang,0,0,0,2007
2007-04-17,Pulau Pinang,0,0,0,2007
2007-04-18,Pulau Pinang,0,0,0,2007
2007-04-19,Pulau Pinang,0,0,0,2007
2007-04-20,Pulau Pinang,0,0,0,2007
2007-04-21,Pulau Pinang,0,0,0,2007
2007-04-22,Pulau Pinang,0,0,0,2007
2007-04-23,Pulau Pinang,0,0,0,2007
2007-04-24,Pulau Pinang,0,0,0,2007
2007-04-25,Pulau Pinang,0,0,0,2007
2007-04-26,Pulau Pinang,0,0,0,2007
2007-04-27,Pulau Pinang,0,0,0,2007
2007-04-28,Pulau Pinang,0,0,0,2007
2007-04-29,Pulau Pinang,0,0,0,2007
2007-04-30,Pulau Pinang,0,0,0,2007
2007-05-01,Pulau Pinang,0,0,0,2007
2007-05-02,Pulau Pinang,0,0,0,2007
2007-05-03,Pulau Pinang,0,0,0,2007
2007-05-04,Pulau Pinang,0,0,0,2007
2007-05-05,Pulau Pinang,0,0,0,2007
2007-05-06,Pulau Pinang,0,0,0,2007
2007-05-07,Pulau Pinang,0,0,0,2007
2007-05-08,Pulau Pinang,0,0,0,2007
2007-05-09,Pulau Pinang,0,0,0,2007
2007-05-10,Pulau Pinang,0,0,0,2007
2007-05-11,Pulau Pinang,0,0,0,2007
2007-05-12,Pulau Pinang,0,0,0,2007
2007-05-13,Pulau Pinang,0,0,0,2007
2007-05-14,Pulau Pinang,0,0,0,2007
2007-05-15,Pulau Pinang,0,0,0,2007
2007-05-16,Pulau Pinang,0,0,0,2007
2007-05-17,Pulau Pinang,0,0,0,2007
2007-05-18,Pulau Pinang,0,0,0,2007
2007-05-19,Pulau Pinang,0,0,0,2007
2007-05-20,Pulau Pinang,0,0,0,2007
2007-05-21,Pulau Pinang,0,0,0,2007
2007-05-22,Pulau Pinang,0,0,0,2007
2007-05-23,Pulau Pinang,0,0,0,2007
2007-05-24,Pulau Pinang,0,0,0,2007
2007-05-25,Pulau Pinang,0,0,0,2007
2007-05-26,Pulau Pinang,0,0,0,2007
2007-05-27,Pulau Pinang,0,0,0,2007
2007-05-28,Pulau Pinang,0,0,0,2007
2007-05-29,Pulau Pinang,0,0,0,2007
2007-05-30,Pulau Pinang,0,0,0,2007
2007-05-31,Pulau Pinang,0,0,0,2007
2007-06-01,Pulau Pinang,0,0,0,2007
2007-06-02,Pulau Pinang,0,0,0,2007
2007-06-03,Pulau Pinang,0,0,0,2007
2007-06-04,Pulau Pinang,0,0,0,2007
2007-06-05,Pulau Pinang,0,0,0,2007
2007-06-06,Pulau Pinang,0,0,0,2007
2007-06-07,Pulau Pinang,0,0,0,2007
2007-06-08,Pulau Pinang,0,0,0,2007
2007-06-09,Pulau Pinang,0,0,0,2007
2007-06-10,Pulau Pinang,0,0,0,2007
2007-06-11,Pulau Pinang,0,0,0,2007
2007-06-12,Pulau Pinang,0,0,0,2007
2007-06-13,Pulau Pinang,0,0,0,2007
2007-06-14,Pulau Pinang,0,0,0,2007
2007-06-15,Pulau Pinang,0,0,0,2007
2007-06-16,Pulau Pinang,0,0,0,2007
2007-06-17,Pulau Pinang,0,0,0,2007
2007-06-18,Pulau Pinang,0,0,0,2007
2007-06-19,Pulau Pinang,0,0,0,2007
2007-06-20,Pulau Pinang,0,0,0,2007
2007-06-21,Pulau Pinang,0,0,0,2007
2007-06-22,Pulau Pinang,0,0,0,2007
2007-06-23,Pulau Pinang,0,0,0,2007
2007-06-24,Pulau Pinang,0,0,0,2007
2007-06-25,Pulau Pinang,0,0,0,2007
2007-06-26,Pulau Pinang,0,0,0,2007
2007-06-27,Pulau Pinang,0,0,0,2007
2007-06-28,Pulau Pinang,0,0,0,2007
2007-06-29,Pulau Pinang,0,0,0,2007
2007-06-30,Pulau Pinang,0,0,0,2007
2007-07-01,Pulau Pinang,0,0,0,2007
2007-07-02,Pulau Pinang,0,0,0,2007
2007-07-03,Pulau Pinang,0,0,0,2007
2007-07-04,Pulau Pinang,0,0,0,2007
2007-07-05,Pulau Pinang,0,0,0,2007
2007-07-06,Pulau Pinang,0,0,0,2007
2007-07-07,Pulau Pinang,0,0,0,2007
2007-07-08,Pulau Pinang,0,0,0,2007
2007-07-09,Pulau Pinang,0,0,0,2007
2007-07-10,Pulau Pinang,0,0,0,2007
2007-07-11,Pulau Pinang,0,0,0,2007
2007-07-12,Pulau Pinang,0,0,0,2007
2007-07-13,Pulau Pinang,0,0,0,2007
2007-07-14,Pulau Pinang,0,0,0,2007
2007-07-15,Pulau Pinang,0,0,0,2007
2007-07-16,Pulau Pinang,0,0,0,2007
2007-07-17,Pulau Pinang,0,0,0,2007
2007-07-18,Pulau Pinang,0,0,0,2007
2007-07-19,Pulau Pinang,0,0,0,2007
2007-07-20,Pulau Pinang,0,0,0,2007
2007-07-21,Pulau Pinang,0,0,0,2007
2007-07-22,Pulau Pinang,0,0,0,2007
2007-07-23,Pulau Pinang,0,0,0,2007
2007-07-24,Pulau Pinang,0,0,0,2007
2007-07-25,Pulau Pinang,0,0,0,2007
2007-07-26,Pulau Pinang,0,0,0,2007
2007-07-27,Pulau Pinang,0,0,0,2007
2007-07-28,Pulau Pinang,0,0,0,2007
2007-07-29,Pulau Pinang,0,0,0,2007
2007-07-30,Pulau Pinang,0,0,0,2007
2007-07-31,Pulau Pinang,0,0,0,2007
2007-08-01,Pulau Pinang,0,0,0,2007
2007-08-02,Pulau Pinang,0,0,0,2007
2007-08-03,Pulau Pinang,0,0,0,2007
2007-08-04,Pulau Pinang,0,0,0,2007
2007-08-05,Pulau Pinang,0,0,0,2007
2007-08-06,Pulau Pinang,0,0,0,2007
2007-08-07,Pulau Pinang,0,0,0,2007
2007-08-08,Pulau Pinang,0,0,0,2007
2007-08-09,Pulau Pinang,0,0,0,2007
2007-08-10,Pulau Pinang,0,0,0,2007
2007-08-11,Pulau Pinang,0,0,0,2007
2007-08-12,Pulau Pinang,0,0,0,2007
2007-08-13,Pulau Pinang,0,0,0,2007
2007-08-14,Pulau Pinang,0,0,0,2007
2007-08-15,Pulau Pinang,0,0,0,2007
2007-08-16,Pulau Pinang,0,0,0,2007
2007-08-17,Pulau Pinang,0,0,0,2007
2007-08-18,Pulau Pinang,0,0,0,2007
2007-08-19,Pulau Pinang,0,0,0,2007
2007-08-20,Pulau Pinang,0,0,0,2007
2007-08-21,Pulau Pinang,0,0,0,2007
2007-08-22,Pulau Pinang,0,0,0,2007
2007-08-23,Pulau Pinang,0,0,0,2007
2007-08-24,Pulau Pinang,0,0,0,2007
2007-08-25,Pulau Pinang,0,0,0,2007
2007-08-26,Pulau Pinang,0,0,0,2007
2007-08-27,Pulau Pinang,0,0,0,2007
2007-08-28,Pulau Pinang,0,0,0,2007
2007-08-29,Pulau Pinang,0,0,0,2007
2007-08-30,Pulau Pinang,0,0,0,2007
2007-08-31,Pulau Pinang,0,0,0,2007
2007-09-01,Pulau Pinang,0,0,0,2007
2007-09-02,Pulau Pinang,0,0,0,2007
2007-09-03,Pulau Pinang,0,0,0,2007
2007-09-04,Pulau Pinang,0,0,0,2007
2007-09-05,Pulau Pinang,0,0,0,2007
2007-09-06,Pulau Pinang,0,0,0,2007
2007-09-07,Pulau Pinang,0,0,0,2007
2007-09-08,Pulau Pinang,0,0,0,2007
2007-09-09,Pulau Pinang,0,0,0,2007
2007-09-10,Pulau Pinang,0,0,0,2007
2007-09-11,Pulau Pinang,0,0,0,2007
2007-09-12,Pulau Pinang,0,0,0,2007
2007-09-13,Pulau Pinang,0,0,0,2007
2007-09-14,Pulau Pinang,0,0,0,2007
2007-09-15,Pulau Pinang,0,0,0,2007
2007-09-16,Pulau Pinang,0,0,0,2007
2007-09-17,Pulau Pinang,0,0,0,2007
2007-09-18,Pulau Pinang,0,0,0,2007
2007-09-19,Pulau Pinang,0,0,0,2007
2007-09-20,Pulau Pinang,0,0,0,2007
2007-09-21,Pulau Pinang,0,0,0,2007
2007-09-22,Pulau Pinang,0,0,0,2007
2007-09-23,Pulau Pinang,0,0,0,2007
2007-09-24,Pulau Pinang,0,0,0,2007
2007-09-25,Pulau Pinang,0,0,0,2007
2007-09-26,Pulau Pinang,0,0,0,2007
2007-09-27,Pulau Pinang,0,0,0,2007
2007-09-28,Pulau Pinang,0,0,0,2007
2007-09-29,Pulau Pinang,0,0,0,2007
2007-09-30,Pulau Pinang,0,0,0,2007
2007-10-01,Pulau Pinang,0,0,0,2007
2007-10-02,Pulau Pinang,0,0,0,2007
2007-10-03,Pulau Pinang,0,0,0,2007
2007-10-04,Pulau Pinang,0,0,0,2007
2007-10-05,Pulau Pinang,0,0,0,2007
2007-10-06,Pulau Pinang,0,0,0,2007
2007-10-07,Pulau Pinang,0,0,0,2007
2007-10-08,Pulau Pinang,0,0,0,2007
2007-10-09,Pulau Pinang,0,0,0,2007
2007-10-10,Pulau Pinang,0,0,0,2007
2007-10-11,Pulau Pinang,0,0,0,2007
2007-10-12,Pulau Pinang,0,0,0,2007
2007-10-13,Pulau Pinang,0,0,0,2007
2007-10-14,Pulau Pinang,0,0,0,2007
2007-10-15,Pulau Pinang,0,0,0,2007
2007-10-16,Pulau Pinang,0,0,0,2007
2007-10-17,Pulau Pinang,0,0,0,2007
2007-10-18,Pulau Pinang,0,0,0,2007
2007-10-19,Pulau Pinang,0,0,0,2007
2007-10-20,Pulau Pinang,0,0,0,2007
2007-10-21,Pulau Pinang,0,0,0,2007
2007-10-22,Pulau Pinang,0,0,0,2007
2007-10-23,Pulau Pinang,0,0,0,2007
2007-10-24,Pulau Pinang,0,0,0,2007
2007-10-25,Pulau Pinang,0,0,0,2007
2007-10-26,Pulau Pinang,0,0,0,2007
2007-10-27,Pulau Pinang,0,0,0,2007
2007-10-28,Pulau Pinang,0,0,0,2007
2007-10-29,Pulau Pinang,0,0,0,2007
2007-10-30,Pulau Pinang,0,0,0,2007
2007-10-31,Pulau Pinang,0,0,0,2007
2007-11-01,Pulau Pinang,0,0,0,2007
2007-11-02,Pulau Pinang,0,0,0,2007
2007-11-03,Pulau Pinang,0,0,0,2007
2007-11-04,Pulau Pinang,0,0,0,2007
2007-11-05,Pulau Pinang,0,0,0,2007
2007-11-06,Pulau Pinang,0,0,0,2007
2007-11-07,Pulau Pinang,0,0,0,2007
2007-11-08,Pulau Pinang,0,0,0,2007
2007-11-09,Pulau Pinang,0,0,0,2007
2007-11-10,Pulau Pinang,0,0,0,2007
2007-11-11,Pulau Pinang,0,0,0,2007
2007-11-12,Pulau Pinang,0,0,0,2007
2007-11-13,Pulau Pinang,0,0,0,2007
2007-11-14,Pulau Pinang,0,0,0,2007
2007-11-15,Pulau Pinang,0,0,0,2007
2007-11-16,Pulau Pinang,0,0,0,2007
2007-11-17,Pulau Pinang,0,0,0,2007
2007-11-18,Pulau Pinang,0,0,0,2007
2007-11-19,Pulau Pinang,0,0,0,2007
2007-11-20,Pulau Pinang,0,0,0,2007
2007-11-21,Pulau Pinang,0,0,0,2007
2007-11-22,Pulau Pinang,0,0,0,2007
2007-11-23,Pulau Pinang,0,0,0,2007
2007-11-24,Pulau Pinang,0,0,0,2007
2007-11-25,Pulau Pinang,0,0,0,2007
2007-11-26,Pulau Pinang,0,0,0,2007
2007-11-27,Pulau Pinang,0,0,0,2007
2007-11-28,Pulau Pinang,0,0,0,2007
2007-11-29,Pulau Pinang,0,0,0,2007
2007-11-30,Pulau Pinang,0,0,0,2007
2007-12-01,Pulau Pinang,0,0,0,2007
2007-12-02,Pulau Pinang,0,0,0,2007
2007-12-03,Pulau Pinang,0,0,0,2007
2007-12-04,Pulau Pinang,0,0,0,2007
2007-12-05,Pulau Pinang,0,0,0,2007
2007-12-06,Pulau Pinang,0,0,0,2007
2007-12-07,Pulau Pinang,0,0,0,2007
2007-12-08,Pulau Pinang,0,0,0,2007
2007-12-09,Pulau Pinang,0,0,0,2007
2007-12-10,Pulau Pinang,0,0,0,2007
2007-12-11,Pulau Pinang,0,0,0,2007
2007-12-12,Pulau Pinang,0,0,0,2007
2007-12-13,Pulau Pinang,0,0,0,2007
2007-12-14,Pulau Pinang,0,0,0,2007
2007-12-15,Pulau Pinang,0,0,0,2007
2007-12-16,Pulau Pinang,0,0,0,2007
2007-12-17,Pulau Pinang,0,0,0,2007
2007-12-18,Pulau Pinang,0,0,0,2007
2007-12-19,Pulau Pinang,0,0,0,2007
2007-12-20,Pulau Pinang,0,0,0,2007
2007-12-21,Pulau Pinang,0,0,0,2007
2007-12-22,Pulau Pinang,0,0,0,2007
2007-12-23,Pulau Pinang,0,0,0,2007
2007-12-24,Pulau Pinang,0,0,0,2007
2007-12-25,Pulau Pinang,0,0,0,2007
2007-12-26,Pulau Pinang,0,0,0,2007
2007-12-27,Pulau Pinang,0,0,0,2007
2007-12-28,Pulau Pinang,0,0,0,2007
2007-12-29,Pulau Pinang,0,0,0,2007
2007-12-30,Pulau Pinang,0,0,0,2007
2007-12-31,Pulau Pinang,0,0,0,2007
2008-01-01,Pulau Pinang,0,0,0,2008
2008-01-02,Pulau Pinang,0,0,0,2008
2008-01-03,Pulau Pinang,0,0,0,2008
2008-01-04,Pulau Pinang,0,0,0,2008
2008-01-05,Pulau Pinang,0,0,0,2008
2008-01-06,Pulau Pinang,0,0,0,2008
2008-01-07,Pulau Pinang,0,0,0,2008
2008-01-08,Pulau Pinang,0,0,0,2008
2008-01-09,Pulau Pinang,0,0,0,2008
2008-01-10,Pulau Pinang,0,0,0,2008
2008-01-11,Pulau Pinang,0,0,0,2008
2008-01-12,Pulau Pinang,0,0,0,2008
2008-01-13,Pulau Pinang,0,0,0,2008
2008-01-14,Pulau Pinang,0,0,0,2008
2008-01-15,Pulau Pinang,0,0,0,2008
2008-01-16,Pulau Pinang,0,0,0,2008
2008-01-17,Pulau Pinang,0,0,0,2008
2008-01-18,Pulau Pinang,0,0,0,2008
2008-01-19,Pulau Pinang,0,0,0,2008
2008-01-20,Pulau Pinang,0,0,0,2008
2008-01-21,Pulau Pinang,0,0,0,2008
2008-01-22,Pulau Pinang,0,0,0,2008
2008-01-23,Pulau Pinang,0,0,0,2008
2008-01-24,Pulau Pinang,0,0,0,2008
2008-01-25,Pulau Pinang,0,0,0,2008
2008-01-26,Pulau Pinang,0,0,0,2008
2008-01-27,Pulau Pinang,0,0,0,2008
2008-01-28,Pulau Pinang,0,0,0,2008
2008-01-29,Pulau Pinang,0,0,0,2008
2008-01-30,Pulau Pinang,0,0,0,2008
2008-01-31,Pulau Pinang,0,0,0,2008
2008-02-01,Pulau Pinang,0,0,0,2008
2008-02-02,Pulau Pinang,0,0,0,2008
2008-02-03,Pulau Pinang,0,0,0,2008
2008-02-04,Pulau Pinang,0,0,0,2008
2008-02-05,Pulau Pinang,0,0,0,2008
2008-02-06,Pulau Pinang,0,0,0,2008
2008-02-07,Pulau Pinang,0,0,0,2008
2008-02-08,Pulau Pinang,0,0,0,2008
2008-02-09,Pulau Pinang,0,0,0,2008
2008-02-10,Pulau Pinang,0,0,0,2008
2008-02-11,Pulau Pinang,0,0,0,2008
2008-02-12,Pulau Pinang,0,0,0,2008
2008-02-13,Pulau Pinang,0,0,0,2008
2008-02-14,Pulau Pinang,0,0,0,2008
2008-02-15,Pulau Pinang,0,0,0,2008
2008-02-16,Pulau Pinang,0,0,0,2008
2008-02-17,Pulau Pinang,0,0,0,2008
2008-02-18,Pulau Pinang,0,0,0,2008
2008-02-19,Pulau Pinang,0,0,0,2008
2008-02-20,Pulau Pinang,0,0,0,2008
2008-02-21,Pulau Pinang,0,0,0,2008
2008-02-22,Pulau Pinang,0,0,0,2008
2008-02-23,Pulau Pinang,0,0,0,2008
2008-02-24,Pulau Pinang,0,0,0,2008
2008-02-25,Pulau Pinang,0,0,0,2008
2008-02-26,Pulau Pinang,0,0,0,2008
2008-02-27,Pulau Pinang,0,0,0,2008
2008-02-28,Pulau Pinang,0,0,0,2008
2008-02-29,Pulau Pinang,0,0,0,2008
2008-03-01,Pulau Pinang,0,0,0,2008
2008-03-02,Pulau Pinang,0,0,0,2008
2008-03-03,Pulau Pinang,0,0,0,2008
2008-03-04,Pulau Pinang,0,0,0,2008
2008-03-05,Pulau Pinang,0,0,0,2008
2008-03-06,Pulau Pinang,0,0,0,2008
2008-03-07,Pulau Pinang,0,0,0,2008
2008-03-08,Pulau Pinang,0,0,0,2008
2008-03-09,Pulau Pinang,0,0,0,2008
2008-03-10,Pulau Pinang,0,0,0,2008
2008-03-11,Pulau Pinang,0,0,0,2008
2008-03-12,Pulau Pinang,0,0,0,2008
2008-03-13,Pulau Pinang,0,0,0,2008
2008-03-14,Pulau Pinang,0,0,0,2008
2008-03-15,Pulau Pinang,0,0,0,2008
2008-03-16,Pulau Pinang,0,0,0,2008
2008-03-17,Pulau Pinang,0,0,0,2008
2008-03-18,Pulau Pinang,0,0,0,2008
2008-03-19,Pulau Pinang,0,0,0,2008
2008-03-20,Pulau Pinang,0,0,0,2008
2008-03-21,Pulau Pinang,0,0,0,2008
2008-03-22,Pulau Pinang,0,0,0,2008
2008-03-23,Pulau Pinang,0,0,0,2008
2008-03-24,Pulau Pinang,0,0,0,2008
2008-03-25,Pulau Pinang,0,0,0,2008
2008-03-26,Pulau Pinang,0,0,0,2008
2008-03-27,Pulau Pinang,0,0,0,2008
2008-03-28,Pulau Pinang,0,0,0,2008
2008-03-29,Pulau Pinang,0,0,0,2008
2008-03-30,Pulau Pinang,0,0,0,2008
2008-03-31,Pulau Pinang,0,0,0,2008
2008-04-01,Pulau Pinang,0,0,0,2008
2008-04-02,Pulau Pinang,0,0,0,2008
2008-04-03,Pulau Pinang,0,0,0,2008
2008-04-04,Pulau Pinang,0,0,0,2008
2008-04-05,Pulau Pinang,0,0,0,2008
2008-04-06,Pulau Pinang,0,0,0,2008
2008-04-07,Pulau Pinang,0,0,0,2008
2008-04-08,Pulau Pinang,0,0,0,2008
2008-04-09,Pulau Pinang,0,0,0,2008
2008-04-10,Pulau Pinang,0,0,0,2008
2008-04-11,Pulau Pinang,0,0,0,2008
2008-04-12,Pulau Pinang,0,0,0,2008
2008-04-13,Pulau Pinang,0,0,0,2008
2008-04-14,Pulau Pinang,0,0,0,2008
2008-04-15,Pulau Pinang,0,0,0,2008
2008-04-16,Pulau Pinang,0,0,0,2008
2008-04-17,Pulau Pinang,0,0,0,2008
2008-04-18,Pulau Pinang,0,0,0,2008
2008-04-19,Pulau Pinang,0,0,0,2008
2008-04-20,Pulau Pinang,0,0,0,2008
2008-04-21,Pulau Pinang,0,0,0,2008
2008-04-22,Pulau Pinang,0,0,0,2008
2008-04-23,Pulau Pinang,0,0,0,2008
2008-04-24,Pulau Pinang,0,0,0,2008
2008-04-25,Pulau Pinang,0,0,0,2008
2008-04-26,Pulau Pinang,0,0,0,2008
2008-04-27,Pulau Pinang,0,0,0,2008
2008-04-28,Pulau Pinang,0,0,0,2008
2008-04-29,Pulau Pinang,0,0,0,2008
2008-04-30,Pulau Pinang,0,0,0,2008
2008-05-01,Pulau Pinang,0,0,0,2008
2008-05-02,Pulau Pinang,0,0,0,2008
2008-05-03,Pulau Pinang,0,0,0,2008
2008-05-04,Pulau Pinang,0,0,0,2008
2008-05-05,Pulau Pinang,0,0,0,2008
2008-05-06,Pulau Pinang,0,0,0,2008
2008-05-07,Pulau Pinang,0,0,0,2008
2008-05-08,Pulau Pinang,0,0,0,2008
2008-05-09,Pulau Pinang,0,0,0,2008
2008-05-10,Pulau Pinang,0,0,0,2008
2008-05-11,Pulau Pinang,0,0,0,2008
2008-05-12,Pulau Pinang,0,0,0,2008
2008-05-13,Pulau Pinang,0,0,0,2008
2008-05-14,Pulau Pinang,0,0,0,2008
2008-05-15,Pulau Pinang,0,0,0,2008
2008-05-16,Pulau Pinang,0,0,0,2008
2008-05-17,Pulau Pinang,0,0,0,2008
2008-05-18,Pulau Pinang,0,0,0,2008
2008-05-19,Pulau Pinang,0,0,0,2008
2008-05-20,Pulau Pinang,0,0,0,2008
2008-05-21,Pulau Pinang,0,0,0,2008
2008-05-22,Pulau Pinang,0,0,0,2008
2008-05-23,Pulau Pinang,0,0,0,2008
2008-05-24,Pulau Pinang,0,0,0,2008
2008-05-25,Pulau Pinang,0,0,0,2008
2008-05-26,Pulau Pinang,0,0,0,2008
2008-05-27,Pulau Pinang,0,0,0,2008
2008-05-28,Pulau Pinang,0,0,0,2008
2008-05-29,Pulau Pinang,0,0,0,2008
2008-05-30,Pulau Pinang,0,0,0,2008
2008-05-31,Pulau Pinang,0,0,0,2008
2008-06-01,Pulau Pinang,0,0,0,2008
2008-06-02,Pulau Pinang,0,0,0,2008
2008-06-03,Pulau Pinang,0,0,0,2008
2008-06-04,Pulau Pinang,0,0,0,2008
2008-06-05,Pulau Pinang,0,0,0,2008
2008-06-06,Pulau Pinang,0,0,0,2008
2008-06-07,Pulau Pinang,0,0,0,2008
2008-06-08,Pulau Pinang,0,0,0,2008
2008-06-09,Pulau Pinang,0,0,0,2008
2008-06-10,Pulau Pinang,0,0,0,2008
2008-06-11,Pulau Pinang,0,0,0,2008
2008-06-12,Pulau Pinang,0,0,0,2008
2008-06-13,Pulau Pinang,0,0,0,2008
2008-06-14,Pulau Pinang,0,0,0,2008
2008-06-15,Pulau Pinang,0,0,0,2008
2008-06-16,Pulau Pinang,0,0,0,2008
2008-06-17,Pulau Pinang,0,0,0,2008
2008-06-18,Pulau Pinang,0,0,0,2008
2008-06-19,Pulau Pinang,0,0,0,2008
2008-06-20,Pulau Pinang,0,0,0,2008
2008-06-21,Pulau Pinang,0,0,0,2008
2008-06-22,Pulau Pinang,0,0,0,2008
2008-06-23,Pulau Pinang,0,0,0,2008
2008-06-24,Pulau Pinang,0,0,0,2008
2008-06-25,Pulau Pinang,0,0,0,2008
2008-06-26,Pulau Pinang,0,0,0,2008
2008-06-27,Pulau Pinang,0,0,0,2008
2008-06-28,Pulau Pinang,0,0,0,2008
2008-06-29,Pulau Pinang,0,0,0,2008
2008-06-30,Pulau Pinang,0,0,0,2008
2008-07-01,Pulau Pinang,0,0,0,2008
2008-07-02,Pulau Pinang,0,0,0,2008
2008-07-03,Pulau Pinang,0,0,0,2008
2008-07-04,Pulau Pinang,0,0,0,2008
2008-07-05,Pulau Pinang,0,0,0,2008
2008-07-06,Pulau Pinang,0,0,0,2008
2008-07-07,Pulau Pinang,0,0,0,2008
2008-07-08,Pulau Pinang,0,0,0,2008
2008-07-09,Pulau Pinang,0,0,0,2008
2008-07-10,Pulau Pinang,0,0,0,2008
2008-07-11,Pulau Pinang,0,0,0,2008
2008-07-12,Pulau Pinang,0,0,0,2008
2008-07-13,Pulau Pinang,0,0,0,2008
2008-07-14,Pulau Pinang,0,0,0,2008
2008-07-15,Pulau Pinang,0,0,0,2008
2008-07-16,Pulau Pinang,0,0,0,2008
2008-07-17,Pulau Pinang,0,0,0,2008
2008-07-18,Pulau Pinang,0,0,0,2008
2008-07-19,Pulau Pinang,0,0,0,2008
2008-07-20,Pulau Pinang,0,0,0,2008
2008-07-21,Pulau Pinang,0,0,0,2008
2008-07-22,Pulau Pinang,0,0,0,2008
2008-07-23,Pulau Pinang,0,0,0,2008
2008-07-24,Pulau Pinang,0,0,0,2008
2008-07-25,Pulau Pinang,0,0,0,2008
2008-07-26,Pulau Pinang,0,0,0,2008
2008-07-27,Pulau Pinang,0,0,0,2008
2008-07-28,Pulau Pinang,0,0,0,2008
2008-07-29,Pulau Pinang,0,0,0,2008
2008-07-30,Pulau Pinang,0,0,0,2008
2008-07-31,Pulau Pinang,0,0,0,2008
2008-08-01,Pulau Pinang,0,0,0,2008
2008-08-02,Pulau Pinang,0,0,0,2008
2008-08-03,Pulau Pinang,0,0,0,2008
2008-08-04,Pulau Pinang,0,0,0,2008
2008-08-05,Pulau Pinang,0,0,0,2008
2008-08-06,Pulau Pinang,0,0,0,2008
2008-08-07,Pulau Pinang,0,0,0,2008
2008-08-08,Pulau Pinang,0,0,0,2008
2008-08-09,Pulau Pinang,0,0,0,2008
2008-08-10,Pulau Pinang,0,0,0,2008
2008-08-11,Pulau Pinang,0,0,0,2008
2008-08-12,Pulau Pinang,0,0,0,2008
2008-08-13,Pulau Pinang,0,0,0,2008
2008-08-14,Pulau Pinang,0,0,0,2008
2008-08-15,Pulau Pinang,0,0,0,2008
2008-08-16,Pulau Pinang,0,0,0,2008
2008-08-17,Pulau Pinang,0,0,0,2008
2008-08-18,Pulau Pinang,0,0,0,2008
2008-08-19,Pulau Pinang,0,0,0,2008
2008-08-20,Pulau Pinang,0,0,0,2008
2008-08-21,Pulau Pinang,0,0,0,2008
2008-08-22,Pulau Pinang,0,0,0,2008
2008-08-23,Pulau Pinang,0,0,0,2008
2008-08-24,Pulau Pinang,0,0,0,2008
2008-08-25,Pulau Pinang,0,0,0,2008
2008-08-26,Pulau Pinang,0,0,0,2008
2008-08-27,Pulau Pinang,0,0,0,2008
2008-08-28,Pulau Pinang,0,0,0,2008
2008-08-29,Pulau Pinang,0,0,0,2008
2008-08-30,Pulau Pinang,0,0,0,2008
2008-08-31,Pulau Pinang,0,0,0,2008
2008-09-01,Pulau Pinang,0,0,0,2008
2008-09-02,Pulau Pinang,0,0,0,2008
2008-09-03,Pulau Pinang,0,0,0,2008
2008-09-04,Pulau Pinang,0,0,0,2008
2008-09-05,Pulau Pinang,0,0,0,2008
2008-09-06,Pulau Pinang,0,0,0,2008
2008-09-07,Pulau Pinang,0,0,0,2008
2008-09-08,Pulau Pinang,0,0,0,2008
2008-09-09,Pulau Pinang,0,0,0,2008
2008-09-10,Pulau Pinang,0,0,0,2008
2008-09-11,Pulau Pinang,0,0,0,2008
2008-09-12,Pulau Pinang,0,0,0,2008
2008-09-13,Pulau Pinang,0,0,0,2008
2008-09-14,Pulau Pinang,0,0,0,2008
2008-09-15,Pulau Pinang,0,0,0,2008
2008-09-16,Pulau Pinang,0,0,0,2008
2008-09-17,Pulau Pinang,0,0,0,2008
2008-09-18,Pulau Pinang,0,0,0,2008
2008-09-19,Pulau Pinang,0,0,0,2008
2008-09-20,Pulau Pinang,0,0,0,2008
2008-09-21,Pulau Pinang,0,0,0,2008
2008-09-22,Pulau Pinang,0,0,0,2008
2008-09-23,Pulau Pinang,0,0,0,2008
2008-09-24,Pulau Pinang,0,0,0,2008
2008-09-25,Pulau Pinang,0,0,0,2008
2008-09-26,Pulau Pinang,0,0,0,2008
2008-09-27,Pulau Pinang,0,0,0,2008
2008-09-28,Pulau Pinang,0,0,0,2008
2008-09-29,Pulau Pinang,0,0,0,2008
2008-09-30,Pulau Pinang,0,0,0,2008
2008-10-01,Pulau Pinang,0,0,0,2008
2008-10-02,Pulau Pinang,0,0,0,2008
2008-10-03,Pulau Pinang,0,0,0,2008
2008-10-04,Pulau Pinang,0,0,0,2008
2008-10-05,Pulau Pinang,0,0,0,2008
2008-10-06,Pulau Pinang,0,0,0,2008
2008-10-07,Pulau Pinang,0,0,0,2008
2008-10-08,Pulau Pinang,0,0,0,2008
2008-10-09,Pulau Pinang,0,0,0,2008
2008-10-10,Pulau Pinang,0,0,0,2008
2008-10-11,Pulau Pinang,0,0,0,2008
2008-10-12,Pulau Pinang,0,0,0,2008
2008-10-13,Pulau Pinang,0,0,0,2008
2008-10-14,Pulau Pinang,0,0,0,2008
2008-10-15,Pulau Pinang,0,0,0,2008
2008-10-16,Pulau Pinang,0,0,0,2008
2008-10-17,Pulau Pinang,0,0,0,2008
2008-10-18,Pulau Pinang,0,0,0,2008
2008-10-19,Pulau Pinang,0,0,0,2008
2008-10-20,Pulau Pinang,0,0,0,2008
2008-10-21,Pulau Pinang,0,0,0,2008
2008-10-22,Pulau Pinang,0,0,0,2008
2008-10-23,Pulau Pinang,0,0,0,2008
2008-10-24,Pulau Pinang,0,0,0,2008
2008-10-25,Pulau Pinang,0,0,0,2008
2008-10-26,Pulau Pinang,0,0,0,2008
2008-10-27,Pulau Pinang,0,0,0,2008
2008-10-28,Pulau Pinang,0,0,0,2008
2008-10-29,Pulau Pinang,0,0,0,2008
2008-10-30,Pulau Pinang,0,0,0,2008
2008-10-31,Pulau Pinang,0,0,0,2008
2008-11-01,Pulau Pinang,0,0,0,2008
2008-11-02,Pulau Pinang,0,0,0,2008
2008-11-03,Pulau Pinang,0,0,0,2008
2008-11-04,Pulau Pinang,0,0,0,2008
2008-11-05,Pulau Pinang,0,0,0,2008
2008-11-06,Pulau Pinang,0,0,0,2008
2008-11-07,Pulau Pinang,0,0,0,2008
2008-11-08,Pulau Pinang,0,0,0,2008
2008-11-09,Pulau Pinang,0,0,0,2008
2008-11-10,Pulau Pinang,0,0,0,2008
2008-11-11,Pulau Pinang,0,0,0,2008
2008-11-12,Pulau Pinang,0,0,0,2008
2008-11-13,Pulau Pinang,0,0,0,2008
2008-11-14,Pulau Pinang,0,0,0,2008
2008-11-15,Pulau Pinang,0,0,0,2008
2008-11-16,Pulau Pinang,0,0,0,2008
2008-11-17,Pulau Pinang,0,0,0,2008
2008-11-18,Pulau Pinang,0,0,0,2008
2008-11-19,Pulau Pinang,0,0,0,2008
2008-11-20,Pulau Pinang,0,0,0,2008
2008-11-21,Pulau Pinang,0,0,0,2008
2008-11-22,Pulau Pinang,0,0,0,2008
2008-11-23,Pulau Pinang,0,0,0,2008
2008-11-24,Pulau Pinang,0,0,0,2008
2008-11-25,Pulau Pinang,0,0,0,2008
2008-11-26,Pulau Pinang,0,0,0,2008
2008-11-27,Pulau Pinang,0,0,0,2008
2008-11-28,Pulau Pinang,0,0,0,2008
2008-11-29,Pulau Pinang,0,0,0,2008
2008-11-30,Pulau Pinang,0,0,0,2008
2008-12-01,Pulau Pinang,0,0,0,2008
2008-12-02,Pulau Pinang,0,0,0,2008
2008-12-03,Pulau Pinang,0,0,0,2008
2008-12-04,Pulau Pinang,0,0,0,2008
2008-12-05,Pulau Pinang,0,0,0,2008
2008-12-06,Pulau Pinang,0,0,0,2008
2008-12-07,Pulau Pinang,0,0,0,2008
2008-12-08,Pulau Pinang,0,0,0,2008
2008-12-09,Pulau Pinang,0,0,0,2008
2008-12-10,Pulau Pinang,0,0,0,2008
2008-12-11,Pulau Pinang,0,0,0,2008
2008-12-12,Pulau Pinang,0,0,0,2008
2008-12-13,Pulau Pinang,0,0,0,2008
2008-12-14,Pulau Pinang,0,0,0,2008
2008-12-15,Pulau Pinang,0,0,0,2008
2008-12-16,Pulau Pinang,0,0,0,2008
2008-12-17,Pulau Pinang,0,0,0,2008
2008-12-18,Pulau Pinang,0,0,0,2008
2008-12-19,Pulau Pinang,0,0,0,2008
2008-12-20,Pulau Pinang,0,0,0,2008
2008-12-21,Pulau Pinang,0,0,0,2008
2008-12-22,Pulau Pinang,0,0,0,2008
2008-12-23,Pulau Pinang,0,0,0,2008
2008-12-24,Pulau Pinang,0,0,0,2008
2008-12-25,Pulau Pinang,0,0,0,2008
2008-12-26,Pulau Pinang,0,0,0,2008
2008-12-27,Pulau Pinang,0,0,0,2008
2008-12-28,Pulau Pinang,0,0,0,2008
2008-12-29,Pulau Pinang,0,0,0,2008
2008-12-30,Pulau Pinang,0,0,0,2008
2008-12-31,Pulau Pinang,0,0,0,2008
2009-01-01,Pulau Pinang,0,0,0,2009
2009-01-02,Pulau Pinang,0,0,0,2009
2009-01-03,Pulau Pinang,0,0,0,2009
2009-01-04,Pulau Pinang,0,0,0,2009
2009-01-05,Pulau Pinang,0,0,0,2009
2009-01-06,Pulau Pinang,0,0,0,2009
2009-01-07,Pulau Pinang,0,0,0,2009
2009-01-08,Pulau Pinang,0,0,0,2009
2009-01-09,Pulau Pinang,0,0,0,2009
2009-01-10,Pulau Pinang,0,0,0,2009
2009-01-11,Pulau Pinang,0,0,0,2009
2009-01-12,Pulau Pinang,0,0,0,2009
2009-01-13,Pulau Pinang,0,0,0,2009
2009-01-14,Pulau Pinang,0,0,0,2009
2009-01-15,Pulau Pinang,0,0,0,2009
2009-01-16,Pulau Pinang,0,0,0,2009
2009-01-17,Pulau Pinang,0,0,0,2009
2009-01-18,Pulau Pinang,0,0,0,2009
2009-01-19,Pulau Pinang,0,0,0,2009
2009-01-20,Pulau Pinang,0,0,0,2009
2009-01-21,Pulau Pinang,0,0,0,2009
2009-01-22,Pulau Pinang,0,0,0,2009
2009-01-23,Pulau Pinang,0,0,0,2009
2009-01-24,Pulau Pinang,0,0,0,2009
2009-01-25,Pulau Pinang,0,0,0,2009
2009-01-26,Pulau Pinang,0,0,0,2009
2009-01-27,Pulau Pinang,0,0,0,2009
2009-01-28,Pulau Pinang,0,0,0,2009
2009-01-29,Pulau Pinang,0,0,0,2009
2009-01-30,Pulau Pinang,0,0,0,2009
2009-01-31,Pulau Pinang,0,0,0,2009
2009-02-01,Pulau Pinang,0,0,0,2009
2009-02-02,Pulau Pinang,0,0,0,2009
2009-02-03,Pulau Pinang,0,0,0,2009
2009-02-04,Pulau Pinang,0,0,0,2009
2009-02-05,Pulau Pinang,0,0,0,2009
2009-02-06,Pulau Pinang,0,0,0,2009
2009-02-07,Pulau Pinang,0,0,0,2009
2009-02-08,Pulau Pinang,0,0,0,2009
2009-02-09,Pulau Pinang,0,0,0,2009
2009-02-10,Pulau Pinang,0,0,0,2009
2009-02-11,Pulau Pinang,0,0,0,2009
2009-02-12,Pulau Pinang,0,0,0,2009
2009-02-13,Pulau Pinang,0,0,0,2009
2009-02-14,Pulau Pinang,0,0,0,2009
2009-02-15,Pulau Pinang,0,0,0,2009
2009-02-16,Pulau Pinang,0,0,0,2009
2009-02-17,Pulau Pinang,0,0,0,2009
2009-02-18,Pulau Pinang,0,0,0,2009
2009-02-19,Pulau Pinang,0,0,0,2009
2009-02-20,Pulau Pinang,0,0,0,2009
2009-02-21,Pulau Pinang,0,0,0,2009
2009-02-22,Pulau Pinang,0,0,0,2009
2009-02-23,Pulau Pinang,0,0,0,2009
2009-02-24,Pulau Pinang,0,0,0,2009
2009-02-25,Pulau Pinang,0,0,0,2009
2009-02-26,Pulau Pinang,0,0,0,2009
2009-02-27,Pulau Pinang,0,0,0,2009
2009-02-28,Pulau Pinang,0,0,0,2009
2009-03-01,Pulau Pinang,0,0,0,2009
2009-03-02,Pulau Pinang,0,0,0,2009
2009-03-03,Pulau Pinang,0,0,0,2009
2009-03-04,Pulau Pinang,0,0,0,2009
2009-03-05,Pulau Pinang,0,0,0,2009
2009-03-06,Pulau Pinang,0,0,0,2009
2009-03-07,Pulau Pinang,0,0,0,2009
2009-03-08,Pulau Pinang,0,0,0,2009
2009-03-09,Pulau Pinang,0,0,0,2009
2009-03-10,Pulau Pinang,0,0,0,2009
2009-03-11,Pulau Pinang,0,0,0,2009
2009-03-12,Pulau Pinang,0,0,0,2009
2009-03-13,Pulau Pinang,0,0,0,2009
2009-03-14,Pulau Pinang,0,0,0,2009
2009-03-15,Pulau Pinang,0,0,0,2009
2009-03-16,Pulau Pinang,0,0,0,2009
2009-03-17,Pulau Pinang,0,0,0,2009
2009-03-18,Pulau Pinang,0,0,0,2009
2009-03-19,Pulau Pinang,0,0,0,2009
2009-03-20,Pulau Pinang,0,0,0,2009
2009-03-21,Pulau Pinang,0,0,0,2009
2009-03-22,Pulau Pinang,0,0,0,2009
2009-03-23,Pulau Pinang,0,0,0,2009
2009-03-24,Pulau Pinang,0,0,0,2009
2009-03-25,Pulau Pinang,0,0,0,2009
2009-03-26,Pulau Pinang,0,0,0,2009
2009-03-27,Pulau Pinang,0,0,0,2009
2009-03-28,Pulau Pinang,0,0,0,2009
2009-03-29,Pulau Pinang,0,0,0,2009
2009-03-30,Pulau Pinang,0,0,0,2009
2009-03-31,Pulau Pinang,0,0,0,2009
2009-04-01,Pulau Pinang,0,0,0,2009
2009-04-02,Pulau Pinang,0,0,0,2009
2009-04-03,Pulau Pinang,0,0,0,2009
2009-04-04,Pulau Pinang,0,0,0,2009
2009-04-05,Pulau Pinang,0,0,0,2009
2009-04-06,Pulau Pinang,0,0,0,2009
2009-04-07,Pulau Pinang,0,0,0,2009
2009-04-08,Pulau Pinang,0,0,0,2009
2009-04-09,Pulau Pinang,0,0,0,2009
2009-04-10,Pulau Pinang,0,0,0,2009
2009-04-11,Pulau Pinang,0,0,0,2009
2009-04-12,Pulau Pinang,0,0,0,2009
2009-04-13,Pulau Pinang,0,0,0,2009
2009-04-14,Pulau Pinang,0,0,0,2009
2009-04-15,Pulau Pinang,0,0,0,2009
2009-04-16,Pulau Pinang,0,0,0,2009
2009-04-17,Pulau Pinang,0,0,0,2009
2009-04-18,Pulau Pinang,0,0,0,2009
2009-04-19,Pulau Pinang,0,0,0,2009
2009-04-20,Pulau Pinang,0,0,0,2009
2009-04-21,Pulau Pinang,0,0,0,2009
2009-04-22,Pulau Pinang,0,0,0,2009
2009-04-23,Pulau Pinang,0,0,0,2009
2009-04-24,Pulau Pinang,0,0,0,2009
2009-04-25,Pulau Pinang,0,0,0,2009
2009-04-26,Pulau Pinang,0,0,0,2009
2009-04-27,Pulau Pinang,0,0,0,2009
2009-04-28,Pulau Pinang,0,0,0,2009
2009-04-29,Pulau Pinang,0,0,0,2009
2009-04-30,Pulau Pinang,0,0,0,2009
2009-05-01,Pulau Pinang,0,0,0,2009
2009-05-02,Pulau Pinang,0,0,0,2009
2009-05-03,Pulau Pinang,0,0,0,2009
2009-05-04,Pulau Pinang,0,0,0,2009
2009-05-05,Pulau Pinang,0,0,0,2009
2009-05-06,Pulau Pinang,0,0,0,2009
2009-05-07,Pulau Pinang,0,0,0,2009
2009-05-08,Pulau Pinang,0,0,0,2009
2009-05-09,Pulau Pinang,0,0,0,2009
2009-05-10,Pulau Pinang,0,0,0,2009
2009-05-11,Pulau Pinang,0,0,0,2009
2009-05-12,Pulau Pinang,0,0,0,2009
2009-05-13,Pulau Pinang,0,0,0,2009
2009-05-14,Pulau Pinang,0,0,0,2009
2009-05-15,Pulau Pinang,0,0,0,2009
2009-05-16,Pulau Pinang,0,0,0,2009
2009-05-17,Pulau Pinang,0,0,0,2009
2009-05-18,Pulau Pinang,0,0,0,2009
2009-05-19,Pulau Pinang,0,0,0,2009
2009-05-20,Pulau Pinang,0,0,0,2009
2009-05-21,Pulau Pinang,0,0,0,2009
2009-05-22,Pulau Pinang,0,0,0,2009
2009-05-23,Pulau Pinang,0,0,0,2009
2009-05-24,Pulau Pinang,0,0,0,2009
2009-05-25,Pulau Pinang,0,0,0,2009
2009-05-26,Pulau Pinang,0,0,0,2009
2009-05-27,Pulau Pinang,0,0,0,2009
2009-05-28,Pulau Pinang,0,0,0,2009
2009-05-29,Pulau Pinang,0,0,0,2009
2009-05-30,Pulau Pinang,0,0,0,2009
2009-05-31,Pulau Pinang,0,0,0,2009
2009-06-01,Pulau Pinang,0,0,0,2009
2009-06-02,Pulau Pinang,0,0,0,2009
2009-06-03,Pulau Pinang,0,0,0,2009
2009-06-04,Pulau Pinang,0,0,0,2009
2009-06-05,Pulau Pinang,0,0,0,2009
2009-06-06,Pulau Pinang,0,0,0,2009
2009-06-07,Pulau Pinang,0,0,0,2009
2009-06-08,Pulau Pinang,0,0,0,2009
2009-06-09,Pulau Pinang,0,0,0,2009
2009-06-10,Pulau Pinang,0,0,0,2009
2009-06-11,Pulau Pinang,0,0,0,2009
2009-06-12,Pulau Pinang,0,0,0,2009
2009-06-13,Pulau Pinang,0,0,0,2009
2009-06-14,Pulau Pinang,0,0,0,2009
2009-06-15,Pulau Pinang,0,0,0,2009
2009-06-16,Pulau Pinang,0,0,0,2009
2009-06-17,Pulau Pinang,0,0,0,2009
2009-06-18,Pulau Pinang,0,0,0,2009
2009-06-19,Pulau Pinang,0,0,0,2009
2009-06-20,Pulau Pinang,0,0,0,2009
2009-06-21,Pulau Pinang,0,0,0,2009
2009-06-22,Pulau Pinang,0,0,0,2009
2009-06-23,Pulau Pinang,0,0,0,2009
2009-06-24,Pulau Pinang,0,0,0,2009
2009-06-25,Pulau Pinang,0,0,0,2009
2009-06-26,Pulau Pinang,0,0,0,2009
2009-06-27,Pulau Pinang,0,0,0,2009
2009-06-28,Pulau Pinang,0,0,0,2009
2009-06-29,Pulau Pinang,0,0,0,2009
2009-06-30,Pulau Pinang,0,0,0,2009
2009-07-01,Pulau Pinang,0,0,0,2009
2009-07-02,Pulau Pinang,0,0,0,2009
2009-07-03,Pulau Pinang,0,0,0,2009
2009-07-04,Pulau Pinang,0,0,0,2009
2009-07-05,Pulau Pinang,0,0,0,2009
2009-07-06,Pulau Pinang,0,0,0,2009
2009-07-07,Pulau Pinang,0,0,0,2009
2009-07-08,Pulau Pinang,0,0,0,2009
2009-07-09,Pulau Pinang,0,0,0,2009
2009-07-10,Pulau Pinang,0,0,0,2009
2009-07-11,Pulau Pinang,0,0,0,2009
2009-07-12,Pulau Pinang,0,0,0,2009
2009-07-13,Pulau Pinang,0,0,0,2009
2009-07-14,Pulau Pinang,0,0,0,2009
2009-07-15,Pulau Pinang,0,0,0,2009
2009-07-16,Pulau Pinang,0,0,0,2009
2009-07-17,Pulau Pinang,0,0,0,2009
2009-07-18,Pulau Pinang,0,0,0,2009
2009-07-19,Pulau Pinang,0,0,0,2009
2009-07-20,Pulau Pinang,0,0,0,2009
2009-07-21,Pulau Pinang,0,0,0,2009
2009-07-22,Pulau Pinang,0,0,0,2009
2009-07-23,Pulau Pinang,0,0,0,2009
2009-07-24,Pulau Pinang,0,0,0,2009
2009-07-25,Pulau Pinang,0,0,0,2009
2009-07-26,Pulau Pinang,0,0,0,2009
2009-07-27,Pulau Pinang,0,0,0,2009
2009-07-28,Pulau Pinang,0,0,0,2009
2009-07-29,Pulau Pinang,0,0,0,2009
2009-07-30,Pulau Pinang,0,0,0,2009
2009-07-31,Pulau Pinang,0,0,0,2009
2009-08-01,Pulau Pinang,0,0,0,2009
2009-08-02,Pulau Pinang,0,0,0,2009
2009-08-03,Pulau Pinang,0,0,0,2009
2009-08-04,Pulau Pinang,0,0,0,2009
2009-08-05,Pulau Pinang,0,0,0,2009
2009-08-06,Pulau Pinang,0,0,0,2009
2009-08-07,Pulau Pinang,0,0,0,2009
2009-08-08,Pulau Pinang,0,0,0,2009
2009-08-09,Pulau Pinang,0,0,0,2009
2009-08-10,Pulau Pinang,0,0,0,2009
2009-08-11,Pulau Pinang,0,0,0,2009
2009-08-12,Pulau Pinang,0,0,0,2009
2009-08-13,Pulau Pinang,0,0,0,2009
2009-08-14,Pulau Pinang,0,0,0,2009
2009-08-15,Pulau Pinang,0,0,0,2009
2009-08-16,Pulau Pinang,0,0,0,2009
2009-08-17,Pulau Pinang,0,0,0,2009
2009-08-18,Pulau Pinang,0,0,0,2009
2009-08-19,Pulau Pinang,0,0,0,2009
2009-08-20,Pulau Pinang,0,0,0,2009
2009-08-21,Pulau Pinang,0,0,0,2009
2009-08-22,Pulau Pinang,0,0,0,2009
2009-08-23,Pulau Pinang,0,0,0,2009
2009-08-24,Pulau Pinang,0,0,0,2009
2009-08-25,Pulau Pinang,0,0,0,2009
2009-08-26,Pulau Pinang,0,0,0,2009
2009-08-27,Pulau Pinang,0,0,0,2009
2009-08-28,Pulau Pinang,0,0,0,2009
2009-08-29,Pulau Pinang,0,0,0,2009
2009-08-30,Pulau Pinang,0,0,0,2009
2009-08-31,Pulau Pinang,0,0,0,2009
2009-09-01,Pulau Pinang,0,0,0,2009
2009-09-02,Pulau Pinang,0,0,0,2009
2009-09-03,Pulau Pinang,0,0,0,2009
2009-09-04,Pulau Pinang,0,0,0,2009
2009-09-05,Pulau Pinang,0,0,0,2009
2009-09-06,Pulau Pinang,0,0,0,2009
2009-09-07,Pulau Pinang,0,0,0,2009
2009-09-08,Pulau Pinang,0,0,0,2009
2009-09-09,Pulau Pinang,0,0,0,2009
2009-09-10,Pulau Pinang,0,0,0,2009
2009-09-11,Pulau Pinang,0,0,0,2009
2009-09-12,Pulau Pinang,0,0,0,2009
2009-09-13,Pulau Pinang,0,0,0,2009
2009-09-14,Pulau Pinang,0,0,0,2009
2009-09-15,Pulau Pinang,0,0,0,2009
2009-09-16,Pulau Pinang,0,0,0,2009
2009-09-17,Pulau Pinang,0,0,0,2009
2009-09-18,Pulau Pinang,0,0,0,2009
2009-09-19,Pulau Pinang,0,0,0,2009
2009-09-20,Pulau Pinang,0,0,0,2009
2009-09-21,Pulau Pinang,0,0,0,2009
2009-09-22,Pulau Pinang,0,0,0,2009
2009-09-23,Pulau Pinang,0,0,0,2009
2009-09-24,Pulau Pinang,0,0,0,2009
2009-09-25,Pulau Pinang,0,0,0,2009
2009-09-26,Pulau Pinang,0,0,0,2009
2009-09-27,Pulau Pinang,0,0,0,2009
2009-09-28,Pulau Pinang,0,0,0,2009
2009-09-29,Pulau Pinang,0,0,0,2009
2009-09-30,Pulau Pinang,0,0,0,2009
2009-10-01,Pulau Pinang,0,0,0,2009
2009-10-02,Pulau Pinang,0,0,0,2009
2009-10-03,Pulau Pinang,0,0,0,2009
2009-10-04,Pulau Pinang,0,0,0,2009
2009-10-05,Pulau Pinang,0,0,0,2009
2009-10-06,Pulau Pinang,0,0,0,2009
2009-10-07,Pulau Pinang,0,0,0,2009
2009-10-08,Pulau Pinang,0,0,0,2009
2009-10-09,Pulau Pinang,0,0,0,2009
2009-10-10,Pulau Pinang,0,0,0,2009
2009-10-11,Pulau Pinang,0,0,0,2009
2009-10-12,Pulau Pinang,0,0,0,2009
2009-10-13,Pulau Pinang,0,0,0,2009
2009-10-14,Pulau Pinang,0,0,0,2009
2009-10-15,Pulau Pinang,0,0,0,2009
2009-10-16,Pulau Pinang,0,0,0,2009
2009-10-17,Pulau Pinang,0,0,0,2009
2009-10-18,Pulau Pinang,0,0,0,2009
2009-10-19,Pulau Pinang,0,0,0,2009
2009-10-20,Pulau Pinang,0,0,0,2009
2009-10-21,Pulau Pinang,0,0,0,2009
2009-10-22,Pulau Pinang,0,0,0,2009
2009-10-23,Pulau Pinang,0,0,0,2009
2009-10-24,Pulau Pinang,0,0,0,2009
2009-10-25,Pulau Pinang,0,0,0,2009
2009-10-26,Pulau Pinang,0,0,0,2009
2009-10-27,Pulau Pinang,0,0,0,2009
2009-10-28,Pulau Pinang,0,0,0,2009
2009-10-29,Pulau Pinang,0,0,0,2009
2009-10-30,Pulau Pinang,0,0,0,2009
2009-10-31,Pulau Pinang,0,0,0,2009
2009-11-01,Pulau Pinang,0,0,0,2009
2009-11-02,Pulau Pinang,0,0,0,2009
2009-11-03,Pulau Pinang,0,0,0,2009
2009-11-04,Pulau Pinang,0,0,0,2009
2009-11-05,Pulau Pinang,0,0,0,2009
2009-11-06,Pulau Pinang,0,0,0,2009
2009-11-07,Pulau Pinang,0,0,0,2009
2009-11-08,Pulau Pinang,0,0,0,2009
2009-11-09,Pulau Pinang,0,0,0,2009
2009-11-10,Pulau Pinang,0,0,0,2009
2009-11-11,Pulau Pinang,0,0,0,2009
2009-11-12,Pulau Pinang,0,0,0,2009
2009-11-13,Pulau Pinang,0,0,0,2009
2009-11-14,Pulau Pinang,0,0,0,2009
2009-11-15,Pulau Pinang,0,0,0,2009
2009-11-16,Pulau Pinang,0,0,0,2009
2009-11-17,Pulau Pinang,0,0,0,2009
2009-11-18,Pulau Pinang,0,0,0,2009
2009-11-19,Pulau Pinang,0,0,0,2009
2009-11-20,Pulau Pinang,0,0,0,2009
2009-11-21,Pulau Pinang,0,0,0,2009
2009-11-22,Pulau Pinang,0,0,0,2009
2009-11-23,Pulau Pinang,0,0,0,2009
2009-11-24,Pulau Pinang,0,0,0,2009
2009-11-25,Pulau Pinang,0,0,0,2009
2009-11-26,Pulau Pinang,0,0,0,2009
2009-11-27,Pulau Pinang,0,0,0,2009
2009-11-28,Pulau Pinang,0,0,0,2009
2009-11-29,Pulau Pinang,0,0,0,2009
2009-11-30,Pulau Pinang,0,0,0,2009
2009-12-01,Pulau Pinang,0,0,0,2009
2009-12-02,Pulau Pinang,0,0,0,2009
2009-12-03,Pulau Pinang,0,0,0,2009
2009-12-04,Pulau Pinang,0,0,0,2009
2009-12-05,Pulau Pinang,0,0,0,2009
2009-12-06,Pulau Pinang,0,0,0,2009
2009-12-07,Pulau Pinang,0,0,0,2009
2009-12-08,Pulau Pinang,0,0,0,2009
2009-12-09,Pulau Pinang,0,0,0,2009
2009-12-10,Pulau Pinang,0,0,0,2009
2009-12-11,Pulau Pinang,0,0,0,2009
2009-12-12,Pulau Pinang,0,0,0,2009
2009-12-13,Pulau Pinang,0,0,0,2009
2009-12-14,Pulau Pinang,0,0,0,2009
2009-12-15,Pulau Pinang,0,0,0,2009
2009-12-16,Pulau Pinang,0,0,0,2009
2009-12-17,Pulau Pinang,0,0,0,2009
2009-12-18,Pulau Pinang,0,0,0,2009
2009-12-19,Pulau Pinang,0,0,0,2009
2009-12-20,Pulau Pinang,0,0,0,2009
2009-12-21,Pulau Pinang,0,0,0,2009
2009-12-22,Pulau Pinang,0,0,0,2009
2009-12-23,Pulau Pinang,0,0,0,2009
2009-12-24,Pulau Pinang,0,0,0,2009
2009-12-25,Pulau Pinang,0,0,0,2009
2009-12-26,Pulau Pinang,0,0,0,2009
2009-12-27,Pulau Pinang,0,0,0,2009
2009-12-28,Pulau Pinang,0,0,0,2009
2009-12-29,Pulau Pinang,0,0,0,2009
2009-12-30,Pulau Pinang,0,0,0,2009
2009-12-31,Pulau Pinang,0,0,0,2009
2010-01-01,Pulau Pinang,0,0,0,2010
2010-01-02,Pulau Pinang,0,0,0,2010
2010-01-03,Pulau Pinang,0,0,0,2010
2010-01-04,Pulau Pinang,0,0,0,2010
2010-01-05,Pulau Pinang,0,0,0,2010
2010-01-06,Pulau Pinang,0,0,0,2010
2010-01-07,Pulau Pinang,0,0,0,2010
2010-01-08,Pulau Pinang,0,0,0,2010
2010-01-09,Pulau Pinang,0,0,0,2010
2010-01-10,Pulau Pinang,0,0,0,2010
2010-01-11,Pulau Pinang,0,0,0,2010
2010-01-12,Pulau Pinang,0,0,0,2010
2010-01-13,Pulau Pinang,0,0,0,2010
2010-01-14,Pulau Pinang,0,0,0,2010
2010-01-15,Pulau Pinang,0,0,0,2010
2010-01-16,Pulau Pinang,0,0,0,2010
2010-01-17,Pulau Pinang,0,0,0,2010
2010-01-18,Pulau Pinang,0,0,0,2010
2010-01-19,Pulau Pinang,0,0,0,2010
2010-01-20,Pulau Pinang,0,0,0,2010
2010-01-21,Pulau Pinang,0,0,0,2010
2010-01-22,Pulau Pinang,0,0,0,2010
2010-01-23,Pulau Pinang,0,0,0,2010
2010-01-24,Pulau Pinang,0,0,0,2010
2010-01-25,Pulau Pinang,0,0,0,2010
2010-01-26,Pulau Pinang,0,0,0,2010
2010-01-27,Pulau Pinang,0,0,0,2010
2010-01-28,Pulau Pinang,0,0,0,2010
2010-01-29,Pulau Pinang,0,0,0,2010
2010-01-30,Pulau Pinang,0,0,0,2010
2010-01-31,Pulau Pinang,0,0,0,2010
2010-02-01,Pulau Pinang,0,0,0,2010
2010-02-02,Pulau Pinang,0,0,0,2010
2010-02-03,Pulau Pinang,0,0,0,2010
2010-02-04,Pulau Pinang,0,0,0,2010
2010-02-05,Pulau Pinang,0,0,0,2010
2010-02-06,Pulau Pinang,0,0,0,2010
2010-02-07,Pulau Pinang,0,0,0,2010
2010-02-08,Pulau Pinang,0,0,0,2010
2010-02-09,Pulau Pinang,0,0,0,2010
2010-02-10,Pulau Pinang,0,0,0,2010
2010-02-11,Pulau Pinang,0,0,0,2010
2010-02-12,Pulau Pinang,0,0,0,2010
2010-02-13,Pulau Pinang,0,0,0,2010
2010-02-14,Pulau Pinang,0,0,0,2010
2010-02-15,Pulau Pinang,0,0,0,2010
2010-02-16,Pulau Pinang,0,0,0,2010
2010-02-17,Pulau Pinang,0,0,0,2010
2010-02-18,Pulau Pinang,0,0,0,2010
2010-02-19,Pulau Pinang,0,0,0,2010
2010-02-20,Pulau Pinang,0,0,0,2010
2010-02-21,Pulau Pinang,0,0,0,2010
2010-02-22,Pulau Pinang,0,0,0,2010
2010-02-23,Pulau Pinang,0,0,0,2010
2010-02-24,Pulau Pinang,0,0,0,2010
2010-02-25,Pulau Pinang,0,0,0,2010
2010-02-26,Pulau Pinang,0,0,0,2010
2010-02-27,Pulau Pinang,0,0,0,2010
2010-02-28,Pulau Pinang,0,0,0,2010
2010-03-01,Pulau Pinang,0,0,0,2010
2010-03-02,Pulau Pinang,0,0,0,2010
2010-03-03,Pulau Pinang,0,0,0,2010
2010-03-04,Pulau Pinang,0,0,0,2010
2010-03-05,Pulau Pinang,0,0,0,2010
2010-03-06,Pulau Pinang,0,0,0,2010
2010-03-07,Pulau Pinang,0,0,0,2010
2010-03-08,Pulau Pinang,0,0,0,2010
2010-03-09,Pulau Pinang,0,0,0,2010
2010-03-10,Pulau Pinang,0,0,0,2010
2010-03-11,Pulau Pinang,0,0,0,2010
2010-03-12,Pulau Pinang,0,0,0,2010
2010-03-13,Pulau Pinang,0,0,0,2010
2010-03-14,Pulau Pinang,0,0,0,2010
2010-03-15,Pulau Pinang,0,0,0,2010
2010-03-16,Pulau Pinang,0,0,0,2010
2010-03-17,Pulau Pinang,0,0,0,2010
2010-03-18,Pulau Pinang,0,0,0,2010
2010-03-19,Pulau Pinang,0,0,0,2010
2010-03-20,Pulau Pinang,0,0,0,2010
2010-03-21,Pulau Pinang,0,0,0,2010
2010-03-22,Pulau Pinang,0,0,0,2010
2010-03-23,Pulau Pinang,0,0,0,2010
2010-03-24,Pulau Pinang,0,0,0,2010
2010-03-25,Pulau Pinang,0,0,0,2010
2010-03-26,Pulau Pinang,0,0,0,2010
2010-03-27,Pulau Pinang,0,0,0,2010
2010-03-28,Pulau Pinang,0,0,0,2010
2010-03-29,Pulau Pinang,0,0,0,2010
2010-03-30,Pulau Pinang,0,0,0,2010
2010-03-31,Pulau Pinang,0,0,0,2010
2010-04-01,Pulau Pinang,0,0,0,2010
2010-04-02,Pulau Pinang,0,0,0,2010
2010-04-03,Pulau Pinang,0,0,0,2010
2010-04-04,Pulau Pinang,0,0,0,2010
2010-04-05,Pulau Pinang,0,0,0,2010
2010-04-06,Pulau Pinang,0,0,0,2010
2010-04-07,Pulau Pinang,0,0,0,2010
2010-04-08,Pulau Pinang,0,0,0,2010
2010-04-09,Pulau Pinang,0,0,0,2010
2010-04-10,Pulau Pinang,0,0,0,2010
2010-04-11,Pulau Pinang,0,0,0,2010
2010-04-12,Pulau Pinang,0,0,0,2010
2010-04-13,Pulau Pinang,0,0,0,2010
2010-04-14,Pulau Pinang,0,0,0,2010
2010-04-15,Pulau Pinang,0,0,0,2010
2010-04-16,Pulau Pinang,0,0,0,2010
2010-04-17,Pulau Pinang,0,0,0,2010
2010-04-18,Pulau Pinang,0,0,0,2010
2010-04-19,Pulau Pinang,0,0,0,2010
2010-04-20,Pulau Pinang,0,0,0,2010
2010-04-21,Pulau Pinang,0,0,0,2010
2010-04-22,Pulau Pinang,0,0,0,2010
2010-04-23,Pulau Pinang,0,0,0,2010
2010-04-24,Pulau Pinang,0,0,0,2010
2010-04-25,Pulau Pinang,0,0,0,2010
2010-04-26,Pulau Pinang,0,0,0,2010
2010-04-27,Pulau Pinang,0,0,0,2010
2010-04-28,Pulau Pinang,0,0,0,2010
2010-04-29,Pulau Pinang,0,0,0,2010
2010-04-30,Pulau Pinang,0,0,0,2010
2010-05-01,Pulau Pinang,0,0,0,2010
2010-05-02,Pulau Pinang,0,0,0,2010
2010-05-03,Pulau Pinang,0,0,0,2010
2010-05-04,Pulau Pinang,0,0,0,2010
2010-05-05,Pulau Pinang,0,0,0,2010
2010-05-06,Pulau Pinang,0,0,0,2010
2010-05-07,Pulau Pinang,0,0,0,2010
2010-05-08,Pulau Pinang,0,0,0,2010
2010-05-09,Pulau Pinang,0,0,0,2010
2010-05-10,Pulau Pinang,0,0,0,2010
2010-05-11,Pulau Pinang,0,0,0,2010
2010-05-12,Pulau Pinang,0,0,0,2010
2010-05-13,Pulau Pinang,0,0,0,2010
2010-05-14,Pulau Pinang,0,0,0,2010
2010-05-15,Pulau Pinang,0,0,0,2010
2010-05-16,Pulau Pinang,0,0,0,2010
2010-05-17,Pulau Pinang,0,0,0,2010
2010-05-18,Pulau Pinang,0,0,0,2010
2010-05-19,Pulau Pinang,0,0,0,2010
2010-05-20,Pulau Pinang,0,0,0,2010
2010-05-21,Pulau Pinang,0,0,0,2010
2010-05-22,Pulau Pinang,0,0,0,2010
2010-05-23,Pulau Pinang,0,0,0,2010
2010-05-24,Pulau Pinang,0,0,0,2010
2010-05-25,Pulau Pinang,0,0,0,2010
2010-05-26,Pulau Pinang,0,0,0,2010
2010-05-27,Pulau Pinang,0,0,0,2010
2010-05-28,Pulau Pinang,0,0,0,2010
2010-05-29,Pulau Pinang,0,0,0,2010
2010-05-30,Pulau Pinang,0,0,0,2010
2010-05-31,Pulau Pinang,0,0,0,2010
2010-06-01,Pulau Pinang,0,0,0,2010
2010-06-02,Pulau Pinang,0,0,0,2010
2010-06-03,Pulau Pinang,0,0,0,2010
2010-06-04,Pulau Pinang,0,0,0,2010
2010-06-05,Pulau Pinang,0,0,0,2010
2010-06-06,Pulau Pinang,0,0,0,2010
2010-06-07,Pulau Pinang,0,0,0,2010
2010-06-08,Pulau Pinang,0,0,0,2010
2010-06-09,Pulau Pinang,0,0,0,2010
2010-06-10,Pulau Pinang,0,0,0,2010
2010-06-11,Pulau Pinang,0,0,0,2010
2010-06-12,Pulau Pinang,0,0,0,2010
2010-06-13,Pulau Pinang,0,0,0,2010
2010-06-14,Pulau Pinang,0,0,0,2010
2010-06-15,Pulau Pinang,0,0,0,2010
2010-06-16,Pulau Pinang,0,0,0,2010
2010-06-17,Pulau Pinang,0,0,0,2010
2010-06-18,Pulau Pinang,0,0,0,2010
2010-06-19,Pulau Pinang,0,0,0,2010
2010-06-20,Pulau Pinang,0,0,0,2010
2010-06-21,Pulau Pinang,0,0,0,2010
2010-06-22,Pulau Pinang,0,0,0,2010
2010-06-23,Pulau Pinang,0,0,0,2010
2010-06-24,Pulau Pinang,0,0,0,2010
2010-06-25,Pulau Pinang,0,0,0,2010
2010-06-26,Pulau Pinang,0,0,0,2010
2010-06-27,Pulau Pinang,0,0,0,2010
2010-06-28,Pulau Pinang,0,0,0,2010
2010-06-29,Pulau Pinang,0,0,0,2010
2010-06-30,Pulau Pinang,0,0,0,2010
2010-07-01,Pulau Pinang,0,0,0,2010
2010-07-02,Pulau Pinang,0,0,0,2010
2010-07-03,Pulau Pinang,0,0,0,2010
2010-07-04,Pulau Pinang,0,0,0,2010
2010-07-05,Pulau Pinang,0,0,0,2010
2010-07-06,Pulau Pinang,0,0,0,2010
2010-07-07,Pulau Pinang,0,0,0,2010
2010-07-08,Pulau Pinang,0,0,0,2010
2010-07-09,Pulau Pinang,0,0,0,2010
2010-07-10,Pulau Pinang,0,0,0,2010
2010-07-11,Pulau Pinang,0,0,0,2010
2010-07-12,Pulau Pinang,0,0,0,2010
2010-07-13,Pulau Pinang,0,0,0,2010
2010-07-14,Pulau Pinang,0,0,0,2010
2010-07-15,Pulau Pinang,0,0,0,2010
2010-07-16,Pulau Pinang,0,0,0,2010
2010-07-17,Pulau Pinang,0,0,0,2010
2010-07-18,Pulau Pinang,0,0,0,2010
2010-07-19,Pulau Pinang,0,0,0,2010
2010-07-20,Pulau Pinang,0,0,0,2010
2010-07-21,Pulau Pinang,0,0,0,2010
2010-07-22,Pulau Pinang,0,0,0,2010
2010-07-23,Pulau Pinang,0,0,0,2010
2010-07-24,Pulau Pinang,0,0,0,2010
2010-07-25,Pulau Pinang,0,0,0,2010
2010-07-26,Pulau Pinang,0,0,0,2010
2010-07-27,Pulau Pinang,0,0,0,2010
2010-07-28,Pulau Pinang,0,0,0,2010
2010-07-29,Pulau Pinang,0,0,0,2010
2010-07-30,Pulau Pinang,0,0,0,2010
2010-07-31,Pulau Pinang,0,0,0,2010
2010-08-01,Pulau Pinang,0,0,0,2010
2010-08-02,Pulau Pinang,0,0,0,2010
2010-08-03,Pulau Pinang,0,0,0,2010
2010-08-04,Pulau Pinang,0,0,0,2010
2010-08-05,Pulau Pinang,0,0,0,2010
2010-08-06,Pulau Pinang,0,0,0,2010
2010-08-07,Pulau Pinang,0,0,0,2010
2010-08-08,Pulau Pinang,0,0,0,2010
2010-08-09,Pulau Pinang,0,0,0,2010
2010-08-10,Pulau Pinang,0,0,0,2010
2010-08-11,Pulau Pinang,0,0,0,2010
2010-08-12,Pulau Pinang,0,0,0,2010
2010-08-13,Pulau Pinang,0,0,0,2010
2010-08-14,Pulau Pinang,0,0,0,2010
2010-08-15,Pulau Pinang,0,0,0,2010
2010-08-16,Pulau Pinang,0,0,0,2010
2010-08-17,Pulau Pinang,0,0,0,2010
2010-08-18,Pulau Pinang,0,0,0,2010
2010-08-19,Pulau Pinang,0,0,0,2010
2010-08-20,Pulau Pinang,0,0,0,2010
2010-08-21,Pulau Pinang,0,0,0,2010
2010-08-22,Pulau Pinang,0,0,0,2010
2010-08-23,Pulau Pinang,0,0,0,2010
2010-08-24,Pulau Pinang,0,0,0,2010
2010-08-25,Pulau Pinang,0,0,0,2010
2010-08-26,Pulau Pinang,0,0,0,2010
2010-08-27,Pulau Pinang,0,0,0,2010
2010-08-28,Pulau Pinang,0,0,0,2010
2010-08-29,Pulau Pinang,0,0,0,2010
2010-08-30,Pulau Pinang,0,0,0,2010
2010-08-31,Pulau Pinang,0,0,0,2010
2010-09-01,Pulau Pinang,0,0,0,2010
2010-09-02,Pulau Pinang,0,0,0,2010
2010-09-03,Pulau Pinang,0,0,0,2010
2010-09-04,Pulau Pinang,0,0,0,2010
2010-09-05,Pulau Pinang,0,0,0,2010
2010-09-06,Pulau Pinang,0,0,0,2010
2010-09-07,Pulau Pinang,0,0,0,2010
2010-09-08,Pulau Pinang,0,0,0,2010
2010-09-09,Pulau Pinang,0,0,0,2010
2010-09-10,Pulau Pinang,0,0,0,2010
2010-09-11,Pulau Pinang,0,0,0,2010
2010-09-12,Pulau Pinang,0,0,0,2010
2010-09-13,Pulau Pinang,0,0,0,2010
2010-09-14,Pulau Pinang,0,0,0,2010
2010-09-15,Pulau Pinang,0,0,0,2010
2010-09-16,Pulau Pinang,0,0,0,2010
2010-09-17,Pulau Pinang,0,0,0,2010
2010-09-18,Pulau Pinang,0,0,0,2010
2010-09-19,Pulau Pinang,0,0,0,2010
2010-09-20,Pulau Pinang,0,0,0,2010
2010-09-21,Pulau Pinang,0,0,0,2010
2010-09-22,Pulau Pinang,0,0,0,2010
2010-09-23,Pulau Pinang,0,0,0,2010
2010-09-24,Pulau Pinang,0,0,0,2010
2010-09-25,Pulau Pinang,0,0,0,2010
2010-09-26,Pulau Pinang,0,0,0,2010
2010-09-27,Pulau Pinang,0,0,0,2010
2010-09-28,Pulau Pinang,0,0,0,2010
2010-09-29,Pulau Pinang,0,0,0,2010
2010-09-30,Pulau Pinang,0,0,0,2010
2010-10-01,Pulau Pinang,0,0,0,2010
2010-10-02,Pulau Pinang,0,0,0,2010
2010-10-03,Pulau Pinang,0,0,0,2010
2010-10-04,Pulau Pinang,0,0,0,2010
2010-10-05,Pulau Pinang,0,0,0,2010
2010-10-06,Pulau Pinang,0,0,0,2010
2010-10-07,Pulau Pinang,0,0,0,2010
2010-10-08,Pulau Pinang,0,0,0,2010
2010-10-09,Pulau Pinang,0,0,0,2010
2010-10-10,Pulau Pinang,0,0,0,2010
2010-10-11,Pulau Pinang,0,0,0,2010
2010-10-12,Pulau Pinang,0,0,0,2010
2010-10-13,Pulau Pinang,0,0,0,2010
2010-10-14,Pulau Pinang,0,0,0,2010
2010-10-15,Pulau Pinang,0,0,0,2010
2010-10-16,Pulau Pinang,0,0,0,2010
2010-10-17,Pulau Pinang,0,0,0,2010
2010-10-18,Pulau Pinang,0,0,0,2010
2010-10-19,Pulau Pinang,0,0,0,2010
2010-10-20,Pulau Pinang,0,0,0,2010
2010-10-21,Pulau Pinang,0,0,0,2010
2010-10-22,Pulau Pinang,0,0,0,2010
2010-10-23,Pulau Pinang,0,0,0,2010
2010-10-24,Pulau Pinang,0,0,0,2010
2010-10-25,Pulau Pinang,0,0,0,2010
2010-10-26,Pulau Pinang,0,0,0,2010
2010-10-27,Pulau Pinang,0,0,0,2010
2010-10-28,Pulau Pinang,0,0,0,2010
2010-10-29,Pulau Pinang,0,0,0,2010
2010-10-30,Pulau Pinang,0,0,0,2010
2010-10-31,Pulau Pinang,0,0,0,2010
2010-11-01,Pulau Pinang,0,0,0,2010
2010-11-02,Pulau Pinang,0,0,0,2010
2010-11-03,Pulau Pinang,0,0,0,2010
2010-11-04,Pulau Pinang,0,0,0,2010
2010-11-05,Pulau Pinang,0,0,0,2010
2010-11-06,Pulau Pinang,0,0,0,2010
2010-11-07,Pulau Pinang,0,0,0,2010
2010-11-08,Pulau Pinang,0,0,0,2010
2010-11-09,Pulau Pinang,0,0,0,2010
2010-11-10,Pulau Pinang,0,0,0,2010
2010-11-11,Pulau Pinang,0,0,0,2010
2010-11-12,Pulau Pinang,0,0,0,2010
2010-11-13,Pulau Pinang,0,0,0,2010
2010-11-14,Pulau Pinang,0,0,0,2010
2010-11-15,Pulau Pinang,0,0,0,2010
2010-11-16,Pulau Pinang,0,0,0,2010
2010-11-17,Pulau Pinang,0,0,0,2010
2010-11-18,Pulau Pinang,0,0,0,2010
2010-11-19,Pulau Pinang,0,0,0,2010
2010-11-20,Pulau Pinang,0,0,0,2010
2010-11-21,Pulau Pinang,0,0,0,2010
2010-11-22,Pulau Pinang,0,0,0,2010
2010-11-23,Pulau Pinang,0,0,0,2010
2010-11-24,Pulau Pinang,0,0,0,2010
2010-11-25,Pulau Pinang,0,0,0,2010
2010-11-26,Pulau Pinang,0,0,0,2010
2010-11-27,Pulau Pinang,0,0,0,2010
2010-11-28,Pulau Pinang,0,0,0,2010
2010-11-29,Pulau Pinang,0,0,0,2010
2010-11-30,Pulau Pinang,0,0,0,2010
2010-12-01,Pulau Pinang,0,0,0,2010
2010-12-02,Pulau Pinang,0,0,0,2010
2010-12-03,Pulau Pinang,0,0,0,2010
2010-12-04,Pulau Pinang,0,0,0,2010
2010-12-05,Pulau Pinang,0,0,0,2010
2010-12-06,Pulau Pinang,0,0,0,2010
2010-12-07,Pulau Pinang,0,0,0,2010
2010-12-08,Pulau Pinang,0,0,0,2010
2010-12-09,Pulau Pinang,0,0,0,2010
2010-12-10,Pulau Pinang,0,0,0,2010
2010-12-11,Pulau Pinang,0,0,0,2010
2010-12-12,Pulau Pinang,0,0,0,2010
2010-12-13,Pulau Pinang,0,0,0,2010
2010-12-14,Pulau Pinang,0,0,0,2010
2010-12-15,Pulau Pinang,0,0,0,2010
2010-12-16,Pulau Pinang,0,0,0,2010
2010-12-17,Pulau Pinang,0,0,0,2010
2010-12-18,Pulau Pinang,0,0,0,2010
2010-12-19,Pulau Pinang,0,0,0,2010
2010-12-20,Pulau Pinang,0,0,0,2010
2010-12-21,Pulau Pinang,0,0,0,2010
2010-12-22,Pulau Pinang,0,0,0,2010
2010-12-23,Pulau Pinang,0,0,0,2010
2010-12-24,Pulau Pinang,0,0,0,2010
2010-12-25,Pulau Pinang,0,0,0,2010
2010-12-26,Pulau Pinang,0,0,0,2010
2010-12-27,Pulau Pinang,0,0,0,2010
2010-12-28,Pulau Pinang,0,0,0,2010
2010-12-29,Pulau Pinang,0,0,0,2010
2010-12-30,Pulau Pinang,0,0,0,2010
2010-12-31,Pulau Pinang,0,0,0,2010
2011-01-01,Pulau Pinang,0,0,0,2011
2011-01-02,Pulau Pinang,0,0,0,2011
2011-01-03,Pulau Pinang,0,0,0,2011
2011-01-04,Pulau Pinang,0,0,0,2011
2011-01-05,Pulau Pinang,0,0,0,2011
2011-01-06,Pulau Pinang,0,0,0,2011
2011-01-07,Pulau Pinang,0,0,0,2011
2011-01-08,Pulau Pinang,0,0,0,2011
2011-01-09,Pulau Pinang,0,0,0,2011
2011-01-10,Pulau Pinang,0,0,0,2011
2011-01-11,Pulau Pinang,0,0,0,2011
2011-01-12,Pulau Pinang,0,0,0,2011
2011-01-13,Pulau Pinang,0,0,0,2011
2011-01-14,Pulau Pinang,0,0,0,2011
2011-01-15,Pulau Pinang,0,0,0,2011
2011-01-16,Pulau Pinang,0,0,0,2011
2011-01-17,Pulau Pinang,0,0,0,2011
2011-01-18,Pulau Pinang,0,0,0,2011
2011-01-19,Pulau Pinang,0,0,0,2011
2011-01-20,Pulau Pinang,0,0,0,2011
2011-01-21,Pulau Pinang,0,0,0,2011
2011-01-22,Pulau Pinang,0,0,0,2011
2011-01-23,Pulau Pinang,0,0,0,2011
2011-01-24,Pulau Pinang,0,0,0,2011
2011-01-25,Pulau Pinang,0,0,0,2011
2011-01-26,Pulau Pinang,0,0,0,2011
2011-01-27,Pulau Pinang,0,0,0,2011
2011-01-28,Pulau Pinang,0,0,0,2011
2011-01-29,Pulau Pinang,0,0,0,2011
2011-01-30,Pulau Pinang,0,0,0,2011
2011-01-31,Pulau Pinang,0,0,0,2011
2011-02-01,Pulau Pinang,0,0,0,2011
2011-02-02,Pulau Pinang,0,0,0,2011
2011-02-03,Pulau Pinang,0,0,0,2011
2011-02-04,Pulau Pinang,0,0,0,2011
2011-02-05,Pulau Pinang,0,0,0,2011
2011-02-06,Pulau Pinang,0,0,0,2011
2011-02-07,Pulau Pinang,0,0,0,2011
2011-02-08,Pulau Pinang,0,0,0,2011
2011-02-09,Pulau Pinang,0,0,0,2011
2011-02-10,Pulau Pinang,0,0,0,2011
2011-02-11,Pulau Pinang,0,0,0,2011
2011-02-12,Pulau Pinang,0,0,0,2011
2011-02-13,Pulau Pinang,0,0,0,2011
2011-02-14,Pulau Pinang,0,0,0,2011
2011-02-15,Pulau Pinang,0,0,0,2011
2011-02-16,Pulau Pinang,0,0,0,2011
2011-02-17,Pulau Pinang,0,0,0,2011
2011-02-18,Pulau Pinang,0,0,0,2011
2011-02-19,Pulau Pinang,0,0,0,2011
2011-02-20,Pulau Pinang,0,0,0,2011
2011-02-21,Pulau Pinang,0,0,0,2011
2011-02-22,Pulau Pinang,0,0,0,2011
2011-02-23,Pulau Pinang,0,0,0,2011
2011-02-24,Pulau Pinang,0,0,0,2011
2011-02-25,Pulau Pinang,0,0,0,2011
2011-02-26,Pulau Pinang,0,0,0,2011
2011-02-27,Pulau Pinang,0,0,0,2011
2011-02-28,Pulau Pinang,0,0,0,2011
2011-03-01,Pulau Pinang,0,0,0,2011
2011-03-02,Pulau Pinang,0,0,0,2011
2011-03-03,Pulau Pinang,0,0,0,2011
2011-03-04,Pulau Pinang,0,0,0,2011
2011-03-05,Pulau Pinang,0,0,0,2011
2011-03-06,Pulau Pinang,0,0,0,2011
2011-03-07,Pulau Pinang,0,0,0,2011
2011-03-08,Pulau Pinang,0,0,0,2011
2011-03-09,Pulau Pinang,0,0,0,2011
2011-03-10,Pulau Pinang,0,0,0,2011
2011-03-11,Pulau Pinang,0,0,0,2011
2011-03-12,Pulau Pinang,0,0,0,2011
2011-03-13,Pulau Pinang,0,0,0,2011
2011-03-14,Pulau Pinang,0,0,0,2011
2011-03-15,Pulau Pinang,0,0,0,2011
2011-03-16,Pulau Pinang,0,0,0,2011
2011-03-17,Pulau Pinang,0,0,0,2011
2011-03-18,Pulau Pinang,0,0,0,2011
2011-03-19,Pulau Pinang,0,0,0,2011
2011-03-20,Pulau Pinang,0,0,0,2011
2011-03-21,Pulau Pinang,0,0,0,2011
2011-03-22,Pulau Pinang,0,0,0,2011
2011-03-23,Pulau Pinang,0,0,0,2011
2011-03-24,Pulau Pinang,0,0,0,2011
2011-03-25,Pulau Pinang,0,0,0,2011
2011-03-26,Pulau Pinang,0,0,0,2011
2011-03-27,Pulau Pinang,0,0,0,2011
2011-03-28,Pulau Pinang,0,0,0,2011
2011-03-29,Pulau Pinang,0,0,0,2011
2011-03-30,Pulau Pinang,0,0,0,2011
2011-03-31,Pulau Pinang,0,0,0,2011
2011-04-01,Pulau Pinang,0,0,0,2011
2011-04-02,Pulau Pinang,0,0,0,2011
2011-04-03,Pulau Pinang,0,0,0,2011
2011-04-04,Pulau Pinang,0,0,0,2011
2011-04-05,Pulau Pinang,0,0,0,2011
2011-04-06,Pulau Pinang,0,0,0,2011
2011-04-07,Pulau Pinang,0,0,0,2011
2011-04-08,Pulau Pinang,0,0,0,2011
2011-04-09,Pulau Pinang,0,0,0,2011
2011-04-10,Pulau Pinang,0,0,0,2011
2011-04-11,Pulau Pinang,0,0,0,2011
2011-04-12,Pulau Pinang,0,0,0,2011
2011-04-13,Pulau Pinang,0,0,0,2011
2011-04-14,Pulau Pinang,0,0,0,2011
2011-04-15,Pulau Pinang,0,0,0,2011
2011-04-16,Pulau Pinang,0,0,0,2011
2011-04-17,Pulau Pinang,0,0,0,2011
2011-04-18,Pulau Pinang,0,0,0,2011
2011-04-19,Pulau Pinang,0,0,0,2011
2011-04-20,Pulau Pinang,0,0,0,2011
2011-04-21,Pulau Pinang,0,0,0,2011
2011-04-22,Pulau Pinang,0,0,0,2011
2011-04-23,Pulau Pinang,0,0,0,2011
2011-04-24,Pulau Pinang,0,0,0,2011
2011-04-25,Pulau Pinang,0,0,0,2011
2011-04-26,Pulau Pinang,0,0,0,2011
2011-04-27,Pulau Pinang,0,0,0,2011
2011-04-28,Pulau Pinang,0,0,0,2011
2011-04-29,Pulau Pinang,0,0,0,2011
2011-04-30,Pulau Pinang,0,0,0,2011
2011-05-01,Pulau Pinang,0,0,0,2011
2011-05-02,Pulau Pinang,0,0,0,2011
2011-05-03,Pulau Pinang,0,0,0,2011
2011-05-04,Pulau Pinang,0,0,0,2011
2011-05-05,Pulau Pinang,0,0,0,2011
2011-05-06,Pulau Pinang,0,0,0,2011
2011-05-07,Pulau Pinang,0,0,0,2011
2011-05-08,Pulau Pinang,0,0,0,2011
2011-05-09,Pulau Pinang,0,0,0,2011
2011-05-10,Pulau Pinang,0,0,0,2011
2011-05-11,Pulau Pinang,0,0,0,2011
2011-05-12,Pulau Pinang,0,0,0,2011
2011-05-13,Pulau Pinang,0,0,0,2011
2011-05-14,Pulau Pinang,0,0,0,2011
2011-05-15,Pulau Pinang,0,0,0,2011
2011-05-16,Pulau Pinang,0,0,0,2011
2011-05-17,Pulau Pinang,0,0,0,2011
2011-05-18,Pulau Pinang,0,0,0,2011
2011-05-19,Pulau Pinang,0,0,0,2011
2011-05-20,Pulau Pinang,0,0,0,2011
2011-05-21,Pulau Pinang,0,0,0,2011
2011-05-22,Pulau Pinang,0,0,0,2011
2011-05-23,Pulau Pinang,0,0,0,2011
2011-05-24,Pulau Pinang,0,0,0,2011
2011-05-25,Pulau Pinang,0,0,0,2011
2011-05-26,Pulau Pinang,0,0,0,2011
2011-05-27,Pulau Pinang,0,0,0,2011
2011-05-28,Pulau Pinang,0,0,0,2011
2011-05-29,Pulau Pinang,0,0,0,2011
2011-05-30,Pulau Pinang,0,0,0,2011
2011-05-31,Pulau Pinang,0,0,0,2011
2011-06-01,Pulau Pinang,0,0,0,2011
2011-06-02,Pulau Pinang,0,0,0,2011
2011-06-03,Pulau Pinang,0,0,0,2011
2011-06-04,Pulau Pinang,0,0,0,2011
2011-06-05,Pulau Pinang,0,0,0,2011
2011-06-06,Pulau Pinang,0,0,0,2011
2011-06-07,Pulau Pinang,0,0,0,2011
2011-06-08,Pulau Pinang,0,0,0,2011
2011-06-09,Pulau Pinang,0,0,0,2011
2011-06-10,Pulau Pinang,0,0,0,2011
2011-06-11,Pulau Pinang,0,0,0,2011
2011-06-12,Pulau Pinang,0,0,0,2011
2011-06-13,Pulau Pinang,0,0,0,2011
2011-06-14,Pulau Pinang,0,0,0,2011
2011-06-15,Pulau Pinang,0,0,0,2011
2011-06-16,Pulau Pinang,0,0,0,2011
2011-06-17,Pulau Pinang,0,0,0,2011
2011-06-18,Pulau Pinang,0,0,0,2011
2011-06-19,Pulau Pinang,0,0,0,2011
2011-06-20,Pulau Pinang,0,0,0,2011
2011-06-21,Pulau Pinang,0,0,0,2011
2011-06-22,Pulau Pinang,0,0,0,2011
2011-06-23,Pulau Pinang,0,0,0,2011
2011-06-24,Pulau Pinang,0,0,0,2011
2011-06-25,Pulau Pinang,0,0,0,2011
2011-06-26,Pulau Pinang,0,0,0,2011
2011-06-27,Pulau Pinang,0,0,0,2011
2011-06-28,Pulau Pinang,0,0,0,2011
2011-06-29,Pulau Pinang,0,0,0,2011
2011-06-30,Pulau Pinang,0,0,0,2011
2011-07-01,Pulau Pinang,0,0,0,2011
2011-07-02,Pulau Pinang,0,0,0,2011
2011-07-03,Pulau Pinang,0,0,0,2011
2011-07-04,Pulau Pinang,0,0,0,2011
2011-07-05,Pulau Pinang,0,0,0,2011
2011-07-06,Pulau Pinang,0,0,0,2011
2011-07-07,Pulau Pinang,0,0,0,2011
2011-07-08,Pulau Pinang,0,0,0,2011
2011-07-09,Pulau Pinang,0,0,0,2011
2011-07-10,Pulau Pinang,0,0,0,2011
2011-07-11,Pulau Pinang,0,0,0,2011
2011-07-12,Pulau Pinang,0,0,0,2011
2011-07-13,Pulau Pinang,0,0,0,2011
2011-07-14,Pulau Pinang,0,0,0,2011
2011-07-15,Pulau Pinang,0,0,0,2011
2011-07-16,Pulau Pinang,0,0,0,2011
2011-07-17,Pulau Pinang,0,0,0,2011
2011-07-18,Pulau Pinang,0,0,0,2011
2011-07-19,Pulau Pinang,0,0,0,2011
2011-07-20,Pulau Pinang,0,0,0,2011
2011-07-21,Pulau Pinang,0,0,0,2011
2011-07-22,Pulau Pinang,0,0,0,2011
2011-07-23,Pulau Pinang,0,0,0,2011
2011-07-24,Pulau Pinang,0,0,0,2011
2011-07-25,Pulau Pinang,0,0,0,2011
2011-07-26,Pulau Pinang,0,0,0,2011
2011-07-27,Pulau Pinang,0,0,0,2011
2011-07-28,Pulau Pinang,0,0,0,2011
2011-07-29,Pulau Pinang,0,0,0,2011
2011-07-30,Pulau Pinang,0,0,0,2011
2011-07-31,Pulau Pinang,0,0,0,2011
2011-08-01,Pulau Pinang,0,0,0,2011
2011-08-02,Pulau Pinang,0,0,0,2011
2011-08-03,Pulau Pinang,0,0,0,2011
2011-08-04,Pulau Pinang,0,0,0,2011
2011-08-05,Pulau Pinang,0,0,0,2011
2011-08-06,Pulau Pinang,0,0,0,2011
2011-08-07,Pulau Pinang,0,0,0,2011
2011-08-08,Pulau Pinang,0,0,0,2011
2011-08-09,Pulau Pinang,0,0,0,2011
2011-08-10,Pulau Pinang,0,0,0,2011
2011-08-11,Pulau Pinang,0,0,0,2011
2011-08-12,Pulau Pinang,0,0,0,2011
2011-08-13,Pulau Pinang,0,0,0,2011
2011-08-14,Pulau Pinang,0,0,0,2011
2011-08-15,Pulau Pinang,0,0,0,2011
2011-08-16,Pulau Pinang,0,0,0,2011
2011-08-17,Pulau Pinang,0,0,0,2011
2011-08-18,Pulau Pinang,0,0,0,2011
2011-08-19,Pulau Pinang,0,0,0,2011
2011-08-20,Pulau Pinang,0,0,0,2011
2011-08-21,Pulau Pinang,0,0,0,2011
2011-08-22,Pulau Pinang,0,0,0,2011
2011-08-23,Pulau Pinang,0,0,0,2011
2011-08-24,Pulau Pinang,0,0,0,2011
2011-08-25,Pulau Pinang,0,0,0,2011
2011-08-26,Pulau Pinang,0,0,0,2011
2011-08-27,Pulau Pinang,0,0,0,2011
2011-08-28,Pulau Pinang,0,0,0,2011
2011-08-29,Pulau Pinang,0,0,0,2011
2011-08-30,Pulau Pinang,0,0,0,2011
2011-08-31,Pulau Pinang,0,0,0,2011
2011-09-01,Pulau Pinang,0,0,0,2011
2011-09-02,Pulau Pinang,0,0,0,2011
2011-09-03,Pulau Pinang,0,0,0,2011
2011-09-04,Pulau Pinang,0,0,0,2011
2011-09-05,Pulau Pinang,0,0,0,2011
2011-09-06,Pulau Pinang,0,0,0,2011
2011-09-07,Pulau Pinang,0,0,0,2011
2011-09-08,Pulau Pinang,0,0,0,2011
2011-09-09,Pulau Pinang,0,0,0,2011
2011-09-10,Pulau Pinang,0,0,0,2011
2011-09-11,Pulau Pinang,0,0,0,2011
2011-09-12,Pulau Pinang,0,0,0,2011
2011-09-13,Pulau Pinang,0,0,0,2011
2011-09-14,Pulau Pinang,0,0,0,2011
2011-09-15,Pulau Pinang,0,0,0,2011
2011-09-16,Pulau Pinang,0,0,0,2011
2011-09-17,Pulau Pinang,0,0,0,2011
2011-09-18,Pulau Pinang,0,0,0,2011
2011-09-19,Pulau Pinang,0,0,0,2011
2011-09-20,Pulau Pinang,0,0,0,2011
2011-09-21,Pulau Pinang,0,0,0,2011
2011-09-22,Pulau Pinang,0,0,0,2011
2011-09-23,Pulau Pinang,0,0,0,2011
2011-09-24,Pulau Pinang,0,0,0,2011
2011-09-25,Pulau Pinang,0,0,0,2011
2011-09-26,Pulau Pinang,0,0,0,2011
2011-09-27,Pulau Pinang,0,0,0,2011
2011-09-28,Pulau Pinang,0,0,0,2011
2011-09-29,Pulau Pinang,0,0,0,2011
2011-09-30,Pulau Pinang,0,0,0,2011
2011-10-01,Pulau Pinang,0,0,0,2011
2011-10-02,Pulau Pinang,0,0,0,2011
2011-10-03,Pulau Pinang,0,0,0,2011
2011-10-04,Pulau Pinang,0,0,0,2011
2011-10-05,Pulau Pinang,0,0,0,2011
2011-10-06,Pulau Pinang,0,0,0,2011
2011-10-07,Pulau Pinang,0,0,0,2011
2011-10-08,Pulau Pinang,0,0,0,2011
2011-10-09,Pulau Pinang,0,0,0,2011
2011-10-10,Pulau Pinang,0,0,0,2011
2011-10-11,Pulau Pinang,0,0,0,2011
2011-10-12,Pulau Pinang,0,0,0,2011
2011-10-13,Pulau Pinang,0,0,0,2011
2011-10-14,Pulau Pinang,0,0,0,2011
2011-10-15,Pulau Pinang,0,0,0,2011
2011-10-16,Pulau Pinang,0,0,0,2011
2011-10-17,Pulau Pinang,0,0,0,2011
2011-10-18,Pulau Pinang,0,0,0,2011
2011-10-19,Pulau Pinang,0,0,0,2011
2011-10-20,Pulau Pinang,0,0,0,2011
2011-10-21,Pulau Pinang,0,0,0,2011
2011-10-22,Pulau Pinang,0,0,0,2011
2011-10-23,Pulau Pinang,0,0,0,2011
2011-10-24,Pulau Pinang,0,0,0,2011
2011-10-25,Pulau Pinang,0,0,0,2011
2011-10-26,Pulau Pinang,0,0,0,2011
2011-10-27,Pulau Pinang,0,0,0,2011
2011-10-28,Pulau Pinang,0,0,0,2011
2011-10-29,Pulau Pinang,0,0,0,2011
2011-10-30,Pulau Pinang,0,0,0,2011
2011-10-31,Pulau Pinang,0,0,0,2011
2011-11-01,Pulau Pinang,0,0,0,2011
2011-11-02,Pulau Pinang,0,0,0,2011
2011-11-03,Pulau Pinang,0,0,0,2011
2011-11-04,Pulau Pinang,0,0,0,2011
2011-11-05,Pulau Pinang,0,0,0,2011
2011-11-06,Pulau Pinang,0,0,0,2011
2011-11-07,Pulau Pinang,0,0,0,2011
2011-11-08,Pulau Pinang,0,0,0,2011
2011-11-09,Pulau Pinang,0,0,0,2011
2011-11-10,Pulau Pinang,0,0,0,2011
2011-11-11,Pulau Pinang,0,0,0,2011
2011-11-12,Pulau Pinang,0,0,0,2011
2011-11-13,Pulau Pinang,0,0,0,2011
2011-11-14,Pulau Pinang,0,0,0,2011
2011-11-15,Pulau Pinang,0,0,0,2011
2011-11-16,Pulau Pinang,0,0,0,2011
2011-11-17,Pulau Pinang,0,0,0,2011
2011-11-18,Pulau Pinang,0,0,0,2011
2011-11-19,Pulau Pinang,0,0,0,2011
2011-11-20,Pulau Pinang,0,0,0,2011
2011-11-21,Pulau Pinang,0,0,0,2011
2011-11-22,Pulau Pinang,0,0,0,2011
2011-11-23,Pulau Pinang,0,0,0,2011
2011-11-24,Pulau Pinang,0,0,0,2011
2011-11-25,Pulau Pinang,0,0,0,2011
2011-11-26,Pulau Pinang,0,0,0,2011
2011-11-27,Pulau Pinang,0,0,0,2011
2011-11-28,Pulau Pinang,0,0,0,2011
2011-11-29,Pulau Pinang,0,0,0,2011
2011-11-30,Pulau Pinang,0,0,0,2011
2011-12-01,Pulau Pinang,0,0,0,2011
2011-12-02,Pulau Pinang,0,0,0,2011
2011-12-03,Pulau Pinang,0,0,0,2011
2011-12-04,Pulau Pinang,0,0,0,2011
2011-12-05,Pulau Pinang,0,0,0,2011
2011-12-06,Pulau Pinang,0,0,0,2011
2011-12-07,Pulau Pinang,0,0,0,2011
2011-12-08,Pulau Pinang,0,0,0,2011
2011-12-09,Pulau Pinang,0,0,0,2011
2011-12-10,Pulau Pinang,0,0,0,2011
2011-12-11,Pulau Pinang,0,0,0,2011
2011-12-12,Pulau Pinang,0,0,0,2011
2011-12-13,Pulau Pinang,0,0,0,2011
2011-12-14,Pulau Pinang,0,0,0,2011
2011-12-15,Pulau Pinang,0,0,0,2011
2011-12-16,Pulau Pinang,0,0,0,2011
2011-12-17,Pulau Pinang,0,0,0,2011
2011-12-18,Pulau Pinang,0,0,0,2011
2011-12-19,Pulau Pinang,0,0,0,2011
2011-12-20,Pulau Pinang,0,0,0,2011
2011-12-21,Pulau Pinang,0,0,0,2011
2011-12-22,Pulau Pinang,0,0,0,2011
2011-12-23,Pulau Pinang,0,0,0,2011
2011-12-24,Pulau Pinang,0,0,0,2011
2011-12-25,Pulau Pinang,0,0,0,2011
2011-12-26,Pulau Pinang,0,0,0,2011
2011-12-27,Pulau Pinang,0,0,0,2011
2011-12-28,Pulau Pinang,0,0,0,2011
2011-12-29,Pulau Pinang,0,0,0,2011
2011-12-30,Pulau Pinang,0,0,0,2011
2011-12-31,Pulau Pinang,0,0,0,2011
2012-01-01,Pulau Pinang,0,0,0,2012
2012-01-02,Pulau Pinang,0,0,0,2012
2012-01-03,Pulau Pinang,0,0,0,2012
2012-01-04,Pulau Pinang,0,0,0,2012
2012-01-05,Pulau Pinang,0,0,0,2012
2012-01-06,Pulau Pinang,0,0,0,2012
2012-01-07,Pulau Pinang,0,0,0,2012
2012-01-08,Pulau Pinang,0,0,0,2012
2012-01-09,Pulau Pinang,0,0,0,2012
2012-01-10,Pulau Pinang,0,0,0,2012
2012-01-11,Pulau Pinang,0,0,0,2012
2012-01-12,Pulau Pinang,0,0,0,2012
2012-01-13,Pulau Pinang,0,0,0,2012
2012-01-14,Pulau Pinang,0,0,0,2012
2012-01-15,Pulau Pinang,0,0,0,2012
2012-01-16,Pulau Pinang,0,0,0,2012
2012-01-17,Pulau Pinang,0,0,0,2012
2012-01-18,Pulau Pinang,0,0,0,2012
2012-01-19,Pulau Pinang,0,0,0,2012
2012-01-20,Pulau Pinang,0,0,0,2012
2012-01-21,Pulau Pinang,0,0,0,2012
2012-01-22,Pulau Pinang,0,0,0,2012
2012-01-23,Pulau Pinang,0,0,0,2012
2012-01-24,Pulau Pinang,0,0,0,2012
2012-01-25,Pulau Pinang,0,0,0,2012
2012-01-26,Pulau Pinang,0,0,0,2012
2012-01-27,Pulau Pinang,0,0,0,2012
2012-01-28,Pulau Pinang,0,0,0,2012
2012-01-29,Pulau Pinang,0,0,0,2012
2012-01-30,Pulau Pinang,0,0,0,2012
2012-01-31,Pulau Pinang,0,0,0,2012
2012-02-01,Pulau Pinang,0,0,0,2012
2012-02-02,Pulau Pinang,0,0,0,2012
2012-02-03,Pulau Pinang,0,0,0,2012
2012-02-04,Pulau Pinang,0,0,0,2012
2012-02-05,Pulau Pinang,0,0,0,2012
2012-02-06,Pulau Pinang,0,0,0,2012
2012-02-07,Pulau Pinang,0,0,0,2012
2012-02-08,Pulau Pinang,0,0,0,2012
2012-02-09,Pulau Pinang,0,0,0,2012
2012-02-10,Pulau Pinang,0,0,0,2012
2012-02-11,Pulau Pinang,0,0,0,2012
2012-02-12,Pulau Pinang,0,0,0,2012
2012-02-13,Pulau Pinang,0,0,0,2012
2012-02-14,Pulau Pinang,0,0,0,2012
2012-02-15,Pulau Pinang,0,0,0,2012
2012-02-16,Pulau Pinang,0,0,0,2012
2012-02-17,Pulau Pinang,0,0,0,2012
2012-02-18,Pulau Pinang,0,0,0,2012
2012-02-19,Pulau Pinang,0,0,0,2012
2012-02-20,Pulau Pinang,0,0,0,2012
2012-02-21,Pulau Pinang,0,0,0,2012
2012-02-22,Pulau Pinang,0,0,0,2012
2012-02-23,Pulau Pinang,0,0,0,2012
2012-02-24,Pulau Pinang,0,0,0,2012
2012-02-25,Pulau Pinang,0,0,0,2012
2012-02-26,Pulau Pinang,0,0,0,2012
2012-02-27,Pulau Pinang,0,0,0,2012
2012-02-28,Pulau Pinang,0,0,0,2012
2012-02-29,Pulau Pinang,0,0,0,2012
2012-03-01,Pulau Pinang,0,0,0,2012
2012-03-02,Pulau Pinang,0,0,0,2012
2012-03-03,Pulau Pinang,0,0,0,2012
2012-03-04,Pulau Pinang,0,0,0,2012
2012-03-05,Pulau Pinang,0,0,0,2012
2012-03-06,Pulau Pinang,0,0,0,2012
2012-03-07,Pulau Pinang,0,0,0,2012
2012-03-08,Pulau Pinang,0,0,0,2012
2012-03-09,Pulau Pinang,0,0,0,2012
2012-03-10,Pulau Pinang,0,0,0,2012
2012-03-11,Pulau Pinang,0,0,0,2012
2012-03-12,Pulau Pinang,0,0,0,2012
2012-03-13,Pulau Pinang,0,0,0,2012
2012-03-14,Pulau Pinang,0,0,0,2012
2012-03-15,Pulau Pinang,0,0,0,2012
2012-03-16,Pulau Pinang,0,0,0,2012
2012-03-17,Pulau Pinang,0,0,0,2012
2012-03-18,Pulau Pinang,0,0,0,2012
2012-03-19,Pulau Pinang,0,0,0,2012
2012-03-20,Pulau Pinang,0,0,0,2012
2012-03-21,Pulau Pinang,0,0,0,2012
2012-03-22,Pulau Pinang,0,0,0,2012
2012-03-23,Pulau Pinang,0,0,0,2012
2012-03-24,Pulau Pinang,0,0,0,2012
2012-03-25,Pulau Pinang,0,0,0,2012
2012-03-26,Pulau Pinang,0,0,0,2012
2012-03-27,Pulau Pinang,0,0,0,2012
2012-03-28,Pulau Pinang,0,0,0,2012
2012-03-29,Pulau Pinang,0,0,0,2012
2012-03-30,Pulau Pinang,0,0,0,2012
2012-03-31,Pulau Pinang,0,0,0,2012
2012-04-01,Pulau Pinang,0,0,0,2012
2012-04-02,Pulau Pinang,0,0,0,2012
2012-04-03,Pulau Pinang,0,0,0,2012
2012-04-04,Pulau Pinang,0,0,0,2012
2012-04-05,Pulau Pinang,0,0,0,2012
2012-04-06,Pulau Pinang,0,0,0,2012
2012-04-07,Pulau Pinang,0,0,0,2012
2012-04-08,Pulau Pinang,0,0,0,2012
2012-04-09,Pulau Pinang,0,0,0,2012
2012-04-10,Pulau Pinang,0,0,0,2012
2012-04-11,Pulau Pinang,0,0,0,2012
2012-04-12,Pulau Pinang,0,0,0,2012
2012-04-13,Pulau Pinang,0,0,0,2012
2012-04-14,Pulau Pinang,0,0,0,2012
2012-04-15,Pulau Pinang,0,0,0,2012
2012-04-16,Pulau Pinang,0,0,0,2012
2012-04-17,Pulau Pinang,0,0,0,2012
2012-04-18,Pulau Pinang,0,0,0,2012
2012-04-19,Pulau Pinang,0,0,0,2012
2012-04-20,Pulau Pinang,0,0,0,2012
2012-04-21,Pulau Pinang,0,0,0,2012
2012-04-22,Pulau Pinang,0,0,0,2012
2012-04-23,Pulau Pinang,0,0,0,2012
2012-04-24,Pulau Pinang,0,0,0,2012
2012-04-25,Pulau Pinang,0,0,0,2012
2012-04-26,Pulau Pinang,0,0,0,2012
2012-04-27,Pulau Pinang,0,0,0,2012
2012-04-28,Pulau Pinang,0,0,0,2012
2012-04-29,Pulau Pinang,0,0,0,2012
2012-04-30,Pulau Pinang,0,0,0,2012
2012-05-01,Pulau Pinang,0,0,0,2012
2012-05-02,Pulau Pinang,0,0,0,2012
2012-05-03,Pulau Pinang,0,0,0,2012
2012-05-04,Pulau Pinang,0,0,0,2012
2012-05-05,Pulau Pinang,0,0,0,2012
2012-05-06,Pulau Pinang,0,0,0,2012
2012-05-07,Pulau Pinang,0,0,0,2012
2012-05-08,Pulau Pinang,0,0,0,2012
2012-05-09,Pulau Pinang,0,0,0,2012
2012-05-10,Pulau Pinang,0,0,0,2012
2012-05-11,Pulau Pinang,0,0,0,2012
2012-05-12,Pulau Pinang,0,0,0,2012
2012-05-13,Pulau Pinang,0,0,0,2012
2012-05-14,Pulau Pinang,0,0,0,2012
2012-05-15,Pulau Pinang,0,0,0,2012
2012-05-16,Pulau Pinang,0,0,0,2012
2012-05-17,Pulau Pinang,0,0,0,2012
2012-05-18,Pulau Pinang,0,0,0,2012
2012-05-19,Pulau Pinang,0,0,0,2012
2012-05-20,Pulau Pinang,0,0,0,2012
2012-05-21,Pulau Pinang,0,0,0,2012
2012-05-22,Pulau Pinang,0,0,0,2012
2012-05-23,Pulau Pinang,0,0,0,2012
2012-05-24,Pulau Pinang,0,0,0,2012
2012-05-25,Pulau Pinang,0,0,0,2012
2012-05-26,Pulau Pinang,0,0,0,2012
2012-05-27,Pulau Pinang,0,0,0,2012
2012-05-28,Pulau Pinang,0,0,0,2012
2012-05-29,Pulau Pinang,0,0,0,2012
2012-05-30,Pulau Pinang,0,0,0,2012
2012-05-31,Pulau Pinang,0,0,0,2012
2012-06-01,Pulau Pinang,0,0,0,2012
2012-06-02,Pulau Pinang,0,0,0,2012
2012-06-03,Pulau Pinang,0,0,0,2012
2012-06-04,Pulau Pinang,0,0,0,2012
2012-06-05,Pulau Pinang,0,0,0,2012
2012-06-06,Pulau Pinang,0,0,0,2012
2012-06-07,Pulau Pinang,0,0,0,2012
2012-06-08,Pulau Pinang,0,0,0,2012
2012-06-09,Pulau Pinang,0,0,0,2012
2012-06-10,Pulau Pinang,0,0,0,2012
2012-06-11,Pulau Pinang,0,0,0,2012
2012-06-12,Pulau Pinang,0,0,0,2012
2012-06-13,Pulau Pinang,0,0,0,2012
2012-06-14,Pulau Pinang,0,0,0,2012
2012-06-15,Pulau Pinang,0,0,0,2012
2012-06-16,Pulau Pinang,0,0,0,2012
2012-06-17,Pulau Pinang,0,0,0,2012
2012-06-18,Pulau Pinang,0,0,0,2012
2012-06-19,Pulau Pinang,0,0,0,2012
2012-06-20,Pulau Pinang,0,0,0,2012
2012-06-21,Pulau Pinang,0,0,0,2012
2012-06-22,Pulau Pinang,0,0,0,2012
2012-06-23,Pulau Pinang,0,0,0,2012
2012-06-24,Pulau Pinang,0,0,0,2012
2012-06-25,Pulau Pinang,0,0,0,2012
2012-06-26,Pulau Pinang,0,0,0,2012
2012-06-27,Pulau Pinang,0,0,0,2012
2012-06-28,Pulau Pinang,0,0,0,2012
2012-06-29,Pulau Pinang,0,0,0,2012
2012-06-30,Pulau Pinang,0,0,0,2012
2012-07-01,Pulau Pinang,0,0,0,2012
2012-07-02,Pulau Pinang,0,0,0,2012
2012-07-03,Pulau Pinang,0,0,0,2012
2012-07-04,Pulau Pinang,0,0,0,2012
2012-07-05,Pulau Pinang,0,0,0,2012
2012-07-06,Pulau Pinang,0,0,0,2012
2012-07-07,Pulau Pinang,0,0,0,2012
2012-07-08,Pulau Pinang,0,0,0,2012
2012-07-09,Pulau Pinang,0,0,0,2012
2012-07-10,Pulau Pinang,0,0,0,2012
2012-07-11,Pulau Pinang,0,0,0,2012
2012-07-12,Pulau Pinang,0,0,0,2012
2012-07-13,Pulau Pinang,0,0,0,2012
2012-07-14,Pulau Pinang,0,0,0,2012
2012-07-15,Pulau Pinang,0,0,0,2012
2012-07-16,Pulau Pinang,0,0,0,2012
2012-07-17,Pulau Pinang,0,0,0,2012
2012-07-18,Pulau Pinang,0,0,0,2012
2012-07-19,Pulau Pinang,0,0,0,2012
2012-07-20,Pulau Pinang,0,0,0,2012
2012-07-21,Pulau Pinang,0,0,0,2012
2012-07-22,Pulau Pinang,0,0,0,2012
2012-07-23,Pulau Pinang,0,0,0,2012
2012-07-24,Pulau Pinang,0,0,0,2012
2012-07-25,Pulau Pinang,0,0,0,2012
2012-07-26,Pulau Pinang,0,0,0,2012
2012-07-27,Pulau Pinang,0,0,0,2012
2012-07-28,Pulau Pinang,0,0,0,2012
2012-07-29,Pulau Pinang,0,0,0,2012
2012-07-30,Pulau Pinang,0,0,0,2012
2012-07-31,Pulau Pinang,0,0,0,2012
2012-08-01,Pulau Pinang,0,0,0,2012
2012-08-02,Pulau Pinang,0,0,0,2012
2012-08-03,Pulau Pinang,0,0,0,2012
2012-08-04,Pulau Pinang,0,0,0,2012
2012-08-05,Pulau Pinang,0,0,0,2012
2012-08-06,Pulau Pinang,0,0,0,2012
2012-08-07,Pulau Pinang,0,0,0,2012
2012-08-08,Pulau Pinang,0,0,0,2012
2012-08-09,Pulau Pinang,0,0,0,2012
2012-08-10,Pulau Pinang,0,0,0,2012
2012-08-11,Pulau Pinang,0,0,0,2012
2012-08-12,Pulau Pinang,0,0,0,2012
2012-08-13,Pulau Pinang,0,0,0,2012
2012-08-14,Pulau Pinang,0,0,0,2012
2012-08-15,Pulau Pinang,0,0,0,2012
2012-08-16,Pulau Pinang,0,0,0,2012
2012-08-17,Pulau Pinang,0,0,0,2012
2012-08-18,Pulau Pinang,0,0,0,2012
2012-08-19,Pulau Pinang,0,0,0,2012
2012-08-20,Pulau Pinang,0,0,0,2012
2012-08-21,Pulau Pinang,0,0,0,2012
2012-08-22,Pulau Pinang,0,0,0,2012
2012-08-23,Pulau Pinang,0,0,0,2012
2012-08-24,Pulau Pinang,0,0,0,2012
2012-08-25,Pulau Pinang,0,0,0,2012
2012-08-26,Pulau Pinang,0,0,0,2012
2012-08-27,Pulau Pinang,0,0,0,2012
2012-08-28,Pulau Pinang,0,0,0,2012
2012-08-29,Pulau Pinang,0,0,0,2012
2012-08-30,Pulau Pinang,0,0,0,2012
2012-08-31,Pulau Pinang,0,0,0,2012
2012-09-01,Pulau Pinang,0,0,0,2012
2012-09-02,Pulau Pinang,0,0,0,2012
2012-09-03,Pulau Pinang,0,0,0,2012
2012-09-04,Pulau Pinang,0,0,0,2012
2012-09-05,Pulau Pinang,0,0,0,2012
2012-09-06,Pulau Pinang,0,0,0,2012
2012-09-07,Pulau Pinang,0,0,0,2012
2012-09-08,Pulau Pinang,0,0,0,2012
2012-09-09,Pulau Pinang,0,0,0,2012
2012-09-10,Pulau Pinang,0,0,0,2012
2012-09-11,Pulau Pinang,0,0,0,2012
2012-09-12,Pulau Pinang,0,0,0,2012
2012-09-13,Pulau Pinang,0,0,0,2012
2012-09-14,Pulau Pinang,0,0,0,2012
2012-09-15,Pulau Pinang,0,0,0,2012
2012-09-16,Pulau Pinang,0,0,0,2012
2012-09-17,Pulau Pinang,0,0,0,2012
2012-09-18,Pulau Pinang,0,0,0,2012
2012-09-19,Pulau Pinang,0,0,0,2012
2012-09-20,Pulau Pinang,0,0,0,2012
2012-09-21,Pulau Pinang,0,0,0,2012
2012-09-22,Pulau Pinang,0,0,0,2012
2012-09-23,Pulau Pinang,0,0,0,2012
2012-09-24,Pulau Pinang,0,0,0,2012
2012-09-25,Pulau Pinang,0,0,0,2012
2012-09-26,Pulau Pinang,0,0,0,2012
2012-09-27,Pulau Pinang,0,0,0,2012
2012-09-28,Pulau Pinang,0,0,0,2012
2012-09-29,Pulau Pinang,0,0,0,2012
2012-09-30,Pulau Pinang,0,0,0,2012
2012-10-01,Pulau Pinang,0,0,0,2012
2012-10-02,Pulau Pinang,0,0,0,2012
2012-10-03,Pulau Pinang,0,0,0,2012
2012-10-04,Pulau Pinang,0,0,0,2012
2012-10-05,Pulau Pinang,0,0,0,2012
2012-10-06,Pulau Pinang,0,0,0,2012
2012-10-07,Pulau Pinang,0,0,0,2012
2012-10-08,Pulau Pinang,0,0,0,2012
2012-10-09,Pulau Pinang,0,0,0,2012
2012-10-10,Pulau Pinang,0,0,0,2012
2012-10-11,Pulau Pinang,0,0,0,2012
2012-10-12,Pulau Pinang,0,0,0,2012
2012-10-13,Pulau Pinang,0,0,0,2012
2012-10-14,Pulau Pinang,0,0,0,2012
2012-10-15,Pulau Pinang,0,0,0,2012
2012-10-16,Pulau Pinang,0,0,0,2012
2012-10-17,Pulau Pinang,0,0,0,2012
2012-10-18,Pulau Pinang,0,0,0,2012
2012-10-19,Pulau Pinang,0,0,0,2012
2012-10-20,Pulau Pinang,0,0,0,2012
2012-10-21,Pulau Pinang,0,0,0,2012
2012-10-22,Pulau Pinang,0,0,0,2012
2012-10-23,Pulau Pinang,0,0,0,2012
2012-10-24,Pulau Pinang,0,0,0,2012
2012-10-25,Pulau Pinang,0,0,0,2012
2012-10-26,Pulau Pinang,0,0,0,2012
2012-10-27,Pulau Pinang,0,0,0,2012
2012-10-28,Pulau Pinang,0,0,0,2012
2012-10-29,Pulau Pinang,0,0,0,2012
2012-10-30,Pulau Pinang,0,0,0,2012
2012-10-31,Pulau Pinang,0,0,0,2012
2012-11-01,Pulau Pinang,0,0,0,2012
2012-11-02,Pulau Pinang,0,0,0,2012
2012-11-03,Pulau Pinang,0,0,0,2012
2012-11-04,Pulau Pinang,0,0,0,2012
2012-11-05,Pulau Pinang,0,0,0,2012
2012-11-06,Pulau Pinang,0,0,0,2012
2012-11-07,Pulau Pinang,0,0,0,2012
2012-11-08,Pulau Pinang,0,0,0,2012
2012-11-09,Pulau Pinang,0,0,0,2012
2012-11-10,Pulau Pinang,0,0,0,2012
2012-11-11,Pulau Pinang,0,0,0,2012
2012-11-12,Pulau Pinang,0,0,0,2012
2012-11-13,Pulau Pinang,0,0,0,2012
2012-11-14,Pulau Pinang,0,0,0,2012
2012-11-15,Pulau Pinang,0,0,0,2012
2012-11-16,Pulau Pinang,0,0,0,2012
2012-11-17,Pulau Pinang,0,0,0,2012
2012-11-18,Pulau Pinang,0,0,0,2012
2012-11-19,Pulau Pinang,0,0,0,2012
2012-11-20,Pulau Pinang,0,0,0,2012
2012-11-21,Pulau Pinang,0,0,0,2012
2012-11-22,Pulau Pinang,0,0,0,2012
2012-11-23,Pulau Pinang,0,0,0,2012
2012-11-24,Pulau Pinang,0,0,0,2012
2012-11-25,Pulau Pinang,0,0,0,2012
2012-11-26,Pulau Pinang,0,0,0,2012
2012-11-27,Pulau Pinang,0,0,0,2012
2012-11-28,Pulau Pinang,0,0,0,2012
2012-11-29,Pulau Pinang,0,0,0,2012
2012-11-30,Pulau Pinang,0,0,0,2012
2012-12-01,Pulau Pinang,0,0,0,2012
2012-12-02,Pulau Pinang,0,0,0,2012
2012-12-03,Pulau Pinang,0,0,0,2012
2012-12-04,Pulau Pinang,0,0,0,2012
2012-12-05,Pulau Pinang,0,0,0,2012
2012-12-06,Pulau Pinang,0,0,0,2012
2012-12-07,Pulau Pinang,0,0,0,2012
2012-12-08,Pulau Pinang,0,0,0,2012
2012-12-09,Pulau Pinang,0,0,0,2012
2012-12-10,Pulau Pinang,0,0,0,2012
2012-12-11,Pulau Pinang,0,0,0,2012
2012-12-12,Pulau Pinang,0,0,0,2012
2012-12-13,Pulau Pinang,0,0,0,2012
2012-12-14,Pulau Pinang,0,0,0,2012
2012-12-15,Pulau Pinang,0,0,0,2012
2012-12-16,Pulau Pinang,0,0,0,2012
2012-12-17,Pulau Pinang,0,0,0,2012
2012-12-18,Pulau Pinang,0,0,0,2012
2012-12-19,Pulau Pinang,0,0,0,2012
2012-12-20,Pulau Pinang,0,0,0,2012
2012-12-21,Pulau Pinang,0,0,0,2012
2012-12-22,Pulau Pinang,0,0,0,2012
2012-12-23,Pulau Pinang,0,0,0,2012
2012-12-24,Pulau Pinang,0,0,0,2012
2012-12-25,Pulau Pinang,0,0,0,2012
2012-12-26,Pulau Pinang,0,0,0,2012
2012-12-27,Pulau Pinang,0,0,0,2012
2012-12-28,Pulau Pinang,0,0,0,2012
2012-12-29,Pulau Pinang,0,0,0,2012
2012-12-30,Pulau Pinang,0,0,0,2012
2012-12-31,Pulau Pinang,0,0,0,2012
2013-01-01,Pulau Pinang,0,0,0,2013
2013-01-02,Pulau Pinang,0,0,0,2013
2013-01-03,Pulau Pinang,0,0,0,2013
2013-01-04,Pulau Pinang,0,0,0,2013
2013-01-05,Pulau Pinang,0,0,0,2013
2013-01-06,Pulau Pinang,0,0,0,2013
2013-01-07,Pulau Pinang,0,0,0,2013
2013-01-08,Pulau Pinang,0,0,0,2013
2013-01-09,Pulau Pinang,0,0,0,2013
2013-01-10,Pulau Pinang,0,0,0,2013
2013-01-11,Pulau Pinang,0,0,0,2013
2013-01-12,Pulau Pinang,0,0,0,2013
2013-01-13,Pulau Pinang,0,0,0,2013
2013-01-14,Pulau Pinang,0,0,0,2013
2013-01-15,Pulau Pinang,0,0,0,2013
2013-01-16,Pulau Pinang,0,0,0,2013
2013-01-17,Pulau Pinang,0,0,0,2013
2013-01-18,Pulau Pinang,0,0,0,2013
2013-01-19,Pulau Pinang,0,0,0,2013
2013-01-20,Pulau Pinang,0,0,0,2013
2013-01-21,Pulau Pinang,0,0,0,2013
2013-01-22,Pulau Pinang,0,0,0,2013
2013-01-23,Pulau Pinang,0,0,0,2013
2013-01-24,Pulau Pinang,0,0,0,2013
2013-01-25,Pulau Pinang,0,0,0,2013
2013-01-26,Pulau Pinang,0,0,0,2013
2013-01-27,Pulau Pinang,0,0,0,2013
2013-01-28,Pulau Pinang,0,0,0,2013
2013-01-29,Pulau Pinang,0,0,0,2013
2013-01-30,Pulau Pinang,0,0,0,2013
2013-01-31,Pulau Pinang,0,0,0,2013
2013-02-01,Pulau Pinang,0,0,0,2013
2013-02-02,Pulau Pinang,0,0,0,2013
2013-02-03,Pulau Pinang,0,0,0,2013
2013-02-04,Pulau Pinang,0,0,0,2013
2013-02-05,Pulau Pinang,0,0,0,2013
2013-02-06,Pulau Pinang,0,0,0,2013
2013-02-07,Pulau Pinang,0,0,0,2013
2013-02-08,Pulau Pinang,0,0,0,2013
2013-02-09,Pulau Pinang,0,0,0,2013
2013-02-10,Pulau Pinang,0,0,0,2013
2013-02-11,Pulau Pinang,0,0,0,2013
2013-02-12,Pulau Pinang,0,0,0,2013
2013-02-13,Pulau Pinang,0,0,0,2013
2013-02-14,Pulau Pinang,0,0,0,2013
2013-02-15,Pulau Pinang,0,0,0,2013
2013-02-16,Pulau Pinang,0,0,0,2013
2013-02-17,Pulau Pinang,0,0,0,2013
2013-02-18,Pulau Pinang,0,0,0,2013
2013-02-19,Pulau Pinang,0,0,0,2013
2013-02-20,Pulau Pinang,0,0,0,2013
2013-02-21,Pulau Pinang,0,0,0,2013
2013-02-22,Pulau Pinang,0,0,0,2013
2013-02-23,Pulau Pinang,0,0,0,2013
2013-02-24,Pulau Pinang,0,0,0,2013
2013-02-25,Pulau Pinang,0,0,0,2013
2013-02-26,Pulau Pinang,0,0,0,2013
2013-02-27,Pulau Pinang,0,0,0,2013
2013-02-28,Pulau Pinang,0,0,0,2013
2013-03-01,Pulau Pinang,0,0,0,2013
2013-03-02,Pulau Pinang,0,0,0,2013
2013-03-03,Pulau Pinang,0,0,0,2013
2013-03-04,Pulau Pinang,0,0,0,2013
2013-03-05,Pulau Pinang,0,0,0,2013
2013-03-06,Pulau Pinang,0,0,0,2013
2013-03-07,Pulau Pinang,0,0,0,2013
2013-03-08,Pulau Pinang,0,0,0,2013
2013-03-09,Pulau Pinang,0,0,0,2013
2013-03-10,Pulau Pinang,0,0,0,2013
2013-03-11,Pulau Pinang,0,0,0,2013
2013-03-12,Pulau Pinang,0,0,0,2013
2013-03-13,Pulau Pinang,0,0,0,2013
2013-03-14,Pulau Pinang,0,0,0,2013
2013-03-15,Pulau Pinang,0,0,0,2013
2013-03-16,Pulau Pinang,0,0,0,2013
2013-03-17,Pulau Pinang,0,0,0,2013
2013-03-18,Pulau Pinang,0,0,0,2013
2013-03-19,Pulau Pinang,0,0,0,2013
2013-03-20,Pulau Pinang,0,0,0,2013
2013-03-21,Pulau Pinang,0,0,0,2013
2013-03-22,Pulau Pinang,0,0,0,2013
2013-03-23,Pulau Pinang,0,0,0,2013
2013-03-24,Pulau Pinang,0,0,0,2013
2013-03-25,Pulau Pinang,0,0,0,2013
2013-03-26,Pulau Pinang,0,0,0,2013
2013-03-27,Pulau Pinang,0,0,0,2013
2013-03-28,Pulau Pinang,0,0,0,2013
2013-03-29,Pulau Pinang,0,0,0,2013
2013-03-30,Pulau Pinang,0,0,0,2013
2013-03-31,Pulau Pinang,0,0,0,2013
2013-04-01,Pulau Pinang,0,0,0,2013
2013-04-02,Pulau Pinang,0,0,0,2013
2013-04-03,Pulau Pinang,0,0,0,2013
2013-04-04,Pulau Pinang,0,0,0,2013
2013-04-05,Pulau Pinang,0,0,0,2013
2013-04-06,Pulau Pinang,0,0,0,2013
2013-04-07,Pulau Pinang,0,0,0,2013
2013-04-08,Pulau Pinang,0,0,0,2013
2013-04-09,Pulau Pinang,0,0,0,2013
2013-04-10,Pulau Pinang,0,0,0,2013
2013-04-11,Pulau Pinang,0,0,0,2013
2013-04-12,Pulau Pinang,0,0,0,2013
2013-04-13,Pulau Pinang,0,0,0,2013
2013-04-14,Pulau Pinang,0,0,0,2013
2013-04-15,Pulau Pinang,0,0,0,2013
2013-04-16,Pulau Pinang,0,0,0,2013
2013-04-17,Pulau Pinang,0,0,0,2013
2013-04-18,Pulau Pinang,0,0,0,2013
2013-04-19,Pulau Pinang,0,0,0,2013
2013-04-20,Pulau Pinang,0,0,0,2013
2013-04-21,Pulau Pinang,0,0,0,2013
2013-04-22,Pulau Pinang,0,0,0,2013
2013-04-23,Pulau Pinang,0,0,0,2013
2013-04-24,Pulau Pinang,0,0,0,2013
2013-04-25,Pulau Pinang,0,0,0,2013
2013-04-26,Pulau Pinang,0,0,0,2013
2013-04-27,Pulau Pinang,0,0,0,2013
2013-04-28,Pulau Pinang,0,0,0,2013
2013-04-29,Pulau Pinang,0,0,0,2013
2013-04-30,Pulau Pinang,0,0,0,2013
2013-05-01,Pulau Pinang,0,0,0,2013
2013-05-02,Pulau Pinang,0,0,0,2013
2013-05-03,Pulau Pinang,0,0,0,2013
2013-05-04,Pulau Pinang,0,0,0,2013
2013-05-05,Pulau Pinang,0,0,0,2013
2013-05-06,Pulau Pinang,0,0,0,2013
2013-05-07,Pulau Pinang,0,0,0,2013
2013-05-08,Pulau Pinang,0,0,0,2013
2013-05-09,Pulau Pinang,0,0,0,2013
2013-05-10,Pulau Pinang,0,0,0,2013
2013-05-11,Pulau Pinang,0,0,0,2013
2013-05-12,Pulau Pinang,0,0,0,2013
2013-05-13,Pulau Pinang,0,0,0,2013
2013-05-14,Pulau Pinang,0,0,0,2013
2013-05-15,Pulau Pinang,0,0,0,2013
2013-05-16,Pulau Pinang,0,0,0,2013
2013-05-17,Pulau Pinang,0,0,0,2013
2013-05-18,Pulau Pinang,0,0,0,2013
2013-05-19,Pulau Pinang,0,0,0,2013
2013-05-20,Pulau Pinang,0,0,0,2013
2013-05-21,Pulau Pinang,0,0,0,2013
2013-05-22,Pulau Pinang,0,0,0,2013
2013-05-23,Pulau Pinang,0,0,0,2013
2013-05-24,Pulau Pinang,0,0,0,2013
2013-05-25,Pulau Pinang,0,0,0,2013
2013-05-26,Pulau Pinang,0,0,0,2013
2013-05-27,Pulau Pinang,0,0,0,2013
2013-05-28,Pulau Pinang,0,0,0,2013
2013-05-29,Pulau Pinang,0,0,0,2013
2013-05-30,Pulau Pinang,0,0,0,2013
2013-05-31,Pulau Pinang,0,0,0,2013
2013-06-01,Pulau Pinang,0,0,0,2013
2013-06-02,Pulau Pinang,0,0,0,2013
2013-06-03,Pulau Pinang,0,0,0,2013
2013-06-04,Pulau Pinang,0,0,0,2013
2013-06-05,Pulau Pinang,0,0,0,2013
2013-06-06,Pulau Pinang,0,0,0,2013
2013-06-07,Pulau Pinang,0,0,0,2013
2013-06-08,Pulau Pinang,0,0,0,2013
2013-06-09,Pulau Pinang,0,0,0,2013
2013-06-10,Pulau Pinang,0,0,0,2013
2013-06-11,Pulau Pinang,0,0,0,2013
2013-06-12,Pulau Pinang,0,0,0,2013
2013-06-13,Pulau Pinang,0,0,0,2013
2013-06-14,Pulau Pinang,0,0,0,2013
2013-06-15,Pulau Pinang,0,0,0,2013
2013-06-16,Pulau Pinang,0,0,0,2013
2013-06-17,Pulau Pinang,0,0,0,2013
2013-06-18,Pulau Pinang,0,0,0,2013
2013-06-19,Pulau Pinang,0,0,0,2013
2013-06-20,Pulau Pinang,0,0,0,2013
2013-06-21,Pulau Pinang,0,0,0,2013
2013-06-22,Pulau Pinang,0,0,0,2013
2013-06-23,Pulau Pinang,0,0,0,2013
2013-06-24,Pulau Pinang,0,0,0,2013
2013-06-25,Pulau Pinang,0,0,0,2013
2013-06-26,Pulau Pinang,0,0,0,2013
2013-06-27,Pulau Pinang,0,0,0,2013
2013-06-28,Pulau Pinang,0,0,0,2013
2013-06-29,Pulau Pinang,0,0,0,2013
2013-06-30,Pulau Pinang,0,0,0,2013
2013-07-01,Pulau Pinang,0,0,0,2013
2013-07-02,Pulau Pinang,0,0,0,2013
2013-07-03,Pulau Pinang,0,0,0,2013
2013-07-04,Pulau Pinang,0,0,0,2013
2013-07-05,Pulau Pinang,0,0,0,2013
2013-07-06,Pulau Pinang,0,0,0,2013
2013-07-07,Pulau Pinang,0,0,0,2013
2013-07-08,Pulau Pinang,0,0,0,2013
2013-07-09,Pulau Pinang,0,0,0,2013
2013-07-10,Pulau Pinang,0,0,0,2013
2013-07-11,Pulau Pinang,0,0,0,2013
2013-07-12,Pulau Pinang,0,0,0,2013
2013-07-13,Pulau Pinang,0,0,0,2013
2013-07-14,Pulau Pinang,0,0,0,2013
2013-07-15,Pulau Pinang,0,0,0,2013
2013-07-16,Pulau Pinang,0,0,0,2013
2013-07-17,Pulau Pinang,0,0,0,2013
2013-07-18,Pulau Pinang,0,0,0,2013
2013-07-19,Pulau Pinang,0,0,0,2013
2013-07-20,Pulau Pinang,0,0,0,2013
2013-07-21,Pulau Pinang,0,0,0,2013
2013-07-22,Pulau Pinang,0,0,0,2013
2013-07-23,Pulau Pinang,0,0,0,2013
2013-07-24,Pulau Pinang,0,0,0,2013
2013-07-25,Pulau Pinang,0,0,0,2013
2013-07-26,Pulau Pinang,0,0,0,2013
2013-07-27,Pulau Pinang,0,0,0,2013
2013-07-28,Pulau Pinang,0,0,0,2013
2013-07-29,Pulau Pinang,0,0,0,2013
2013-07-30,Pulau Pinang,0,0,0,2013
2013-07-31,Pulau Pinang,0,0,0,2013
2013-08-01,Pulau Pinang,0,0,0,2013
2013-08-02,Pulau Pinang,0,0,0,2013
2013-08-03,Pulau Pinang,0,0,0,2013
2013-08-04,Pulau Pinang,0,0,0,2013
2013-08-05,Pulau Pinang,0,0,0,2013
2013-08-06,Pulau Pinang,0,0,0,2013
2013-08-07,Pulau Pinang,0,0,0,2013
2013-08-08,Pulau Pinang,0,0,0,2013
2013-08-09,Pulau Pinang,0,0,0,2013
2013-08-10,Pulau Pinang,0,0,0,2013
2013-08-11,Pulau Pinang,0,0,0,2013
2013-08-12,Pulau Pinang,0,0,0,2013
2013-08-13,Pulau Pinang,0,0,0,2013
2013-08-14,Pulau Pinang,0,0,0,2013
2013-08-15,Pulau Pinang,0,0,0,2013
2013-08-16,Pulau Pinang,0,0,0,2013
2013-08-17,Pulau Pinang,0,0,0,2013
2013-08-18,Pulau Pinang,0,0,0,2013
2013-08-19,Pulau Pinang,0,0,0,2013
2013-08-20,Pulau Pinang,0,0,0,2013
2013-08-21,Pulau Pinang,0,0,0,2013
2013-08-22,Pulau Pinang,0,0,0,2013
2013-08-23,Pulau Pinang,0,0,0,2013
2013-08-24,Pulau Pinang,0,0,0,2013
2013-08-25,Pulau Pinang,0,0,0,2013
2013-08-26,Pulau Pinang,0,0,0,2013
2013-08-27,Pulau Pinang,0,0,0,2013
2013-08-28,Pulau Pinang,0,0,0,2013
2013-08-29,Pulau Pinang,0,0,0,2013
2013-08-30,Pulau Pinang,0,0,0,2013
2013-08-31,Pulau Pinang,0,0,0,2013
2013-09-01,Pulau Pinang,0,0,0,2013
2013-09-02,Pulau Pinang,0,0,0,2013
2013-09-03,Pulau Pinang,0,0,0,2013
2013-09-04,Pulau Pinang,0,0,0,2013
2013-09-05,Pulau Pinang,0,0,0,2013
2013-09-06,Pulau Pinang,0,0,0,2013
2013-09-07,Pulau Pinang,0,0,0,2013
2013-09-08,Pulau Pinang,0,0,0,2013
2013-09-09,Pulau Pinang,0,0,0,2013
2013-09-10,Pulau Pinang,0,0,0,2013
2013-09-11,Pulau Pinang,0,0,0,2013
2013-09-12,Pulau Pinang,0,0,0,2013
2013-09-13,Pulau Pinang,0,0,0,2013
2013-09-14,Pulau Pinang,0,0,0,2013
2013-09-15,Pulau Pinang,0,0,0,2013
2013-09-16,Pulau Pinang,0,0,0,2013
2013-09-17,Pulau Pinang,0,0,0,2013
2013-09-18,Pulau Pinang,0,0,0,2013
2013-09-19,Pulau Pinang,0,0,0,2013
2013-09-20,Pulau Pinang,0,0,0,2013
2013-09-21,Pulau Pinang,0,0,0,2013
2013-09-22,Pulau Pinang,0,0,0,2013
2013-09-23,Pulau Pinang,0,0,0,2013
2013-09-24,Pulau Pinang,0,0,0,2013
2013-09-25,Pulau Pinang,0,0,0,2013
2013-09-26,Pulau Pinang,0,0,0,2013
2013-09-27,Pulau Pinang,0,0,0,2013
2013-09-28,Pulau Pinang,0,0,0,2013
2013-09-29,Pulau Pinang,0,0,0,2013
2013-09-30,Pulau Pinang,0,0,0,2013
2013-10-01,Pulau Pinang,0,0,0,2013
2013-10-02,Pulau Pinang,0,0,0,2013
2013-10-03,Pulau Pinang,0,0,0,2013
2013-10-04,Pulau Pinang,0,0,0,2013
2013-10-05,Pulau Pinang,0,0,0,2013
2013-10-06,Pulau Pinang,0,0,0,2013
2013-10-07,Pulau Pinang,0,0,0,2013
2013-10-08,Pulau Pinang,0,0,0,2013
2013-10-09,Pulau Pinang,0,0,0,2013
2013-10-10,Pulau Pinang,0,0,0,2013
2013-10-11,Pulau Pinang,0,0,0,2013
2013-10-12,Pulau Pinang,0,0,0,2013
2013-10-13,Pulau Pinang,0,0,0,2013
2013-10-14,Pulau Pinang,0,0,0,2013
2013-10-15,Pulau Pinang,0,0,0,2013
2013-10-16,Pulau Pinang,0,0,0,2013
2013-10-17,Pulau Pinang,0,0,0,2013
2013-10-18,Pulau Pinang,0,0,0,2013
2013-10-19,Pulau Pinang,0,0,0,2013
2013-10-20,Pulau Pinang,0,0,0,2013
2013-10-21,Pulau Pinang,0,0,0,2013
2013-10-22,Pulau Pinang,0,0,0,2013
2013-10-23,Pulau Pinang,0,0,0,2013
2013-10-24,Pulau Pinang,0,0,0,2013
2013-10-25,Pulau Pinang,0,0,0,2013
2013-10-26,Pulau Pinang,0,0,0,2013
2013-10-27,Pulau Pinang,0,0,0,2013
2013-10-28,Pulau Pinang,0,0,0,2013
2013-10-29,Pulau Pinang,0,0,0,2013
2013-10-30,Pulau Pinang,0,0,0,2013
2013-10-31,Pulau Pinang,0,0,0,2013
2013-11-01,Pulau Pinang,0,0,0,2013
2013-11-02,Pulau Pinang,0,0,0,2013
2013-11-03,Pulau Pinang,0,0,0,2013
2013-11-04,Pulau Pinang,0,0,0,2013
2013-11-05,Pulau Pinang,0,0,0,2013
2013-11-06,Pulau Pinang,0,0,0,2013
2013-11-07,Pulau Pinang,0,0,0,2013
2013-11-08,Pulau Pinang,0,0,0,2013
2013-11-09,Pulau Pinang,0,0,0,2013
2013-11-10,Pulau Pinang,0,0,0,2013
2013-11-11,Pulau Pinang,0,0,0,2013
2013-11-12,Pulau Pinang,0,0,0,2013
2013-11-13,Pulau Pinang,0,0,0,2013
2013-11-14,Pulau Pinang,0,0,0,2013
2013-11-15,Pulau Pinang,0,0,0,2013
2013-11-16,Pulau Pinang,0,0,0,2013
2013-11-17,Pulau Pinang,0,0,0,2013
2013-11-18,Pulau Pinang,0,0,0,2013
2013-11-19,Pulau Pinang,0,0,0,2013
2013-11-20,Pulau Pinang,0,0,0,2013
2013-11-21,Pulau Pinang,0,0,0,2013
2013-11-22,Pulau Pinang,0,0,0,2013
2013-11-23,Pulau Pinang,0,0,0,2013
2013-11-24,Pulau Pinang,0,0,0,2013
2013-11-25,Pulau Pinang,0,0,0,2013
2013-11-26,Pulau Pinang,0,0,0,2013
2013-11-27,Pulau Pinang,0,0,0,2013
2013-11-28,Pulau Pinang,0,0,0,2013
2013-11-29,Pulau Pinang,0,0,0,2013
2013-11-30,Pulau Pinang,0,0,0,2013
2013-12-01,Pulau Pinang,0,0,0,2013
2013-12-02,Pulau Pinang,0,0,0,2013
2013-12-03,Pulau Pinang,0,0,0,2013
2013-12-04,Pulau Pinang,0,0,0,2013
2013-12-05,Pulau Pinang,0,0,0,2013
2013-12-06,Pulau Pinang,0,0,0,2013
2013-12-07,Pulau Pinang,0,0,0,2013
2013-12-08,Pulau Pinang,0,0,0,2013
2013-12-09,Pulau Pinang,0,0,0,2013
2013-12-10,Pulau Pinang,0,0,0,2013
2013-12-11,Pulau Pinang,0,0,0,2013
2013-12-12,Pulau Pinang,0,0,0,2013
2013-12-13,Pulau Pinang,0,0,0,2013
2013-12-14,Pulau Pinang,0,0,0,2013
2013-12-15,Pulau Pinang,0,0,0,2013
2013-12-16,Pulau Pinang,0,0,0,2013
2013-12-17,Pulau Pinang,0,0,0,2013
2013-12-18,Pulau Pinang,0,0,0,2013
2013-12-19,Pulau Pinang,0,0,0,2013
2013-12-20,Pulau Pinang,0,0,0,2013
2013-12-21,Pulau Pinang,0,0,0,2013
2013-12-22,Pulau Pinang,0,0,0,2013
2013-12-23,Pulau Pinang,0,0,0,2013
2013-12-24,Pulau Pinang,0,0,0,2013
2013-12-25,Pulau Pinang,0,0,0,2013
2013-12-26,Pulau Pinang,0,0,0,2013
2013-12-27,Pulau Pinang,0,0,0,2013
2013-12-28,Pulau Pinang,0,0,0,2013
2013-12-29,Pulau Pinang,0,0,0,2013
2013-12-30,Pulau Pinang,0,0,0,2013
2013-12-31,Pulau Pinang,0,0,0,2013
2014-01-01,Pulau Pinang,0,0,0,2014
2014-01-02,Pulau Pinang,0,0,0,2014
2014-01-03,Pulau Pinang,0,0,0,2014
2014-01-04,Pulau Pinang,0,0,0,2014
2014-01-05,Pulau Pinang,0,0,0,2014
2014-01-06,Pulau Pinang,0,0,0,2014
2014-01-07,Pulau Pinang,0,0,0,2014
2014-01-08,Pulau Pinang,0,0,0,2014
2014-01-09,Pulau Pinang,0,0,0,2014
2014-01-10,Pulau Pinang,0,0,0,2014
2014-01-11,Pulau Pinang,0,0,0,2014
2014-01-12,Pulau Pinang,0,0,0,2014
2014-01-13,Pulau Pinang,0,0,0,2014
2014-01-14,Pulau Pinang,0,0,0,2014
2014-01-15,Pulau Pinang,0,0,0,2014
2014-01-16,Pulau Pinang,0,0,0,2014
2014-01-17,Pulau Pinang,0,0,0,2014
2014-01-18,Pulau Pinang,0,0,0,2014
2014-01-19,Pulau Pinang,0,0,0,2014
2014-01-20,Pulau Pinang,0,0,0,2014
2014-01-21,Pulau Pinang,0,0,0,2014
2014-01-22,Pulau Pinang,0,0,0,2014
2014-01-23,Pulau Pinang,0,0,0,2014
2014-01-24,Pulau Pinang,0,0,0,2014
2014-01-25,Pulau Pinang,0,0,0,2014
2014-01-26,Pulau Pinang,0,0,0,2014
2014-01-27,Pulau Pinang,0,0,0,2014
2014-01-28,Pulau Pinang,0,0,0,2014
2014-01-29,Pulau Pinang,0,0,0,2014
2014-01-30,Pulau Pinang,0,0,0,2014
2014-01-31,Pulau Pinang,0,0,0,2014
2014-02-01,Pulau Pinang,0,0,0,2014
2014-02-02,Pulau Pinang,0,0,0,2014
2014-02-03,Pulau Pinang,0,0,0,2014
2014-02-04,Pulau Pinang,0,0,0,2014
2014-02-05,Pulau Pinang,0,0,0,2014
2014-02-06,Pulau Pinang,0,0,0,2014
2014-02-07,Pulau Pinang,0,0,0,2014
2014-02-08,Pulau Pinang,0,0,0,2014
2014-02-09,Pulau Pinang,0,0,0,2014
2014-02-10,Pulau Pinang,0,0,0,2014
2014-02-11,Pulau Pinang,0,0,0,2014
2014-02-12,Pulau Pinang,0,0,0,2014
2014-02-13,Pulau Pinang,0,0,0,2014
2014-02-14,Pulau Pinang,0,0,0,2014
2014-02-15,Pulau Pinang,0,0,0,2014
2014-02-16,Pulau Pinang,0,0,0,2014
2014-02-17,Pulau Pinang,0,0,0,2014
2014-02-18,Pulau Pinang,0,0,0,2014
2014-02-19,Pulau Pinang,0,0,0,2014
2014-02-20,Pulau Pinang,0,0,0,2014
2014-02-21,Pulau Pinang,0,0,0,2014
2014-02-22,Pulau Pinang,0,0,0,2014
2014-02-23,Pulau Pinang,0,0,0,2014
2014-02-24,Pulau Pinang,0,0,0,2014
2014-02-25,Pulau Pinang,0,0,0,2014
2014-02-26,Pulau Pinang,0,0,0,2014
2014-02-27,Pulau Pinang,0,0,0,2014
2014-02-28,Pulau Pinang,0,0,0,2014
2014-03-01,Pulau Pinang,0,0,0,2014
2014-03-02,Pulau Pinang,0,0,0,2014
2014-03-03,Pulau Pinang,0,0,0,2014
2014-03-04,Pulau Pinang,0,0,0,2014
2014-03-05,Pulau Pinang,0,0,0,2014
2014-03-06,Pulau Pinang,0,0,0,2014
2014-03-07,Pulau Pinang,0,0,0,2014
2014-03-08,Pulau Pinang,0,0,0,2014
2014-03-09,Pulau Pinang,0,0,0,2014
2014-03-10,Pulau Pinang,0,0,0,2014
2014-03-11,Pulau Pinang,0,0,0,2014
2014-03-12,Pulau Pinang,0,0,0,2014
2014-03-13,Pulau Pinang,0,0,0,2014
2014-03-14,Pulau Pinang,0,0,0,2014
2014-03-15,Pulau Pinang,0,0,0,2014
2014-03-16,Pulau Pinang,0,0,0,2014
2014-03-17,Pulau Pinang,0,0,0,2014
2014-03-18,Pulau Pinang,0,0,0,2014
2014-03-19,Pulau Pinang,0,0,0,2014
2014-03-20,Pulau Pinang,0,0,0,2014
2014-03-21,Pulau Pinang,0,0,0,2014
2014-03-22,Pulau Pinang,0,0,0,2014
2014-03-23,Pulau Pinang,0,0,0,2014
2014-03-24,Pulau Pinang,0,0,0,2014
2014-03-25,Pulau Pinang,0,0,0,2014
2014-03-26,Pulau Pinang,0,0,0,2014
2014-03-27,Pulau Pinang,0,0,0,2014
2014-03-28,Pulau Pinang,0,0,0,2014
2014-03-29,Pulau Pinang,0,0,0,2014
2014-03-30,Pulau Pinang,0,0,0,2014
2014-03-31,Pulau Pinang,0,0,0,2014
2014-04-01,Pulau Pinang,0,0,0,2014
2014-04-02,Pulau Pinang,0,0,0,2014
2014-04-03,Pulau Pinang,0,0,0,2014
2014-04-04,Pulau Pinang,0,0,0,2014
2014-04-05,Pulau Pinang,0,0,0,2014
2014-04-06,Pulau Pinang,0,0,0,2014
2014-04-07,Pulau Pinang,0,0,0,2014
2014-04-08,Pulau Pinang,0,0,0,2014
2014-04-09,Pulau Pinang,0,0,0,2014
2014-04-10,Pulau Pinang,0,0,0,2014
2014-04-11,Pulau Pinang,0,0,0,2014
2014-04-12,Pulau Pinang,0,0,0,2014
2014-04-13,Pulau Pinang,0,0,0,2014
2014-04-14,Pulau Pinang,0,0,0,2014
2014-04-15,Pulau Pinang,0,0,0,2014
2014-04-16,Pulau Pinang,0,0,0,2014
2014-04-17,Pulau Pinang,0,0,0,2014
2014-04-18,Pulau Pinang,0,0,0,2014
2014-04-19,Pulau Pinang,0,0,0,2014
2014-04-20,Pulau Pinang,0,0,0,2014
2014-04-21,Pulau Pinang,44,40,4,2014
2014-04-22,Pulau Pinang,188,138,50,2014
2014-04-23,Pulau Pinang,144,111,33,2014
2014-04-24,Pulau Pinang,159,145,14,2014
2014-04-25,Pulau Pinang,36,27,9,2014
2014-04-26,Pulau Pinang,183,160,23,2014
2014-04-27,Pulau Pinang,248,235,13,2014
2014-04-28,Pulau Pinang,38,33,5,2014
2014-04-29,Pulau Pinang,93,80,13,2014
2014-04-30,Pulau Pinang,32,28,4,2014
2014-05-01,Pulau Pinang,197,143,54,2014
2014-05-02,Pulau Pinang,30,26,4,2014
2014-05-03,Pulau Pinang,188,113,75,2014
2014-05-04,Pulau Pinang,171,121,50,2014
2014-05-05,Pulau Pinang,71,62,9,2014
2014-05-06,Pulau Pinang,35,27,8,2014
2014-05-07,Pulau Pinang,92,85,7,2014
2014-05-08,Pulau Pinang,86,75,11,2014
2014-05-09,Pulau Pinang,62,43,19,2014
2014-05-10,Pulau Pinang,9,7,2,2014
2014-05-11,Pulau Pinang,204,170,34,2014
2014-05-12,Pulau Pinang,101,86,15,2014
2014-05-13,Pulau Pinang,128,115,13,2014
2014-05-14,Pulau Pinang,200,165,35,2014
2014-05-15,Pulau Pinang,99,80,19,2014
2014-05-16,Pulau Pinang,27,23,4,2014
2014-05-17,Pulau Pinang,121,88,33,2014
2014-05-18,Pulau Pinang,178,128,50,2014
2014-05-19,Pulau Pinang,51,40,11,2014
2014-05-20,Pulau Pinang,136,101,35,2014
2014-05-21,Pulau Pinang,97,79,18,2014
2014-05-22,Pulau Pinang,234,207,27,2014
2014-05-23,Pulau Pinang,28,21,7,2014
2014-05-24,Pulau Pinang,167,129,38,2014
2014-05-25,Pulau Pinang,82,60,22,2014
2014-05-26,Pulau Pinang,197,164,33,2014
2014-05-27,Pulau Pinang,70,56,14,2014
2014-05-28,Pulau Pinang,284,240,44,2014
2014-05-29,Pulau Pinang,111,87,24,2014
2014-05-30,Pulau Pinang,128,106,22,2014
2014-05-31,Pulau Pinang,16,12,4,2014
2014-06-01,Pulau Pinang,48,37,11,2014
2014-06-02,Pulau Pinang,39,35,4,2014
2014-06-03,Pulau Pinang,93,67,26,2014
2014-06-04,Pulau Pinang,69,56,13,2014
2014-06-05,Pulau Pinang,63,55,8,2014
2014-06-06,Pulau Pinang,140,106,34,2014
2014-06-07,Pulau Pinang,154,140,14,2014
2014-06-08,Pulau Pinang,196,188,8,2014
2014-06-09,Pulau Pinang,90,82,8,2014
2014-06-10,Pulau Pinang,170,144,26,2014
2014-06-11,Pulau Pinang,145,129,16,2014
2014-06-12,Pulau Pinang,170,138,32,2014
2014-06-13,Pulau Pinang,135,102,33,2014
2014-06-14,Pulau Pinang,106,100,6,2014
2014-06-15,Pulau Pinang,221,165,56,2014
2014-06-16,Pulau Pinang,66,59,7,2014
2014-06-17,Pulau Pinang,221,159,62,2014
2014-06-18,Pulau Pinang,157,101,56,2014
2014-06-19,Pulau Pinang,75,55,20,2014
2014-06-20,Pulau Pinang,39,27,12,2014
2014-06-21,Pulau Pinang,134,83,51,2014
2014-06-22,Pulau Pinang,322,219,103,2014
2014-06-23,Pulau Pinang,166,139,27,2014
2014-06-24,Pulau Pinang,151,112,39,2014
2014-06-25,Pulau Pinang,159,132,27,2014
2014-06-26,Pulau Pinang,78,42,36,2014
2014-06-27,Pulau Pinang,64,51,13,2014
2014-06-28,Pulau Pinang,0,0,0,2014
2014-06-29,Pulau Pinang,60,49,11,2014
2014-06-30,Pulau Pinang,27,23,4,2014
2014-07-01,Pulau Pinang,29,21,8,2014
2014-07-02,Pulau Pinang,31,24,7,2014
2014-07-03,Pulau Pinang,48,45,3,2014
2014-07-04,Pulau Pinang,26,17,9,2014
2014-07-05,Pulau Pinang,54,43,11,2014
2014-07-06,Pulau Pinang,272,229,43,2014
2014-07-07,Pulau Pinang,0,0,0,2014
2014-07-08,Pulau Pinang,46,34,12,2014
2014-07-09,Pulau Pinang,129,113,16,2014
2014-07-10,Pulau Pinang,31,26,5,2014
2014-07-11,Pulau Pinang,28,23,5,2014
2014-07-12,Pulau Pinang,114,87,27,2014
2014-07-13,Pulau Pinang,171,128,43,2014
2014-07-14,Pulau Pinang,86,72,14,2014
2014-07-15,Pulau Pinang,22,16,6,2014
2014-07-16,Pulau Pinang,98,90,8,2014
2014-07-17,Pulau Pinang,127,113,14,2014
2014-07-18,Pulau Pinang,25,20,5,2014
2014-07-19,Pulau Pinang,24,18,6,2014
2014-07-20,Pulau Pinang,197,129,68,2014
2014-07-21,Pulau Pinang,39,33,6,2014
2014-07-22,Pulau Pinang,116,91,25,2014
2014-07-23,Pulau Pinang,39,29,10,2014
2014-07-24,Pulau Pinang,138,106,32,2014
2014-07-25,Pulau Pinang,37,26,11,2014
2014-07-26,Pulau Pinang,23,15,8,2014
2014-07-27,Pulau Pinang,100,35,65,2014
2014-07-28,Pulau Pinang,0,0,0,2014
2014-07-29,Pulau Pinang,0,0,0,2014
2014-07-30,Pulau Pinang,39,30,9,2014
2014-07-31,Pulau Pinang,45,30,15,2014
2014-08-01,Pulau Pinang,37,22,15,2014
2014-08-02,Pulau Pinang,72,52,20,2014
2014-08-03,Pulau Pinang,176,120,56,2014
2014-08-04,Pulau Pinang,42,26,16,2014
2014-08-05,Pulau Pinang,41,19,22,2014
2014-08-06,Pulau Pinang,78,47,31,2014
2014-08-07,Pulau Pinang,167,112,55,2014
2014-08-08,Pulau Pinang,144,104,40,2014
2014-08-09,Pulau Pinang,96,76,20,2014
2014-08-10,Pulau Pinang,142,118,24,2014
2014-08-11,Pulau Pinang,101,67,34,2014
2014-08-12,Pulau Pinang,98,63,35,2014
2014-08-13,Pulau Pinang,79,46,33,2014
2014-08-14,Pulau Pinang,170,135,35,2014
2014-08-15,Pulau Pinang,65,51,14,2014
2014-08-16,Pulau Pinang,36,27,9,2014
2014-08-17,Pulau Pinang,311,167,144,2014
2014-08-18,Pulau Pinang,122,97,25,2014
2014-08-19,Pulau Pinang,161,127,34,2014
2014-08-20,Pulau Pinang,201,156,45,2014
2014-08-21,Pulau Pinang,77,48,29,2014
2014-08-22,Pulau Pinang,33,15,18,2014
2014-08-23,Pulau Pinang,34,16,18,2014
2014-08-24,Pulau Pinang,346,206,140,2014
2014-08-25,Pulau Pinang,66,31,35,2014
2014-08-26,Pulau Pinang,133,89,44,2014
2014-08-27,Pulau Pinang,290,216,74,2014
2014-08-28,Pulau Pinang,232,167,65,2014
2014-08-29,Pulau Pinang,165,116,49,2014
2014-08-30,Pulau Pinang,9,5,4,2014
2014-08-31,Pulau Pinang,238,191,47,2014
2014-09-01,Pulau Pinang,0,0,0,2014
2014-09-02,Pulau Pinang,50,26,24,2014
2014-09-03,Pulau Pinang,196,155,41,2014
2014-09-04,Pulau Pinang,59,30,29,2014
2014-09-05,Pulau Pinang,69,48,21,2014
2014-09-06,Pulau Pinang,16,6,10,2014
2014-09-07,Pulau Pinang,271,126,145,2014
2014-09-08,Pulau Pinang,87,65,22,2014
2014-09-09,Pulau Pinang,115,87,28,2014
2014-09-10,Pulau Pinang,136,111,25,2014
2014-09-11,Pulau Pinang,147,120,27,2014
2014-09-12,Pulau Pinang,39,11,28,2014
2014-09-13,Pulau Pinang,135,81,54,2014
2014-09-14,Pulau Pinang,190,102,88,2014
2014-09-15,Pulau Pinang,58,22,36,2014
2014-09-16,Pulau Pinang,72,48,24,2014
2014-09-17,Pulau Pinang,256,168,88,2014
2014-09-18,Pulau Pinang,130,86,44,2014
2014-09-19,Pulau Pinang,39,21,18,2014
2014-09-20,Pulau Pinang,87,60,27,2014
2014-09-21,Pulau Pinang,109,83,26,2014
2014-09-22,Pulau Pinang,90,44,46,2014
2014-09-23,Pulau Pinang,72,40,32,2014
2014-09-24,Pulau Pinang,94,59,35,2014
2014-09-25,Pulau Pinang,213,149,64,2014
2014-09-26,Pulau Pinang,30,13,17,2014
2014-09-27,Pulau Pinang,44,33,11,2014
2014-09-28,Pulau Pinang,156,91,65,2014
2014-09-29,Pulau Pinang,47,23,24,2014
2014-09-30,Pulau Pinang,104,82,22,2014
2014-10-01,Pulau Pinang,180,122,58,2014
2014-10-02,Pulau Pinang,240,175,65,2014
2014-10-03,Pulau Pinang,43,14,29,2014
2014-10-04,Pulau Pinang,13,4,9,2014
2014-10-05,Pulau Pinang,0,0,0,2014
2014-10-06,Pulau Pinang,0,0,0,2014
2014-10-07,Pulau Pinang,187,86,101,2014
2014-10-08,Pulau Pinang,74,24,50,2014
2014-10-09,Pulau Pinang,113,80,33,2014
2014-10-10,Pulau Pinang,27,7,20,2014
2014-10-11,Pulau Pinang,75,56,19,2014
2014-10-12,Pulau Pinang,115,85,30,2014
2014-10-13,Pulau Pinang,62,36,26,2014
2014-10-14,Pulau Pinang,193,128,65,2014
2014-10-15,Pulau Pinang,87,65,22,2014
2014-10-16,Pulau Pinang,134,100,34,2014
2014-10-17,Pulau Pinang,67,39,28,2014
2014-10-18,Pulau Pinang,128,88,40,2014
2014-10-19,Pulau Pinang,194,107,87,2014
2014-10-20,Pulau Pinang,50,33,17,2014
2014-10-21,Pulau Pinang,85,55,30,2014
2014-10-22,Pulau Pinang,84,50,34,2014
2014-10-23,Pulau Pinang,71,53,18,2014
2014-10-24,Pulau Pinang,46,17,29,2014
2014-10-25,Pulau Pinang,13,8,5,2014
2014-10-26,Pulau Pinang,85,55,30,2014
2014-10-27,Pulau Pinang,64,31,33,2014
2014-10-28,Pulau Pinang,51,24,27,2014
2014-10-29,Pulau Pinang,79,44,35,2014
2014-10-30,Pulau Pinang,96,73,23,2014
2014-10-31,Pulau Pinang,28,9,19,2014
2014-11-01,Pulau Pinang,421,309,112,2014
2014-11-02,Pulau Pinang,153,48,105,2014
2014-11-03,Pulau Pinang,116,72,44,2014
2014-11-04,Pulau Pinang,99,40,59,2014
2014-11-05,Pulau Pinang,126,70,56,2014
2014-11-06,Pulau Pinang,115,68,47,2014
2014-11-07,Pulau Pinang,31,17,14,2014
2014-11-08,Pulau Pinang,108,77,31,2014
2014-11-09,Pulau Pinang,163,66,97,2014
2014-11-10,Pulau Pinang,28,8,20,2014
2014-11-11,Pulau Pinang,175,110,65,2014
2014-11-12,Pulau Pinang,71,54,17,2014
2014-11-13,Pulau Pinang,84,53,31,2014
2014-11-14,Pulau Pinang,82,50,32,2014
2014-11-15,Pulau Pinang,0,0,0,2014
2014-11-16,Pulau Pinang,275,144,131,2014
2014-11-17,Pulau Pinang,143,61,82,2014
2014-11-18,Pulau Pinang,122,83,39,2014
2014-11-19,Pulau Pinang,89,35,54,2014
2014-11-20,Pulau Pinang,290,146,144,2014
2014-11-21,Pulau Pinang,30,10,20,2014
2014-11-22,Pulau Pinang,88,55,33,2014
2014-11-23,Pulau Pinang,158,86,72,2014
2014-11-24,Pulau Pinang,50,22,28,2014
2014-11-25,Pulau Pinang,96,54,42,2014
2014-11-26,Pulau Pinang,140,109,31,2014
2014-11-27,Pulau Pinang,24,6,18,2014
2014-11-28,Pulau Pinang,25,6,19,2014
2014-11-29,Pulau Pinang,27,21,6,2014
2014-11-30,Pulau Pinang,100,78,22,2014
2014-12-01,Pulau Pinang,66,24,42,2014
2014-12-02,Pulau Pinang,162,75,87,2014
2014-12-03,Pulau Pinang,140,83,57,2014
2014-12-04,Pulau Pinang,141,108,33,2014
2014-12-05,Pulau Pinang,67,35,32,2014
2014-12-06,Pulau Pinang,39,19,20,2014
2014-12-07,Pulau Pinang,270,74,196,2014
2014-12-08,Pulau Pinang,52,25,27,2014
2014-12-09,Pulau Pinang,98,56,42,2014
2014-12-10,Pulau Pinang,59,32,27,2014
2014-12-11,Pulau Pinang,74,45,29,2014
2014-12-12,Pulau Pinang,46,12,34,2014
2014-12-13,Pulau Pinang,9,7,2,2014
2014-12-14,Pulau Pinang,94,70,24,2014
2014-12-15,Pulau Pinang,101,56,45,2014
2014-12-16,Pulau Pinang,29,6,23,2014
2014-12-17,Pulau Pinang,76,41,35,2014
2014-12-18,Pulau Pinang,96,64,32,2014
2014-12-19,Pulau Pinang,36,5,31,2014
2014-12-20,Pulau Pinang,44,28,16,2014
2014-12-21,Pulau Pinang,197,78,119,2014
2014-12-22,Pulau Pinang,171,116,55,2014
2014-12-23,Pulau Pinang,103,56,47,2014
2014-12-24,Pulau Pinang,183,94,89,2014
2014-12-25,Pulau Pinang,61,33,28,2014
2014-12-26,Pulau Pinang,68,21,47,2014
2014-12-27,Pulau Pinang,74,41,33,2014
2014-12-28,Pulau Pinang,302,146,156,2014
2014-12-29,Pulau Pinang,236,136,100,2014
2014-12-30,Pulau Pinang,161,74,87,2014
2014-12-31,Pulau Pinang,171,74,97,2014
2015-01-01,Pulau Pinang,54,34,20,2015
2015-01-02,Pulau Pinang,64,18,46,2015
2015-01-03,Pulau Pinang,43,30,13,2015
2015-01-04,Pulau Pinang,39,14,25,2015
2015-01-05,Pulau Pinang,58,16,42,2015
2015-01-06,Pulau Pinang,98,53,45,2015
2015-01-07,Pulau Pinang,104,45,59,2015
2015-01-08,Pulau Pinang,123,66,57,2015
2015-01-09,Pulau Pinang,177,109,68,2015
2015-01-10,Pulau Pinang,98,55,43,2015
2015-01-11,Pulau Pinang,382,180,202,2015
2015-01-12,Pulau Pinang,105,55,50,2015
2015-01-13,Pulau Pinang,120,72,48,2015
2015-01-14,Pulau Pinang,93,58,35,2015
2015-01-15,Pulau Pinang,161,108,53,2015
2015-01-16,Pulau Pinang,90,49,41,2015
2015-01-17,Pulau Pinang,156,111,45,2015
2015-01-18,Pulau Pinang,307,156,151,2015
2015-01-19,Pulau Pinang,93,41,52,2015
2015-01-20,Pulau Pinang,96,57,39,2015
2015-01-21,Pulau Pinang,63,31,32,2015
2015-01-22,Pulau Pinang,323,210,113,2015
2015-01-23,Pulau Pinang,32,7,25,2015
2015-01-24,Pulau Pinang,210,186,24,2015
2015-01-25,Pulau Pinang,109,32,77,2015
2015-01-26,Pulau Pinang,24,9,15,2015
2015-01-27,Pulau Pinang,52,20,32,2015
2015-01-28,Pulau Pinang,212,149,63,2015
2015-01-29,Pulau Pinang,112,73,39,2015
2015-01-30,Pulau Pinang,45,10,35,2015
2015-01-31,Pulau Pinang,59,27,32,2015
2015-02-01,Pulau Pinang,112,20,92,2015
2015-02-02,Pulau Pinang,32,11,21,2015
2015-02-03,Pulau Pinang,408,283,125,2015
2015-02-04,Pulau Pinang,97,34,63,2015
2015-02-05,Pulau Pinang,267,138,129,2015
2015-02-06,Pulau Pinang,34,9,25,2015
2015-02-07,Pulau Pinang,10,1,9,2015
2015-02-08,Pulau Pinang,227,96,131,2015
2015-02-09,Pulau Pinang,85,47,38,2015
2015-02-10,Pulau Pinang,86,45,41,2015
2015-02-11,Pulau Pinang,81,35,46,2015
2015-02-12,Pulau Pinang,123,64,59,2015
2015-02-13,Pulau Pinang,32,10,22,2015
2015-02-14,Pulau Pinang,35,20,15,2015
2015-02-15,Pulau Pinang,173,57,116,2015
2015-02-16,Pulau Pinang,42,5,37,2015
2015-02-17,Pulau Pinang,114,46,68,2015
2015-02-18,Pulau Pinang,109,39,70,2015
2015-02-19,Pulau Pinang,43,20,23,2015
2015-02-20,Pulau Pinang,0,0,0,2015
2015-02-21,Pulau Pinang,67,44,23,2015
2015-02-22,Pulau Pinang,17,11,6,2015
2015-02-23,Pulau Pinang,62,20,42,2015
2015-02-24,Pulau Pinang,123,58,65,2015
2015-02-25,Pulau Pinang,150,65,85,2015
2015-02-26,Pulau Pinang,152,104,48,2015
2015-02-27,Pulau Pinang,45,16,29,2015
2015-02-28,Pulau Pinang,83,48,35,2015
2015-03-01,Pulau Pinang,56,32,24,2015
2015-03-02,Pulau Pinang,37,6,31,2015
2015-03-03,Pulau Pinang,102,36,66,2015
2015-03-04,Pulau Pinang,116,51,65,2015
2015-03-05,Pulau Pinang,185,113,72,2015
2015-03-06,Pulau Pinang,58,22,36,2015
2015-03-07,Pulau Pinang,90,58,32,2015
2015-03-08,Pulau Pinang,268,90,178,2015
2015-03-09,Pulau Pinang,97,43,54,2015
2015-03-10,Pulau Pinang,289,145,144,2015
2015-03-11,Pulau Pinang,253,132,121,2015
2015-03-12,Pulau Pinang,124,49,75,2015
2015-03-13,Pulau Pinang,35,11,24,2015
2015-03-14,Pulau Pinang,30,14,16,2015
2015-03-15,Pulau Pinang,129,41,88,2015
2015-03-16,Pulau Pinang,81,29,52,2015
2015-03-17,Pulau Pinang,61,13,48,2015
2015-03-18,Pulau Pinang,159,78,81,2015
2015-03-19,Pulau Pinang,60,8,52,2015
2015-03-20,Pulau Pinang,26,4,22,2015
2015-03-21,Pulau Pinang,132,78,54,2015
2015-03-22,Pulau Pinang,301,119,182,2015
2015-03-23,Pulau Pinang,105,32,73,2015
2015-03-24,Pulau Pinang,47,12,35,2015
2015-03-25,Pulau Pinang,142,78,64,2015
2015-03-26,Pulau Pinang,104,51,53,2015
2015-03-27,Pulau Pinang,55,29,26,2015
2015-03-28,Pulau Pinang,61,34,27,2015
2015-03-29,Pulau Pinang,51,28,23,2015
2015-03-30,Pulau Pinang,37,4,33,2015
2015-03-31,Pulau Pinang,80,46,34,2015
2015-04-01,Pulau Pinang,87,35,52,2015
2015-04-02,Pulau Pinang,179,89,90,2015
2015-04-03,Pulau Pinang,44,8,36,2015
2015-04-04,Pulau Pinang,38,12,26,2015
2015-04-05,Pulau Pinang,85,51,34,2015
2015-04-06,Pulau Pinang,96,45,51,2015
2015-04-07,Pulau Pinang,122,37,85,2015
2015-04-08,Pulau Pinang,43,20,23,2015
2015-04-09,Pulau Pinang,162,65,97,2015
2015-04-10,Pulau Pinang,61,13,48,2015
2015-04-11,Pulau Pinang,168,97,71,2015
2015-04-12,Pulau Pinang,177,42,135,2015
2015-04-13,Pulau Pinang,157,85,72,2015
2015-04-14,Pulau Pinang,72,18,54,2015
2015-04-15,Pulau Pinang,192,70,122,2015
2015-04-16,Pulau Pinang,62,35,27,2015
2015-04-17,Pulau Pinang,37,5,32,2015
2015-04-18,Pulau Pinang,138,87,51,2015
2015-04-19,Pulau Pinang,157,70,87,2015
2015-04-20,Pulau Pinang,76,18,58,2015
2015-04-21,Pulau Pinang,125,58,67,2015
2015-04-22,Pulau Pinang,113,39,74,2015
2015-04-23,Pulau Pinang,100,36,64,2015
2015-04-24,Pulau Pinang,39,16,23,2015
2015-04-25,Pulau Pinang,33,12,21,2015
2015-04-26,Pulau Pinang,428,134,294,2015
2015-04-27,Pulau Pinang,48,17,31,2015
2015-04-28,Pulau Pinang,147,84,63,2015
2015-04-29,Pulau Pinang,131,61,70,2015
2015-04-30,Pulau Pinang,158,65,93,2015
2015-05-01,Pulau Pinang,87,34,53,2015
2015-05-02,Pulau Pinang,40,16,24,2015
2015-05-03,Pulau Pinang,187,118,69,2015
2015-05-04,Pulau Pinang,67,31,36,2015
2015-05-05,Pulau Pinang,86,32,54,2015
2015-05-06,Pulau Pinang,90,44,46,2015
2015-05-07,Pulau Pinang,198,110,88,2015
2015-05-08,Pulau Pinang,75,43,32,2015
2015-05-09,Pulau Pinang,144,68,76,2015
2015-05-10,Pulau Pinang,343,90,253,2015
2015-05-11,Pulau Pinang,47,10,37,2015
2015-05-12,Pulau Pinang,60,35,25,2015
2015-05-13,Pulau Pinang,82,24,58,2015
2015-05-14,Pulau Pinang,141,59,82,2015
2015-05-15,Pulau Pinang,26,0,26,2015
2015-05-16,Pulau Pinang,89,58,31,2015
2015-05-17,Pulau Pinang,182,59,123,2015
2015-05-18,Pulau Pinang,33,5,28,2015
2015-05-19,Pulau Pinang,122,79,43,2015
2015-05-20,Pulau Pinang,85,23,62,2015
2015-05-21,Pulau Pinang,457,213,244,2015
2015-05-22,Pulau Pinang,34,9,25,2015
2015-05-23,Pulau Pinang,42,26,16,2015
2015-05-24,Pulau Pinang,127,58,69,2015
2015-05-25,Pulau Pinang,33,11,22,2015
2015-05-26,Pulau Pinang,126,55,71,2015
2015-05-27,Pulau Pinang,167,93,74,2015
2015-05-28,Pulau Pinang,75,29,46,2015
2015-05-29,Pulau Pinang,26,5,21,2015
2015-05-30,Pulau Pinang,33,21,12,2015
2015-05-31,Pulau Pinang,50,16,34,2015
2015-06-01,Pulau Pinang,138,40,98,2015
2015-06-02,Pulau Pinang,158,74,84,2015
2015-06-03,Pulau Pinang,151,66,85,2015
2015-06-04,Pulau Pinang,215,87,128,2015
2015-06-05,Pulau Pinang,42,7,35,2015
2015-06-06,Pulau Pinang,122,61,61,2015
2015-06-07,Pulau Pinang,152,26,126,2015
2015-06-08,Pulau Pinang,57,12,45,2015
2015-06-09,Pulau Pinang,158,62,96,2015
2015-06-10,Pulau Pinang,228,89,139,2015
2015-06-11,Pulau Pinang,158,59,99,2015
2015-06-12,Pulau Pinang,112,34,78,2015
2015-06-13,Pulau Pinang,121,60,61,2015
2015-06-14,Pulau Pinang,209,100,109,2015
2015-06-15,Pulau Pinang,94,54,40,2015
2015-06-16,Pulau Pinang,180,114,66,2015
2015-06-17,Pulau Pinang,124,58,66,2015
2015-06-18,Pulau Pinang,31,8,23,2015
2015-06-19,Pulau Pinang,31,2,29,2015
2015-06-20,Pulau Pinang,16,9,7,2015
2015-06-21,Pulau Pinang,72,20,52,2015
2015-06-22,Pulau Pinang,18,3,15,2015
2015-06-23,Pulau Pinang,31,2,29,2015
2015-06-24,Pulau Pinang,47,16,31,2015
2015-06-25,Pulau Pinang,41,12,29,2015
2015-06-26,Pulau Pinang,15,2,13,2015
2015-06-27,Pulau Pinang,35,15,20,2015
2015-06-28,Pulau Pinang,110,54,56,2015
2015-06-29,Pulau Pinang,26,4,22,2015
2015-06-30,Pulau Pinang,45,9,36,2015
2015-07-01,Pulau Pinang,130,31,99,2015
2015-07-02,Pulau Pinang,38,7,31,2015
2015-07-03,Pulau Pinang,38,7,31,2015
2015-07-04,Pulau Pinang,26,7,19,2015
2015-07-05,Pulau Pinang,311,73,238,2015
2015-07-06,Pulau Pinang,50,9,41,2015
2015-07-07,Pulau Pinang,19,7,12,2015
2015-07-08,Pulau Pinang,61,25,36,2015
2015-07-09,Pulau Pinang,146,61,85,2015
2015-07-10,Pulau Pinang,52,25,27,2015
2015-07-11,Pulau Pinang,92,36,56,2015
2015-07-12,Pulau Pinang,196,62,134,2015
2015-07-13,Pulau Pinang,68,24,44,2015
2015-07-14,Pulau Pinang,74,32,42,2015
2015-07-15,Pulau Pinang,66,21,45,2015
2015-07-16,Pulau Pinang,56,12,44,2015
2015-07-17,Pulau Pinang,0,0,0,2015
2015-07-18,Pulau Pinang,0,0,0,2015
2015-07-19,Pulau Pinang,84,57,27,2015
2015-07-20,Pulau Pinang,124,45,79,2015
2015-07-21,Pulau Pinang,78,35,43,2015
2015-07-22,Pulau Pinang,59,17,42,2015
2015-07-23,Pulau Pinang,110,38,72,2015
2015-07-24,Pulau Pinang,56,15,41,2015
2015-07-25,Pulau Pinang,116,48,68,2015
2015-07-26,Pulau Pinang,276,96,180,2015
2015-07-27,Pulau Pinang,225,138,87,2015
2015-07-28,Pulau Pinang,238,141,97,2015
2015-07-29,Pulau Pinang,309,201,108,2015
2015-07-30,Pulau Pinang,174,113,61,2015
2015-07-31,Pulau Pinang,59,12,47,2015
2015-08-01,Pulau Pinang,144,82,62,2015
2015-08-02,Pulau Pinang,343,95,248,2015
2015-08-03,Pulau Pinang,159,84,75,2015
2015-08-04,Pulau Pinang,100,43,57,2015
2015-08-05,Pulau Pinang,115,59,56,2015
2015-08-06,Pulau Pinang,76,38,38,2015
2015-08-07,Pulau Pinang,35,5,30,2015
2015-08-08,Pulau Pinang,115,65,50,2015
2015-08-09,Pulau Pinang,152,54,98,2015
2015-08-10,Pulau Pinang,36,5,31,2015
2015-08-11,Pulau Pinang,50,18,32,2015
2015-08-12,Pulau Pinang,623,410,213,2015
2015-08-13,Pulau Pinang,196,97,99,2015
2015-08-14,Pulau Pinang,30,3,27,2015
2015-08-15,Pulau Pinang,25,19,6,2015
2015-08-16,Pulau Pinang,164,53,111,2015
2015-08-17,Pulau Pinang,34,7,27,2015
2015-08-18,Pulau Pinang,112,44,68,2015
2015-08-19,Pulau Pinang,283,111,172,2015
2015-08-20,Pulau Pinang,154,71,83,2015
2015-08-21,Pulau Pinang,39,2,37,2015
2015-08-22,Pulau Pinang,197,119,78,2015
2015-08-23,Pulau Pinang,235,62,173,2015
2015-08-24,Pulau Pinang,36,6,30,2015
2015-08-25,Pulau Pinang,220,82,138,2015
2015-08-26,Pulau Pinang,217,104,113,2015
2015-08-27,Pulau Pinang,27,6,21,2015
2015-08-28,Pulau Pinang,28,4,24,2015
2015-08-29,Pulau Pinang,59,32,27,2015
2015-08-30,Pulau Pinang,298,217,81,2015
2015-08-31,Pulau Pinang,144,48,96,2015
2015-09-01,Pulau Pinang,41,11,30,2015
2015-09-02,Pulau Pinang,183,77,106,2015
2015-09-03,Pulau Pinang,85,21,64,2015
2015-09-04,Pulau Pinang,29,1,28,2015
2015-09-05,Pulau Pinang,115,71,44,2015
2015-09-06,Pulau Pinang,228,61,167,2015
2015-09-07,Pulau Pinang,103,35,68,2015
2015-09-08,Pulau Pinang,163,51,112,2015
2015-09-09,Pulau Pinang,149,54,95,2015
2015-09-10,Pulau Pinang,190,94,96,2015
2015-09-11,Pulau Pinang,30,4,26,2015
2015-09-12,Pulau Pinang,140,70,70,2015
2015-09-13,Pulau Pinang,156,73,83,2015
2015-09-14,Pulau Pinang,77,26,51,2015
2015-09-15,Pulau Pinang,80,33,47,2015
2015-09-16,Pulau Pinang,74,44,30,2015
2015-09-17,Pulau Pinang,119,59,60,2015
2015-09-18,Pulau Pinang,118,34,84,2015
2015-09-19,Pulau Pinang,52,34,18,2015
2015-09-20,Pulau Pinang,333,105,228,2015
2015-09-21,Pulau Pinang,82,26,56,2015
2015-09-22,Pulau Pinang,64,9,55,2015
2015-09-23,Pulau Pinang,67,12,55,2015
2015-09-24,Pulau Pinang,0,0,0,2015
2015-09-25,Pulau Pinang,40,16,24,2015
2015-09-26,Pulau Pinang,0,0,0,2015
2015-09-27,Pulau Pinang,72,21,51,2015
2015-09-28,Pulau Pinang,79,21,58,2015
2015-09-29,Pulau Pinang,202,74,128,2015
2015-09-30,Pulau Pinang,244,120,124,2015
2015-10-01,Pulau Pinang,91,71,20,2015
2015-10-02,Pulau Pinang,69,29,40,2015
2015-10-03,Pulau Pinang,138,67,71,2015
2015-10-04,Pulau Pinang,276,93,183,2015
2015-10-05,Pulau Pinang,31,3,28,2015
2015-10-06,Pulau Pinang,31,6,25,2015
2015-10-07,Pulau Pinang,129,63,66,2015
2015-10-08,Pulau Pinang,70,20,50,2015
2015-10-09,Pulau Pinang,20,2,18,2015
2015-10-10,Pulau Pinang,17,7,10,2015
2015-10-11,Pulau Pinang,260,57,203,2015
2015-10-12,Pulau Pinang,214,54,160,2015
2015-10-13,Pulau Pinang,151,77,74,2015
2015-10-14,Pulau Pinang,52,24,28,2015
2015-10-15,Pulau Pinang,155,64,91,2015
2015-10-16,Pulau Pinang,55,19,36,2015
2015-10-17,Pulau Pinang,96,38,58,2015
2015-10-18,Pulau Pinang,164,77,87,2015
2015-10-19,Pulau Pinang,42,5,37,2015
2015-10-20,Pulau Pinang,233,116,117,2015
2015-10-21,Pulau Pinang,49,6,43,2015
2015-10-22,Pulau Pinang,100,46,54,2015
2015-10-23,Pulau Pinang,31,5,26,2015
2015-10-24,Pulau Pinang,85,35,50,2015
2015-10-25,Pulau Pinang,107,40,67,2015
2015-10-26,Pulau Pinang,59,21,38,2015
2015-10-27,Pulau Pinang,263,102,161,2015
2015-10-28,Pulau Pinang,184,69,115,2015
2015-10-29,Pulau Pinang,163,54,109,2015
2015-10-30,Pulau Pinang,32,7,25,2015
2015-10-31,Pulau Pinang,66,50,16,2015
2015-11-01,Pulau Pinang,176,99,77,2015
2015-11-02,Pulau Pinang,37,7,30,2015
2015-11-03,Pulau Pinang,120,41,79,2015
2015-11-04,Pulau Pinang,73,39,34,2015
2015-11-05,Pulau Pinang,81,43,38,2015
2015-11-06,Pulau Pinang,30,2,28,2015
2015-11-07,Pulau Pinang,194,76,118,2015
2015-11-08,Pulau Pinang,307,73,234,2015
2015-11-09,Pulau Pinang,51,4,47,2015
2015-11-10,Pulau Pinang,36,15,21,2015
2015-11-11,Pulau Pinang,83,24,59,2015
2015-11-12,Pulau Pinang,79,28,51,2015
2015-11-13,Pulau Pinang,39,3,36,2015
2015-11-14,Pulau Pinang,65,29,36,2015
2015-11-15,Pulau Pinang,234,50,184,2015
2015-11-16,Pulau Pinang,36,2,34,2015
2015-11-17,Pulau Pinang,81,37,44,2015
2015-11-18,Pulau Pinang,84,38,46,2015
2015-11-19,Pulau Pinang,49,16,33,2015
2015-11-20,Pulau Pinang,103,55,48,2015
2015-11-21,Pulau Pinang,42,24,18,2015
2015-11-22,Pulau Pinang,158,35,123,2015
2015-11-23,Pulau Pinang,138,42,96,2015
2015-11-24,Pulau Pinang,138,49,89,2015
2015-11-25,Pulau Pinang,244,90,154,2015
2015-11-26,Pulau Pinang,94,30,64,2015
2015-11-27,Pulau Pinang,26,6,20,2015
2015-11-28,Pulau Pinang,152,66,86,2015
2015-11-29,Pulau Pinang,207,90,117,2015
2015-11-30,Pulau Pinang,73,22,51,2015
2015-12-01,Pulau Pinang,88,41,47,2015
2015-12-02,Pulau Pinang,57,18,39,2015
2015-12-03,Pulau Pinang,101,30,71,2015
2015-12-04,Pulau Pinang,33,9,24,2015
2015-12-05,Pulau Pinang,149,53,96,2015
2015-12-06,Pulau Pinang,230,35,195,2015
2015-12-07,Pulau Pinang,73,23,50,2015
2015-12-08,Pulau Pinang,292,128,164,2015
2015-12-09,Pulau Pinang,153,43,110,2015
2015-12-10,Pulau Pinang,252,116,136,2015
2015-12-11,Pulau Pinang,34,6,28,2015
2015-12-12,Pulau Pinang,0,0,0,2015
2015-12-13,Pulau Pinang,262,136,126,2015
2015-12-14,Pulau Pinang,131,54,77,2015
2015-12-15,Pulau Pinang,147,54,93,2015
2015-12-16,Pulau Pinang,95,30,65,2015
2015-12-17,Pulau Pinang,120,53,67,2015
2015-12-18,Pulau Pinang,37,4,33,2015
2015-12-19,Pulau Pinang,69,36,33,2015
2015-12-20,Pulau Pinang,67,46,21,2015
2015-12-21,Pulau Pinang,41,5,36,2015
2015-12-22,Pulau Pinang,172,77,95,2015
2015-12-23,Pulau Pinang,113,48,65,2015
2015-12-24,Pulau Pinang,27,11,16,2015
2015-12-25,Pulau Pinang,47,21,26,2015
2015-12-26,Pulau Pinang,50,20,30,2015
2015-12-27,Pulau Pinang,237,60,177,2015
2015-12-28,Pulau Pinang,75,13,62,2015
2015-12-29,Pulau Pinang,68,11,57,2015
2015-12-30,Pulau Pinang,100,41,59,2015
2015-12-31,Pulau Pinang,190,66,124,2015
2016-01-01,Pulau Pinang,68,31,37,2016
2016-01-02,Pulau Pinang,63,26,37,2016
2016-01-03,Pulau Pinang,168,39,129,2016
2016-01-04,Pulau Pinang,39,6,33,2016
2016-01-05,Pulau Pinang,86,16,70,2016
2016-01-06,Pulau Pinang,104,41,63,2016
2016-01-07,Pulau Pinang,53,16,37,2016
2016-01-08,Pulau Pinang,45,5,40,2016
2016-01-09,Pulau Pinang,48,24,24,2016
2016-01-10,Pulau Pinang,242,64,178,2016
2016-01-11,Pulau Pinang,29,5,24,2016
2016-01-12,Pulau Pinang,62,20,42,2016
2016-01-13,Pulau Pinang,104,44,60,2016
2016-01-14,Pulau Pinang,127,38,89,2016
2016-01-15,Pulau Pinang,32,4,28,2016
2016-01-16,Pulau Pinang,84,35,49,2016
2016-01-17,Pulau Pinang,292,69,223,2016
2016-01-18,Pulau Pinang,73,23,50,2016
2016-01-19,Pulau Pinang,33,8,25,2016
2016-01-20,Pulau Pinang,202,110,92,2016
2016-01-21,Pulau Pinang,348,161,187,2016
2016-01-22,Pulau Pinang,52,13,39,2016
2016-01-23,Pulau Pinang,0,0,0,2016
2016-01-24,Pulau Pinang,466,204,262,2016
2016-01-25,Pulau Pinang,30,13,17,2016
2016-01-26,Pulau Pinang,76,19,57,2016
2016-01-27,Pulau Pinang,148,49,99,2016
2016-01-28,Pulau Pinang,312,146,166,2016
2016-01-29,Pulau Pinang,22,1,21,2016
2016-01-30,Pulau Pinang,66,35,31,2016
2016-01-31,Pulau Pinang,121,72,49,2016
2016-02-01,Pulau Pinang,61,20,41,2016
2016-02-02,Pulau Pinang,73,31,42,2016
2016-02-03,Pulau Pinang,107,28,79,2016
2016-02-04,Pulau Pinang,127,41,86,2016
2016-02-05,Pulau Pinang,49,7,42,2016
2016-02-06,Pulau Pinang,67,25,42,2016
2016-02-07,Pulau Pinang,90,34,56,2016
2016-02-08,Pulau Pinang,58,25,33,2016
2016-02-09,Pulau Pinang,70,34,36,2016
2016-02-10,Pulau Pinang,90,16,74,2016
2016-02-11,Pulau Pinang,77,24,53,2016
2016-02-12,Pulau Pinang,77,12,65,2016
2016-02-13,Pulau Pinang,42,16,26,2016
2016-02-14,Pulau Pinang,69,34,35,2016
2016-02-15,Pulau Pinang,40,7,33,2016
2016-02-16,Pulau Pinang,192,86,106,2016
2016-02-17,Pulau Pinang,177,84,93,2016
2016-02-18,Pulau Pinang,185,92,93,2016
2016-02-19,Pulau Pinang,69,13,56,2016
2016-02-20,Pulau Pinang,77,32,45,2016
2016-02-21,Pulau Pinang,375,77,298,2016
2016-02-22,Pulau Pinang,55,19,36,2016
2016-02-23,Pulau Pinang,183,77,106,2016
2016-02-24,Pulau Pinang,181,67,114,2016
2016-02-25,Pulau Pinang,191,100,91,2016
2016-02-26,Pulau Pinang,37,6,31,2016
2016-02-27,Pulau Pinang,241,192,49,2016
2016-02-28,Pulau Pinang,133,39,94,2016
2016-02-29,Pulau Pinang,139,57,82,2016
2016-03-01,Pulau Pinang,225,91,134,2016
2016-03-02,Pulau Pinang,119,37,82,2016
2016-03-03,Pulau Pinang,118,50,68,2016
2016-03-04,Pulau Pinang,32,2,30,2016
2016-03-05,Pulau Pinang,59,21,38,2016
2016-03-06,Pulau Pinang,293,54,239,2016
2016-03-07,Pulau Pinang,46,14,32,2016
2016-03-08,Pulau Pinang,123,55,68,2016
2016-03-09,Pulau Pinang,204,76,128,2016
2016-03-10,Pulau Pinang,301,66,235,2016
2016-03-11,Pulau Pinang,77,24,53,2016
2016-03-12,Pulau Pinang,81,28,53,2016
2016-03-13,Pulau Pinang,232,66,166,2016
2016-03-14,Pulau Pinang,47,6,41,2016
2016-03-15,Pulau Pinang,91,23,68,2016
2016-03-16,Pulau Pinang,162,67,95,2016
2016-03-17,Pulau Pinang,136,47,89,2016
2016-03-18,Pulau Pinang,35,8,27,2016
2016-03-19,Pulau Pinang,118,61,57,2016
2016-03-20,Pulau Pinang,117,49,68,2016
2016-03-21,Pulau Pinang,39,6,33,2016
2016-03-22,Pulau Pinang,103,21,82,2016
2016-03-23,Pulau Pinang,78,16,62,2016
2016-03-24,Pulau Pinang,229,83,146,2016
2016-03-25,Pulau Pinang,35,3,32,2016
2016-03-26,Pulau Pinang,280,159,121,2016
2016-03-27,Pulau Pinang,47,22,25,2016
2016-03-28,Pulau Pinang,71,26,45,2016
2016-03-29,Pulau Pinang,103,40,63,2016
2016-03-30,Pulau Pinang,115,40,75,2016
2016-03-31,Pulau Pinang,138,53,85,2016
2016-04-01,Pulau Pinang,41,4,37,2016
2016-04-02,Pulau Pinang,55,16,39,2016
2016-04-03,Pulau Pinang,77,57,20,2016
2016-04-04,Pulau Pinang,53,10,43,2016
2016-04-05,Pulau Pinang,117,42,75,2016
2016-04-06,Pulau Pinang,78,35,43,2016
2016-04-07,Pulau Pinang,92,29,63,2016
2016-04-08,Pulau Pinang,40,5,35,2016
2016-04-09,Pulau Pinang,125,35,90,2016
2016-04-10,Pulau Pinang,252,25,227,2016
2016-04-11,Pulau Pinang,75,20,55,2016
2016-04-12,Pulau Pinang,200,106,94,2016
2016-04-13,Pulau Pinang,245,86,159,2016
2016-04-14,Pulau Pinang,92,21,71,2016
2016-04-15,Pulau Pinang,100,33,67,2016
2016-04-16,Pulau Pinang,73,24,49,2016
2016-04-17,Pulau Pinang,344,78,266,2016
2016-04-18,Pulau Pinang,173,62,111,2016
2016-04-19,Pulau Pinang,111,51,60,2016
2016-04-20,Pulau Pinang,269,107,162,2016
2016-04-21,Pulau Pinang,207,96,111,2016
2016-04-22,Pulau Pinang,37,6,31,2016
2016-04-23,Pulau Pinang,184,91,93,2016
2016-04-24,Pulau Pinang,228,88,140,2016
2016-04-25,Pulau Pinang,39,3,36,2016
2016-04-26,Pulau Pinang,87,39,48,2016
2016-04-27,Pulau Pinang,70,12,58,2016
2016-04-28,Pulau Pinang,192,66,126,2016
2016-04-29,Pulau Pinang,37,7,30,2016
2016-04-30,Pulau Pinang,87,33,54,2016
2016-05-01,Pulau Pinang,403,225,178,2016
2016-05-02,Pulau Pinang,96,39,57,2016
2016-05-03,Pulau Pinang,34,4,30,2016
2016-05-04,Pulau Pinang,39,4,35,2016
2016-05-05,Pulau Pinang,100,38,62,2016
2016-05-06,Pulau Pinang,51,11,40,2016
2016-05-07,Pulau Pinang,82,27,55,2016
2016-05-08,Pulau Pinang,281,97,184,2016
2016-05-09,Pulau Pinang,51,15,36,2016
2016-05-10,Pulau Pinang,69,17,52,2016
2016-05-11,Pulau Pinang,145,45,100,2016
2016-05-12,Pulau Pinang,179,72,107,2016
2016-05-13,Pulau Pinang,67,27,40,2016
2016-05-14,Pulau Pinang,59,28,31,2016
2016-05-15,Pulau Pinang,283,56,227,2016
2016-05-16,Pulau Pinang,66,16,50,2016
2016-05-17,Pulau Pinang,127,39,88,2016
2016-05-18,Pulau Pinang,131,46,85,2016
2016-05-19,Pulau Pinang,146,40,106,2016
2016-05-20,Pulau Pinang,192,82,110,2016
2016-05-21,Pulau Pinang,120,45,75,2016
2016-05-22,Pulau Pinang,266,80,186,2016
2016-05-23,Pulau Pinang,93,45,48,2016
2016-05-24,Pulau Pinang,218,36,182,2016
2016-05-25,Pulau Pinang,383,159,224,2016
2016-05-26,Pulau Pinang,362,146,216,2016
2016-05-27,Pulau Pinang,34,3,31,2016
2016-05-28,Pulau Pinang,108,47,61,2016
2016-05-29,Pulau Pinang,191,59,132,2016
2016-05-30,Pulau Pinang,48,21,27,2016
2016-05-31,Pulau Pinang,153,52,101,2016
2016-06-01,Pulau Pinang,146,49,97,2016
2016-06-02,Pulau Pinang,110,45,65,2016
2016-06-03,Pulau Pinang,43,4,39,2016
2016-06-04,Pulau Pinang,152,58,94,2016
2016-06-05,Pulau Pinang,148,17,131,2016
2016-06-06,Pulau Pinang,33,1,32,2016
2016-06-07,Pulau Pinang,80,33,47,2016
2016-06-08,Pulau Pinang,57,12,45,2016
2016-06-09,Pulau Pinang,42,6,36,2016
2016-06-10,Pulau Pinang,21,4,17,2016
2016-06-11,Pulau Pinang,41,11,30,2016
2016-06-12,Pulau Pinang,260,90,170,2016
2016-06-13,Pulau Pinang,26,1,25,2016
2016-06-14,Pulau Pinang,102,55,47,2016
2016-06-15,Pulau Pinang,104,52,52,2016
2016-06-16,Pulau Pinang,38,6,32,2016
2016-06-17,Pulau Pinang,22,6,16,2016
2016-06-18,Pulau Pinang,41,19,22,2016
2016-06-19,Pulau Pinang,228,72,156,2016
2016-06-20,Pulau Pinang,63,22,41,2016
2016-06-21,Pulau Pinang,61,17,44,2016
2016-06-22,Pulau Pinang,37,14,23,2016
2016-06-23,Pulau Pinang,47,15,32,2016
2016-06-24,Pulau Pinang,29,1,28,2016
2016-06-25,Pulau Pinang,83,35,48,2016
2016-06-26,Pulau Pinang,217,69,148,2016
2016-06-27,Pulau Pinang,30,0,30,2016
2016-06-28,Pulau Pinang,122,73,49,2016
2016-06-29,Pulau Pinang,151,62,89,2016
2016-06-30,Pulau Pinang,44,11,33,2016
2016-07-01,Pulau Pinang,24,3,21,2016
2016-07-02,Pulau Pinang,37,9,28,2016
2016-07-03,Pulau Pinang,237,32,205,2016
2016-07-04,Pulau Pinang,64,13,51,2016
2016-07-05,Pulau Pinang,57,6,51,2016
2016-07-06,Pulau Pinang,0,0,0,2016
2016-07-07,Pulau Pinang,0,0,0,2016
2016-07-08,Pulau Pinang,15,5,10,2016
2016-07-09,Pulau Pinang,12,6,6,2016
2016-07-10,Pulau Pinang,138,69,69,2016
2016-07-11,Pulau Pinang,74,6,68,2016
2016-07-12,Pulau Pinang,126,42,84,2016
2016-07-13,Pulau Pinang,172,53,119,2016
2016-07-14,Pulau Pinang,117,62,55,2016
2016-07-15,Pulau Pinang,49,4,45,2016
2016-07-16,Pulau Pinang,0,0,0,2016
2016-07-17,Pulau Pinang,229,46,183,2016
2016-07-18,Pulau Pinang,75,10,65,2016
2016-07-19,Pulau Pinang,47,11,36,2016
2016-07-20,Pulau Pinang,108,55,53,2016
2016-07-21,Pulau Pinang,151,76,75,2016
2016-07-22,Pulau Pinang,46,2,44,2016
2016-07-23,Pulau Pinang,189,93,96,2016
2016-07-24,Pulau Pinang,215,76,139,2016
2016-07-25,Pulau Pinang,111,46,65,2016
2016-07-26,Pulau Pinang,252,124,128,2016
2016-07-27,Pulau Pinang,201,92,109,2016
2016-07-28,Pulau Pinang,188,87,101,2016
2016-07-29,Pulau Pinang,29,2,27,2016
2016-07-30,Pulau Pinang,85,44,41,2016
2016-07-31,Pulau Pinang,295,115,180,2016
2016-08-01,Pulau Pinang,50,7,43,2016
2016-08-02,Pulau Pinang,212,82,130,2016
2016-08-03,Pulau Pinang,258,92,166,2016
2016-08-04,Pulau Pinang,195,56,139,2016
2016-08-05,Pulau Pinang,52,19,33,2016
2016-08-06,Pulau Pinang,50,15,35,2016
2016-08-07,Pulau Pinang,230,63,167,2016
2016-08-08,Pulau Pinang,44,6,38,2016
2016-08-09,Pulau Pinang,119,42,77,2016
2016-08-10,Pulau Pinang,166,31,135,2016
2016-08-11,Pulau Pinang,102,25,77,2016
2016-08-12,Pulau Pinang,25,1,24,2016
2016-08-13,Pulau Pinang,46,33,13,2016
2016-08-14,Pulau Pinang,355,72,283,2016
2016-08-15,Pulau Pinang,42,5,37,2016
2016-08-16,Pulau Pinang,101,36,65,2016
2016-08-17,Pulau Pinang,178,61,117,2016
2016-08-18,Pulau Pinang,139,39,100,2016
2016-08-19,Pulau Pinang,33,3,30,2016
2016-08-20,Pulau Pinang,0,0,0,2016
2016-08-21,Pulau Pinang,256,63,193,2016
2016-08-22,Pulau Pinang,36,2,34,2016
2016-08-23,Pulau Pinang,132,58,74,2016
2016-08-24,Pulau Pinang,129,38,91,2016
2016-08-25,Pulau Pinang,426,228,198,2016
2016-08-26,Pulau Pinang,41,8,33,2016
2016-08-27,Pulau Pinang,198,80,118,2016
2016-08-28,Pulau Pinang,63,15,48,2016
2016-08-29,Pulau Pinang,77,6,71,2016
2016-08-30,Pulau Pinang,316,130,186,2016
2016-08-31,Pulau Pinang,238,78,160,2016
2016-09-01,Pulau Pinang,178,88,90,2016
2016-09-02,Pulau Pinang,29,4,25,2016
2016-09-03,Pulau Pinang,60,13,47,2016
2016-09-04,Pulau Pinang,272,39,233,2016
2016-09-05,Pulau Pinang,80,12,68,2016
2016-09-06,Pulau Pinang,195,75,120,2016
2016-09-07,Pulau Pinang,190,81,109,2016
2016-09-08,Pulau Pinang,236,110,126,2016
2016-09-09,Pulau Pinang,115,63,52,2016
2016-09-10,Pulau Pinang,46,20,26,2016
2016-09-11,Pulau Pinang,247,62,185,2016
2016-09-12,Pulau Pinang,0,0,0,2016
2016-09-13,Pulau Pinang,46,2,44,2016
2016-09-14,Pulau Pinang,46,8,38,2016
2016-09-15,Pulau Pinang,175,49,126,2016
2016-09-16,Pulau Pinang,47,22,25,2016
2016-09-17,Pulau Pinang,24,8,16,2016
2016-09-18,Pulau Pinang,182,88,94,2016
2016-09-19,Pulau Pinang,71,11,60,2016
2016-09-20,Pulau Pinang,120,33,87,2016
2016-09-21,Pulau Pinang,167,70,97,2016
2016-09-22,Pulau Pinang,153,53,100,2016
2016-09-23,Pulau Pinang,45,13,32,2016
2016-09-24,Pulau Pinang,69,33,36,2016
2016-09-25,Pulau Pinang,151,56,95,2016
2016-09-26,Pulau Pinang,41,1,40,2016
2016-09-27,Pulau Pinang,213,86,127,2016
2016-09-28,Pulau Pinang,296,68,228,2016
2016-09-29,Pulau Pinang,123,35,88,2016
2016-09-30,Pulau Pinang,34,5,29,2016
2016-10-01,Pulau Pinang,37,8,29,2016
2016-10-02,Pulau Pinang,239,78,161,2016
2016-10-03,Pulau Pinang,44,18,26,2016
2016-10-04,Pulau Pinang,42,4,38,2016
2016-10-05,Pulau Pinang,112,52,60,2016
2016-10-06,Pulau Pinang,97,38,59,2016
2016-10-07,Pulau Pinang,53,9,44,2016
2016-10-08,Pulau Pinang,80,16,64,2016
2016-10-09,Pulau Pinang,273,69,204,2016
2016-10-10,Pulau Pinang,44,7,37,2016
2016-10-11,Pulau Pinang,98,54,44,2016
2016-10-12,Pulau Pinang,135,49,86,2016
2016-10-13,Pulau Pinang,152,39,113,2016
2016-10-14,Pulau Pinang,40,4,36,2016
2016-10-15,Pulau Pinang,68,25,43,2016
2016-10-16,Pulau Pinang,176,46,130,2016
2016-10-17,Pulau Pinang,108,62,46,2016
2016-10-18,Pulau Pinang,179,49,130,2016
2016-10-19,Pulau Pinang,28,4,24,2016
2016-10-20,Pulau Pinang,168,56,112,2016
2016-10-21,Pulau Pinang,34,5,29,2016
2016-10-22,Pulau Pinang,14,3,11,2016
2016-10-23,Pulau Pinang,315,86,229,2016
2016-10-24,Pulau Pinang,33,4,29,2016
2016-10-25,Pulau Pinang,58,18,40,2016
2016-10-26,Pulau Pinang,76,23,53,2016
2016-10-27,Pulau Pinang,101,61,40,2016
2016-10-28,Pulau Pinang,32,4,28,2016
2016-10-29,Pulau Pinang,103,36,67,2016
2016-10-30,Pulau Pinang,106,38,68,2016
2016-10-31,Pulau Pinang,116,65,51,2016
2016-11-01,Pulau Pinang,79,18,61,2016
2016-11-02,Pulau Pinang,174,60,114,2016
2016-11-03,Pulau Pinang,119,41,78,2016
2016-11-04,Pulau Pinang,31,3,28,2016
2016-11-05,Pulau Pinang,67,15,52,2016
2016-11-06,Pulau Pinang,247,33,214,2016
2016-11-07,Pulau Pinang,30,7,23,2016
2016-11-08,Pulau Pinang,96,24,72,2016
2016-11-09,Pulau Pinang,115,30,85,2016
2016-11-10,Pulau Pinang,53,9,44,2016
2016-11-11,Pulau Pinang,30,5,25,2016
2016-11-12,Pulau Pinang,82,24,58,2016
2016-11-13,Pulau Pinang,270,107,163,2016
2016-11-14,Pulau Pinang,79,20,59,2016
2016-11-15,Pulau Pinang,92,34,58,2016
2016-11-16,Pulau Pinang,125,36,89,2016
2016-11-17,Pulau Pinang,142,54,88,2016
2016-11-18,Pulau Pinang,31,4,27,2016
2016-11-19,Pulau Pinang,57,33,24,2016
2016-11-20,Pulau Pinang,132,25,107,2016
2016-11-21,Pulau Pinang,72,19,53,2016
2016-11-22,Pulau Pinang,129,37,92,2016
2016-11-23,Pulau Pinang,151,58,93,2016
2016-11-24,Pulau Pinang,206,80,126,2016
2016-11-25,Pulau Pinang,28,3,25,2016
2016-11-26,Pulau Pinang,0,0,0,2016
2016-11-27,Pulau Pinang,251,73,178,2016
2016-11-28,Pulau Pinang,43,4,39,2016
2016-11-29,Pulau Pinang,163,74,89,2016
2016-11-30,Pulau Pinang,63,17,46,2016
2016-12-01,Pulau Pinang,83,24,59,2016
2016-12-02,Pulau Pinang,34,2,32,2016
2016-12-03,Pulau Pinang,64,31,33,2016
2016-12-04,Pulau Pinang,219,36,183,2016
2016-12-05,Pulau Pinang,49,9,40,2016
2016-12-06,Pulau Pinang,105,21,84,2016
2016-12-07,Pulau Pinang,75,26,49,2016
2016-12-08,Pulau Pinang,185,73,112,2016
2016-12-09,Pulau Pinang,70,11,59,2016
2016-12-10,Pulau Pinang,24,12,12,2016
2016-12-11,Pulau Pinang,105,26,79,2016
2016-12-12,Pulau Pinang,14,1,13,2016
2016-12-13,Pulau Pinang,106,30,76,2016
2016-12-14,Pulau Pinang,135,42,93,2016
2016-12-15,Pulau Pinang,184,49,135,2016
2016-12-16,Pulau Pinang,45,5,40,2016
2016-12-17,Pulau Pinang,19,8,11,2016
2016-12-18,Pulau Pinang,282,77,205,2016
2016-12-19,Pulau Pinang,233,42,191,2016
2016-12-20,Pulau Pinang,165,38,127,2016
2016-12-21,Pulau Pinang,149,32,117,2016
2016-12-22,Pulau Pinang,140,46,94,2016
2016-12-23,Pulau Pinang,43,6,37,2016
2016-12-24,Pulau Pinang,60,17,43,2016
2016-12-25,Pulau Pinang,208,90,118,2016
2016-12-26,Pulau Pinang,17,0,17,2016
2016-12-27,Pulau Pinang,75,32,43,2016
2016-12-28,Pulau Pinang,52,9,43,2016
2016-12-29,Pulau Pinang,123,29,94,2016
2016-12-30,Pulau Pinang,53,6,47,2016
2016-12-31,Pulau Pinang,62,21,41,2016
2017-01-01,Pulau Pinang,124,33,91,2017
2017-01-02,Pulau Pinang,110,49,61,2017
2017-01-03,Pulau Pinang,60,4,56,2017
2017-01-04,Pulau Pinang,74,30,44,2017
2017-01-05,Pulau Pinang,75,18,57,2017
2017-01-06,Pulau Pinang,39,1,38,2017
2017-01-07,Pulau Pinang,156,63,93,2017
2017-01-08,Pulau Pinang,318,58,260,2017
2017-01-09,Pulau Pinang,35,6,29,2017
2017-01-10,Pulau Pinang,54,4,50,2017
2017-01-11,Pulau Pinang,181,72,109,2017
2017-01-12,Pulau Pinang,136,60,76,2017
2017-01-13,Pulau Pinang,36,3,33,2017
2017-01-14,Pulau Pinang,120,52,68,2017
2017-01-15,Pulau Pinang,201,49,152,2017
2017-01-16,Pulau Pinang,36,4,32,2017
2017-01-17,Pulau Pinang,164,68,96,2017
2017-01-18,Pulau Pinang,118,46,72,2017
2017-01-19,Pulau Pinang,124,46,78,2017
2017-01-20,Pulau Pinang,37,4,33,2017
2017-01-21,Pulau Pinang,70,26,44,2017
2017-01-22,Pulau Pinang,79,18,61,2017
2017-01-23,Pulau Pinang,45,5,40,2017
2017-01-24,Pulau Pinang,77,23,54,2017
2017-01-25,Pulau Pinang,413,182,231,2017
2017-01-26,Pulau Pinang,224,90,134,2017
2017-01-27,Pulau Pinang,41,1,40,2017
2017-01-28,Pulau Pinang,43,15,28,2017
2017-01-29,Pulau Pinang,149,54,95,2017
2017-01-30,Pulau Pinang,34,8,26,2017
2017-01-31,Pulau Pinang,65,13,52,2017
2017-02-01,Pulau Pinang,82,27,55,2017
2017-02-02,Pulau Pinang,161,78,83,2017
2017-02-03,Pulau Pinang,89,24,65,2017
2017-02-04,Pulau Pinang,94,30,64,2017
2017-02-05,Pulau Pinang,99,38,61,2017
2017-02-06,Pulau Pinang,91,14,77,2017
2017-02-07,Pulau Pinang,162,54,108,2017
2017-02-08,Pulau Pinang,114,42,72,2017
2017-02-09,Pulau Pinang,388,153,235,2017
2017-02-10,Pulau Pinang,181,132,49,2017
2017-02-11,Pulau Pinang,253,155,98,2017
2017-02-12,Pulau Pinang,349,40,309,2017
2017-02-13,Pulau Pinang,50,4,46,2017
2017-02-14,Pulau Pinang,249,83,166,2017
2017-02-15,Pulau Pinang,183,79,104,2017
2017-02-16,Pulau Pinang,205,109,96,2017
2017-02-17,Pulau Pinang,44,10,34,2017
2017-02-18,Pulau Pinang,15,4,11,2017
2017-02-19,Pulau Pinang,180,45,135,2017
2017-02-20,Pulau Pinang,101,50,51,2017
2017-02-21,Pulau Pinang,78,32,46,2017
2017-02-22,Pulau Pinang,164,77,87,2017
2017-02-23,Pulau Pinang,59,9,50,2017
2017-02-24,Pulau Pinang,64,13,51,2017
2017-02-25,Pulau Pinang,113,43,70,2017
2017-02-26,Pulau Pinang,96,40,56,2017
2017-02-27,Pulau Pinang,122,43,79,2017
2017-02-28,Pulau Pinang,114,40,74,2017
2017-03-01,Pulau Pinang,169,55,114,2017
2017-03-02,Pulau Pinang,98,20,78,2017
2017-03-03,Pulau Pinang,28,1,27,2017
2017-03-04,Pulau Pinang,203,77,126,2017
2017-03-05,Pulau Pinang,393,114,279,2017
2017-03-06,Pulau Pinang,40,3,37,2017
2017-03-07,Pulau Pinang,84,15,69,2017
2017-03-08,Pulau Pinang,154,61,93,2017
2017-03-09,Pulau Pinang,122,22,100,2017
2017-03-10,Pulau Pinang,57,12,45,2017
2017-03-11,Pulau Pinang,89,36,53,2017
2017-03-12,Pulau Pinang,210,64,146,2017
2017-03-13,Pulau Pinang,100,19,81,2017
2017-03-14,Pulau Pinang,215,35,180,2017
2017-03-15,Pulau Pinang,128,40,88,2017
2017-03-16,Pulau Pinang,199,86,113,2017
2017-03-17,Pulau Pinang,129,37,92,2017
2017-03-18,Pulau Pinang,25,13,12,2017
2017-03-19,Pulau Pinang,551,164,387,2017
2017-03-20,Pulau Pinang,72,15,57,2017
2017-03-21,Pulau Pinang,72,20,52,2017
2017-03-22,Pulau Pinang,228,57,171,2017
2017-03-23,Pulau Pinang,119,26,93,2017
2017-03-24,Pulau Pinang,23,2,21,2017
2017-03-25,Pulau Pinang,41,17,24,2017
2017-03-26,Pulau Pinang,149,72,77,2017
2017-03-27,Pulau Pinang,73,12,61,2017
2017-03-28,Pulau Pinang,176,52,124,2017
2017-03-29,Pulau Pinang,111,16,95,2017
2017-03-30,Pulau Pinang,71,17,54,2017
2017-03-31,Pulau Pinang,49,6,43,2017
2017-04-01,Pulau Pinang,47,14,33,2017
2017-04-02,Pulau Pinang,145,84,61,2017
2017-04-03,Pulau Pinang,65,16,49,2017
2017-04-04,Pulau Pinang,117,21,96,2017
2017-04-05,Pulau Pinang,155,56,99,2017
2017-04-06,Pulau Pinang,118,45,73,2017
2017-04-07,Pulau Pinang,45,16,29,2017
2017-04-08,Pulau Pinang,71,44,27,2017
2017-04-09,Pulau Pinang,160,19,141,2017
2017-04-10,Pulau Pinang,75,15,60,2017
2017-04-11,Pulau Pinang,132,43,89,2017
2017-04-12,Pulau Pinang,171,45,126,2017
2017-04-13,Pulau Pinang,123,50,73,2017
2017-04-14,Pulau Pinang,50,17,33,2017
2017-04-15,Pulau Pinang,161,73,88,2017
2017-04-16,Pulau Pinang,330,56,274,2017
2017-04-17,Pulau Pinang,34,5,29,2017
2017-04-18,Pulau Pinang,163,40,123,2017
2017-04-19,Pulau Pinang,103,17,86,2017
2017-04-20,Pulau Pinang,143,40,103,2017
2017-04-21,Pulau Pinang,22,2,20,2017
2017-04-22,Pulau Pinang,112,30,82,2017
2017-04-23,Pulau Pinang,111,22,89,2017
2017-04-24,Pulau Pinang,0,0,0,2017
2017-04-25,Pulau Pinang,93,31,62,2017
2017-04-26,Pulau Pinang,45,2,43,2017
2017-04-27,Pulau Pinang,182,33,149,2017
2017-04-28,Pulau Pinang,107,31,76,2017
2017-04-29,Pulau Pinang,0,0,0,2017
2017-04-30,Pulau Pinang,0,0,0,2017
2017-05-01,Pulau Pinang,151,50,101,2017
2017-05-02,Pulau Pinang,32,1,31,2017
2017-05-03,Pulau Pinang,122,25,97,2017
2017-05-04,Pulau Pinang,141,50,91,2017
2017-05-05,Pulau Pinang,38,4,34,2017
2017-05-06,Pulau Pinang,171,57,114,2017
2017-05-07,Pulau Pinang,216,47,169,2017
2017-05-08,Pulau Pinang,42,5,37,2017
2017-05-09,Pulau Pinang,182,49,133,2017
2017-05-10,Pulau Pinang,83,26,57,2017
2017-05-11,Pulau Pinang,106,34,72,2017
2017-05-12,Pulau Pinang,93,28,65,2017
2017-05-13,Pulau Pinang,30,16,14,2017
2017-05-14,Pulau Pinang,344,44,300,2017
2017-05-15,Pulau Pinang,76,25,51,2017
2017-05-16,Pulau Pinang,196,77,119,2017
2017-05-17,Pulau Pinang,262,103,159,2017
2017-05-18,Pulau Pinang,204,55,149,2017
2017-05-19,Pulau Pinang,28,4,24,2017
2017-05-20,Pulau Pinang,158,55,103,2017
2017-05-21,Pulau Pinang,180,22,158,2017
2017-05-22,Pulau Pinang,135,44,91,2017
2017-05-23,Pulau Pinang,108,52,56,2017
2017-05-24,Pulau Pinang,131,37,94,2017
2017-05-25,Pulau Pinang,113,27,86,2017
2017-05-26,Pulau Pinang,48,4,44,2017
2017-05-27,Pulau Pinang,22,10,12,2017
2017-05-28,Pulau Pinang,172,42,130,2017
2017-05-29,Pulau Pinang,25,3,22,2017
2017-05-30,Pulau Pinang,22,6,16,2017
2017-05-31,Pulau Pinang,36,11,25,2017
2017-06-01,Pulau Pinang,65,27,38,2017
2017-06-02,Pulau Pinang,18,2,16,2017
2017-06-03,Pulau Pinang,27,1,26,2017
2017-06-04,Pulau Pinang,202,36,166,2017
2017-06-05,Pulau Pinang,25,4,21,2017
2017-06-06,Pulau Pinang,44,7,37,2017
2017-06-07,Pulau Pinang,70,23,47,2017
2017-06-08,Pulau Pinang,54,19,35,2017
2017-06-09,Pulau Pinang,31,7,24,2017
2017-06-10,Pulau Pinang,69,19,50,2017
2017-06-11,Pulau Pinang,147,30,117,2017
2017-06-12,Pulau Pinang,40,11,29,2017
2017-06-13,Pulau Pinang,33,2,31,2017
2017-06-14,Pulau Pinang,59,20,39,2017
2017-06-15,Pulau Pinang,61,15,46,2017
2017-06-16,Pulau Pinang,26,0,26,2017
2017-06-17,Pulau Pinang,23,3,20,2017
2017-06-18,Pulau Pinang,349,47,302,2017
2017-06-19,Pulau Pinang,46,6,40,2017
2017-06-20,Pulau Pinang,77,19,58,2017
2017-06-21,Pulau Pinang,75,21,54,2017
2017-06-22,Pulau Pinang,109,30,79,2017
2017-06-23,Pulau Pinang,46,3,43,2017
2017-06-24,Pulau Pinang,31,5,26,2017
2017-06-25,Pulau Pinang,0,0,0,2017
2017-06-26,Pulau Pinang,0,0,0,2017
2017-06-27,Pulau Pinang,24,10,14,2017
2017-06-28,Pulau Pinang,72,15,57,2017
2017-06-29,Pulau Pinang,79,18,61,2017
2017-06-30,Pulau Pinang,39,0,39,2017
2017-07-01,Pulau Pinang,38,6,32,2017
2017-07-02,Pulau Pinang,187,30,157,2017
2017-07-03,Pulau Pinang,45,1,44,2017
2017-07-04,Pulau Pinang,120,20,100,2017
2017-07-05,Pulau Pinang,121,38,83,2017
2017-07-06,Pulau Pinang,167,57,110,2017
2017-07-07,Pulau Pinang,85,25,60,2017
2017-07-08,Pulau Pinang,93,32,61,2017
2017-07-09,Pulau Pinang,182,46,136,2017
2017-07-10,Pulau Pinang,65,14,51,2017
2017-07-11,Pulau Pinang,97,18,79,2017
2017-07-12,Pulau Pinang,114,19,95,2017
2017-07-13,Pulau Pinang,142,15,127,2017
2017-07-14,Pulau Pinang,96,14,82,2017
2017-07-15,Pulau Pinang,0,0,0,2017
2017-07-16,Pulau Pinang,464,93,371,2017
2017-07-17,Pulau Pinang,147,36,111,2017
2017-07-18,Pulau Pinang,206,87,119,2017
2017-07-19,Pulau Pinang,288,93,195,2017
2017-07-20,Pulau Pinang,411,131,280,2017
2017-07-21,Pulau Pinang,28,7,21,2017
2017-07-22,Pulau Pinang,18,9,9,2017
2017-07-23,Pulau Pinang,297,65,232,2017
2017-07-24,Pulau Pinang,109,38,71,2017
2017-07-25,Pulau Pinang,93,32,61,2017
2017-07-26,Pulau Pinang,85,29,56,2017
2017-07-27,Pulau Pinang,135,50,85,2017
2017-07-28,Pulau Pinang,180,63,117,2017
2017-07-29,Pulau Pinang,32,9,23,2017
2017-07-30,Pulau Pinang,154,37,117,2017
2017-07-31,Pulau Pinang,86,30,56,2017
2017-08-01,Pulau Pinang,209,76,133,2017
2017-08-02,Pulau Pinang,140,41,99,2017
2017-08-03,Pulau Pinang,126,37,89,2017
2017-08-04,Pulau Pinang,25,0,25,2017
2017-08-05,Pulau Pinang,53,21,32,2017
2017-08-06,Pulau Pinang,269,95,174,2017
2017-08-07,Pulau Pinang,59,14,45,2017
2017-08-08,Pulau Pinang,223,58,165,2017
2017-08-09,Pulau Pinang,261,70,191,2017
2017-08-10,Pulau Pinang,151,53,98,2017
2017-08-11,Pulau Pinang,25,1,24,2017
2017-08-12,Pulau Pinang,53,29,24,2017
2017-08-13,Pulau Pinang,254,43,211,2017
2017-08-14,Pulau Pinang,174,37,137,2017
2017-08-15,Pulau Pinang,87,25,62,2017
2017-08-16,Pulau Pinang,86,31,55,2017
2017-08-17,Pulau Pinang,185,53,132,2017
2017-08-18,Pulau Pinang,33,8,25,2017
2017-08-19,Pulau Pinang,54,28,26,2017
2017-08-20,Pulau Pinang,241,61,180,2017
2017-08-21,Pulau Pinang,182,80,102,2017
2017-08-22,Pulau Pinang,236,110,126,2017
2017-08-23,Pulau Pinang,165,82,83,2017
2017-08-24,Pulau Pinang,150,79,71,2017
2017-08-25,Pulau Pinang,110,29,81,2017
2017-08-26,Pulau Pinang,128,64,64,2017
2017-08-27,Pulau Pinang,125,38,87,2017
2017-08-28,Pulau Pinang,40,6,34,2017
2017-08-29,Pulau Pinang,121,37,84,2017
2017-08-30,Pulau Pinang,176,59,117,2017
2017-08-31,Pulau Pinang,120,43,77,2017
2017-09-01,Pulau Pinang,0,0,0,2017
2017-09-02,Pulau Pinang,18,3,15,2017
2017-09-03,Pulau Pinang,169,17,152,2017
2017-09-04,Pulau Pinang,62,11,51,2017
2017-09-05,Pulau Pinang,38,2,36,2017
2017-09-06,Pulau Pinang,381,167,214,2017
2017-09-07,Pulau Pinang,154,37,117,2017
2017-09-08,Pulau Pinang,29,3,26,2017
2017-09-09,Pulau Pinang,375,344,31,2017
2017-09-10,Pulau Pinang,56,27,29,2017
2017-09-11,Pulau Pinang,46,2,44,2017
2017-09-12,Pulau Pinang,183,62,121,2017
2017-09-13,Pulau Pinang,187,64,123,2017
2017-09-14,Pulau Pinang,102,27,75,2017
2017-09-15,Pulau Pinang,24,5,19,2017
2017-09-16,Pulau Pinang,98,35,63,2017
2017-09-17,Pulau Pinang,245,38,207,2017
2017-09-18,Pulau Pinang,106,30,76,2017
2017-09-19,Pulau Pinang,86,19,67,2017
2017-09-20,Pulau Pinang,221,74,147,2017
2017-09-21,Pulau Pinang,60,17,43,2017
2017-09-22,Pulau Pinang,32,10,22,2017
2017-09-23,Pulau Pinang,19,6,13,2017
2017-09-24,Pulau Pinang,290,37,253,2017
2017-09-25,Pulau Pinang,94,23,71,2017
2017-09-26,Pulau Pinang,88,12,76,2017
2017-09-27,Pulau Pinang,56,14,42,2017
2017-09-28,Pulau Pinang,117,27,90,2017
2017-09-29,Pulau Pinang,36,6,30,2017
2017-09-30,Pulau Pinang,147,69,78,2017
2017-10-01,Pulau Pinang,121,45,76,2017
2017-10-02,Pulau Pinang,23,0,23,2017
2017-10-03,Pulau Pinang,75,7,68,2017
2017-10-04,Pulau Pinang,176,52,124,2017
2017-10-05,Pulau Pinang,63,25,38,2017
2017-10-06,Pulau Pinang,36,4,32,2017
2017-10-07,Pulau Pinang,125,36,89,2017
2017-10-08,Pulau Pinang,89,28,61,2017
2017-10-09,Pulau Pinang,36,3,33,2017
2017-10-10,Pulau Pinang,257,54,203,2017
2017-10-11,Pulau Pinang,105,34,71,2017
2017-10-12,Pulau Pinang,50,11,39,2017
2017-10-13,Pulau Pinang,30,2,28,2017
2017-10-14,Pulau Pinang,113,51,62,2017
2017-10-15,Pulau Pinang,228,35,193,2017
2017-10-16,Pulau Pinang,38,2,36,2017
2017-10-17,Pulau Pinang,65,10,55,2017
2017-10-18,Pulau Pinang,37,11,26,2017
2017-10-19,Pulau Pinang,73,16,57,2017
2017-10-20,Pulau Pinang,51,3,48,2017
2017-10-21,Pulau Pinang,21,1,20,2017
2017-10-22,Pulau Pinang,48,15,33,2017
2017-10-23,Pulau Pinang,51,7,44,2017
2017-10-24,Pulau Pinang,165,30,135,2017
2017-10-25,Pulau Pinang,93,23,70,2017
2017-10-26,Pulau Pinang,72,16,56,2017
2017-10-27,Pulau Pinang,29,3,26,2017
2017-10-28,Pulau Pinang,162,64,98,2017
2017-10-29,Pulau Pinang,254,77,177,2017
2017-10-30,Pulau Pinang,40,7,33,2017
2017-10-31,Pulau Pinang,69,9,60,2017
2017-11-01,Pulau Pinang,171,44,127,2017
2017-11-02,Pulau Pinang,151,36,115,2017
2017-11-03,Pulau Pinang,24,3,21,2017
2017-11-04,Pulau Pinang,122,20,102,2017
2017-11-05,Pulau Pinang,56,1,55,2017
2017-11-06,Pulau Pinang,32,4,28,2017
2017-11-07,Pulau Pinang,149,44,105,2017
2017-11-08,Pulau Pinang,126,33,93,2017
2017-11-09,Pulau Pinang,53,13,40,2017
2017-11-10,Pulau Pinang,62,6,56,2017
2017-11-11,Pulau Pinang,74,23,51,2017
2017-11-12,Pulau Pinang,192,19,173,2017
2017-11-13,Pulau Pinang,82,14,68,2017
2017-11-14,Pulau Pinang,120,30,90,2017
2017-11-15,Pulau Pinang,116,37,79,2017
2017-11-16,Pulau Pinang,102,40,62,2017
2017-11-17,Pulau Pinang,63,12,51,2017
2017-11-18,Pulau Pinang,51,23,28,2017
2017-11-19,Pulau Pinang,220,30,190,2017
2017-11-20,Pulau Pinang,54,3,51,2017
2017-11-21,Pulau Pinang,156,57,99,2017
2017-11-22,Pulau Pinang,148,46,102,2017
2017-11-23,Pulau Pinang,192,61,131,2017
2017-11-24,Pulau Pinang,37,8,29,2017
2017-11-25,Pulau Pinang,92,32,60,2017
2017-11-26,Pulau Pinang,182,47,135,2017
2017-11-27,Pulau Pinang,110,30,80,2017
2017-11-28,Pulau Pinang,134,79,55,2017
2017-11-29,Pulau Pinang,127,57,70,2017
2017-11-30,Pulau Pinang,92,25,67,2017
2017-12-01,Pulau Pinang,0,0,0,2017
2017-12-02,Pulau Pinang,39,7,32,2017
2017-12-03,Pulau Pinang,259,29,230,2017
2017-12-04,Pulau Pinang,54,5,49,2017
2017-12-05,Pulau Pinang,74,16,58,2017
2017-12-06,Pulau Pinang,194,54,140,2017
2017-12-07,Pulau Pinang,63,13,50,2017
2017-12-08,Pulau Pinang,119,30,89,2017
2017-12-09,Pulau Pinang,50,17,33,2017
2017-12-10,Pulau Pinang,224,45,179,2017
2017-12-11,Pulau Pinang,61,11,50,2017
2017-12-12,Pulau Pinang,233,46,187,2017
2017-12-13,Pulau Pinang,135,25,110,2017
2017-12-14,Pulau Pinang,90,9,81,2017
2017-12-15,Pulau Pinang,48,5,43,2017
2017-12-16,Pulau Pinang,15,4,11,2017
2017-12-17,Pulau Pinang,210,50,160,2017
2017-12-18,Pulau Pinang,174,58,116,2017
2017-12-19,Pulau Pinang,151,35,116,2017
2017-12-20,Pulau Pinang,130,39,91,2017
2017-12-21,Pulau Pinang,175,45,130,2017
2017-12-22,Pulau Pinang,32,3,29,2017
2017-12-23,Pulau Pinang,16,7,9,2017
2017-12-24,Pulau Pinang,133,81,52,2017
2017-12-25,Pulau Pinang,46,17,29,2017
2017-12-26,Pulau Pinang,52,8,44,2017
2017-12-27,Pulau Pinang,138,47,91,2017
2017-12-28,Pulau Pinang,116,25,91,2017
2017-12-29,Pulau Pinang,47,4,43,2017
2017-12-30,Pulau Pinang,17,5,12,2017
2017-12-31,Pulau Pinang,148,30,118,2017
2018-01-01,Pulau Pinang,61,15,46,2018
2018-01-02,Pulau Pinang,37,5,32,2018
2018-01-03,Pulau Pinang,175,55,120,2018
2018-01-04,Pulau Pinang,37,8,29,2018
2018-01-05,Pulau Pinang,40,2,38,2018
2018-01-06,Pulau Pinang,83,18,65,2018
2018-01-07,Pulau Pinang,201,31,170,2018
2018-01-08,Pulau Pinang,91,25,66,2018
2018-01-09,Pulau Pinang,58,11,47,2018
2018-01-10,Pulau Pinang,114,45,69,2018
2018-01-11,Pulau Pinang,33,8,25,2018
2018-01-12,Pulau Pinang,59,9,50,2018
2018-01-13,Pulau Pinang,79,34,45,2018
2018-01-14,Pulau Pinang,251,29,222,2018
2018-01-15,Pulau Pinang,32,6,26,2018
2018-01-16,Pulau Pinang,54,10,44,2018
2018-01-17,Pulau Pinang,199,32,167,2018
2018-01-18,Pulau Pinang,184,36,148,2018
2018-01-19,Pulau Pinang,29,2,27,2018
2018-01-20,Pulau Pinang,121,61,60,2018
2018-01-21,Pulau Pinang,286,56,230,2018
2018-01-22,Pulau Pinang,39,1,38,2018
2018-01-23,Pulau Pinang,129,28,101,2018
2018-01-24,Pulau Pinang,109,57,52,2018
2018-01-25,Pulau Pinang,390,165,225,2018
2018-01-26,Pulau Pinang,36,2,34,2018
2018-01-27,Pulau Pinang,51,30,21,2018
2018-01-28,Pulau Pinang,246,44,202,2018
2018-01-29,Pulau Pinang,139,46,93,2018
2018-01-30,Pulau Pinang,93,34,59,2018
2018-01-31,Pulau Pinang,394,137,257,2018
2018-02-01,Pulau Pinang,48,9,39,2018
2018-02-02,Pulau Pinang,91,15,76,2018
2018-02-03,Pulau Pinang,56,11,45,2018
2018-02-04,Pulau Pinang,188,54,134,2018
2018-02-05,Pulau Pinang,40,6,34,2018
2018-02-06,Pulau Pinang,166,25,141,2018
2018-02-07,Pulau Pinang,454,220,234,2018
2018-02-08,Pulau Pinang,192,55,137,2018
2018-02-09,Pulau Pinang,35,1,34,2018
2018-02-10,Pulau Pinang,81,38,43,2018
2018-02-11,Pulau Pinang,61,23,38,2018
2018-02-12,Pulau Pinang,80,7,73,2018
2018-02-13,Pulau Pinang,249,80,169,2018
2018-02-14,Pulau Pinang,108,27,81,2018
2018-02-15,Pulau Pinang,67,11,56,2018
2018-02-16,Pulau Pinang,0,0,0,2018
2018-02-17,Pulau Pinang,42,9,33,2018
2018-02-18,Pulau Pinang,234,49,185,2018
2018-02-19,Pulau Pinang,64,9,55,2018
2018-02-20,Pulau Pinang,80,23,57,2018
2018-02-21,Pulau Pinang,156,26,130,2018
2018-02-22,Pulau Pinang,245,81,164,2018
2018-02-23,Pulau Pinang,36,8,28,2018
2018-02-24,Pulau Pinang,20,4,16,2018
2018-02-25,Pulau Pinang,217,23,194,2018
2018-02-26,Pulau Pinang,82,27,55,2018
2018-02-27,Pulau Pinang,222,36,186,2018
2018-02-28,Pulau Pinang,204,106,98,2018
2018-03-01,Pulau Pinang,75,16,59,2018
2018-03-02,Pulau Pinang,36,3,33,2018
2018-03-03,Pulau Pinang,65,9,56,2018
2018-03-04,Pulau Pinang,294,34,260,2018
2018-03-05,Pulau Pinang,83,27,56,2018
2018-03-06,Pulau Pinang,127,58,69,2018
2018-03-07,Pulau Pinang,257,57,200,2018
2018-03-08,Pulau Pinang,107,25,82,2018
2018-03-09,Pulau Pinang,30,4,26,2018
2018-03-10,Pulau Pinang,114,34,80,2018
2018-03-11,Pulau Pinang,161,24,137,2018
2018-03-12,Pulau Pinang,61,11,50,2018
2018-03-13,Pulau Pinang,92,15,77,2018
2018-03-14,Pulau Pinang,119,36,83,2018
2018-03-15,Pulau Pinang,122,34,88,2018
2018-03-16,Pulau Pinang,33,3,30,2018
2018-03-17,Pulau Pinang,89,32,57,2018
2018-03-18,Pulau Pinang,359,76,283,2018
2018-03-19,Pulau Pinang,84,13,71,2018
2018-03-20,Pulau Pinang,142,29,113,2018
2018-03-21,Pulau Pinang,123,32,91,2018
2018-03-22,Pulau Pinang,65,17,48,2018
2018-03-23,Pulau Pinang,35,4,31,2018
2018-03-24,Pulau Pinang,138,53,85,2018
2018-03-25,Pulau Pinang,479,127,352,2018
2018-03-26,Pulau Pinang,57,17,40,2018
2018-03-27,Pulau Pinang,69,24,45,2018
2018-03-28,Pulau Pinang,28,4,24,2018
2018-03-29,Pulau Pinang,107,32,75,2018
2018-03-30,Pulau Pinang,36,3,33,2018
2018-03-31,Pulau Pinang,211,107,104,2018
2018-04-01,Pulau Pinang,241,103,138,2018
2018-04-02,Pulau Pinang,24,2,22,2018
2018-04-03,Pulau Pinang,96,23,73,2018
2018-04-04,Pulau Pinang,169,46,123,2018
2018-04-05,Pulau Pinang,193,75,118,2018
2018-04-06,Pulau Pinang,43,4,39,2018
2018-04-07,Pulau Pinang,37,2,35,2018
2018-04-08,Pulau Pinang,181,25,156,2018
2018-04-09,Pulau Pinang,112,13,99,2018
2018-04-10,Pulau Pinang,222,60,162,2018
2018-04-11,Pulau Pinang,107,25,82,2018
2018-04-12,Pulau Pinang,282,69,213,2018
2018-04-13,Pulau Pinang,42,3,39,2018
2018-04-14,Pulau Pinang,11,4,7,2018
2018-04-15,Pulau Pinang,172,34,138,2018
2018-04-16,Pulau Pinang,53,9,44,2018
2018-04-17,Pulau Pinang,173,31,142,2018
2018-04-18,Pulau Pinang,187,30,157,2018
2018-04-19,Pulau Pinang,77,16,61,2018
2018-04-20,Pulau Pinang,34,4,30,2018
2018-04-21,Pulau Pinang,115,36,79,2018
2018-04-22,Pulau Pinang,126,28,98,2018
2018-04-23,Pulau Pinang,86,15,71,2018
2018-04-24,Pulau Pinang,80,13,67,2018
2018-04-25,Pulau Pinang,167,42,125,2018
2018-04-26,Pulau Pinang,188,44,144,2018
2018-04-27,Pulau Pinang,52,9,43,2018
2018-04-28,Pulau Pinang,114,34,80,2018
2018-04-29,Pulau Pinang,155,52,103,2018
2018-04-30,Pulau Pinang,111,13,98,2018
2018-05-01,Pulau Pinang,168,62,106,2018
2018-05-02,Pulau Pinang,172,59,113,2018
2018-05-03,Pulau Pinang,158,56,102,2018
2018-05-04,Pulau Pinang,55,10,45,2018
2018-05-05,Pulau Pinang,182,42,140,2018
2018-05-06,Pulau Pinang,211,21,190,2018
2018-05-07,Pulau Pinang,171,54,117,2018
2018-05-08,Pulau Pinang,116,25,91,2018
2018-05-09,Pulau Pinang,0,0,0,2018
2018-05-10,Pulau Pinang,0,0,0,2018
2018-05-11,Pulau Pinang,44,9,35,2018
2018-05-12,Pulau Pinang,91,27,64,2018
2018-05-13,Pulau Pinang,160,37,123,2018
2018-05-14,Pulau Pinang,171,54,117,2018
2018-05-15,Pulau Pinang,152,57,95,2018
2018-05-16,Pulau Pinang,193,30,163,2018
2018-05-17,Pulau Pinang,21,2,19,2018
2018-05-18,Pulau Pinang,25,3,22,2018
2018-05-19,Pulau Pinang,61,22,39,2018
2018-05-20,Pulau Pinang,162,44,118,2018
2018-05-21,Pulau Pinang,26,1,25,2018
2018-05-22,Pulau Pinang,69,25,44,2018
2018-05-23,Pulau Pinang,58,16,42,2018
2018-05-24,Pulau Pinang,66,20,46,2018
2018-05-25,Pulau Pinang,25,1,24,2018
2018-05-26,Pulau Pinang,49,11,38,2018
2018-05-27,Pulau Pinang,406,57,349,2018
2018-05-28,Pulau Pinang,49,5,44,2018
2018-05-29,Pulau Pinang,174,53,121,2018
2018-05-30,Pulau Pinang,53,15,38,2018
2018-05-31,Pulau Pinang,85,24,61,2018
2018-06-01,Pulau Pinang,26,4,22,2018
2018-06-02,Pulau Pinang,53,16,37,2018
2018-06-03,Pulau Pinang,321,41,280,2018
2018-06-04,Pulau Pinang,143,42,101,2018
2018-06-05,Pulau Pinang,59,17,42,2018
2018-06-06,Pulau Pinang,92,57,35,2018
2018-06-07,Pulau Pinang,47,12,35,2018
2018-06-08,Pulau Pinang,68,17,51,2018
2018-06-09,Pulau Pinang,45,12,33,2018
2018-06-10,Pulau Pinang,201,39,162,2018
2018-06-11,Pulau Pinang,58,11,47,2018
2018-06-12,Pulau Pinang,82,18,64,2018
2018-06-13,Pulau Pinang,61,6,55,2018
2018-06-14,Pulau Pinang,92,24,68,2018
2018-06-15,Pulau Pinang,0,0,0,2018
2018-06-16,Pulau Pinang,0,0,0,2018
2018-06-17,Pulau Pinang,139,30,109,2018
2018-06-18,Pulau Pinang,42,4,38,2018
2018-06-19,Pulau Pinang,144,32,112,2018
2018-06-20,Pulau Pinang,109,23,86,2018
2018-06-21,Pulau Pinang,100,40,60,2018
2018-06-22,Pulau Pinang,53,8,45,2018
2018-06-23,Pulau Pinang,128,41,87,2018
2018-06-24,Pulau Pinang,224,38,186,2018
2018-06-25,Pulau Pinang,44,6,38,2018
2018-06-26,Pulau Pinang,81,18,63,2018
2018-06-27,Pulau Pinang,162,47,115,2018
2018-06-28,Pulau Pinang,148,32,116,2018
2018-06-29,Pulau Pinang,56,18,38,2018
2018-06-30,Pulau Pinang,16,7,9,2018
2018-07-01,Pulau Pinang,165,70,95,2018
2018-07-02,Pulau Pinang,125,19,106,2018
2018-07-03,Pulau Pinang,92,27,65,2018
2018-07-04,Pulau Pinang,146,39,107,2018
2018-07-05,Pulau Pinang,105,34,71,2018
2018-07-06,Pulau Pinang,22,0,22,2018
2018-07-07,Pulau Pinang,60,24,36,2018
2018-07-08,Pulau Pinang,162,31,131,2018
2018-07-09,Pulau Pinang,110,49,61,2018
2018-07-10,Pulau Pinang,226,52,174,2018
2018-07-11,Pulau Pinang,153,41,112,2018
2018-07-12,Pulau Pinang,173,45,128,2018
2018-07-13,Pulau Pinang,42,4,38,2018
2018-07-14,Pulau Pinang,75,28,47,2018
2018-07-15,Pulau Pinang,440,108,332,2018
2018-07-16,Pulau Pinang,34,4,30,2018
2018-07-17,Pulau Pinang,112,46,66,2018
2018-07-18,Pulau Pinang,135,49,86,2018
2018-07-19,Pulau Pinang,280,52,228,2018
2018-07-20,Pulau Pinang,46,9,37,2018
2018-07-21,Pulau Pinang,109,46,63,2018
2018-07-22,Pulau Pinang,188,37,151,2018
2018-07-23,Pulau Pinang,161,18,143,2018
2018-07-24,Pulau Pinang,189,80,109,2018
2018-07-25,Pulau Pinang,222,98,124,2018
2018-07-26,Pulau Pinang,152,24,128,2018
2018-07-27,Pulau Pinang,57,18,39,2018
2018-07-28,Pulau Pinang,171,60,111,2018
2018-07-29,Pulau Pinang,304,73,231,2018
2018-07-30,Pulau Pinang,126,22,104,2018
2018-07-31,Pulau Pinang,148,25,123,2018
2018-08-01,Pulau Pinang,57,5,52,2018
2018-08-02,Pulau Pinang,250,66,184,2018
2018-08-03,Pulau Pinang,32,6,26,2018
2018-08-04,Pulau Pinang,101,18,83,2018
2018-08-05,Pulau Pinang,291,52,239,2018
2018-08-06,Pulau Pinang,196,98,98,2018
2018-08-07,Pulau Pinang,179,69,110,2018
2018-08-08,Pulau Pinang,318,103,215,2018
2018-08-09,Pulau Pinang,256,144,112,2018
2018-08-10,Pulau Pinang,166,130,36,2018
2018-08-11,Pulau Pinang,47,25,22,2018
2018-08-12,Pulau Pinang,122,24,98,2018
2018-08-13,Pulau Pinang,104,17,87,2018
2018-08-14,Pulau Pinang,168,31,137,2018
2018-08-15,Pulau Pinang,454,174,280,2018
2018-08-16,Pulau Pinang,152,50,102,2018
2018-08-17,Pulau Pinang,58,11,47,2018
2018-08-18,Pulau Pinang,81,43,38,2018
2018-08-19,Pulau Pinang,147,39,108,2018
2018-08-20,Pulau Pinang,84,17,67,2018
2018-08-21,Pulau Pinang,83,18,65,2018
2018-08-22,Pulau Pinang,0,0,0,2018
2018-08-23,Pulau Pinang,24,8,16,2018
2018-08-24,Pulau Pinang,30,5,25,2018
2018-08-25,Pulau Pinang,22,6,16,2018
2018-08-26,Pulau Pinang,120,31,89,2018
2018-08-27,Pulau Pinang,156,10,146,2018
2018-08-28,Pulau Pinang,61,12,49,2018
2018-08-29,Pulau Pinang,235,99,136,2018
2018-08-30,Pulau Pinang,126,60,66,2018
2018-08-31,Pulau Pinang,232,41,191,2018
2018-09-01,Pulau Pinang,29,4,25,2018
2018-09-02,Pulau Pinang,230,35,195,2018
2018-09-03,Pulau Pinang,52,13,39,2018
2018-09-04,Pulau Pinang,127,40,87,2018
2018-09-05,Pulau Pinang,99,29,70,2018
2018-09-06,Pulau Pinang,101,18,83,2018
2018-09-07,Pulau Pinang,20,2,18,2018
2018-09-08,Pulau Pinang,198,132,66,2018
2018-09-09,Pulau Pinang,198,39,159,2018
2018-09-10,Pulau Pinang,0,0,0,2018
2018-09-11,Pulau Pinang,21,6,15,2018
2018-09-12,Pulau Pinang,104,26,78,2018
2018-09-13,Pulau Pinang,232,86,146,2018
2018-09-14,Pulau Pinang,94,36,58,2018
2018-09-15,Pulau Pinang,0,0,0,2018
2018-09-16,Pulau Pinang,333,81,252,2018
2018-09-17,Pulau Pinang,0,0,0,2018
2018-09-18,Pulau Pinang,84,15,69,2018
2018-09-19,Pulau Pinang,109,51,58,2018
2018-09-20,Pulau Pinang,173,73,100,2018
2018-09-21,Pulau Pinang,41,12,29,2018
2018-09-22,Pulau Pinang,56,17,39,2018
2018-09-23,Pulau Pinang,108,30,78,2018
2018-09-24,Pulau Pinang,69,20,49,2018
2018-09-25,Pulau Pinang,177,47,130,2018
2018-09-26,Pulau Pinang,171,48,123,2018
2018-09-27,Pulau Pinang,60,14,46,2018
2018-09-28,Pulau Pinang,112,31,81,2018
2018-09-29,Pulau Pinang,114,37,77,2018
2018-09-30,Pulau Pinang,317,48,269,2018
2018-10-01,Pulau Pinang,104,13,91,2018
2018-10-02,Pulau Pinang,104,29,75,2018
2018-10-03,Pulau Pinang,156,49,107,2018
2018-10-04,Pulau Pinang,94,41,53,2018
2018-10-05,Pulau Pinang,29,5,24,2018
2018-10-06,Pulau Pinang,95,29,66,2018
2018-10-07,Pulau Pinang,287,48,239,2018
2018-10-08,Pulau Pinang,35,1,34,2018
2018-10-09,Pulau Pinang,91,31,60,2018
2018-10-10,Pulau Pinang,135,39,96,2018
2018-10-11,Pulau Pinang,147,43,104,2018
2018-10-12,Pulau Pinang,73,37,36,2018
2018-10-13,Pulau Pinang,114,34,80,2018
2018-10-14,Pulau Pinang,171,50,121,2018
2018-10-15,Pulau Pinang,55,12,43,2018
2018-10-16,Pulau Pinang,53,6,47,2018
2018-10-17,Pulau Pinang,146,53,93,2018
2018-10-18,Pulau Pinang,149,31,118,2018
2018-10-19,Pulau Pinang,23,1,22,2018
2018-10-20,Pulau Pinang,89,20,69,2018
2018-10-21,Pulau Pinang,170,57,113,2018
2018-10-22,Pulau Pinang,83,20,63,2018
2018-10-23,Pulau Pinang,188,63,125,2018
2018-10-24,Pulau Pinang,101,29,72,2018
2018-10-25,Pulau Pinang,94,19,75,2018
2018-10-26,Pulau Pinang,176,62,114,2018
2018-10-27,Pulau Pinang,123,41,82,2018
2018-10-28,Pulau Pinang,168,23,145,2018
2018-10-29,Pulau Pinang,197,18,179,2018
2018-10-30,Pulau Pinang,141,27,114,2018
2018-10-31,Pulau Pinang,104,33,71,2018
2018-11-01,Pulau Pinang,285,100,185,2018
2018-11-02,Pulau Pinang,39,2,37,2018
2018-11-03,Pulau Pinang,106,17,89,2018
2018-11-04,Pulau Pinang,207,14,193,2018
2018-11-05,Pulau Pinang,50,5,45,2018
2018-11-06,Pulau Pinang,107,29,78,2018
2018-11-07,Pulau Pinang,80,20,60,2018
2018-11-08,Pulau Pinang,74,20,54,2018
2018-11-09,Pulau Pinang,34,1,33,2018
2018-11-10,Pulau Pinang,98,35,63,2018
2018-11-11,Pulau Pinang,168,27,141,2018
2018-11-12,Pulau Pinang,102,29,73,2018
2018-11-13,Pulau Pinang,126,28,98,2018
2018-11-14,Pulau Pinang,160,34,126,2018
2018-11-15,Pulau Pinang,64,16,48,2018
2018-11-16,Pulau Pinang,38,6,32,2018
2018-11-17,Pulau Pinang,73,32,41,2018
2018-11-18,Pulau Pinang,286,49,237,2018
2018-11-19,Pulau Pinang,82,22,60,2018
2018-11-20,Pulau Pinang,44,13,31,2018
2018-11-21,Pulau Pinang,122,20,102,2018
2018-11-22,Pulau Pinang,295,61,234,2018
2018-11-23,Pulau Pinang,36,7,29,2018
2018-11-24,Pulau Pinang,112,33,79,2018
2018-11-25,Pulau Pinang,150,38,112,2018
2018-11-26,Pulau Pinang,120,54,66,2018
2018-11-27,Pulau Pinang,152,34,118,2018
2018-11-28,Pulau Pinang,138,23,115,2018
2018-11-29,Pulau Pinang,93,17,76,2018
2018-11-30,Pulau Pinang,45,4,41,2018
2018-12-01,Pulau Pinang,53,6,47,2018
2018-12-02,Pulau Pinang,292,41,251,2018
2018-12-03,Pulau Pinang,52,12,40,2018
2018-12-04,Pulau Pinang,211,82,129,2018
2018-12-05,Pulau Pinang,148,53,95,2018
2018-12-06,Pulau Pinang,129,59,70,2018
2018-12-07,Pulau Pinang,27,1,26,2018
2018-12-08,Pulau Pinang,92,30,62,2018
2018-12-09,Pulau Pinang,120,24,96,2018
2018-12-10,Pulau Pinang,61,10,51,2018
2018-12-11,Pulau Pinang,129,33,96,2018
2018-12-12,Pulau Pinang,117,33,84,2018
2018-12-13,Pulau Pinang,101,43,58,2018
2018-12-14,Pulau Pinang,24,0,24,2018
2018-12-15,Pulau Pinang,28,4,24,2018
2018-12-16,Pulau Pinang,82,14,68,2018
2018-12-17,Pulau Pinang,147,28,119,2018
2018-12-18,Pulau Pinang,184,57,127,2018
2018-12-19,Pulau Pinang,242,61,181,2018
2018-12-20,Pulau Pinang,160,47,113,2018
2018-12-21,Pulau Pinang,42,4,38,2018
2018-12-22,Pulau Pinang,36,3,33,2018
2018-12-23,Pulau Pinang,89,23,66,2018
2018-12-24,Pulau Pinang,60,8,52,2018
2018-12-25,Pulau Pinang,81,24,57,2018
2018-12-26,Pulau Pinang,49,8,41,2018
2018-12-27,Pulau Pinang,224,59,165,2018
2018-12-28,Pulau Pinang,45,7,38,2018
2018-12-29,Pulau Pinang,49,14,35,2018
2018-12-30,Pulau Pinang,163,69,94,2018
2018-12-31,Pulau Pinang,57,6,51,2018
2019-01-01,Pulau Pinang,118,24,94,2019
2019-01-02,Pulau Pinang,26,1,25,2019
2019-01-03,Pulau Pinang,61,14,47,2019
2019-01-04,Pulau Pinang,44,9,35,2019
2019-01-05,Pulau Pinang,77,13,64,2019
2019-01-06,Pulau Pinang,263,53,210,2019
2019-01-07,Pulau Pinang,123,43,80,2019
2019-01-08,Pulau Pinang,61,17,44,2019
2019-01-09,Pulau Pinang,136,39,97,2019
2019-01-10,Pulau Pinang,333,108,225,2019
2019-01-11,Pulau Pinang,162,58,104,2019
2019-01-12,Pulau Pinang,76,19,57,2019
2019-01-13,Pulau Pinang,554,111,443,2019
2019-01-14,Pulau Pinang,86,24,62,2019
2019-01-15,Pulau Pinang,142,27,115,2019
2019-01-16,Pulau Pinang,96,24,72,2019
2019-01-17,Pulau Pinang,107,36,71,2019
2019-01-18,Pulau Pinang,45,9,36,2019
2019-01-19,Pulau Pinang,0,0,0,2019
2019-01-20,Pulau Pinang,321,71,250,2019
2019-01-21,Pulau Pinang,450,149,301,2019
2019-01-22,Pulau Pinang,52,3,49,2019
2019-01-23,Pulau Pinang,256,100,156,2019
2019-01-24,Pulau Pinang,265,104,161,2019
2019-01-25,Pulau Pinang,138,68,70,2019
2019-01-26,Pulau Pinang,182,43,139,2019
2019-01-27,Pulau Pinang,137,31,106,2019
2019-01-28,Pulau Pinang,98,20,78,2019
2019-01-29,Pulau Pinang,97,37,60,2019
2019-01-30,Pulau Pinang,184,42,142,2019
2019-01-31,Pulau Pinang,97,33,64,2019
2019-02-01,Pulau Pinang,95,40,55,2019
2019-02-02,Pulau Pinang,51,13,38,2019
2019-02-03,Pulau Pinang,90,26,64,2019
2019-02-04,Pulau Pinang,58,3,55,2019
2019-02-05,Pulau Pinang,116,41,75,2019
2019-02-06,Pulau Pinang,87,32,55,2019
2019-02-07,Pulau Pinang,100,20,80,2019
2019-02-08,Pulau Pinang,61,9,52,2019
2019-02-09,Pulau Pinang,73,31,42,2019
2019-02-10,Pulau Pinang,281,77,204,2019
2019-02-11,Pulau Pinang,71,19,52,2019
2019-02-12,Pulau Pinang,97,10,87,2019
2019-02-13,Pulau Pinang,74,15,59,2019
2019-02-14,Pulau Pinang,113,28,85,2019
2019-02-15,Pulau Pinang,36,4,32,2019
2019-02-16,Pulau Pinang,56,16,40,2019
2019-02-17,Pulau Pinang,177,28,149,2019
2019-02-18,Pulau Pinang,48,3,45,2019
2019-02-19,Pulau Pinang,231,34,197,2019
2019-02-20,Pulau Pinang,153,43,110,2019
2019-02-21,Pulau Pinang,52,5,47,2019
2019-02-22,Pulau Pinang,43,9,34,2019
2019-02-23,Pulau Pinang,9,4,5,2019
2019-02-24,Pulau Pinang,310,45,265,2019
2019-02-25,Pulau Pinang,143,33,110,2019
2019-02-26,Pulau Pinang,101,18,83,2019
2019-02-27,Pulau Pinang,294,67,227,2019
2019-02-28,Pulau Pinang,110,36,74,2019
2019-03-01,Pulau Pinang,64,17,47,2019
2019-03-02,Pulau Pinang,41,3,38,2019
2019-03-03,Pulau Pinang,242,50,192,2019
2019-03-04,Pulau Pinang,51,11,40,2019
2019-03-05,Pulau Pinang,108,27,81,2019
2019-03-06,Pulau Pinang,238,46,192,2019
2019-03-07,Pulau Pinang,69,5,64,2019
2019-03-08,Pulau Pinang,38,7,31,2019
2019-03-09,Pulau Pinang,263,77,186,2019
2019-03-10,Pulau Pinang,418,69,349,2019
2019-03-11,Pulau Pinang,103,39,64,2019
2019-03-12,Pulau Pinang,193,34,159,2019
2019-03-13,Pulau Pinang,218,31,187,2019
2019-03-14,Pulau Pinang,196,65,131,2019
2019-03-15,Pulau Pinang,26,0,26,2019
2019-03-16,Pulau Pinang,122,50,72,2019
2019-03-17,Pulau Pinang,397,107,290,2019
2019-03-18,Pulau Pinang,54,2,52,2019
2019-03-19,Pulau Pinang,198,77,121,2019
2019-03-20,Pulau Pinang,208,84,124,2019
2019-03-21,Pulau Pinang,179,41,138,2019
2019-03-22,Pulau Pinang,34,3,31,2019
2019-03-23,Pulau Pinang,97,32,65,2019
2019-03-24,Pulau Pinang,303,48,255,2019
2019-03-25,Pulau Pinang,114,28,86,2019
2019-03-26,Pulau Pinang,60,13,47,2019
2019-03-27,Pulau Pinang,89,9,80,2019
2019-03-28,Pulau Pinang,164,43,121,2019
2019-03-29,Pulau Pinang,35,2,33,2019
2019-03-30,Pulau Pinang,73,24,49,2019
2019-03-31,Pulau Pinang,136,41,95,2019
2019-04-01,Pulau Pinang,97,34,63,2019
2019-04-02,Pulau Pinang,106,40,66,2019
2019-04-03,Pulau Pinang,77,46,31,2019
2019-04-04,Pulau Pinang,116,41,75,2019
2019-04-05,Pulau Pinang,40,5,35,2019
2019-04-06,Pulau Pinang,123,34,89,2019
2019-04-07,Pulau Pinang,198,67,131,2019
2019-04-08,Pulau Pinang,116,32,84,2019
2019-04-09,Pulau Pinang,215,59,156,2019
2019-04-10,Pulau Pinang,117,33,84,2019
2019-04-11,Pulau Pinang,113,44,69,2019
2019-04-12,Pulau Pinang,82,27,55,2019
2019-04-13,Pulau Pinang,94,18,76,2019
2019-04-14,Pulau Pinang,345,30,315,2019
2019-04-15,Pulau Pinang,85,11,74,2019
2019-04-16,Pulau Pinang,119,32,87,2019
2019-04-17,Pulau Pinang,224,114,110,2019
2019-04-18,Pulau Pinang,162,55,107,2019
2019-04-19,Pulau Pinang,45,6,39,2019
2019-04-20,Pulau Pinang,152,75,77,2019
2019-04-21,Pulau Pinang,181,35,146,2019
2019-04-22,Pulau Pinang,130,21,109,2019
2019-04-23,Pulau Pinang,156,43,113,2019
2019-04-24,Pulau Pinang,71,7,64,2019
2019-04-25,Pulau Pinang,252,89,163,2019
2019-04-26,Pulau Pinang,43,4,39,2019
2019-04-27,Pulau Pinang,81,15,66,2019
2019-04-28,Pulau Pinang,260,41,219,2019
2019-04-29,Pulau Pinang,134,43,91,2019
2019-04-30,Pulau Pinang,152,33,119,2019
2019-05-01,Pulau Pinang,240,51,189,2019
2019-05-02,Pulau Pinang,61,8,53,2019
2019-05-03,Pulau Pinang,48,3,45,2019
2019-05-04,Pulau Pinang,64,12,52,2019
2019-05-05,Pulau Pinang,111,24,87,2019
2019-05-06,Pulau Pinang,50,13,37,2019
2019-05-07,Pulau Pinang,58,19,39,2019
2019-05-08,Pulau Pinang,50,16,34,2019
2019-05-09,Pulau Pinang,59,9,50,2019
2019-05-10,Pulau Pinang,19,2,17,2019
2019-05-11,Pulau Pinang,17,1,16,2019
2019-05-12,Pulau Pinang,259,46,213,2019
2019-05-13,Pulau Pinang,33,0,33,2019
2019-05-14,Pulau Pinang,34,3,31,2019
2019-05-15,Pulau Pinang,191,35,156,2019
2019-05-16,Pulau Pinang,99,16,83,2019
2019-05-17,Pulau Pinang,16,0,16,2019
2019-05-18,Pulau Pinang,15,4,11,2019
2019-05-19,Pulau Pinang,242,48,194,2019
2019-05-20,Pulau Pinang,14,3,11,2019
2019-05-21,Pulau Pinang,80,20,60,2019
2019-05-22,Pulau Pinang,34,8,26,2019
2019-05-23,Pulau Pinang,53,15,38,2019
2019-05-24,Pulau Pinang,86,16,70,2019
2019-05-25,Pulau Pinang,70,20,50,2019
2019-05-26,Pulau Pinang,259,56,203,2019
2019-05-27,Pulau Pinang,56,14,42,2019
2019-05-28,Pulau Pinang,34,2,32,2019
2019-05-29,Pulau Pinang,45,17,28,2019
2019-05-30,Pulau Pinang,83,34,49,2019
2019-05-31,Pulau Pinang,21,0,21,2019
2019-06-01,Pulau Pinang,27,2,25,2019
2019-06-02,Pulau Pinang,196,21,175,2019
2019-06-03,Pulau Pinang,70,15,55,2019
2019-06-04,Pulau Pinang,71,8,63,2019
2019-06-05,Pulau Pinang,0,0,0,2019
2019-06-06,Pulau Pinang,0,0,0,2019
2019-06-07,Pulau Pinang,54,6,48,2019
2019-06-08,Pulau Pinang,35,5,30,2019
2019-06-09,Pulau Pinang,163,33,130,2019
2019-06-10,Pulau Pinang,56,7,49,2019
2019-06-11,Pulau Pinang,122,17,105,2019
2019-06-12,Pulau Pinang,38,4,34,2019
2019-06-13,Pulau Pinang,170,13,157,2019
2019-06-14,Pulau Pinang,137,19,118,2019
2019-06-15,Pulau Pinang,82,14,68,2019
2019-06-16,Pulau Pinang,302,81,221,2019
2019-06-17,Pulau Pinang,175,16,159,2019
2019-06-18,Pulau Pinang,260,66,194,2019
2019-06-19,Pulau Pinang,156,41,115,2019
2019-06-20,Pulau Pinang,226,61,165,2019
2019-06-21,Pulau Pinang,48,9,39,2019
2019-06-22,Pulau Pinang,345,276,69,2019
2019-06-23,Pulau Pinang,228,58,170,2019
2019-06-24,Pulau Pinang,99,17,82,2019
2019-06-25,Pulau Pinang,281,76,205,2019
2019-06-26,Pulau Pinang,158,47,111,2019
2019-06-27,Pulau Pinang,284,73,211,2019
2019-06-28,Pulau Pinang,32,4,28,2019
2019-06-29,Pulau Pinang,77,18,59,2019
2019-06-30,Pulau Pinang,230,61,169,2019
2019-07-01,Pulau Pinang,104,16,88,2019
2019-07-02,Pulau Pinang,82,30,52,2019
2019-07-03,Pulau Pinang,136,42,94,2019
2019-07-04,Pulau Pinang,147,44,103,2019
2019-07-05,Pulau Pinang,35,3,32,2019
2019-07-06,Pulau Pinang,103,26,77,2019
2019-07-07,Pulau Pinang,181,71,110,2019
2019-07-08,Pulau Pinang,125,48,77,2019
2019-07-09,Pulau Pinang,130,20,110,2019
2019-07-10,Pulau Pinang,114,14,100,2019
2019-07-11,Pulau Pinang,140,70,70,2019
2019-07-12,Pulau Pinang,54,7,47,2019
2019-07-13,Pulau Pinang,47,27,20,2019
2019-07-14,Pulau Pinang,258,35,223,2019
2019-07-15,Pulau Pinang,101,21,80,2019
2019-07-16,Pulau Pinang,103,19,84,2019
2019-07-17,Pulau Pinang,117,27,90,2019
2019-07-18,Pulau Pinang,94,30,64,2019
2019-07-19,Pulau Pinang,43,9,34,2019
2019-07-20,Pulau Pinang,121,43,78,2019
2019-07-21,Pulau Pinang,269,73,196,2019
2019-07-22,Pulau Pinang,51,4,47,2019
2019-07-23,Pulau Pinang,123,47,76,2019
2019-07-24,Pulau Pinang,106,20,86,2019
2019-07-25,Pulau Pinang,147,56,91,2019
2019-07-26,Pulau Pinang,216,167,49,2019
2019-07-27,Pulau Pinang,211,96,115,2019
2019-07-28,Pulau Pinang,204,39,165,2019
2019-07-29,Pulau Pinang,141,33,108,2019
2019-07-30,Pulau Pinang,79,22,57,2019
2019-07-31,Pulau Pinang,145,16,129,2019
2019-08-01,Pulau Pinang,116,31,85,2019
2019-08-02,Pulau Pinang,36,8,28,2019
2019-08-03,Pulau Pinang,42,4,38,2019
2019-08-04,Pulau Pinang,253,88,165,2019
2019-08-05,Pulau Pinang,111,38,73,2019
2019-08-06,Pulau Pinang,191,42,149,2019
2019-08-07,Pulau Pinang,266,75,191,2019
2019-08-08,Pulau Pinang,299,110,189,2019
2019-08-09,Pulau Pinang,29,3,26,2019
2019-08-10,Pulau Pinang,136,52,84,2019
2019-08-11,Pulau Pinang,0,0,0,2019
2019-08-12,Pulau Pinang,0,0,0,2019
2019-08-13,Pulau Pinang,86,14,72,2019
2019-08-14,Pulau Pinang,280,27,253,2019
2019-08-15,Pulau Pinang,92,33,59,2019
2019-08-16,Pulau Pinang,25,2,23,2019
2019-08-17,Pulau Pinang,32,12,20,2019
2019-08-18,Pulau Pinang,281,40,241,2019
2019-08-19,Pulau Pinang,43,2,41,2019
2019-08-20,Pulau Pinang,102,37,65,2019
2019-08-21,Pulau Pinang,93,37,56,2019
2019-08-22,Pulau Pinang,105,39,66,2019
2019-08-23,Pulau Pinang,22,1,21,2019
2019-08-24,Pulau Pinang,113,58,55,2019
2019-08-25,Pulau Pinang,195,43,152,2019
2019-08-26,Pulau Pinang,36,1,35,2019
2019-08-27,Pulau Pinang,62,19,43,2019
2019-08-28,Pulau Pinang,103,24,79,2019
2019-08-29,Pulau Pinang,95,26,69,2019
2019-08-30,Pulau Pinang,69,17,52,2019
2019-08-31,Pulau Pinang,191,28,163,2019
2019-09-01,Pulau Pinang,108,23,85,2019
2019-09-02,Pulau Pinang,64,14,50,2019
2019-09-03,Pulau Pinang,79,28,51,2019
2019-09-04,Pulau Pinang,33,3,30,2019
2019-09-05,Pulau Pinang,51,5,46,2019
2019-09-06,Pulau Pinang,39,3,36,2019
2019-09-07,Pulau Pinang,103,25,78,2019
2019-09-08,Pulau Pinang,101,5,96,2019
2019-09-09,Pulau Pinang,84,21,63,2019
2019-09-10,Pulau Pinang,103,15,88,2019
2019-09-11,Pulau Pinang,145,57,88,2019
2019-09-12,Pulau Pinang,64,3,61,2019
2019-09-13,Pulau Pinang,26,3,23,2019
2019-09-14,Pulau Pinang,94,42,52,2019
2019-09-15,Pulau Pinang,154,41,113,2019
2019-09-16,Pulau Pinang,298,80,218,2019
2019-09-17,Pulau Pinang,126,43,83,2019
2019-09-18,Pulau Pinang,45,10,35,2019
2019-09-19,Pulau Pinang,161,56,105,2019
2019-09-20,Pulau Pinang,60,24,36,2019
2019-09-21,Pulau Pinang,50,13,37,2019
2019-09-22,Pulau Pinang,228,41,187,2019
2019-09-23,Pulau Pinang,133,17,116,2019
2019-09-24,Pulau Pinang,103,16,87,2019
2019-09-25,Pulau Pinang,165,27,138,2019
2019-09-26,Pulau Pinang,75,23,52,2019
2019-09-27,Pulau Pinang,37,3,34,2019
2019-09-28,Pulau Pinang,26,11,15,2019
2019-09-29,Pulau Pinang,227,60,167,2019
2019-09-30,Pulau Pinang,27,2,25,2019
2019-10-01,Pulau Pinang,98,24,74,2019
2019-10-02,Pulau Pinang,137,49,88,2019
2019-10-03,Pulau Pinang,146,54,92,2019
2019-10-04,Pulau Pinang,53,11,42,2019
2019-10-05,Pulau Pinang,65,7,58,2019
2019-10-06,Pulau Pinang,251,35,216,2019
2019-10-07,Pulau Pinang,102,33,69,2019
2019-10-08,Pulau Pinang,43,3,40,2019
2019-10-09,Pulau Pinang,158,31,127,2019
2019-10-10,Pulau Pinang,131,20,111,2019
2019-10-11,Pulau Pinang,42,1,41,2019
2019-10-12,Pulau Pinang,40,13,27,2019
2019-10-13,Pulau Pinang,142,41,101,2019
2019-10-14,Pulau Pinang,96,8,88,2019
2019-10-15,Pulau Pinang,279,78,201,2019
2019-10-16,Pulau Pinang,132,40,92,2019
2019-10-17,Pulau Pinang,54,14,40,2019
2019-10-18,Pulau Pinang,72,18,54,2019
2019-10-19,Pulau Pinang,107,24,83,2019
2019-10-20,Pulau Pinang,223,41,182,2019
2019-10-21,Pulau Pinang,54,12,42,2019
2019-10-22,Pulau Pinang,102,12,90,2019
2019-10-23,Pulau Pinang,69,14,55,2019
2019-10-24,Pulau Pinang,168,35,133,2019
2019-10-25,Pulau Pinang,40,4,36,2019
2019-10-26,Pulau Pinang,112,27,85,2019
2019-10-27,Pulau Pinang,145,29,116,2019
2019-10-28,Pulau Pinang,81,18,63,2019
2019-10-29,Pulau Pinang,54,3,51,2019
2019-10-30,Pulau Pinang,67,18,49,2019
2019-10-31,Pulau Pinang,179,34,145,2019
2019-11-01,Pulau Pinang,36,3,33,2019
2019-11-02,Pulau Pinang,135,43,92,2019
2019-11-03,Pulau Pinang,151,23,128,2019
2019-11-04,Pulau Pinang,59,12,47,2019
2019-11-05,Pulau Pinang,118,10,108,2019
2019-11-06,Pulau Pinang,117,29,88,2019
2019-11-07,Pulau Pinang,106,21,85,2019
2019-11-08,Pulau Pinang,25,1,24,2019
2019-11-09,Pulau Pinang,110,39,71,2019
2019-11-10,Pulau Pinang,188,25,163,2019
2019-11-11,Pulau Pinang,39,0,39,2019
2019-11-12,Pulau Pinang,42,6,36,2019
2019-11-13,Pulau Pinang,85,21,64,2019
2019-11-14,Pulau Pinang,126,36,90,2019
2019-11-15,Pulau Pinang,33,2,31,2019
2019-11-16,Pulau Pinang,0,0,0,2019
2019-11-17,Pulau Pinang,293,34,259,2019
2019-11-18,Pulau Pinang,29,2,27,2019
2019-11-19,Pulau Pinang,54,6,48,2019
2019-11-20,Pulau Pinang,147,55,92,2019
2019-11-21,Pulau Pinang,140,40,100,2019
2019-11-22,Pulau Pinang,64,12,52,2019
2019-11-23,Pulau Pinang,124,40,84,2019
2019-11-24,Pulau Pinang,197,48,149,2019
2019-11-25,Pulau Pinang,53,5,48,2019
2019-11-26,Pulau Pinang,104,12,92,2019
2019-11-27,Pulau Pinang,149,43,106,2019
2019-11-28,Pulau Pinang,227,26,201,2019
2019-11-29,Pulau Pinang,36,3,33,2019
2019-11-30,Pulau Pinang,25,5,20,2019
2019-12-01,Pulau Pinang,262,31,231,2019
2019-12-02,Pulau Pinang,67,18,49,2019
2019-12-03,Pulau Pinang,98,12,86,2019
2019-12-04,Pulau Pinang,218,34,184,2019
2019-12-05,Pulau Pinang,184,47,137,2019
2019-12-06,Pulau Pinang,24,3,21,2019
2019-12-07,Pulau Pinang,127,52,75,2019
2019-12-08,Pulau Pinang,209,56,153,2019
2019-12-09,Pulau Pinang,115,23,92,2019
2019-12-10,Pulau Pinang,197,40,157,2019
2019-12-11,Pulau Pinang,181,59,122,2019
2019-12-12,Pulau Pinang,168,37,131,2019
2019-12-13,Pulau Pinang,49,17,32,2019
2019-12-14,Pulau Pinang,19,4,15,2019
2019-12-15,Pulau Pinang,218,36,182,2019
2019-12-16,Pulau Pinang,28,3,25,2019
2019-12-17,Pulau Pinang,108,28,80,2019
2019-12-18,Pulau Pinang,85,13,72,2019
2019-12-19,Pulau Pinang,87,33,54,2019
2019-12-20,Pulau Pinang,47,8,39,2019
2019-12-21,Pulau Pinang,0,0,0,2019
2019-12-22,Pulau Pinang,129,32,97,2019
2019-12-23,Pulau Pinang,73,12,61,2019
2019-12-24,Pulau Pinang,75,17,58,2019
2019-12-25,Pulau Pinang,124,23,101,2019
2019-12-26,Pulau Pinang,173,25,148,2019
2019-12-27,Pulau Pinang,45,5,40,2019
2019-12-28,Pulau Pinang,58,15,43,2019
2019-12-29,Pulau Pinang,101,21,80,2019
2019-12-30,Pulau Pinang,40,3,37,2019
2019-12-31,Pulau Pinang,88,18,70,2019
2020-01-01,Pulau Pinang,60,9,51,2020
2020-01-02,Pulau Pinang,38,6,32,2020
2020-01-03,Pulau Pinang,45,6,39,2020
2020-01-04,Pulau Pinang,46,8,38,2020
2020-01-05,Pulau Pinang,342,62,280,2020
2020-01-06,Pulau Pinang,27,0,27,2020
2020-01-07,Pulau Pinang,55,4,51,2020
2020-01-08,Pulau Pinang,142,31,111,2020
2020-01-09,Pulau Pinang,116,33,83,2020
2020-01-10,Pulau Pinang,94,48,46,2020
2020-01-11,Pulau Pinang,85,29,56,2020
2020-01-12,Pulau Pinang,271,29,242,2020
2020-01-13,Pulau Pinang,44,6,38,2020
2020-01-14,Pulau Pinang,79,10,69,2020
2020-01-15,Pulau Pinang,79,8,71,2020
2020-01-16,Pulau Pinang,87,16,71,2020
2020-01-17,Pulau Pinang,69,17,52,2020
2020-01-18,Pulau Pinang,85,27,58,2020
2020-01-19,Pulau Pinang,112,31,81,2020
2020-01-20,Pulau Pinang,131,43,88,2020
2020-01-21,Pulau Pinang,183,49,134,2020
2020-01-22,Pulau Pinang,185,43,142,2020
2020-01-23,Pulau Pinang,146,44,102,2020
2020-01-24,Pulau Pinang,56,5,51,2020
2020-01-25,Pulau Pinang,40,11,29,2020
2020-01-26,Pulau Pinang,17,5,12,2020
2020-01-27,Pulau Pinang,64,10,54,2020
2020-01-28,Pulau Pinang,89,14,75,2020
2020-01-29,Pulau Pinang,97,16,81,2020
2020-01-30,Pulau Pinang,74,16,58,2020
2020-01-31,Pulau Pinang,182,73,109,2020
2020-02-01,Pulau Pinang,44,20,24,2020
2020-02-02,Pulau Pinang,76,19,57,2020
2020-02-03,Pulau Pinang,101,26,75,2020
2020-02-04,Pulau Pinang,70,9,61,2020
2020-02-05,Pulau Pinang,260,124,136,2020
2020-02-06,Pulau Pinang,88,26,62,2020
2020-02-07,Pulau Pinang,141,38,103,2020
2020-02-08,Pulau Pinang,461,119,342,2020
2020-02-09,Pulau Pinang,352,31,321,2020
2020-02-10,Pulau Pinang,61,11,50,2020
2020-02-11,Pulau Pinang,99,37,62,2020
2020-02-12,Pulau Pinang,132,52,80,2020
2020-02-13,Pulau Pinang,101,37,64,2020
2020-02-14,Pulau Pinang,118,40,78,2020
2020-02-15,Pulau Pinang,0,0,0,2020
2020-02-16,Pulau Pinang,180,23,157,2020
2020-02-17,Pulau Pinang,121,26,95,2020
2020-02-18,Pulau Pinang,77,19,58,2020
2020-02-19,Pulau Pinang,100,36,64,2020
2020-02-20,Pulau Pinang,70,18,52,2020
2020-02-21,Pulau Pinang,44,5,39,2020
2020-02-22,Pulau Pinang,0,0,0,2020
2020-02-23,Pulau Pinang,126,17,109,2020
2020-02-24,Pulau Pinang,93,39,54,2020
2020-02-25,Pulau Pinang,184,22,162,2020
2020-02-26,Pulau Pinang,243,80,163,2020
2020-02-27,Pulau Pinang,107,33,74,2020
2020-02-28,Pulau Pinang,35,2,33,2020
2020-02-29,Pulau Pinang,78,20,58,2020
2020-03-01,Pulau Pinang,221,15,206,2020
2020-03-02,Pulau Pinang,78,10,68,2020
2020-03-03,Pulau Pinang,36,4,32,2020
2020-03-04,Pulau Pinang,120,57,63,2020
2020-03-05,Pulau Pinang,106,30,76,2020
2020-03-06,Pulau Pinang,35,4,31,2020
2020-03-07,Pulau Pinang,79,16,63,2020
2020-03-08,Pulau Pinang,309,53,256,2020
2020-03-09,Pulau Pinang,56,5,51,2020
2020-03-10,Pulau Pinang,113,34,79,2020
2020-03-11,Pulau Pinang,84,17,67,2020
2020-03-12,Pulau Pinang,70,20,50,2020
2020-03-13,Pulau Pinang,38,8,30,2020
2020-03-14,Pulau Pinang,17,4,13,2020
2020-03-15,Pulau Pinang,106,27,79,2020
2020-03-16,Pulau Pinang,26,5,21,2020
2020-03-17,Pulau Pinang,57,14,43,2020
2020-03-18,Pulau Pinang,26,2,24,2020
2020-03-19,Pulau Pinang,58,8,50,2020
2020-03-20,Pulau Pinang,87,22,65,2020
2020-03-21,Pulau Pinang,73,19,54,2020
2020-03-22,Pulau Pinang,34,4,30,2020
2020-03-23,Pulau Pinang,68,11,57,2020
2020-03-24,Pulau Pinang,133,32,101,2020
2020-03-25,Pulau Pinang,140,37,103,2020
2020-03-26,Pulau Pinang,135,35,100,2020
2020-03-27,Pulau Pinang,99,21,78,2020
2020-03-28,Pulau Pinang,93,22,71,2020
2020-03-29,Pulau Pinang,104,19,85,2020
2020-03-30,Pulau Pinang,72,16,56,2020
2020-03-31,Pulau Pinang,77,12,65,2020
2020-04-01,Pulau Pinang,100,19,81,2020
2020-04-02,Pulau Pinang,60,8,52,2020
2020-04-03,Pulau Pinang,61,9,52,2020
2020-04-04,Pulau Pinang,50,8,42,2020
2020-04-05,Pulau Pinang,110,26,84,2020
2020-04-06,Pulau Pinang,73,11,62,2020
2020-04-07,Pulau Pinang,69,14,55,2020
2020-04-08,Pulau Pinang,54,4,50,2020
2020-04-09,Pulau Pinang,54,6,48,2020
2020-04-10,Pulau Pinang,69,13,56,2020
2020-04-11,Pulau Pinang,132,18,114,2020
2020-04-12,Pulau Pinang,275,32,243,2020
2020-04-13,Pulau Pinang,68,9,59,2020
2020-04-14,Pulau Pinang,66,12,54,2020
2020-04-15,Pulau Pinang,45,7,38,2020
2020-04-16,Pulau Pinang,50,11,39,2020
2020-04-17,Pulau Pinang,60,12,48,2020
2020-04-18,Pulau Pinang,44,12,32,2020
2020-04-19,Pulau Pinang,119,12,107,2020
2020-04-20,Pulau Pinang,76,17,59,2020
2020-04-21,Pulau Pinang,129,29,100,2020
2020-04-22,Pulau Pinang,148,28,120,2020
2020-04-23,Pulau Pinang,64,6,58,2020
2020-04-24,Pulau Pinang,24,7,17,2020
2020-04-25,Pulau Pinang,91,20,71,2020
2020-04-26,Pulau Pinang,170,29,141,2020
2020-04-27,Pulau Pinang,28,1,27,2020
2020-04-28,Pulau Pinang,96,20,76,2020
2020-04-29,Pulau Pinang,58,12,46,2020
2020-04-30,Pulau Pinang,47,2,45,2020
2020-05-01,Pulau Pinang,46,14,32,2020
2020-05-02,Pulau Pinang,40,6,34,2020
2020-05-03,Pulau Pinang,190,38,152,2020
2020-05-04,Pulau Pinang,43,3,40,2020
2020-05-05,Pulau Pinang,60,10,50,2020
2020-05-06,Pulau Pinang,44,10,34,2020
2020-05-07,Pulau Pinang,51,4,47,2020
2020-05-08,Pulau Pinang,42,8,34,2020
2020-05-09,Pulau Pinang,31,3,28,2020
2020-05-10,Pulau Pinang,189,30,159,2020
2020-05-11,Pulau Pinang,62,13,49,2020
2020-05-12,Pulau Pinang,42,5,37,2020
2020-05-13,Pulau Pinang,43,6,37,2020
2020-05-14,Pulau Pinang,79,17,62,2020
2020-05-15,Pulau Pinang,43,6,37,2020
2020-05-16,Pulau Pinang,64,7,57,2020
2020-05-17,Pulau Pinang,289,39,250,2020
2020-05-18,Pulau Pinang,83,11,72,2020
2020-05-19,Pulau Pinang,49,2,47,2020
2020-05-20,Pulau Pinang,42,10,32,2020
2020-05-21,Pulau Pinang,87,10,77,2020
2020-05-22,Pulau Pinang,62,8,54,2020
2020-05-23,Pulau Pinang,213,29,184,2020
2020-05-24,Pulau Pinang,0,0,0,2020
2020-05-25,Pulau Pinang,0,0,0,2020
2020-05-26,Pulau Pinang,74,23,51,2020
2020-05-27,Pulau Pinang,137,27,110,2020
2020-05-28,Pulau Pinang,107,18,89,2020
2020-05-29,Pulau Pinang,126,26,100,2020
2020-05-30,Pulau Pinang,241,66,175,2020
2020-05-31,Pulau Pinang,377,66,311,2020
2020-06-01,Pulau Pinang,77,8,69,2020
2020-06-02,Pulau Pinang,57,9,48,2020
2020-06-03,Pulau Pinang,159,69,90,2020
2020-06-04,Pulau Pinang,105,23,82,2020
2020-06-05,Pulau Pinang,53,7,46,2020
2020-06-06,Pulau Pinang,135,31,104,2020
2020-06-07,Pulau Pinang,205,39,166,2020
2020-06-08,Pulau Pinang,138,31,107,2020
2020-06-09,Pulau Pinang,147,27,120,2020
2020-06-10,Pulau Pinang,57,7,50,2020
2020-06-11,Pulau Pinang,103,27,76,2020
2020-06-12,Pulau Pinang,35,4,31,2020
2020-06-13,Pulau Pinang,137,44,93,2020
2020-06-14,Pulau Pinang,316,63,253,2020
2020-06-15,Pulau Pinang,128,22,106,2020
2020-06-16,Pulau Pinang,67,14,53,2020
2020-06-17,Pulau Pinang,139,32,107,2020
2020-06-18,Pulau Pinang,71,13,58,2020
2020-06-19,Pulau Pinang,53,4,49,2020
2020-06-20,Pulau Pinang,182,65,117,2020
2020-06-21,Pulau Pinang,339,73,266,2020
2020-06-22,Pulau Pinang,73,10,63,2020
2020-06-23,Pulau Pinang,147,31,116,2020
2020-06-24,Pulau Pinang,110,13,97,2020
2020-06-25,Pulau Pinang,52,18,34,2020
2020-06-26,Pulau Pinang,51,5,46,2020
2020-06-27,Pulau Pinang,48,11,37,2020
2020-06-28,Pulau Pinang,295,67,228,2020
2020-06-29,Pulau Pinang,80,8,72,2020
2020-06-30,Pulau Pinang,56,8,48,2020
2020-07-01,Pulau Pinang,168,81,87,2020
2020-07-02,Pulau Pinang,154,14,140,2020
2020-07-03,Pulau Pinang,41,3,38,2020
2020-07-04,Pulau Pinang,32,5,27,2020
2020-07-05,Pulau Pinang,194,20,174,2020
2020-07-06,Pulau Pinang,46,6,40,2020
2020-07-07,Pulau Pinang,88,21,67,2020
2020-07-08,Pulau Pinang,81,21,60,2020
2020-07-09,Pulau Pinang,134,41,93,2020
2020-07-10,Pulau Pinang,40,4,36,2020
2020-07-11,Pulau Pinang,91,16,75,2020
2020-07-12,Pulau Pinang,152,17,135,2020
2020-07-13,Pulau Pinang,70,7,63,2020
2020-07-14,Pulau Pinang,70,20,50,2020
2020-07-15,Pulau Pinang,77,25,52,2020
2020-07-16,Pulau Pinang,35,6,29,2020
2020-07-17,Pulau Pinang,62,14,48,2020
2020-07-18,Pulau Pinang,78,11,67,2020
2020-07-19,Pulau Pinang,185,29,156,2020
2020-07-20,Pulau Pinang,108,24,84,2020
2020-07-21,Pulau Pinang,81,27,54,2020
2020-07-22,Pulau Pinang,173,35,138,2020
2020-07-23,Pulau Pinang,78,15,63,2020
2020-07-24,Pulau Pinang,55,8,47,2020
2020-07-25,Pulau Pinang,113,27,86,2020
2020-07-26,Pulau Pinang,198,26,172,2020
2020-07-27,Pulau Pinang,64,17,47,2020
2020-07-28,Pulau Pinang,125,44,81,2020
2020-07-29,Pulau Pinang,66,12,54,2020
2020-07-30,Pulau Pinang,49,7,42,2020
2020-07-31,Pulau Pinang,0,0,0,2020
2020-08-01,Pulau Pinang,0,0,0,2020
2020-08-02,Pulau Pinang,119,15,104,2020
2020-08-03,Pulau Pinang,51,5,46,2020
2020-08-04,Pulau Pinang,88,35,53,2020
2020-08-05,Pulau Pinang,91,26,65,2020
2020-08-06,Pulau Pinang,96,30,66,2020
2020-08-07,Pulau Pinang,38,5,33,2020
2020-08-08,Pulau Pinang,59,14,45,2020
2020-08-09,Pulau Pinang,197,25,172,2020
2020-08-10,Pulau Pinang,52,10,42,2020
2020-08-11,Pulau Pinang,103,24,79,2020
2020-08-12,Pulau Pinang,41,5,36,2020
2020-08-13,Pulau Pinang,73,14,59,2020
2020-08-14,Pulau Pinang,35,6,29,2020
2020-08-15,Pulau Pinang,83,17,66,2020
2020-08-16,Pulau Pinang,263,40,223,2020
2020-08-17,Pulau Pinang,145,52,93,2020
2020-08-18,Pulau Pinang,54,14,40,2020
2020-08-19,Pulau Pinang,139,43,96,2020
2020-08-20,Pulau Pinang,107,28,79,2020
2020-08-21,Pulau Pinang,38,3,35,2020
2020-08-22,Pulau Pinang,21,3,18,2020
2020-08-23,Pulau Pinang,186,28,158,2020
2020-08-24,Pulau Pinang,47,9,38,2020
2020-08-25,Pulau Pinang,105,40,65,2020
2020-08-26,Pulau Pinang,71,8,63,2020
2020-08-27,Pulau Pinang,76,18,58,2020
2020-08-28,Pulau Pinang,51,4,47,2020
2020-08-29,Pulau Pinang,74,15,59,2020
2020-08-30,Pulau Pinang,232,42,190,2020
2020-08-31,Pulau Pinang,193,46,147,2020
2020-09-01,Pulau Pinang,168,36,132,2020
2020-09-02,Pulau Pinang,190,45,145,2020
2020-09-03,Pulau Pinang,81,11,70,2020
2020-09-04,Pulau Pinang,29,3,26,2020
2020-09-05,Pulau Pinang,103,16,87,2020
2020-09-06,Pulau Pinang,147,36,111,2020
2020-09-07,Pulau Pinang,79,18,61,2020
2020-09-08,Pulau Pinang,69,22,47,2020
2020-09-09,Pulau Pinang,90,14,76,2020
2020-09-10,Pulau Pinang,61,6,55,2020
2020-09-11,Pulau Pinang,49,3,46,2020
2020-09-12,Pulau Pinang,72,14,58,2020
2020-09-13,Pulau Pinang,341,67,274,2020
2020-09-14,Pulau Pinang,49,6,43,2020
2020-09-15,Pulau Pinang,113,18,95,2020
2020-09-16,Pulau Pinang,189,43,146,2020
2020-09-17,Pulau Pinang,61,6,55,2020
2020-09-18,Pulau Pinang,43,5,38,2020
2020-09-19,Pulau Pinang,152,38,114,2020
2020-09-20,Pulau Pinang,184,44,140,2020
2020-09-21,Pulau Pinang,53,1,52,2020
2020-09-22,Pulau Pinang,96,9,87,2020
2020-09-23,Pulau Pinang,117,49,68,2020
2020-09-24,Pulau Pinang,214,48,166,2020
2020-09-25,Pulau Pinang,41,2,39,2020
2020-09-26,Pulau Pinang,62,21,41,2020
2020-09-27,Pulau Pinang,388,37,351,2020
2020-09-28,Pulau Pinang,36,2,34,2020
2020-09-29,Pulau Pinang,125,27,98,2020
2020-09-30,Pulau Pinang,91,16,75,2020
2020-10-01,Pulau Pinang,65,5,60,2020
2020-10-02,Pulau Pinang,30,4,26,2020
2020-10-03,Pulau Pinang,54,8,46,2020
2020-10-04,Pulau Pinang,173,26,147,2020
2020-10-05,Pulau Pinang,39,1,38,2020
2020-10-06,Pulau Pinang,45,3,42,2020
2020-10-07,Pulau Pinang,85,26,59,2020
2020-10-08,Pulau Pinang,98,12,86,2020
2020-10-09,Pulau Pinang,42,5,37,2020
2020-10-10,Pulau Pinang,78,21,57,2020
2020-10-11,Pulau Pinang,303,26,277,2020
2020-10-12,Pulau Pinang,45,1,44,2020
2020-10-13,Pulau Pinang,45,6,39,2020
2020-10-14,Pulau Pinang,118,37,81,2020
2020-10-15,Pulau Pinang,65,16,49,2020
2020-10-16,Pulau Pinang,34,5,29,2020
2020-10-17,Pulau Pinang,50,8,42,2020
2020-10-18,Pulau Pinang,264,65,199,2020
2020-10-19,Pulau Pinang,68,14,54,2020
2020-10-20,Pulau Pinang,35,4,31,2020
2020-10-21,Pulau Pinang,111,24,87,2020
2020-10-22,Pulau Pinang,171,70,101,2020
2020-10-23,Pulau Pinang,32,1,31,2020
2020-10-24,Pulau Pinang,27,6,21,2020
2020-10-25,Pulau Pinang,161,19,142,2020
2020-10-26,Pulau Pinang,34,2,32,2020
2020-10-27,Pulau Pinang,40,4,36,2020
2020-10-28,Pulau Pinang,120,13,107,2020
2020-10-29,Pulau Pinang,73,14,59,2020
2020-10-30,Pulau Pinang,39,4,35,2020
2020-10-31,Pulau Pinang,62,19,43,2020
2020-11-01,Pulau Pinang,115,21,94,2020
2020-11-02,Pulau Pinang,33,4,29,2020
2020-11-03,Pulau Pinang,44,9,35,2020
2020-11-04,Pulau Pinang,172,48,124,2020
2020-11-05,Pulau Pinang,55,3,52,2020
2020-11-06,Pulau Pinang,26,2,24,2020
2020-11-07,Pulau Pinang,56,11,45,2020
2020-11-08,Pulau Pinang,132,13,119,2020
2020-11-09,Pulau Pinang,73,6,67,2020
2020-11-10,Pulau Pinang,86,15,71,2020
2020-11-11,Pulau Pinang,124,33,91,2020
2020-11-12,Pulau Pinang,92,24,68,2020
2020-11-13,Pulau Pinang,69,9,60,2020
2020-11-14,Pulau Pinang,124,47,77,2020
2020-11-15,Pulau Pinang,176,32,144,2020
2020-11-16,Pulau Pinang,49,5,44,2020
2020-11-17,Pulau Pinang,42,9,33,2020
2020-11-18,Pulau Pinang,34,15,19,2020
2020-11-19,Pulau Pinang,91,31,60,2020
2020-11-20,Pulau Pinang,60,4,56,2020
2020-11-21,Pulau Pinang,148,28,120,2020
2020-11-22,Pulau Pinang,242,33,209,2020
2020-11-23,Pulau Pinang,181,49,132,2020
2020-11-24,Pulau Pinang,70,12,58,2020
2020-11-25,Pulau Pinang,193,79,114,2020
2020-11-26,Pulau Pinang,61,6,55,2020
2020-11-27,Pulau Pinang,63,8,55,2020
2020-11-28,Pulau Pinang,42,8,34,2020
2020-11-29,Pulau Pinang,123,31,92,2020
2020-11-30,Pulau Pinang,112,32,80,2020
2020-12-01,Pulau Pinang,63,20,43,2020
2020-12-02,Pulau Pinang,96,20,76,2020
2020-12-03,Pulau Pinang,110,18,92,2020
2020-12-04,Pulau Pinang,47,3,44,2020
2020-12-05,Pulau Pinang,159,28,131,2020
2020-12-06,Pulau Pinang,237,31,206,2020
2020-12-07,Pulau Pinang,35,2,33,2020
2020-12-08,Pulau Pinang,94,5,89,2020
2020-12-09,Pulau Pinang,116,13,103,2020
2020-12-10,Pulau Pinang,85,18,67,2020
2020-12-11,Pulau Pinang,43,3,40,2020
2020-12-12,Pulau Pinang,115,24,91,2020
2020-12-13,Pulau Pinang,394,77,317,2020
2020-12-14,Pulau Pinang,62,8,54,2020
2020-12-15,Pulau Pinang,89,17,72,2020
2020-12-16,Pulau Pinang,92,16,76,2020
2020-12-17,Pulau Pinang,76,19,57,2020
2020-12-18,Pulau Pinang,35,0,35,2020
2020-12-19,Pulau Pinang,53,10,43,2020
2020-12-20,Pulau Pinang,193,19,174,2020
2020-12-21,Pulau Pinang,63,9,54,2020
2020-12-22,Pulau Pinang,94,26,68,2020
2020-12-23,Pulau Pinang,78,10,68,2020
2020-12-24,Pulau Pinang,99,11,88,2020
2020-12-25,Pulau Pinang,22,3,19,2020
2020-12-26,Pulau Pinang,62,5,57,2020
2020-12-27,Pulau Pinang,230,39,191,2020
2020-12-28,Pulau Pinang,55,7,48,2020
2020-12-29,Pulau Pinang,48,4,44,2020
2020-12-30,Pulau Pinang,99,9,90,2020
2020-12-31,Pulau Pinang,132,21,111,2020
2021-01-01,Pulau Pinang,51,9,42,2021
2021-01-02,Pulau Pinang,53,8,45,2021
2021-01-03,Pulau Pinang,181,18,163,2021
2021-01-04,Pulau Pinang,31,3,28,2021
2021-01-05,Pulau Pinang,50,6,44,2021
2021-01-06,Pulau Pinang,142,30,112,2021
2021-01-07,Pulau Pinang,112,25,87,2021
2021-01-08,Pulau Pinang,38,3,35,2021
2021-01-09,Pulau Pinang,156,61,95,2021
2021-01-10,Pulau Pinang,133,31,102,2021
2021-01-11,Pulau Pinang,37,2,35,2021
2021-01-12,Pulau Pinang,39,2,37,2021
2021-01-13,Pulau Pinang,119,26,93,2021
2021-01-14,Pulau Pinang,53,6,47,2021
2021-01-15,Pulau Pinang,54,3,51,2021
2021-01-16,Pulau Pinang,93,27,66,2021
2021-01-17,Pulau Pinang,113,22,91,2021
2021-01-18,Pulau Pinang,32,3,29,2021
2021-01-19,Pulau Pinang,44,2,42,2021
2021-01-20,Pulau Pinang,77,9,68,2021
2021-01-21,Pulau Pinang,78,15,63,2021
2021-01-22,Pulau Pinang,66,6,60,2021
2021-01-23,Pulau Pinang,184,51,133,2021
2021-01-24,Pulau Pinang,192,48,144,2021
2021-01-25,Pulau Pinang,87,22,65,2021
2021-01-26,Pulau Pinang,81,12,69,2021
2021-01-27,Pulau Pinang,54,11,43,2021
2021-01-28,Pulau Pinang,165,36,129,2021
2021-01-29,Pulau Pinang,46,5,41,2021
2021-01-30,Pulau Pinang,250,63,187,2021
2021-01-31,Pulau Pinang,323,55,268,2021
2021-02-01,Pulau Pinang,60,11,49,2021
2021-02-02,Pulau Pinang,40,5,35,2021
2021-02-03,Pulau Pinang,77,14,63,2021
2021-02-04,Pulau Pinang,70,10,60,2021
2021-02-05,Pulau Pinang,28,0,28,2021
2021-02-06,Pulau Pinang,66,13,53,2021
2021-02-07,Pulau Pinang,100,28,72,2021
2021-02-08,Pulau Pinang,59,8,51,2021
2021-02-09,Pulau Pinang,53,4,49,2021
2021-02-10,Pulau Pinang,56,4,52,2021
2021-02-11,Pulau Pinang,134,19,115,2021
2021-02-12,Pulau Pinang,62,17,45,2021
2021-02-13,Pulau Pinang,76,12,64,2021
2021-02-14,Pulau Pinang,129,27,102,2021
2021-02-15,Pulau Pinang,86,7,79,2021
2021-02-16,Pulau Pinang,60,10,50,2021
2021-02-17,Pulau Pinang,88,9,79,2021
2021-02-18,Pulau Pinang,93,14,79,2021
2021-02-19,Pulau Pinang,45,3,42,2021
2021-02-20,Pulau Pinang,107,31,76,2021
2021-02-21,Pulau Pinang,194,61,133,2021
2021-02-22,Pulau Pinang,57,6,51,2021
2021-02-23,Pulau Pinang,44,3,41,2021
2021-02-24,Pulau Pinang,84,11,73,2021
2021-02-25,Pulau Pinang,163,20,143,2021
2021-02-26,Pulau Pinang,53,6,47,2021
2021-02-27,Pulau Pinang,145,32,113,2021
2021-02-28,Pulau Pinang,395,49,346,2021
2021-03-01,Pulau Pinang,59,7,52,2021
2021-03-02,Pulau Pinang,58,7,51,2021
2021-03-03,Pulau Pinang,95,14,81,2021
2021-03-04,Pulau Pinang,287,145,142,2021
2021-03-05,Pulau Pinang,48,1,47,2021
2021-03-06,Pulau Pinang,120,26,94,2021
2021-03-07,Pulau Pinang,238,34,204,2021
2021-03-08,Pulau Pinang,37,4,33,2021
2021-03-09,Pulau Pinang,53,4,49,2021
2021-03-10,Pulau Pinang,89,18,71,2021
2021-03-11,Pulau Pinang,68,14,54,2021
2021-03-12,Pulau Pinang,35,1,34,2021
2021-03-13,Pulau Pinang,171,42,129,2021
2021-03-14,Pulau Pinang,206,31,175,2021
2021-03-15,Pulau Pinang,43,1,42,2021
2021-03-16,Pulau Pinang,65,11,54,2021
2021-03-17,Pulau Pinang,140,25,115,2021
2021-03-18,Pulau Pinang,194,77,117,2021
2021-03-19,Pulau Pinang,45,2,43,2021
2021-03-20,Pulau Pinang,117,21,96,2021
2021-03-21,Pulau Pinang,185,33,152,2021
2021-03-22,Pulau Pinang,66,13,53,2021
2021-03-23,Pulau Pinang,41,1,40,2021
2021-03-24,Pulau Pinang,87,17,70,2021
2021-03-25,Pulau Pinang,97,12,85,2021
2021-03-26,Pulau Pinang,54,2,52,2021
2021-03-27,Pulau Pinang,99,20,79,2021
2021-03-28,Pulau Pinang,198,20,178,2021
2021-03-29,Pulau Pinang,53,7,46,2021
2021-03-30,Pulau Pinang,52,5,47,2021
2021-03-31,Pulau Pinang,95,10,85,2021
2021-04-01,Pulau Pinang,224,61,163,2021
2021-04-02,Pulau Pinang,41,3,38,2021
2021-04-03,Pulau Pinang,83,8,75,2021
2021-04-04,Pulau Pinang,129,38,91,2021
2021-04-05,Pulau Pinang,55,4,51,2021
2021-04-06,Pulau Pinang,50,2,48,2021
2021-04-07,Pulau Pinang,105,24,81,2021
2021-04-08,Pulau Pinang,126,20,106,2021
2021-04-09,Pulau Pinang,51,7,44,2021
2021-04-10,Pulau Pinang,130,21,109,2021
2021-04-11,Pulau Pinang,234,35,199,2021
2021-04-12,Pulau Pinang,203,95,108,2021
2021-04-13,Pulau Pinang,29,3,26,2021
2021-04-14,Pulau Pinang,48,8,40,2021
2021-04-15,Pulau Pinang,54,7,47,2021
2021-04-16,Pulau Pinang,29,1,28,2021
2021-04-17,Pulau Pinang,98,30,68,2021
2021-04-18,Pulau Pinang,263,29,234,2021
2021-04-19,Pulau Pinang,24,2,22,2021
2021-04-20,Pulau Pinang,39,5,34,2021
2021-04-21,Pulau Pinang,41,8,33,2021
2021-04-22,Pulau Pinang,83,16,67,2021
2021-04-23,Pulau Pinang,45,9,36,2021
2021-04-24,Pulau Pinang,51,10,41,2021
2021-04-25,Pulau Pinang,200,19,181,2021
2021-04-26,Pulau Pinang,47,6,41,2021
2021-04-27,Pulau Pinang,41,8,33,2021
2021-04-28,Pulau Pinang,44,11,33,2021
2021-04-29,Pulau Pinang,72,20,52,2021
2021-04-30,Pulau Pinang,42,1,41,2021
2021-05-01,Pulau Pinang,297,78,219,2021
2021-05-02,Pulau Pinang,195,24,171,2021
2021-05-03,Pulau Pinang,107,25,82,2021
2021-05-04,Pulau Pinang,35,1,34,2021
2021-05-05,Pulau Pinang,57,10,47,2021
2021-05-06,Pulau Pinang,84,16,68,2021
2021-05-07,Pulau Pinang,32,0,32,2021
2021-05-08,Pulau Pinang,94,25,69,2021
2021-05-09,Pulau Pinang,114,22,92,2021
2021-05-10,Pulau Pinang,45,1,44,2021
2021-05-11,Pulau Pinang,52,5,47,2021
2021-05-12,Pulau Pinang,59,7,52,2021
2021-05-13,Pulau Pinang,0,0,0,2021
2021-05-14,Pulau Pinang,0,0,0,2021
2021-05-15,Pulau Pinang,60,5,55,2021
2021-05-16,Pulau Pinang,237,32,205,2021
2021-05-17,Pulau Pinang,83,7,76,2021
2021-05-18,Pulau Pinang,68,10,58,2021
2021-05-19,Pulau Pinang,136,27,109,2021
2021-05-20,Pulau Pinang,101,22,79,2021
2021-05-21,Pulau Pinang,53,7,46,2021
2021-05-22,Pulau Pinang,163,24,139,2021
2021-05-23,Pulau Pinang,175,27,148,2021
2021-05-24,Pulau Pinang,83,10,73,2021
2021-05-25,Pulau Pinang,134,35,99,2021
2021-05-26,Pulau Pinang,137,29,108,2021
2021-05-27,Pulau Pinang,183,29,154,2021
2021-05-28,Pulau Pinang,61,5,56,2021
2021-05-29,Pulau Pinang,48,11,37,2021
2021-05-30,Pulau Pinang,185,31,154,2021
2021-05-31,Pulau Pinang,90,13,77,2021
2021-06-01,Pulau Pinang,55,12,43,2021
2021-06-02,Pulau Pinang,58,4,54,2021
2021-06-03,Pulau Pinang,132,15,117,2021
2021-06-04,Pulau Pinang,69,7,62,2021
2021-06-05,Pulau Pinang,114,22,92,2021
2021-06-06,Pulau Pinang,107,19,88,2021
2021-06-07,Pulau Pinang,124,28,96,2021
2021-06-08,Pulau Pinang,106,27,79,2021
2021-06-09,Pulau Pinang,117,16,101,2021
2021-06-10,Pulau Pinang,90,10,80,2021
2021-06-11,Pulau Pinang,74,17,57,2021
2021-06-12,Pulau Pinang,127,33,94,2021
2021-06-13,Pulau Pinang,339,42,297,2021
2021-06-14,Pulau Pinang,110,11,99,2021
2021-06-15,Pulau Pinang,79,14,65,2021
2021-06-16,Pulau Pinang,118,28,90,2021
2021-06-17,Pulau Pinang,81,11,70,2021
2021-06-18,Pulau Pinang,64,8,56,2021
2021-06-19,Pulau Pinang,127,28,99,2021
2021-06-20,Pulau Pinang,226,46,180,2021
2021-06-21,Pulau Pinang,111,28,83,2021
2021-06-22,Pulau Pinang,99,22,77,2021
2021-06-23,Pulau Pinang,117,18,99,2021
2021-06-24,Pulau Pinang,128,15,113,2021
2021-06-25,Pulau Pinang,54,11,43,2021
2021-06-26,Pulau Pinang,131,16,115,2021
2021-06-27,Pulau Pinang,123,14,109,2021
2021-06-28,Pulau Pinang,61,7,54,2021
2021-06-29,Pulau Pinang,51,8,43,2021
2021-06-30,Pulau Pinang,119,20,99,2021
2021-07-01,Pulau Pinang,118,24,94,2021
2021-07-02,Pulau Pinang,49,5,44,2021
2021-07-03,Pulau Pinang,81,9,72,2021
2021-07-04,Pulau Pinang,156,26,130,2021
2021-07-05,Pulau Pinang,56,2,54,2021
2021-07-06,Pulau Pinang,74,7,67,2021
2021-07-07,Pulau Pinang,60,11,49,2021
2021-07-08,Pulau Pinang,85,9,76,2021
2021-07-09,Pulau Pinang,35,3,32,2021
2021-07-10,Pulau Pinang,135,37,98,2021
2021-07-11,Pulau Pinang,124,18,106,2021
2021-07-12,Pulau Pinang,55,6,49,2021
2021-07-13,Pulau Pinang,42,3,39,2021
2021-07-14,Pulau Pinang,58,8,50,2021
2021-07-15,Pulau Pinang,84,14,70,2021
2021-07-16,Pulau Pinang,45,3,42,2021
2021-07-17,Pulau Pinang,120,27,93,2021
2021-07-18,Pulau Pinang,161,35,126,2021
2021-07-19,Pulau Pinang,66,6,60,2021
2021-07-20,Pulau Pinang,0,0,0,2021
2021-07-21,Pulau Pinang,50,5,45,2021
2021-07-22,Pulau Pinang,60,16,44,2021
2021-07-23,Pulau Pinang,52,5,47,2021
2021-07-24,Pulau Pinang,134,29,105,2021
2021-07-25,Pulau Pinang,220,25,195,2021
2021-07-26,Pulau Pinang,45,6,39,2021
2021-07-27,Pulau Pinang,40,7,33,2021
2021-07-28,Pulau Pinang,64,11,53,2021
2021-07-29,Pulau Pinang,58,10,48,2021
2021-07-30,Pulau Pinang,26,2,24,2021
2021-07-31,Pulau Pinang,98,18,80,2021
2021-08-01,Pulau Pinang,113,32,81,2021
2021-08-02,Pulau Pinang,52,6,46,2021
2021-08-03,Pulau Pinang,49,8,41,2021
2021-08-04,Pulau Pinang,61,5,56,2021
2021-08-05,Pulau Pinang,47,6,41,2021
2021-08-06,Pulau Pinang,32,5,27,2021
2021-08-07,Pulau Pinang,86,13,73,2021
2021-08-08,Pulau Pinang,134,38,96,2021
2021-08-09,Pulau Pinang,51,6,45,2021
2021-08-10,Pulau Pinang,78,12,66,2021
2021-08-11,Pulau Pinang,41,3,38,2021
2021-08-12,Pulau Pinang,65,10,55,2021
2021-08-13,Pulau Pinang,29,3,26,2021
2021-08-14,Pulau Pinang,105,28,77,2021
2021-08-15,Pulau Pinang,144,23,121,2021
2021-08-16,Pulau Pinang,36,7,29,2021
2021-08-17,Pulau Pinang,35,4,31,2021
2021-08-18,Pulau Pinang,53,9,44,2021
2021-08-19,Pulau Pinang,199,58,141,2021
2021-08-20,Pulau Pinang,39,2,37,2021
2021-08-21,Pulau Pinang,125,27,98,2021
2021-08-22,Pulau Pinang,145,19,126,2021
2021-08-23,Pulau Pinang,43,7,36,2021
2021-08-24,Pulau Pinang,145,22,123,2021
2021-08-25,Pulau Pinang,138,23,115,2021
2021-08-26,Pulau Pinang,195,46,149,2021
2021-08-27,Pulau Pinang,56,15,41,2021
2021-08-28,Pulau Pinang,149,29,120,2021
2021-08-29,Pulau Pinang,270,39,231,2021
2021-08-30,Pulau Pinang,44,7,37,2021
2021-08-31,Pulau Pinang,210,31,179,2021
2021-09-01,Pulau Pinang,111,27,84,2021
2021-09-02,Pulau Pinang,81,25,56,2021
2021-09-03,Pulau Pinang,35,2,33,2021
2021-09-04,Pulau Pinang,117,22,95,2021
2021-09-05,Pulau Pinang,142,27,115,2021
2021-09-06,Pulau Pinang,40,5,35,2021
2021-09-07,Pulau Pinang,42,0,42,2021
2021-09-08,Pulau Pinang,46,8,38,2021
2021-09-09,Pulau Pinang,68,6,62,2021
2021-09-10,Pulau Pinang,39,6,33,2021
2021-09-11,Pulau Pinang,121,28,93,2021
2021-09-12,Pulau Pinang,289,28,261,2021
2021-09-13,Pulau Pinang,67,13,54,2021
2021-09-14,Pulau Pinang,53,6,47,2021
2021-09-15,Pulau Pinang,42,2,40,2021
2021-09-16,Pulau Pinang,277,84,193,2021
2021-09-17,Pulau Pinang,37,1,36,2021
2021-09-18,Pulau Pinang,118,36,82,2021
2021-09-19,Pulau Pinang,78,14,64,2021
2021-09-20,Pulau Pinang,53,9,44,2021
2021-09-21,Pulau Pinang,62,11,51,2021
2021-09-22,Pulau Pinang,90,14,76,2021
2021-09-23,Pulau Pinang,77,14,63,2021
2021-09-24,Pulau Pinang,31,4,27,2021
2021-09-25,Pulau Pinang,112,23,89,2021
2021-09-26,Pulau Pinang,287,30,257,2021
2021-09-27,Pulau Pinang,52,10,42,2021
2021-09-28,Pulau Pinang,71,15,56,2021
2021-09-29,Pulau Pinang,99,9,90,2021
2021-09-30,Pulau Pinang,145,29,116,2021
2021-10-01,Pulau Pinang,36,3,33,2021
2021-10-02,Pulau Pinang,83,5,78,2021
2021-10-03,Pulau Pinang,110,58,52,2021
2021-10-04,Pulau Pinang,59,4,55,2021
2021-10-05,Pulau Pinang,54,6,48,2021
2021-10-06,Pulau Pinang,47,3,44,2021
2021-10-07,Pulau Pinang,76,9,67,2021
2021-10-08,Pulau Pinang,45,1,44,2021
2021-10-09,Pulau Pinang,29,9,20,2021
2021-10-10,Pulau Pinang,186,23,163,2021
2021-10-11,Pulau Pinang,59,8,51,2021
2021-10-12,Pulau Pinang,109,25,84,2021
2021-10-13,Pulau Pinang,103,12,91,2021
2021-10-14,Pulau Pinang,113,20,93,2021
2021-10-15,Pulau Pinang,70,14,56,2021
2021-10-16,Pulau Pinang,50,4,46,2021
2021-10-17,Pulau Pinang,291,45,246,2021
2021-10-18,Pulau Pinang,73,13,60,2021
2021-10-19,Pulau Pinang,107,25,82,2021
2021-10-20,Pulau Pinang,73,10,63,2021
2021-10-21,Pulau Pinang,81,10,71,2021
2021-10-22,Pulau Pinang,48,4,44,2021
2021-10-23,Pulau Pinang,75,12,63,2021
2021-10-24,Pulau Pinang,275,49,226,2021
2021-10-25,Pulau Pinang,61,6,55,2021
2021-10-26,Pulau Pinang,49,4,45,2021
2021-10-27,Pulau Pinang,74,8,66,2021
2021-10-28,Pulau Pinang,129,19,110,2021
2021-10-29,Pulau Pinang,41,2,39,2021
2021-10-30,Pulau Pinang,68,12,56,2021
2021-10-31,Pulau Pinang,129,31,98,2021
2021-11-01,Pulau Pinang,170,38,132,2021
2021-11-02,Pulau Pinang,86,19,67,2021
2021-11-03,Pulau Pinang,58,8,50,2021
2021-11-04,Pulau Pinang,133,21,112,2021
2021-11-05,Pulau Pinang,44,6,38,2021
2021-11-06,Pulau Pinang,84,20,64,2021
2021-11-07,Pulau Pinang,185,37,148,2021
2021-11-08,Pulau Pinang,48,8,40,2021
2021-11-09,Pulau Pinang,109,17,92,2021
2021-11-10,Pulau Pinang,52,10,42,2021
2021-11-11,Pulau Pinang,112,24,88,2021
2021-11-12,Pulau Pinang,26,3,23,2021
2021-11-13,Pulau Pinang,138,45,93,2021
2021-11-14,Pulau Pinang,296,36,260,2021
2021-11-15,Pulau Pinang,46,9,37,2021
2021-11-16,Pulau Pinang,118,23,95,2021
2021-11-17,Pulau Pinang,152,31,121,2021
2021-11-18,Pulau Pinang,174,34,140,2021
2021-11-19,Pulau Pinang,28,0,28,2021
2021-11-20,Pulau Pinang,57,10,47,2021
2021-11-21,Pulau Pinang,188,52,136,2021
2021-11-22,Pulau Pinang,149,32,117,2021
2021-11-23,Pulau Pinang,63,9,54,2021
2021-11-24,Pulau Pinang,66,11,55,2021
2021-11-25,Pulau Pinang,123,29,94,2021
2021-11-26,Pulau Pinang,27,1,26,2021
2021-11-27,Pulau Pinang,47,11,36,2021
2021-11-28,Pulau Pinang,173,19,154,2021
2021-11-29,Pulau Pinang,65,8,57,2021
2021-11-30,Pulau Pinang,116,46,70,2021
2021-12-01,Pulau Pinang,49,4,45,2021
2021-12-02,Pulau Pinang,183,63,120,2021
2021-12-03,Pulau Pinang,30,2,28,2021
2021-12-04,Pulau Pinang,114,19,95,2021
2021-12-05,Pulau Pinang,178,28,150,2021
2021-12-06,Pulau Pinang,77,16,61,2021
2021-12-07,Pulau Pinang,83,12,71,2021
2021-12-08,Pulau Pinang,58,11,47,2021
2021-12-09,Pulau Pinang,104,17,87,2021
2021-12-10,Pulau Pinang,57,4,53,2021
2021-12-11,Pulau Pinang,60,10,50,2021
2021-12-12,Pulau Pinang,241,35,206,2021
2021-12-13,Pulau Pinang,54,6,48,2021
2021-12-14,Pulau Pinang,118,23,95,2021
2021-12-15,Pulau Pinang,104,24,80,2021
2021-12-16,Pulau Pinang,82,14,68,2021
2021-12-17,Pulau Pinang,37,6,31,2021
2021-12-18,Pulau Pinang,26,10,16,2021
2021-12-19,Pulau Pinang,167,16,151,2021
2021-12-20,Pulau Pinang,63,3,60,2021
2021-12-21,Pulau Pinang,65,7,58,2021
2021-12-22,Pulau Pinang,70,13,57,2021
2021-12-23,Pulau Pinang,106,28,78,2021
2021-12-24,Pulau Pinang,50,5,45,2021
2021-12-25,Pulau Pinang,76,15,61,2021
2021-12-26,Pulau Pinang,150,21,129,2021
2021-12-27,Pulau Pinang,70,3,67,2021
2021-12-28,Pulau Pinang,66,5,61,2021
2021-12-29,Pulau Pinang,109,16,93,2021
2021-12-30,Pulau Pinang,154,20,134,2021
2021-12-31,Pulau Pinang,59,5,54,2021
2022-01-01,Pulau Pinang,179,25,154,2022
2022-01-02,Pulau Pinang,151,21,130,2022
2022-01-03,Pulau Pinang,64,6,58,2022
2022-01-04,Pulau Pinang,56,5,51,2022
2022-01-05,Pulau Pinang,95,23,72,2022
2022-01-06,Pulau Pinang,125,50,75,2022
2022-01-07,Pulau Pinang,30,3,27,2022
2022-01-08,Pulau Pinang,30,6,24,2022
2022-01-09,Pulau Pinang,270,45,225,2022
2022-01-10,Pulau Pinang,59,5,54,2022
2022-01-11,Pulau Pinang,58,5,53,2022
2022-01-12,Pulau Pinang,65,7,58,2022
2022-01-13,Pulau Pinang,115,33,82,2022
2022-01-14,Pulau Pinang,44,0,44,2022
2022-01-15,Pulau Pinang,48,15,33,2022
2022-01-16,Pulau Pinang,126,34,92,2022
2022-01-17,Pulau Pinang,91,26,65,2022
2022-01-18,Pulau Pinang,65,18,47,2022
2022-01-19,Pulau Pinang,56,7,49,2022
2022-01-20,Pulau Pinang,74,16,58,2022
2022-01-21,Pulau Pinang,44,4,40,2022
2022-01-22,Pulau Pinang,130,79,51,2022
2022-01-23,Pulau Pinang,187,53,134,2022
2022-01-24,Pulau Pinang,107,13,94,2022
2022-01-25,Pulau Pinang,97,13,84,2022
2022-01-26,Pulau Pinang,36,3,33,2022
2022-01-27,Pulau Pinang,117,16,101,2022
2022-01-28,Pulau Pinang,36,3,33,2022
2022-01-29,Pulau Pinang,36,8,28,2022
2022-01-30,Pulau Pinang,112,18,94,2022
2022-01-31,Pulau Pinang,78,5,73,2022
2022-02-01,Pulau Pinang,68,16,52,2022
2022-02-02,Pulau Pinang,84,26,58,2022
2022-02-03,Pulau Pinang,105,46,59,2022
2022-02-04,Pulau Pinang,53,5,48,2022
2022-02-05,Pulau Pinang,77,9,68,2022
2022-02-06,Pulau Pinang,151,40,111,2022
2022-02-07,Pulau Pinang,49,5,44,2022
2022-02-08,Pulau Pinang,64,10,54,2022
2022-02-09,Pulau Pinang,215,74,141,2022
2022-02-10,Pulau Pinang,92,16,76,2022
2022-02-11,Pulau Pinang,30,1,29,2022
2022-02-12,Pulau Pinang,107,13,94,2022
2022-02-13,Pulau Pinang,258,17,241,2022
2022-02-14,Pulau Pinang,69,10,59,2022
2022-02-15,Pulau Pinang,69,9,60,2022
2022-02-16,Pulau Pinang,63,7,56,2022
2022-02-17,Pulau Pinang,87,14,73,2022
2022-02-18,Pulau Pinang,42,2,40,2022
2022-02-19,Pulau Pinang,23,1,22,2022
2022-02-20,Pulau Pinang,293,58,235,2022
2022-02-21,Pulau Pinang,86,12,74,2022
2022-02-22,Pulau Pinang,45,3,42,2022
2022-02-23,Pulau Pinang,73,9,64,2022
2022-02-24,Pulau Pinang,92,18,74,2022
2022-02-25,Pulau Pinang,52,6,46,2022
2022-02-26,Pulau Pinang,36,10,26,2022
2022-02-27,Pulau Pinang,219,19,200,2022
2022-02-28,Pulau Pinang,96,6,90,2022
2022-03-01,Pulau Pinang,67,10,57,2022
2022-03-02,Pulau Pinang,53,13,40,2022
2022-03-03,Pulau Pinang,97,7,90,2022
2022-03-04,Pulau Pinang,39,5,34,2022
2022-03-05,Pulau Pinang,81,8,73,2022
2022-03-06,Pulau Pinang,201,24,177,2022
2022-03-07,Pulau Pinang,69,6,63,2022
2022-03-08,Pulau Pinang,62,14,48,2022
2022-03-09,Pulau Pinang,63,11,52,2022
2022-03-10,Pulau Pinang,136,18,118,2022
2022-03-11,Pulau Pinang,41,4,37,2022
2022-03-12,Pulau Pinang,53,16,37,2022
2022-03-13,Pulau Pinang,256,26,230,2022
2022-03-14,Pulau Pinang,56,10,46,2022
2022-03-15,Pulau Pinang,65,6,59,2022
2022-03-16,Pulau Pinang,100,14,86,2022
2022-03-17,Pulau Pinang,148,39,109,2022
2022-03-18,Pulau Pinang,58,7,51,2022
2022-03-19,Pulau Pinang,132,22,110,2022
2022-03-20,Pulau Pinang,330,40,290,2022
2022-03-21,Pulau Pinang,76,9,67,2022
2022-03-22,Pulau Pinang,58,7,51,2022
2022-03-23,Pulau Pinang,63,10,53,2022
2022-03-24,Pulau Pinang,157,31,126,2022
2022-03-25,Pulau Pinang,64,7,57,2022
2022-03-26,Pulau Pinang,104,19,85,2022
2022-03-27,Pulau Pinang,166,46,120,2022
2022-03-28,Pulau Pinang,110,12,98,2022
2022-03-29,Pulau Pinang,97,22,75,2022
2022-03-30,Pulau Pinang,130,35,95,2022
2022-03-31,Pulau Pinang,109,11,98,2022
2022-04-01,Pulau Pinang,76,13,63,2022
2022-04-02,Pulau Pinang,193,39,154,2022
2022-04-03,Pulau Pinang,107,18,89,2022
2022-04-04,Pulau Pinang,35,9,26,2022
2022-04-05,Pulau Pinang,41,1,40,2022
2022-04-06,Pulau Pinang,47,7,40,2022
2022-04-07,Pulau Pinang,116,30,86,2022
2022-04-08,Pulau Pinang,57,9,48,2022
2022-04-09,Pulau Pinang,77,7,70,2022
2022-04-10,Pulau Pinang,289,15,274,2022
2022-04-11,Pulau Pinang,34,5,29,2022
2022-04-12,Pulau Pinang,107,30,77,2022
2022-04-13,Pulau Pinang,81,11,70,2022
2022-04-14,Pulau Pinang,108,28,80,2022
2022-04-15,Pulau Pinang,39,6,33,2022
2022-04-16,Pulau Pinang,158,46,112,2022
2022-04-17,Pulau Pinang,209,32,177,2022
2022-04-18,Pulau Pinang,54,11,43,2022
2022-04-19,Pulau Pinang,32,5,27,2022
2022-04-20,Pulau Pinang,61,11,50,2022
2022-04-21,Pulau Pinang,89,22,67,2022
2022-04-22,Pulau Pinang,35,7,28,2022
2022-04-23,Pulau Pinang,65,12,53,2022
2022-04-24,Pulau Pinang,191,41,150,2022
2022-04-25,Pulau Pinang,53,2,51,2022
2022-04-26,Pulau Pinang,79,12,67,2022
2022-04-27,Pulau Pinang,64,15,49,2022
2022-04-28,Pulau Pinang,79,19,60,2022
2022-04-29,Pulau Pinang,39,4,35,2022
2022-04-30,Pulau Pinang,120,26,94,2022
2022-05-01,Pulau Pinang,234,50,184,2022
2022-05-02,Pulau Pinang,0,0,0,2022
2022-05-03,Pulau Pinang,0,0,0,2022
2022-05-04,Pulau Pinang,0,0,0,2022
2022-05-05,Pulau Pinang,125,34,91,2022
2022-05-06,Pulau Pinang,58,9,49,2022
2022-05-07,Pulau Pinang,107,21,86,2022
2022-05-08,Pulau Pinang,282,36,246,2022
2022-05-09,Pulau Pinang,75,12,63,2022
2022-05-10,Pulau Pinang,72,14,58,2022
2022-05-11,Pulau Pinang,114,18,96,2022
2022-05-12,Pulau Pinang,155,24,131,2022
2022-05-13,Pulau Pinang,70,11,59,2022
2022-05-14,Pulau Pinang,167,65,102,2022
2022-05-15,Pulau Pinang,180,33,147,2022
2022-05-16,Pulau Pinang,89,15,74,2022
2022-05-17,Pulau Pinang,96,16,80,2022
2022-05-18,Pulau Pinang,109,17,92,2022
2022-05-19,Pulau Pinang,87,16,71,2022
2022-05-20,Pulau Pinang,97,19,78,2022
2022-05-21,Pulau Pinang,67,24,43,2022
2022-05-22,Pulau Pinang,211,32,179,2022
2022-05-23,Pulau Pinang,80,19,61,2022
2022-05-24,Pulau Pinang,74,23,51,2022
2022-05-25,Pulau Pinang,121,36,85,2022
2022-05-26,Pulau Pinang,96,21,75,2022
2022-05-27,Pulau Pinang,37,2,35,2022
2022-05-28,Pulau Pinang,61,13,48,2022
2022-05-29,Pulau Pinang,173,20,153,2022
2022-05-30,Pulau Pinang,114,17,97,2022
2022-05-31,Pulau Pinang,119,27,92,2022
2022-06-01,Pulau Pinang,161,74,87,2022
2022-06-02,Pulau Pinang,83,23,60,2022
2022-06-03,Pulau Pinang,49,3,46,2022
2022-06-04,Pulau Pinang,171,44,127,2022
2022-06-05,Pulau Pinang,152,30,122,2022
2022-06-06,Pulau Pinang,193,75,118,2022
2022-06-07,Pulau Pinang,159,55,104,2022
2022-06-08,Pulau Pinang,132,42,90,2022
2022-06-09,Pulau Pinang,252,64,188,2022
2022-06-10,Pulau Pinang,30,5,25,2022
2022-06-11,Pulau Pinang,42,7,35,2022
2022-06-12,Pulau Pinang,277,17,260,2022
2022-06-13,Pulau Pinang,89,23,66,2022
2022-06-14,Pulau Pinang,83,9,74,2022
2022-06-15,Pulau Pinang,134,45,89,2022
2022-06-16,Pulau Pinang,249,69,180,2022
2022-06-17,Pulau Pinang,46,6,40,2022
2022-06-18,Pulau Pinang,82,18,64,2022
2022-06-19,Pulau Pinang,334,70,264,2022
2022-06-20,Pulau Pinang,104,25,79,2022
2022-06-21,Pulau Pinang,90,20,70,2022
2022-06-22,Pulau Pinang,133,23,110,2022
2022-06-23,Pulau Pinang,154,52,102,2022
2022-06-24,Pulau Pinang,46,6,40,2022
2022-06-25,Pulau Pinang,141,43,98,2022
2022-06-26,Pulau Pinang,272,44,228,2022
2022-06-27,Pulau Pinang,136,26,110,2022
2022-06-28,Pulau Pinang,73,3,70,2022
2022-06-29,Pulau Pinang,114,44,70,2022
2022-06-30,Pulau Pinang,108,29,79,2022
2022-07-01,Pulau Pinang,55,1,54,2022
2022-07-02,Pulau Pinang,47,3,44,2022
2022-07-03,Pulau Pinang,227,22,205,2022
2022-07-04,Pulau Pinang,47,4,43,2022
2022-07-05,Pulau Pinang,61,7,54,2022
2022-07-06,Pulau Pinang,117,15,102,2022
2022-07-07,Pulau Pinang,136,45,91,2022
2022-07-08,Pulau Pinang,57,3,54,2022
2022-07-09,Pulau Pinang,71,17,54,2022
2022-07-10,Pulau Pinang,0,0,0,2022
2022-07-11,Pulau Pinang,0,0,0,2022
2022-07-12,Pulau Pinang,96,5,91,2022
2022-07-13,Pulau Pinang,125,22,103,2022
2022-07-14,Pulau Pinang,134,18,116,2022
2022-07-15,Pulau Pinang,42,2,40,2022
2022-07-16,Pulau Pinang,31,16,15,2022
2022-07-17,Pulau Pinang,286,37,249,2022
2022-07-18,Pulau Pinang,101,17,84,2022
2022-07-19,Pulau Pinang,79,11,68,2022
2022-07-20,Pulau Pinang,97,13,84,2022
2022-07-21,Pulau Pinang,116,49,67,2022
2022-07-22,Pulau Pinang,164,15,149,2022
2022-07-23,Pulau Pinang,119,28,91,2022
2022-07-24,Pulau Pinang,186,38,148,2022
2022-07-25,Pulau Pinang,34,4,30,2022
2022-07-26,Pulau Pinang,64,7,57,2022
2022-07-27,Pulau Pinang,119,29,90,2022
2022-07-28,Pulau Pinang,95,17,78,2022
2022-07-29,Pulau Pinang,36,1,35,2022
2022-07-30,Pulau Pinang,93,27,66,2022
2022-07-31,Pulau Pinang,254,35,219,2022
2022-08-01,Pulau Pinang,82,14,68,2022
2022-08-02,Pulau Pinang,78,18,60,2022
2022-08-03,Pulau Pinang,95,32,63,2022
2022-08-04,Pulau Pinang,192,49,143,2022
2022-08-05,Pulau Pinang,37,0,37,2022
2022-08-06,Pulau Pinang,85,17,68,2022
2022-08-07,Pulau Pinang,285,80,205,2022
2022-08-08,Pulau Pinang,71,8,63,2022
2022-08-09,Pulau Pinang,87,12,75,2022
2022-08-10,Pulau Pinang,97,17,80,2022
2022-08-11,Pulau Pinang,120,25,95,2022
2022-08-12,Pulau Pinang,43,5,38,2022
2022-08-13,Pulau Pinang,53,5,48,2022
2022-08-14,Pulau Pinang,264,30,234,2022
2022-08-15,Pulau Pinang,69,12,57,2022
2022-08-16,Pulau Pinang,84,13,71,2022
2022-08-17,Pulau Pinang,70,8,62,2022
2022-08-18,Pulau Pinang,154,44,110,2022
2022-08-19,Pulau Pinang,41,2,39,2022
2022-08-20,Pulau Pinang,0,0,0,2022
2022-08-21,Pulau Pinang,157,26,131,2022
2022-08-22,Pulau Pinang,75,11,64,2022
2022-08-23,Pulau Pinang,189,56,133,2022
2022-08-24,Pulau Pinang,226,84,142,2022
2022-08-25,Pulau Pinang,204,87,117,2022
2022-08-26,Pulau Pinang,42,3,39,2022
2022-08-27,Pulau Pinang,109,33,76,2022
2022-08-28,Pulau Pinang,191,22,169,2022
2022-08-29,Pulau Pinang,98,26,72,2022
2022-08-30,Pulau Pinang,80,14,66,2022
2022-08-31,Pulau Pinang,215,32,183,2022
2022-09-01,Pulau Pinang,205,53,152,2022
2022-09-02,Pulau Pinang,42,2,40,2022
2022-09-03,Pulau Pinang,141,14,127,2022
2022-09-04,Pulau Pinang,243,23,220,2022
2022-09-05,Pulau Pinang,43,6,37,2022
2022-09-06,Pulau Pinang,160,70,90,2022
2022-09-07,Pulau Pinang,59,19,40,2022
2022-09-08,Pulau Pinang,187,87,100,2022
2022-09-09,Pulau Pinang,40,3,37,2022
2022-09-10,Pulau Pinang,43,13,30,2022
2022-09-11,Pulau Pinang,256,44,212,2022
2022-09-12,Pulau Pinang,50,4,46,2022
2022-09-13,Pulau Pinang,61,6,55,2022
2022-09-14,Pulau Pinang,126,45,81,2022
2022-09-15,Pulau Pinang,133,23,110,2022
2022-09-16,Pulau Pinang,0,0,0,2022
2022-09-17,Pulau Pinang,84,23,61,2022
2022-09-18,Pulau Pinang,205,36,169,2022
2022-09-19,Pulau Pinang,77,10,67,2022
2022-09-20,Pulau Pinang,144,22,122,2022
2022-09-21,Pulau Pinang,187,53,134,2022
2022-09-22,Pulau Pinang,186,67,119,2022
2022-09-23,Pulau Pinang,39,0,39,2022
2022-09-24,Pulau Pinang,77,16,61,2022
2022-09-25,Pulau Pinang,207,20,187,2022
2022-09-26,Pulau Pinang,79,12,67,2022
2022-09-27,Pulau Pinang,99,40,59,2022
2022-09-28,Pulau Pinang,165,28,137,2022
2022-09-29,Pulau Pinang,139,42,97,2022
2022-09-30,Pulau Pinang,34,3,31,2022
2022-10-01,Pulau Pinang,82,8,74,2022
2022-10-02,Pulau Pinang,179,25,154,2022
2022-10-03,Pulau Pinang,86,6,80,2022
2022-10-04,Pulau Pinang,106,18,88,2022
2022-10-05,Pulau Pinang,149,40,109,2022
2022-10-06,Pulau Pinang,103,21,82,2022
2022-10-07,Pulau Pinang,42,0,42,2022
2022-10-08,Pulau Pinang,73,25,48,2022
2022-10-09,Pulau Pinang,111,17,94,2022
2022-10-10,Pulau Pinang,93,10,83,2022
2022-10-11,Pulau Pinang,80,21,59,2022
2022-10-12,Pulau Pinang,94,16,78,2022
2022-10-13,Pulau Pinang,95,19,76,2022
2022-10-14,Pulau Pinang,53,9,44,2022
2022-10-15,Pulau Pinang,93,16,77,2022
2022-10-16,Pulau Pinang,222,21,201,2022
2022-10-17,Pulau Pinang,56,6,50,2022
2022-10-18,Pulau Pinang,92,20,72,2022
2022-10-19,Pulau Pinang,120,53,67,2022
2022-10-20,Pulau Pinang,105,37,68,2022
2022-10-21,Pulau Pinang,58,6,52,2022
2022-10-22,Pulau Pinang,127,69,58,2022
2022-10-23,Pulau Pinang,177,40,137,2022
2022-10-24,Pulau Pinang,94,40,54,2022
2022-10-25,Pulau Pinang,153,58,95,2022
2022-10-26,Pulau Pinang,88,11,77,2022
2022-10-27,Pulau Pinang,150,27,123,2022
2022-10-28,Pulau Pinang,47,7,40,2022
2022-10-29,Pulau Pinang,88,15,73,2022
2022-10-30,Pulau Pinang,146,16,130,2022
2022-10-31,Pulau Pinang,73,13,60,2022
2022-11-01,Pulau Pinang,87,21,66,2022
2022-11-02,Pulau Pinang,140,34,106,2022
2022-11-03,Pulau Pinang,145,54,91,2022
2022-11-04,Pulau Pinang,30,4,26,2022
2022-11-05,Pulau Pinang,114,21,93,2022
2022-11-06,Pulau Pinang,126,16,110,2022
2022-11-07,Pulau Pinang,54,6,48,2022
2022-11-08,Pulau Pinang,47,3,44,2022
2022-11-09,Pulau Pinang,121,41,80,2022
2022-11-10,Pulau Pinang,119,49,70,2022
2022-11-11,Pulau Pinang,37,1,36,2022
2022-11-12,Pulau Pinang,42,9,33,2022
2022-11-13,Pulau Pinang,168,14,154,2022
2022-11-14,Pulau Pinang,50,4,46,2022
2022-11-15,Pulau Pinang,117,23,94,2022
2022-11-16,Pulau Pinang,118,23,95,2022
2022-11-17,Pulau Pinang,151,36,115,2022
2022-11-18,Pulau Pinang,0,0,0,2022
2022-11-19,Pulau Pinang,0,0,0,2022
2022-11-20,Pulau Pinang,100,9,91,2022
2022-11-21,Pulau Pinang,67,5,62,2022
2022-11-22,Pulau Pinang,60,6,54,2022
2022-11-23,Pulau Pinang,111,12,99,2022
2022-11-24,Pulau Pinang,175,23,152,2022
2022-11-25,Pulau Pinang,39,1,38,2022
2022-11-26,Pulau Pinang,17,4,13,2022
2022-11-27,Pulau Pinang,195,28,167,2022
2022-11-28,Pulau Pinang,74,12,62,2022
2022-11-29,Pulau Pinang,77,10,67,2022
2022-11-30,Pulau Pinang,134,25,109,2022
2022-12-01,Pulau Pinang,129,25,104,2022
2022-12-02,Pulau Pinang,48,2,46,2022
2022-12-03,Pulau Pinang,96,12,84,2022
2022-12-04,Pulau Pinang,249,16,233,2022
2022-12-05,Pulau Pinang,57,7,50,2022
2022-12-06,Pulau Pinang,89,7,82,2022
2022-12-07,Pulau Pinang,126,26,100,2022
2022-12-08,Pulau Pinang,163,38,125,2022
2022-12-09,Pulau Pinang,50,9,41,2022
2022-12-10,Pulau Pinang,234,94,140,2022
2022-12-11,Pulau Pinang,259,25,234,2022
2022-12-12,Pulau Pinang,71,11,60,2022
2022-12-13,Pulau Pinang,87,9,78,2022
2022-12-14,Pulau Pinang,138,18,120,2022
2022-12-15,Pulau Pinang,109,19,90,2022
2022-12-16,Pulau Pinang,64,0,64,2022
2022-12-17,Pulau Pinang,34,7,27,2022
2022-12-18,Pulau Pinang,165,23,142,2022
2022-12-19,Pulau Pinang,74,9,65,2022
2022-12-20,Pulau Pinang,61,4,57,2022
2022-12-21,Pulau Pinang,76,13,63,2022
2022-12-22,Pulau Pinang,140,25,115,2022
2022-12-23,Pulau Pinang,91,6,85,2022
2022-12-24,Pulau Pinang,59,6,53,2022
2022-12-25,Pulau Pinang,100,17,83,2022
2022-12-26,Pulau Pinang,78,12,66,2022
2022-12-27,Pulau Pinang,82,2,80,2022
2022-12-28,Pulau Pinang,259,80,179,2022
2022-12-29,Pulau Pinang,119,23,96,2022
2022-12-30,Pulau Pinang,78,7,71,2022
2022-12-31,Pulau Pinang,78,12,66,2022
2023-01-01,Pulau Pinang,379,33,346,2023
2023-01-02,Pulau Pinang,44,6,38,2023
2023-01-03,Pulau Pinang,86,8,78,2023
2023-01-04,Pulau Pinang,171,104,67,2023
2023-01-05,Pulau Pinang,85,13,72,2023
2023-01-06,Pulau Pinang,43,4,39,2023
2023-01-07,Pulau Pinang,179,61,118,2023
2023-01-08,Pulau Pinang,110,22,88,2023
2023-01-09,Pulau Pinang,81,11,70,2023
2023-01-10,Pulau Pinang,139,29,110,2023
2023-01-11,Pulau Pinang,201,71,130,2023
2023-01-12,Pulau Pinang,253,64,189,2023
2023-01-13,Pulau Pinang,51,8,43,2023
2023-01-14,Pulau Pinang,64,6,58,2023
2023-01-15,Pulau Pinang,182,62,120,2023
2023-01-16,Pulau Pinang,89,11,78,2023
2023-01-17,Pulau Pinang,83,15,68,2023
2023-01-18,Pulau Pinang,158,43,115,2023
2023-01-19,Pulau Pinang,193,77,116,2023
2023-01-20,Pulau Pinang,70,3,67,2023
2023-01-21,Pulau Pinang,29,4,25,2023
2023-01-22,Pulau Pinang,89,14,75,2023
2023-01-23,Pulau Pinang,94,18,76,2023
2023-01-24,Pulau Pinang,51,8,43,2023
2023-01-25,Pulau Pinang,124,18,106,2023
2023-01-26,Pulau Pinang,94,14,80,2023
2023-01-27,Pulau Pinang,49,1,48,2023
2023-01-28,Pulau Pinang,39,23,16,2023
2023-01-29,Pulau Pinang,167,31,136,2023
2023-01-30,Pulau Pinang,164,48,116,2023
2023-01-31,Pulau Pinang,75,9,66,2023
2023-02-01,Pulau Pinang,68,9,59,2023
2023-02-02,Pulau Pinang,168,60,108,2023
2023-02-03,Pulau Pinang,42,1,41,2023
2023-02-04,Pulau Pinang,124,48,76,2023
2023-02-05,Pulau Pinang,456,104,352,2023
2023-02-06,Pulau Pinang,67,11,56,2023
2023-02-07,Pulau Pinang,82,13,69,2023
2023-02-08,Pulau Pinang,197,26,171,2023
2023-02-09,Pulau Pinang,128,23,105,2023
2023-02-10,Pulau Pinang,42,4,38,2023
2023-02-11,Pulau Pinang,134,39,95,2023
2023-02-12,Pulau Pinang,270,39,231,2023
2023-02-13,Pulau Pinang,70,6,64,2023
2023-02-14,Pulau Pinang,72,4,68,2023
2023-02-15,Pulau Pinang,112,20,92,2023
2023-02-16,Pulau Pinang,135,37,98,2023
2023-02-17,Pulau Pinang,63,2,61,2023
2023-02-18,Pulau Pinang,51,8,43,2023
2023-02-19,Pulau Pinang,308,44,264,2023
2023-02-20,Pulau Pinang,67,8,59,2023
2023-02-21,Pulau Pinang,152,23,129,2023
2023-02-22,Pulau Pinang,166,41,125,2023
2023-02-23,Pulau Pinang,93,12,81,2023
2023-02-24,Pulau Pinang,35,3,32,2023
2023-02-25,Pulau Pinang,65,45,20,2023
2023-02-26,Pulau Pinang,198,63,135,2023
2023-02-27,Pulau Pinang,99,11,88,2023
2023-02-28,Pulau Pinang,93,9,84,2023
2023-03-01,Pulau Pinang,143,39,104,2023
2023-03-02,Pulau Pinang,190,43,147,2023
2023-03-03,Pulau Pinang,44,4,40,2023
2023-03-04,Pulau Pinang,121,15,106,2023
2023-03-05,Pulau Pinang,308,35,273,2023
2023-03-06,Pulau Pinang,101,23,78,2023
2023-03-07,Pulau Pinang,127,13,114,2023
2023-03-08,Pulau Pinang,124,37,87,2023
2023-03-09,Pulau Pinang,159,54,105,2023
2023-03-10,Pulau Pinang,47,4,43,2023
2023-03-11,Pulau Pinang,188,42,146,2023
2023-03-12,Pulau Pinang,339,39,300,2023
2023-03-13,Pulau Pinang,148,40,108,2023
2023-03-14,Pulau Pinang,112,16,96,2023
2023-03-15,Pulau Pinang,97,25,72,2023
2023-03-16,Pulau Pinang,157,29,128,2023
2023-03-17,Pulau Pinang,47,1,46,2023
2023-03-18,Pulau Pinang,99,14,85,2023
2023-03-19,Pulau Pinang,165,29,136,2023
2023-03-20,Pulau Pinang,90,8,82,2023
2023-03-21,Pulau Pinang,210,64,146,2023
2023-03-22,Pulau Pinang,293,50,243,2023
2023-03-23,Pulau Pinang,48,3,45,2023
2023-03-24,Pulau Pinang,27,2,25,2023
2023-03-25,Pulau Pinang,95,19,76,2023
2023-03-26,Pulau Pinang,195,25,170,2023
2023-03-27,Pulau Pinang,44,5,39,2023
2023-03-28,Pulau Pinang,61,4,57,2023
2023-03-29,Pulau Pinang,66,16,50,2023
2023-03-30,Pulau Pinang,50,3,47,2023
2023-03-31,Pulau Pinang,41,4,37,2023
2023-04-01,Pulau Pinang,102,8,94,2023
2023-04-02,Pulau Pinang,138,30,108,2023
2023-04-03,Pulau Pinang,33,4,29,2023
2023-04-04,Pulau Pinang,94,18,76,2023
2023-04-05,Pulau Pinang,53,8,45,2023
2023-04-06,Pulau Pinang,110,24,86,2023
2023-04-07,Pulau Pinang,31,2,29,2023
2023-04-08,Pulau Pinang,105,14,91,2023
2023-04-09,Pulau Pinang,283,25,258,2023
2023-04-10,Pulau Pinang,39,1,38,2023
2023-04-11,Pulau Pinang,102,56,46,2023
2023-04-12,Pulau Pinang,147,70,77,2023
2023-04-13,Pulau Pinang,73,12,61,2023
2023-04-14,Pulau Pinang,36,3,33,2023
2023-04-15,Pulau Pinang,56,6,50,2023
2023-04-16,Pulau Pinang,224,20,204,2023
2023-04-17,Pulau Pinang,68,4,64,2023
2023-04-18,Pulau Pinang,79,5,74,2023
2023-04-19,Pulau Pinang,100,19,81,2023
2023-04-20,Pulau Pinang,121,26,95,2023
2023-04-21,Pulau Pinang,12,0,12,2023
2023-04-22,Pulau Pinang,0,0,0,2023
2023-04-23,Pulau Pinang,0,0,0,2023
2023-04-24,Pulau Pinang,64,6,58,2023
2023-04-25,Pulau Pinang,82,16,66,2023
2023-04-26,Pulau Pinang,76,8,68,2023
2023-04-27,Pulau Pinang,113,9,104,2023
2023-04-28,Pulau Pinang,54,0,54,2023
2023-04-29,Pulau Pinang,65,9,56,2023
2023-04-30,Pulau Pinang,91,12,79,2023
2023-05-01,Pulau Pinang,158,18,140,2023
2023-05-02,Pulau Pinang,87,9,78,2023
2023-05-03,Pulau Pinang,105,20,85,2023
2023-05-04,Pulau Pinang,120,11,109,2023
2023-05-05,Pulau Pinang,55,4,51,2023
2023-05-06,Pulau Pinang,87,22,65,2023
2023-05-07,Pulau Pinang,244,29,215,2023
2023-05-08,Pulau Pinang,92,15,77,2023
2023-05-09,Pulau Pinang,128,46,82,2023
2023-05-10,Pulau Pinang,179,67,112,2023
2023-05-11,Pulau Pinang,198,50,148,2023
2023-05-12,Pulau Pinang,47,2,45,2023
2023-05-13,Pulau Pinang,78,20,58,2023
2023-05-14,Pulau Pinang,232,33,199,2023
2023-05-15,Pulau Pinang,62,9,53,2023
2023-05-16,Pulau Pinang,77,9,68,2023
2023-05-17,Pulau Pinang,76,6,70,2023
2023-05-18,Pulau Pinang,87,16,71,2023
2023-05-19,Pulau Pinang,29,4,25,2023
2023-05-20,Pulau Pinang,98,24,74,2023
2023-05-21,Pulau Pinang,250,37,213,2023
2023-05-22,Pulau Pinang,134,53,81,2023
2023-05-23,Pulau Pinang,102,19,83,2023
2023-05-24,Pulau Pinang,107,31,76,2023
2023-05-25,Pulau Pinang,80,14,66,2023
2023-05-26,Pulau Pinang,38,2,36,2023
2023-05-27,Pulau Pinang,156,58,98,2023
2023-05-28,Pulau Pinang,101,17,84,2023
2023-05-29,Pulau Pinang,175,32,143,2023
2023-05-30,Pulau Pinang,131,27,104,2023
2023-05-31,Pulau Pinang,100,12,88,2023
2023-06-01,Pulau Pinang,153,18,135,2023
2023-06-02,Pulau Pinang,44,2,42,2023
2023-06-03,Pulau Pinang,108,14,94,2023
2023-06-04,Pulau Pinang,239,23,216,2023
2023-06-05,Pulau Pinang,121,16,105,2023
2023-06-06,Pulau Pinang,110,6,104,2023
2023-06-07,Pulau Pinang,94,6,88,2023
2023-06-08,Pulau Pinang,134,16,118,2023
2023-06-09,Pulau Pinang,36,3,33,2023
2023-06-10,Pulau Pinang,123,27,96,2023
2023-06-11,Pulau Pinang,452,67,385,2023
2023-06-12,Pulau Pinang,64,4,60,2023
2023-06-13,Pulau Pinang,138,39,99,2023
2023-06-14,Pulau Pinang,206,56,150,2023
2023-06-15,Pulau Pinang,144,21,123,2023
2023-06-16,Pulau Pinang,68,6,62,2023
2023-06-17,Pulau Pinang,41,9,32,2023
2023-06-18,Pulau Pinang,280,63,217,2023
2023-06-19,Pulau Pinang,66,4,62,2023
2023-06-20,Pulau Pinang,83,16,67,2023
2023-06-21,Pulau Pinang,174,32,142,2023
2023-06-22,Pulau Pinang,181,63,118,2023
2023-06-23,Pulau Pinang,51,3,48,2023
2023-06-24,Pulau Pinang,278,87,191,2023
2023-06-25,Pulau Pinang,181,31,150,2023
2023-06-26,Pulau Pinang,92,19,73,2023
2023-06-27,Pulau Pinang,66,6,60,2023
2023-06-28,Pulau Pinang,135,46,89,2023
2023-06-29,Pulau Pinang,0,0,0,2023
2023-06-30,Pulau Pinang,59,7,52,2023
2023-07-01,Pulau Pinang,81,26,55,2023
2023-07-02,Pulau Pinang,101,17,84,2023
2023-07-03,Pulau Pinang,110,9,101,2023
2023-07-04,Pulau Pinang,129,28,101,2023
2023-07-05,Pulau Pinang,82,24,58,2023
2023-07-06,Pulau Pinang,136,31,105,2023
2023-07-07,Pulau Pinang,26,4,22,2023
2023-07-08,Pulau Pinang,127,26,101,2023
2023-07-09,Pulau Pinang,219,17,202,2023
2023-07-10,Pulau Pinang,89,5,84,2023
2023-07-11,Pulau Pinang,88,16,72,2023
2023-07-12,Pulau Pinang,117,28,89,2023
2023-07-13,Pulau Pinang,150,29,121,2023
2023-07-14,Pulau Pinang,42,4,38,2023
2023-07-15,Pulau Pinang,25,3,22,2023
2023-07-16,Pulau Pinang,233,35,198,2023
2023-07-17,Pulau Pinang,97,12,85,2023
2023-07-18,Pulau Pinang,75,10,65,2023
2023-07-19,Pulau Pinang,95,14,81,2023
2023-07-20,Pulau Pinang,150,23,127,2023
2023-07-21,Pulau Pinang,53,4,49,2023
2023-07-22,Pulau Pinang,31,4,27,2023
2023-07-23,Pulau Pinang,291,40,251,2023
2023-07-24,Pulau Pinang,106,24,82,2023
2023-07-25,Pulau Pinang,91,13,78,2023
2023-07-26,Pulau Pinang,92,20,72,2023
2023-07-27,Pulau Pinang,107,20,87,2023
2023-07-28,Pulau Pinang,39,2,37,2023
2023-07-29,Pulau Pinang,102,17,85,2023
2023-07-30,Pulau Pinang,156,34,122,2023
2023-07-31,Pulau Pinang,100,27,73,2023
2023-08-01,Pulau Pinang,66,7,59,2023
2023-08-02,Pulau Pinang,84,22,62,2023
2023-08-03,Pulau Pinang,112,19,93,2023
2023-08-04,Pulau Pinang,39,1,38,2023
2023-08-05,Pulau Pinang,121,32,89,2023
2023-08-06,Pulau Pinang,265,20,245,2023
2023-08-07,Pulau Pinang,79,13,66,2023
2023-08-08,Pulau Pinang,123,21,102,2023
2023-08-09,Pulau Pinang,131,43,88,2023
2023-08-10,Pulau Pinang,269,121,148,2023
2023-08-11,Pulau Pinang,41,0,41,2023
2023-08-12,Pulau Pinang,0,0,0,2023
2023-08-13,Pulau Pinang,139,20,119,2023
2023-08-14,Pulau Pinang,81,17,64,2023
2023-08-15,Pulau Pinang,123,23,100,2023
2023-08-16,Pulau Pinang,140,25,115,2023
2023-08-17,Pulau Pinang,204,63,141,2023
2023-08-18,Pulau Pinang,40,5,35,2023
2023-08-19,Pulau Pinang,55,7,48,2023
2023-08-20,Pulau Pinang,196,22,174,2023
2023-08-21,Pulau Pinang,67,9,58,2023
2023-08-22,Pulau Pinang,90,39,51,2023
2023-08-23,Pulau Pinang,163,45,118,2023
2023-08-24,Pulau Pinang,113,25,88,2023
2023-08-25,Pulau Pinang,44,6,38,2023
2023-08-26,Pulau Pinang,43,21,22,2023
2023-08-27,Pulau Pinang,119,24,95,2023
2023-08-28,Pulau Pinang,114,33,81,2023
2023-08-29,Pulau Pinang,84,19,65,2023
2023-08-30,Pulau Pinang,132,38,94,2023
2023-08-31,Pulau Pinang,135,21,114,2023
2023-09-01,Pulau Pinang,46,3,43,2023
2023-09-02,Pulau Pinang,0,0,0,2023
2023-09-03,Pulau Pinang,288,37,251,2023
2023-09-04,Pulau Pinang,64,24,40,2023
2023-09-05,Pulau Pinang,62,8,54,2023
2023-09-06,Pulau Pinang,174,33,141,2023
2023-09-07,Pulau Pinang,105,13,92,2023
2023-09-08,Pulau Pinang,38,3,35,2023
2023-09-09,Pulau Pinang,193,35,158,2023
2023-09-10,Pulau Pinang,322,35,287,2023
2023-09-11,Pulau Pinang,90,26,64,2023
2023-09-12,Pulau Pinang,145,36,109,2023
2023-09-13,Pulau Pinang,157,50,107,2023
2023-09-14,Pulau Pinang,125,21,104,2023
2023-09-15,Pulau Pinang,42,6,36,2023
2023-09-16,Pulau Pinang,108,25,83,2023
2023-09-17,Pulau Pinang,182,34,148,2023
2023-09-18,Pulau Pinang,174,29,145,2023
2023-09-19,Pulau Pinang,106,19,87,2023
2023-09-20,Pulau Pinang,155,41,114,2023
2023-09-21,Pulau Pinang,181,33,148,2023
2023-09-22,Pulau Pinang,31,2,29,2023
2023-09-23,Pulau Pinang,85,47,38,2023
2023-09-24,Pulau Pinang,261,35,226,2023
2023-09-25,Pulau Pinang,73,5,68,2023
2023-09-26,Pulau Pinang,123,12,111,2023
2023-09-27,Pulau Pinang,274,40,234,2023
2023-09-28,Pulau Pinang,96,12,84,2023
2023-09-29,Pulau Pinang,51,3,48,2023
2023-09-30,Pulau Pinang,160,45,115,2023
2023-10-01,Pulau Pinang,121,25,96,2023
2023-10-02,Pulau Pinang,102,15,87,2023
2023-10-03,Pulau Pinang,57,5,52,2023
2023-10-04,Pulau Pinang,166,38,128,2023
2023-10-05,Pulau Pinang,172,31,141,2023
2023-10-06,Pulau Pinang,32,2,30,2023
2023-10-07,Pulau Pinang,90,11,79,2023
2023-10-08,Pulau Pinang,235,24,211,2023
2023-10-09,Pulau Pinang,125,32,93,2023
2023-10-10,Pulau Pinang,86,8,78,2023
2023-10-11,Pulau Pinang,175,21,154,2023
2023-10-12,Pulau Pinang,225,49,176,2023
2023-10-13,Pulau Pinang,44,1,43,2023
2023-10-14,Pulau Pinang,155,46,109,2023
2023-10-15,Pulau Pinang,141,40,101,2023
2023-10-16,Pulau Pinang,100,15,85,2023
2023-10-17,Pulau Pinang,84,7,77,2023
2023-10-18,Pulau Pinang,252,53,199,2023
2023-10-19,Pulau Pinang,199,49,150,2023
2023-10-20,Pulau Pinang,26,1,25,2023
2023-10-21,Pulau Pinang,62,10,52,2023
2023-10-22,Pulau Pinang,108,23,85,2023
2023-10-23,Pulau Pinang,67,8,59,2023
2023-10-24,Pulau Pinang,75,14,61,2023
2023-10-25,Pulau Pinang,138,48,90,2023
2023-10-26,Pulau Pinang,150,38,112,2023
2023-10-27,Pulau Pinang,35,2,33,2023
2023-10-28,Pulau Pinang,160,66,94,2023
2023-10-29,Pulau Pinang,181,25,156,2023
2023-10-30,Pulau Pinang,44,1,43,2023
2023-10-31,Pulau Pinang,64,8,56,2023
2023-11-01,Pulau Pinang,139,26,113,2023
2023-11-02,Pulau Pinang,135,49,86,2023
2023-11-03,Pulau Pinang,28,0,28,2023
2023-11-04,Pulau Pinang,140,9,131,2023
2023-11-05,Pulau Pinang,214,23,191,2023
2023-11-06,Pulau Pinang,63,5,58,2023
2023-11-07,Pulau Pinang,152,36,116,2023
2023-11-08,Pulau Pinang,100,35,65,2023
2023-11-09,Pulau Pinang,155,29,126,2023
2023-11-10,Pulau Pinang,44,2,42,2023
2023-11-11,Pulau Pinang,30,15,15,2023
2023-11-12,Pulau Pinang,178,29,149,2023
2023-11-13,Pulau Pinang,87,11,76,2023
2023-11-14,Pulau Pinang,79,10,69,2023
2023-11-15,Pulau Pinang,105,28,77,2023
2023-11-16,Pulau Pinang,108,21,87,2023
2023-11-17,Pulau Pinang,40,5,35,2023
2023-11-18,Pulau Pinang,57,15,42,2023
2023-11-19,Pulau Pinang,212,17,195,2023
2023-11-20,Pulau Pinang,84,27,57,2023
2023-11-21,Pulau Pinang,90,16,74,2023
2023-11-22,Pulau Pinang,67,14,53,2023
2023-11-23,Pulau Pinang,155,18,137,2023
2023-11-24,Pulau Pinang,35,1,34,2023
2023-11-25,Pulau Pinang,64,4,60,2023
2023-11-26,Pulau Pinang,128,27,101,2023
2023-11-27,Pulau Pinang,73,5,68,2023
2023-11-28,Pulau Pinang,49,5,44,2023
2023-11-29,Pulau Pinang,99,19,80,2023
2023-11-30,Pulau Pinang,117,23,94,2023
2023-12-01,Pulau Pinang,78,21,57,2023
2023-12-02,Pulau Pinang,67,6,61,2023
2023-12-03,Pulau Pinang,186,21,165,2023
2023-12-04,Pulau Pinang,80,29,51,2023
2023-12-05,Pulau Pinang,59,9,50,2023
2023-12-06,Pulau Pinang,96,20,76,2023
2023-12-07,Pulau Pinang,156,42,114,2023
2023-12-08,Pulau Pinang,50,2,48,2023
2023-12-09,Pulau Pinang,41,7,34,2023
2023-12-10,Pulau Pinang,325,23,302,2023
2023-12-11,Pulau Pinang,70,19,51,2023
2023-12-12,Pulau Pinang,145,38,107,2023
2023-12-13,Pulau Pinang,117,21,96,2023
2023-12-14,Pulau Pinang,78,14,64,2023
2023-12-15,Pulau Pinang,41,5,36,2023
2023-12-16,Pulau Pinang,53,4,49,2023
2023-12-17,Pulau Pinang,131,16,115,2023
2023-12-18,Pulau Pinang,80,12,68,2023
2023-12-19,Pulau Pinang,82,10,72,2023
2023-12-20,Pulau Pinang,150,34,116,2023
2023-12-21,Pulau Pinang,87,3,84,2023
2023-12-22,Pulau Pinang,42,2,40,2023
2023-12-23,Pulau Pinang,53,7,46,2023
2023-12-24,Pulau Pinang,156,19,137,2023
2023-12-25,Pulau Pinang,125,20,105,2023
2023-12-26,Pulau Pinang,67,2,65,2023
2023-12-27,Pulau Pinang,118,22,96,2023
2023-12-28,Pulau Pinang,96,13,83,2023
2023-12-29,Pulau Pinang,55,1,54,2023
2023-12-30,Pulau Pinang,65,13,52,2023
2023-12-31,Pulau Pinang,109,15,94,2023
2024-01-01,Pulau Pinang,202,24,178,2024
2024-01-02,Pulau Pinang,55,3,52,2024
2024-01-03,Pulau Pinang,72,24,48,2024
2024-01-04,Pulau Pinang,90,28,62,2024
2024-01-05,Pulau Pinang,65,15,50,2024
2024-01-06,Pulau Pinang,173,55,118,2024
2024-01-07,Pulau Pinang,124,21,103,2024
2024-01-08,Pulau Pinang,92,13,79,2024
2024-01-09,Pulau Pinang,116,22,94,2024
2024-01-10,Pulau Pinang,68,7,61,2024
2024-01-11,Pulau Pinang,123,17,106,2024
2024-01-12,Pulau Pinang,62,4,58,2024
2024-01-13,Pulau Pinang,90,5,85,2024
2024-01-14,Pulau Pinang,203,32,171,2024
2024-01-15,Pulau Pinang,85,12,73,2024
2024-01-16,Pulau Pinang,122,11,111,2024
2024-01-17,Pulau Pinang,110,24,86,2024
2024-01-18,Pulau Pinang,263,80,183,2024
2024-01-19,Pulau Pinang,63,6,57,2024
2024-01-20,Pulau Pinang,102,37,65,2024
2024-01-21,Pulau Pinang,117,17,100,2024
2024-01-22,Pulau Pinang,84,9,75,2024
2024-01-23,Pulau Pinang,48,6,42,2024
2024-01-24,Pulau Pinang,161,51,110,2024
2024-01-25,Pulau Pinang,376,86,290,2024
2024-01-26,Pulau Pinang,49,4,45,2024
2024-01-27,Pulau Pinang,40,11,29,2024
2024-01-28,Pulau Pinang,361,41,320,2024
2024-01-29,Pulau Pinang,38,5,33,2024
2024-01-30,Pulau Pinang,58,9,49,2024
2024-01-31,Pulau Pinang,125,19,106,2024
2024-02-01,Pulau Pinang,117,36,81,2024
2024-02-02,Pulau Pinang,46,5,41,2024
2006-01-01,Sabah,0,0,0,2006
2006-01-02,Sabah,0,0,0,2006
2006-01-03,Sabah,0,0,0,2006
2006-01-04,Sabah,2,0,2,2006
2006-01-05,Sabah,2,0,2,2006
2006-01-06,Sabah,0,0,0,2006
2006-01-07,Sabah,0,0,0,2006
2006-01-08,Sabah,0,0,0,2006
2006-01-09,Sabah,0,0,0,2006
2006-01-10,Sabah,0,0,0,2006
2006-01-11,Sabah,1,0,1,2006
2006-01-12,Sabah,2,0,2,2006
2006-01-13,Sabah,0,0,0,2006
2006-01-14,Sabah,0,0,0,2006
2006-01-15,Sabah,0,0,0,2006
2006-01-16,Sabah,1,1,0,2006
2006-01-17,Sabah,0,0,0,2006
2006-01-18,Sabah,0,0,0,2006
2006-01-19,Sabah,0,0,0,2006
2006-01-20,Sabah,0,0,0,2006
2006-01-21,Sabah,0,0,0,2006
2006-01-22,Sabah,0,0,0,2006
2006-01-23,Sabah,0,0,0,2006
2006-01-24,Sabah,0,0,0,2006
2006-01-25,Sabah,0,0,0,2006
2006-01-26,Sabah,1,0,1,2006
2006-01-27,Sabah,0,0,0,2006
2006-01-28,Sabah,0,0,0,2006
2006-01-29,Sabah,0,0,0,2006
2006-01-30,Sabah,0,0,0,2006
2006-01-31,Sabah,0,0,0,2006
2006-02-01,Sabah,0,0,0,2006
2006-02-02,Sabah,0,0,0,2006
2006-02-03,Sabah,0,0,0,2006
2006-02-04,Sabah,0,0,0,2006
2006-02-05,Sabah,0,0,0,2006
2006-02-06,Sabah,1,0,1,2006
2006-02-07,Sabah,2,0,2,2006
2006-02-08,Sabah,0,0,0,2006
2006-02-09,Sabah,2,0,2,2006
2006-02-10,Sabah,0,0,0,2006
2006-02-11,Sabah,0,0,0,2006
2006-02-12,Sabah,0,0,0,2006
2006-02-13,Sabah,0,0,0,2006
2006-02-14,Sabah,1,0,1,2006
2006-02-15,Sabah,0,0,0,2006
2006-02-16,Sabah,0,0,0,2006
2006-02-17,Sabah,0,0,0,2006
2006-02-18,Sabah,0,0,0,2006
2006-02-19,Sabah,0,0,0,2006
2006-02-20,Sabah,0,0,0,2006
2006-02-21,Sabah,1,0,1,2006
2006-02-22,Sabah,0,0,0,2006
2006-02-23,Sabah,1,0,1,2006
2006-02-24,Sabah,1,0,1,2006
2006-02-25,Sabah,0,0,0,2006
2006-02-26,Sabah,0,0,0,2006
2006-02-27,Sabah,0,0,0,2006
2006-02-28,Sabah,0,0,0,2006
2006-03-01,Sabah,0,0,0,2006
2006-03-02,Sabah,0,0,0,2006
2006-03-03,Sabah,0,0,0,2006
2006-03-04,Sabah,0,0,0,2006
2006-03-05,Sabah,0,0,0,2006
2006-03-06,Sabah,1,0,1,2006
2006-03-07,Sabah,1,0,1,2006
2006-03-08,Sabah,0,0,0,2006
2006-03-09,Sabah,0,0,0,2006
2006-03-10,Sabah,0,0,0,2006
2006-03-11,Sabah,0,0,0,2006
2006-03-12,Sabah,0,0,0,2006
2006-03-13,Sabah,1,0,1,2006
2006-03-14,Sabah,2,0,2,2006
2006-03-15,Sabah,1,0,1,2006
2006-03-16,Sabah,0,0,0,2006
2006-03-17,Sabah,3,0,3,2006
2006-03-18,Sabah,0,0,0,2006
2006-03-19,Sabah,1,0,1,2006
2006-03-20,Sabah,3,1,2,2006
2006-03-21,Sabah,0,0,0,2006
2006-03-22,Sabah,0,0,0,2006
2006-03-23,Sabah,0,0,0,2006
2006-03-24,Sabah,0,0,0,2006
2006-03-25,Sabah,0,0,0,2006
2006-03-26,Sabah,0,0,0,2006
2006-03-27,Sabah,0,0,0,2006
2006-03-28,Sabah,1,0,1,2006
2006-03-29,Sabah,0,0,0,2006
2006-03-30,Sabah,0,0,0,2006
2006-03-31,Sabah,0,0,0,2006
2006-04-01,Sabah,0,0,0,2006
2006-04-02,Sabah,0,0,0,2006
2006-04-03,Sabah,1,0,1,2006
2006-04-04,Sabah,0,0,0,2006
2006-04-05,Sabah,0,0,0,2006
2006-04-06,Sabah,0,0,0,2006
2006-04-07,Sabah,0,0,0,2006
2006-04-08,Sabah,0,0,0,2006
2006-04-09,Sabah,0,0,0,2006
2006-04-10,Sabah,0,0,0,2006
2006-04-11,Sabah,0,0,0,2006
2006-04-12,Sabah,0,0,0,2006
2006-04-13,Sabah,1,0,1,2006
2006-04-14,Sabah,0,0,0,2006
2006-04-15,Sabah,0,0,0,2006
2006-04-16,Sabah,0,0,0,2006
2006-04-17,Sabah,0,0,0,2006
2006-04-18,Sabah,0,0,0,2006
2006-04-19,Sabah,1,0,1,2006
2006-04-20,Sabah,4,4,0,2006
2006-04-21,Sabah,12,12,0,2006
2006-04-22,Sabah,0,0,0,2006
2006-04-23,Sabah,0,0,0,2006
2006-04-24,Sabah,11,10,1,2006
2006-04-25,Sabah,10,9,1,2006
2006-04-26,Sabah,7,7,0,2006
2006-04-27,Sabah,45,43,2,2006
2006-04-28,Sabah,5,4,1,2006
2006-04-29,Sabah,0,0,0,2006
2006-04-30,Sabah,0,0,0,2006
2006-05-01,Sabah,0,0,0,2006
2006-05-02,Sabah,85,83,2,2006
2006-05-03,Sabah,42,42,0,2006
2006-05-04,Sabah,37,36,1,2006
2006-05-05,Sabah,4,4,0,2006
2006-05-06,Sabah,0,0,0,2006
2006-05-07,Sabah,0,0,0,2006
2006-05-08,Sabah,11,11,0,2006
2006-05-09,Sabah,11,9,2,2006
2006-05-10,Sabah,15,13,2,2006
2006-05-11,Sabah,7,7,0,2006
2006-05-12,Sabah,0,0,0,2006
2006-05-13,Sabah,0,0,0,2006
2006-05-14,Sabah,0,0,0,2006
2006-05-15,Sabah,14,14,0,2006
2006-05-16,Sabah,11,11,0,2006
2006-05-17,Sabah,8,8,0,2006
2006-05-18,Sabah,6,6,0,2006
2006-05-19,Sabah,13,13,0,2006
2006-05-20,Sabah,0,0,0,2006
2006-05-21,Sabah,0,0,0,2006
2006-05-22,Sabah,16,15,1,2006
2006-05-23,Sabah,31,31,0,2006
2006-05-24,Sabah,11,11,0,2006
2006-05-25,Sabah,10,10,0,2006
2006-05-26,Sabah,14,14,0,2006
2006-05-27,Sabah,0,0,0,2006
2006-05-28,Sabah,0,0,0,2006
2006-05-29,Sabah,11,11,0,2006
2006-05-30,Sabah,0,0,0,2006
2006-05-31,Sabah,0,0,0,2006
2006-06-01,Sabah,26,24,2,2006
2006-06-02,Sabah,21,21,0,2006
2006-06-03,Sabah,25,24,1,2006
2006-06-04,Sabah,1,0,1,2006
2006-06-05,Sabah,17,17,0,2006
2006-06-06,Sabah,11,10,1,2006
2006-06-07,Sabah,19,16,3,2006
2006-06-08,Sabah,23,23,0,2006
2006-06-09,Sabah,22,21,1,2006
2006-06-10,Sabah,0,0,0,2006
2006-06-11,Sabah,0,0,0,2006
2006-06-12,Sabah,26,25,1,2006
2006-06-13,Sabah,56,56,0,2006
2006-06-14,Sabah,1,1,0,2006
2006-06-15,Sabah,68,67,1,2006
2006-06-16,Sabah,26,26,0,2006
2006-06-17,Sabah,0,0,0,2006
2006-06-18,Sabah,0,0,0,2006
2006-06-19,Sabah,15,15,0,2006
2006-06-20,Sabah,43,43,0,2006
2006-06-21,Sabah,24,24,0,2006
2006-06-22,Sabah,13,11,2,2006
2006-06-23,Sabah,10,10,0,2006
2006-06-24,Sabah,17,17,0,2006
2006-06-25,Sabah,0,0,0,2006
2006-06-26,Sabah,32,28,4,2006
2006-06-27,Sabah,7,6,1,2006
2006-06-28,Sabah,26,26,0,2006
2006-06-29,Sabah,20,17,3,2006
2006-06-30,Sabah,13,12,1,2006
2006-07-01,Sabah,0,0,0,2006
2006-07-02,Sabah,0,0,0,2006
2006-07-03,Sabah,39,35,4,2006
2006-07-04,Sabah,12,10,2,2006
2006-07-05,Sabah,14,12,2,2006
2006-07-06,Sabah,20,19,1,2006
2006-07-07,Sabah,16,16,0,2006
2006-07-08,Sabah,0,0,0,2006
2006-07-09,Sabah,0,0,0,2006
2006-07-10,Sabah,15,15,0,2006
2006-07-11,Sabah,19,17,2,2006
2006-07-12,Sabah,19,19,0,2006
2006-07-13,Sabah,10,9,1,2006
2006-07-14,Sabah,10,10,0,2006
2006-07-15,Sabah,0,0,0,2006
2006-07-16,Sabah,0,0,0,2006
2006-07-17,Sabah,15,14,1,2006
2006-07-18,Sabah,14,13,1,2006
2006-07-19,Sabah,24,23,1,2006
2006-07-20,Sabah,11,10,1,2006
2006-07-21,Sabah,13,12,1,2006
2006-07-22,Sabah,0,0,0,2006
2006-07-23,Sabah,0,0,0,2006
2006-07-24,Sabah,13,13,0,2006
2006-07-25,Sabah,27,26,1,2006
2006-07-26,Sabah,10,7,3,2006
2006-07-27,Sabah,13,12,1,2006
2006-07-28,Sabah,9,7,2,2006
2006-07-29,Sabah,0,0,0,2006
2006-07-30,Sabah,0,0,0,2006
2006-07-31,Sabah,21,20,1,2006
2006-08-01,Sabah,9,6,3,2006
2006-08-02,Sabah,28,24,4,2006
2006-08-03,Sabah,7,6,1,2006
2006-08-04,Sabah,5,4,1,2006
2006-08-05,Sabah,0,0,0,2006
2006-08-06,Sabah,0,0,0,2006
2006-08-07,Sabah,17,16,1,2006
2006-08-08,Sabah,21,18,3,2006
2006-08-09,Sabah,17,12,5,2006
2006-08-10,Sabah,17,13,4,2006
2006-08-11,Sabah,4,4,0,2006
2006-08-12,Sabah,0,0,0,2006
2006-08-13,Sabah,1,0,1,2006
2006-08-14,Sabah,14,11,3,2006
2006-08-15,Sabah,12,11,1,2006
2006-08-16,Sabah,6,4,2,2006
2006-08-17,Sabah,19,12,7,2006
2006-08-18,Sabah,9,8,1,2006
2006-08-19,Sabah,0,0,0,2006
2006-08-20,Sabah,0,0,0,2006
2006-08-21,Sabah,8,8,0,2006
2006-08-22,Sabah,22,21,1,2006
2006-08-23,Sabah,8,7,1,2006
2006-08-24,Sabah,8,6,2,2006
2006-08-25,Sabah,3,2,1,2006
2006-08-26,Sabah,0,0,0,2006
2006-08-27,Sabah,0,0,0,2006
2006-08-28,Sabah,9,8,1,2006
2006-08-29,Sabah,15,11,4,2006
2006-08-30,Sabah,2,2,0,2006
2006-08-31,Sabah,0,0,0,2006
2006-09-01,Sabah,1,1,0,2006
2006-09-02,Sabah,0,0,0,2006
2006-09-03,Sabah,0,0,0,2006
2006-09-04,Sabah,58,45,13,2006
2006-09-05,Sabah,8,6,2,2006
2006-09-06,Sabah,14,10,4,2006
2006-09-07,Sabah,5,5,0,2006
2006-09-08,Sabah,1,0,1,2006
2006-09-09,Sabah,0,0,0,2006
2006-09-10,Sabah,0,0,0,2006
2006-09-11,Sabah,9,9,0,2006
2006-09-12,Sabah,21,12,9,2006
2006-09-13,Sabah,13,7,6,2006
2006-09-14,Sabah,4,3,1,2006
2006-09-15,Sabah,7,7,0,2006
2006-09-16,Sabah,0,0,0,2006
2006-09-17,Sabah,0,0,0,2006
2006-09-18,Sabah,0,0,0,2006
2006-09-19,Sabah,0,0,0,2006
2006-09-20,Sabah,0,0,0,2006
2006-09-21,Sabah,1,0,1,2006
2006-09-22,Sabah,19,17,2,2006
2006-09-23,Sabah,0,0,0,2006
2006-09-24,Sabah,0,0,0,2006
2006-09-25,Sabah,7,3,4,2006
2006-09-26,Sabah,6,4,2,2006
2006-09-27,Sabah,5,4,1,2006
2006-09-28,Sabah,6,3,3,2006
2006-09-29,Sabah,9,4,5,2006
2006-09-30,Sabah,1,0,1,2006
2006-10-01,Sabah,0,0,0,2006
2006-10-02,Sabah,17,11,6,2006
2006-10-03,Sabah,7,5,2,2006
2006-10-04,Sabah,7,3,4,2006
2006-10-05,Sabah,6,3,3,2006
2006-10-06,Sabah,11,6,5,2006
2006-10-07,Sabah,6,3,3,2006
2006-10-08,Sabah,0,0,0,2006
2006-10-09,Sabah,9,8,1,2006
2006-10-10,Sabah,20,13,7,2006
2006-10-11,Sabah,16,12,4,2006
2006-10-12,Sabah,9,5,4,2006
2006-10-13,Sabah,11,9,2,2006
2006-10-14,Sabah,0,0,0,2006
2006-10-15,Sabah,0,0,0,2006
2006-10-16,Sabah,18,12,6,2006
2006-10-17,Sabah,22,17,5,2006
2006-10-18,Sabah,17,9,8,2006
2006-10-19,Sabah,15,9,6,2006
2006-10-20,Sabah,12,4,8,2006
2006-10-21,Sabah,0,0,0,2006
2006-10-22,Sabah,1,0,1,2006
2006-10-23,Sabah,8,4,4,2006
2006-10-24,Sabah,0,0,0,2006
2006-10-25,Sabah,3,3,0,2006
2006-10-26,Sabah,9,6,3,2006
2006-10-27,Sabah,20,15,5,2006
2006-10-28,Sabah,0,0,0,2006
2006-10-29,Sabah,0,0,0,2006
2006-10-30,Sabah,35,25,10,2006
2006-10-31,Sabah,24,16,8,2006
2006-11-01,Sabah,18,10,8,2006
2006-11-02,Sabah,19,11,8,2006
2006-11-03,Sabah,28,19,9,2006
2006-11-04,Sabah,7,4,3,2006
2006-11-05,Sabah,0,0,0,2006
2006-11-06,Sabah,26,14,12,2006
2006-11-07,Sabah,32,21,11,2006
2006-11-08,Sabah,37,26,11,2006
2006-11-09,Sabah,57,44,13,2006
2006-11-10,Sabah,28,24,4,2006
2006-11-11,Sabah,0,0,0,2006
2006-11-12,Sabah,1,0,1,2006
2006-11-13,Sabah,27,24,3,2006
2006-11-14,Sabah,18,12,6,2006
2006-11-15,Sabah,21,18,3,2006
2006-11-16,Sabah,38,30,8,2006
2006-11-17,Sabah,25,22,3,2006
2006-11-18,Sabah,0,0,0,2006
2006-11-19,Sabah,0,0,0,2006
2006-11-20,Sabah,14,11,3,2006
2006-11-21,Sabah,30,22,8,2006
2006-11-22,Sabah,8,6,2,2006
2006-11-23,Sabah,5,4,1,2006
2006-11-24,Sabah,5,3,2,2006
2006-11-25,Sabah,0,0,0,2006
2006-11-26,Sabah,0,0,0,2006
2006-11-27,Sabah,24,15,9,2006
2006-11-28,Sabah,27,19,8,2006
2006-11-29,Sabah,14,9,5,2006
2006-11-30,Sabah,25,16,9,2006
2006-12-01,Sabah,6,5,1,2006
2006-12-02,Sabah,0,0,0,2006
2006-12-03,Sabah,0,0,0,2006
2006-12-04,Sabah,12,10,2,2006
2006-12-05,Sabah,12,6,6,2006
2006-12-06,Sabah,5,3,2,2006
2006-12-07,Sabah,8,6,2,2006
2006-12-08,Sabah,9,5,4,2006
2006-12-09,Sabah,0,0,0,2006
2006-12-10,Sabah,0,0,0,2006
2006-12-11,Sabah,11,4,7,2006
2006-12-12,Sabah,13,11,2,2006
2006-12-13,Sabah,11,6,5,2006
2006-12-14,Sabah,7,5,2,2006
2006-12-15,Sabah,11,6,5,2006
2006-12-16,Sabah,1,1,0,2006
2006-12-17,Sabah,0,0,0,2006
2006-12-18,Sabah,15,8,7,2006
2006-12-19,Sabah,10,5,5,2006
2006-12-20,Sabah,14,8,6,2006
2006-12-21,Sabah,11,5,6,2006
2006-12-22,Sabah,13,11,2,2006
2006-12-23,Sabah,0,0,0,2006
2006-12-24,Sabah,0,0,0,2006
2006-12-25,Sabah,0,0,0,2006
2006-12-26,Sabah,16,10,6,2006
2006-12-27,Sabah,25,17,8,2006
2006-12-28,Sabah,13,11,2,2006
2006-12-29,Sabah,27,18,9,2006
2006-12-30,Sabah,1,0,1,2006
2006-12-31,Sabah,0,0,0,2006
2007-01-01,Sabah,0,0,0,2007
2007-01-02,Sabah,8,4,4,2007
2007-01-03,Sabah,18,14,4,2007
2007-01-04,Sabah,38,34,4,2007
2007-01-05,Sabah,63,53,10,2007
2007-01-06,Sabah,13,13,0,2007
2007-01-07,Sabah,6,6,0,2007
2007-01-08,Sabah,37,29,8,2007
2007-01-09,Sabah,59,48,11,2007
2007-01-10,Sabah,19,12,7,2007
2007-01-11,Sabah,97,88,9,2007
2007-01-12,Sabah,29,23,6,2007
2007-01-13,Sabah,19,19,0,2007
2007-01-14,Sabah,1,0,1,2007
2007-01-15,Sabah,31,28,3,2007
2007-01-16,Sabah,27,13,14,2007
2007-01-17,Sabah,31,22,9,2007
2007-01-18,Sabah,24,14,10,2007
2007-01-19,Sabah,21,17,4,2007
2007-01-20,Sabah,0,0,0,2007
2007-01-21,Sabah,0,0,0,2007
2007-01-22,Sabah,2,0,2,2007
2007-01-23,Sabah,16,9,7,2007
2007-01-24,Sabah,4,3,1,2007
2007-01-25,Sabah,22,17,5,2007
2007-01-26,Sabah,17,13,4,2007
2007-01-27,Sabah,0,0,0,2007
2007-01-28,Sabah,0,0,0,2007
2007-01-29,Sabah,6,6,0,2007
2007-01-30,Sabah,19,12,7,2007
2007-01-31,Sabah,24,17,7,2007
2007-02-01,Sabah,63,57,6,2007
2007-02-02,Sabah,48,34,14,2007
2007-02-03,Sabah,157,149,8,2007
2007-02-04,Sabah,0,0,0,2007
2007-02-05,Sabah,28,18,10,2007
2007-02-06,Sabah,33,23,10,2007
2007-02-07,Sabah,11,9,2,2007
2007-02-08,Sabah,13,9,4,2007
2007-02-09,Sabah,9,4,5,2007
2007-02-10,Sabah,0,0,0,2007
2007-02-11,Sabah,0,0,0,2007
2007-02-12,Sabah,12,5,7,2007
2007-02-13,Sabah,32,21,11,2007
2007-02-14,Sabah,18,9,9,2007
2007-02-15,Sabah,15,9,6,2007
2007-02-16,Sabah,7,5,2,2007
2007-02-17,Sabah,0,0,0,2007
2007-02-18,Sabah,0,0,0,2007
2007-02-19,Sabah,7,5,2,2007
2007-02-20,Sabah,22,22,0,2007
2007-02-21,Sabah,16,12,4,2007
2007-02-22,Sabah,31,19,12,2007
2007-02-23,Sabah,15,9,6,2007
2007-02-24,Sabah,0,0,0,2007
2007-02-25,Sabah,0,0,0,2007
2007-02-26,Sabah,23,9,14,2007
2007-02-27,Sabah,41,31,10,2007
2007-02-28,Sabah,25,16,9,2007
2007-03-01,Sabah,27,18,9,2007
2007-03-02,Sabah,15,7,8,2007
2007-03-03,Sabah,0,0,0,2007
2007-03-04,Sabah,0,0,0,2007
2007-03-05,Sabah,18,8,10,2007
2007-03-06,Sabah,22,14,8,2007
2007-03-07,Sabah,22,12,10,2007
2007-03-08,Sabah,18,12,6,2007
2007-03-09,Sabah,13,4,9,2007
2007-03-10,Sabah,0,0,0,2007
2007-03-11,Sabah,0,0,0,2007
2007-03-12,Sabah,10,7,3,2007
2007-03-13,Sabah,25,14,11,2007
2007-03-14,Sabah,29,16,13,2007
2007-03-15,Sabah,15,6,9,2007
2007-03-16,Sabah,9,4,5,2007
2007-03-17,Sabah,0,0,0,2007
2007-03-18,Sabah,0,0,0,2007
2007-03-19,Sabah,33,20,13,2007
2007-03-20,Sabah,15,7,8,2007
2007-03-21,Sabah,11,4,7,2007
2007-03-22,Sabah,14,3,11,2007
2007-03-23,Sabah,2,1,1,2007
2007-03-24,Sabah,0,0,0,2007
2007-03-25,Sabah,0,0,0,2007
2007-03-26,Sabah,21,12,9,2007
2007-03-27,Sabah,12,9,3,2007
2007-03-28,Sabah,5,4,1,2007
2007-03-29,Sabah,14,5,9,2007
2007-03-30,Sabah,13,9,4,2007
2007-03-31,Sabah,0,0,0,2007
2007-04-01,Sabah,0,0,0,2007
2007-04-02,Sabah,27,16,11,2007
2007-04-03,Sabah,12,4,8,2007
2007-04-04,Sabah,48,39,9,2007
2007-04-05,Sabah,26,20,6,2007
2007-04-06,Sabah,0,0,0,2007
2007-04-07,Sabah,1,0,1,2007
2007-04-08,Sabah,0,0,0,2007
2007-04-09,Sabah,26,11,15,2007
2007-04-10,Sabah,23,15,8,2007
2007-04-11,Sabah,22,15,7,2007
2007-04-12,Sabah,23,18,5,2007
2007-04-13,Sabah,13,3,10,2007
2007-04-14,Sabah,0,0,0,2007
2007-04-15,Sabah,0,0,0,2007
2007-04-16,Sabah,16,5,11,2007
2007-04-17,Sabah,37,25,12,2007
2007-04-18,Sabah,15,7,8,2007
2007-04-19,Sabah,16,9,7,2007
2007-04-20,Sabah,10,4,6,2007
2007-04-21,Sabah,0,0,0,2007
2007-04-22,Sabah,0,0,0,2007
2007-04-23,Sabah,12,7,5,2007
2007-04-24,Sabah,12,7,5,2007
2007-04-25,Sabah,16,8,8,2007
2007-04-26,Sabah,2,2,0,2007
2007-04-27,Sabah,13,7,6,2007
2007-04-28,Sabah,0,0,0,2007
2007-04-29,Sabah,0,0,0,2007
2007-04-30,Sabah,15,5,10,2007
2007-05-01,Sabah,7,7,0,2007
2007-05-02,Sabah,0,0,0,2007
2007-05-03,Sabah,19,13,6,2007
2007-05-04,Sabah,21,16,5,2007
2007-05-05,Sabah,0,0,0,2007
2007-05-06,Sabah,0,0,0,2007
2007-05-07,Sabah,24,17,7,2007
2007-05-08,Sabah,13,6,7,2007
2007-05-09,Sabah,15,7,8,2007
2007-05-10,Sabah,14,1,13,2007
2007-05-11,Sabah,5,2,3,2007
2007-05-12,Sabah,0,0,0,2007
2007-05-13,Sabah,0,0,0,2007
2007-05-14,Sabah,8,4,4,2007
2007-05-15,Sabah,16,5,11,2007
2007-05-16,Sabah,22,12,10,2007
2007-05-17,Sabah,16,7,9,2007
2007-05-18,Sabah,7,1,6,2007
2007-05-19,Sabah,0,0,0,2007
2007-05-20,Sabah,2,1,1,2007
2007-05-21,Sabah,35,25,10,2007
2007-05-22,Sabah,15,8,7,2007
2007-05-23,Sabah,7,4,3,2007
2007-05-24,Sabah,15,9,6,2007
2007-05-25,Sabah,6,4,2,2007
2007-05-26,Sabah,0,0,0,2007
2007-05-27,Sabah,0,0,0,2007
2007-05-28,Sabah,0,0,0,2007
2007-05-29,Sabah,21,18,3,2007
2007-05-30,Sabah,0,0,0,2007
2007-05-31,Sabah,0,0,0,2007
2007-06-01,Sabah,47,34,13,2007
2007-06-02,Sabah,1,0,1,2007
2007-06-03,Sabah,11,4,7,2007
2007-06-04,Sabah,31,20,11,2007
2007-06-05,Sabah,34,25,9,2007
2007-06-06,Sabah,43,35,8,2007
2007-06-07,Sabah,60,48,12,2007
2007-06-08,Sabah,20,16,4,2007
2007-06-09,Sabah,14,9,5,2007
2007-06-10,Sabah,9,8,1,2007
2007-06-11,Sabah,24,12,12,2007
2007-06-12,Sabah,30,24,6,2007
2007-06-13,Sabah,0,0,0,2007
2007-06-14,Sabah,56,36,20,2007
2007-06-15,Sabah,23,14,9,2007
2007-06-16,Sabah,19,17,2,2007
2007-06-17,Sabah,0,0,0,2007
2007-06-18,Sabah,22,16,6,2007
2007-06-19,Sabah,26,21,5,2007
2007-06-20,Sabah,18,16,2,2007
2007-06-21,Sabah,40,34,6,2007
2007-06-22,Sabah,2,2,0,2007
2007-06-23,Sabah,0,0,0,2007
2007-06-24,Sabah,1,1,0,2007
2007-06-25,Sabah,20,8,12,2007
2007-06-26,Sabah,12,6,6,2007
2007-06-27,Sabah,10,6,4,2007
2007-06-28,Sabah,8,3,5,2007
2007-06-29,Sabah,2,1,1,2007
2007-06-30,Sabah,0,0,0,2007
2007-07-01,Sabah,43,42,1,2007
2007-07-02,Sabah,17,13,4,2007
2007-07-03,Sabah,26,12,14,2007
2007-07-04,Sabah,33,24,9,2007
2007-07-05,Sabah,18,10,8,2007
2007-07-06,Sabah,127,118,9,2007
2007-07-07,Sabah,27,26,1,2007
2007-07-08,Sabah,62,51,11,2007
2007-07-09,Sabah,36,28,8,2007
2007-07-10,Sabah,44,32,12,2007
2007-07-11,Sabah,19,11,8,2007
2007-07-12,Sabah,125,105,20,2007
2007-07-13,Sabah,88,84,4,2007
2007-07-14,Sabah,34,33,1,2007
2007-07-15,Sabah,0,0,0,2007
2007-07-16,Sabah,196,174,22,2007
2007-07-17,Sabah,55,46,9,2007
2007-07-18,Sabah,39,31,8,2007
2007-07-19,Sabah,56,43,13,2007
2007-07-20,Sabah,96,90,6,2007
2007-07-21,Sabah,133,125,8,2007
2007-07-22,Sabah,18,17,1,2007
2007-07-23,Sabah,73,60,13,2007
2007-07-24,Sabah,49,41,8,2007
2007-07-25,Sabah,27,24,3,2007
2007-07-26,Sabah,65,55,10,2007
2007-07-27,Sabah,24,20,4,2007
2007-07-28,Sabah,161,148,13,2007
2007-07-29,Sabah,3,3,0,2007
2007-07-30,Sabah,36,22,14,2007
2007-07-31,Sabah,39,26,13,2007
2007-08-01,Sabah,43,35,8,2007
2007-08-02,Sabah,19,9,10,2007
2007-08-03,Sabah,48,39,9,2007
2007-08-04,Sabah,4,3,1,2007
2007-08-05,Sabah,46,44,2,2007
2007-08-06,Sabah,38,27,11,2007
2007-08-07,Sabah,18,7,11,2007
2007-08-08,Sabah,100,89,11,2007
2007-08-09,Sabah,32,24,8,2007
2007-08-10,Sabah,26,25,1,2007
2007-08-11,Sabah,108,99,9,2007
2007-08-12,Sabah,150,137,13,2007
2007-08-13,Sabah,66,58,8,2007
2007-08-14,Sabah,89,80,9,2007
2007-08-15,Sabah,82,65,17,2007
2007-08-16,Sabah,74,61,13,2007
2007-08-17,Sabah,59,54,5,2007
2007-08-18,Sabah,10,5,5,2007
2007-08-19,Sabah,115,108,7,2007
2007-08-20,Sabah,99,84,15,2007
2007-08-21,Sabah,41,35,6,2007
2007-08-22,Sabah,61,48,13,2007
2007-08-23,Sabah,33,27,6,2007
2007-08-24,Sabah,31,22,9,2007
2007-08-25,Sabah,102,96,6,2007
2007-08-26,Sabah,17,13,4,2007
2007-08-27,Sabah,37,31,6,2007
2007-08-28,Sabah,29,20,9,2007
2007-08-29,Sabah,32,26,6,2007
2007-08-30,Sabah,17,14,3,2007
2007-08-31,Sabah,9,7,2,2007
2007-09-01,Sabah,13,13,0,2007
2007-09-02,Sabah,109,96,13,2007
2007-09-03,Sabah,12,9,3,2007
2007-09-04,Sabah,42,29,13,2007
2007-09-05,Sabah,7,5,2,2007
2007-09-06,Sabah,112,97,15,2007
2007-09-07,Sabah,2,1,1,2007
2007-09-08,Sabah,578,523,55,2007
2007-09-09,Sabah,1,1,0,2007
2007-09-10,Sabah,66,48,18,2007
2007-09-11,Sabah,26,18,8,2007
2007-09-12,Sabah,42,31,11,2007
2007-09-13,Sabah,15,6,9,2007
2007-09-14,Sabah,6,1,5,2007
2007-09-15,Sabah,22,22,0,2007
2007-09-16,Sabah,142,126,16,2007
2007-09-17,Sabah,0,0,0,2007
2007-09-18,Sabah,72,49,23,2007
2007-09-19,Sabah,60,51,9,2007
2007-09-20,Sabah,10,8,2,2007
2007-09-21,Sabah,16,14,2,2007
2007-09-22,Sabah,26,25,1,2007
2007-09-23,Sabah,79,68,11,2007
2007-09-24,Sabah,27,17,10,2007
2007-09-25,Sabah,35,26,9,2007
2007-09-26,Sabah,62,58,4,2007
2007-09-27,Sabah,97,87,10,2007
2007-09-28,Sabah,43,35,8,2007
2007-09-29,Sabah,0,0,0,2007
2007-09-30,Sabah,35,32,3,2007
2007-10-01,Sabah,12,4,8,2007
2007-10-02,Sabah,10,6,4,2007
2007-10-03,Sabah,42,32,10,2007
2007-10-04,Sabah,53,46,7,2007
2007-10-05,Sabah,51,39,12,2007
2007-10-06,Sabah,12,6,6,2007
2007-10-07,Sabah,57,53,4,2007
2007-10-08,Sabah,18,10,8,2007
2007-10-09,Sabah,82,60,22,2007
2007-10-10,Sabah,22,15,7,2007
2007-10-11,Sabah,25,18,7,2007
2007-10-12,Sabah,38,29,9,2007
2007-10-13,Sabah,12,8,4,2007
2007-10-14,Sabah,33,30,3,2007
2007-10-15,Sabah,18,12,6,2007
2007-10-16,Sabah,39,25,14,2007
2007-10-17,Sabah,53,36,17,2007
2007-10-18,Sabah,6,4,2,2007
2007-10-19,Sabah,6,4,2,2007
2007-10-20,Sabah,77,69,8,2007
2007-10-21,Sabah,101,89,12,2007
2007-10-22,Sabah,66,45,21,2007
2007-10-23,Sabah,136,87,49,2007
2007-10-24,Sabah,79,54,25,2007
2007-10-25,Sabah,85,76,9,2007
2007-10-26,Sabah,37,19,18,2007
2007-10-27,Sabah,80,62,18,2007
2007-10-28,Sabah,5,5,0,2007
2007-10-29,Sabah,81,49,32,2007
2007-10-30,Sabah,135,87,48,2007
2007-10-31,Sabah,92,80,12,2007
2007-11-01,Sabah,13,13,0,2007
2007-11-02,Sabah,75,32,43,2007
2007-11-03,Sabah,18,14,4,2007
2007-11-04,Sabah,96,84,12,2007
2007-11-05,Sabah,9,3,6,2007
2007-11-06,Sabah,51,35,16,2007
2007-11-07,Sabah,118,98,20,2007
2007-11-08,Sabah,17,15,2,2007
2007-11-09,Sabah,19,8,11,2007
2007-11-10,Sabah,147,127,20,2007
2007-11-11,Sabah,138,73,65,2007
2007-11-12,Sabah,20,18,2,2007
2007-11-13,Sabah,91,58,33,2007
2007-11-14,Sabah,87,54,33,2007
2007-11-15,Sabah,40,23,17,2007
2007-11-16,Sabah,46,40,6,2007
2007-11-17,Sabah,101,80,21,2007
2007-11-18,Sabah,57,44,13,2007
2007-11-19,Sabah,44,26,18,2007
2007-11-20,Sabah,21,11,10,2007
2007-11-21,Sabah,33,25,8,2007
2007-11-22,Sabah,111,90,21,2007
2007-11-23,Sabah,1,0,1,2007
2007-11-24,Sabah,0,0,0,2007
2007-11-25,Sabah,77,57,20,2007
2007-11-26,Sabah,0,0,0,2007
2007-11-27,Sabah,27,9,18,2007
2007-11-28,Sabah,18,10,8,2007
2007-11-29,Sabah,39,20,19,2007
2007-11-30,Sabah,40,22,18,2007
2007-12-01,Sabah,23,18,5,2007
2007-12-02,Sabah,23,21,2,2007
2007-12-03,Sabah,19,10,9,2007
2007-12-04,Sabah,25,17,8,2007
2007-12-05,Sabah,55,47,8,2007
2007-12-06,Sabah,97,69,28,2007
2007-12-07,Sabah,91,72,19,2007
2007-12-08,Sabah,28,16,12,2007
2007-12-09,Sabah,129,107,22,2007
2007-12-10,Sabah,66,51,15,2007
2007-12-11,Sabah,32,19,13,2007
2007-12-12,Sabah,37,19,18,2007
2007-12-13,Sabah,83,64,19,2007
2007-12-14,Sabah,22,10,12,2007
2007-12-15,Sabah,104,86,18,2007
2007-12-16,Sabah,238,140,98,2007
2007-12-17,Sabah,21,14,7,2007
2007-12-18,Sabah,54,35,19,2007
2007-12-19,Sabah,24,16,8,2007
2007-12-20,Sabah,0,0,0,2007
2007-12-21,Sabah,27,17,10,2007
2007-12-22,Sabah,12,8,4,2007
2007-12-23,Sabah,132,92,40,2007
2007-12-24,Sabah,5,2,3,2007
2007-12-25,Sabah,9,5,4,2007
2007-12-26,Sabah,11,2,9,2007
2007-12-27,Sabah,42,30,12,2007
2007-12-28,Sabah,26,23,3,2007
2007-12-29,Sabah,18,9,9,2007
2007-12-30,Sabah,6,5,1,2007
2007-12-31,Sabah,73,54,19,2007
2008-01-01,Sabah,0,0,0,2008
2008-01-02,Sabah,15,4,11,2008
2008-01-03,Sabah,17,10,7,2008
2008-01-04,Sabah,30,16,14,2008
2008-01-05,Sabah,12,10,2,2008
2008-01-06,Sabah,23,20,3,2008
2008-01-07,Sabah,35,22,13,2008
2008-01-08,Sabah,109,86,23,2008
2008-01-09,Sabah,88,56,32,2008
2008-01-10,Sabah,74,57,17,2008
2008-01-11,Sabah,40,31,9,2008
2008-01-12,Sabah,13,8,5,2008
2008-01-13,Sabah,21,21,0,2008
2008-01-14,Sabah,82,64,18,2008
2008-01-15,Sabah,72,54,18,2008
2008-01-16,Sabah,72,43,29,2008
2008-01-17,Sabah,61,45,16,2008
2008-01-18,Sabah,62,53,9,2008
2008-01-19,Sabah,40,31,9,2008
2008-01-20,Sabah,98,62,36,2008
2008-01-21,Sabah,59,42,17,2008
2008-01-22,Sabah,2,0,2,2008
2008-01-23,Sabah,24,5,19,2008
2008-01-24,Sabah,52,35,17,2008
2008-01-25,Sabah,20,16,4,2008
2008-01-26,Sabah,74,51,23,2008
2008-01-27,Sabah,51,35,16,2008
2008-01-28,Sabah,75,63,12,2008
2008-01-29,Sabah,60,44,16,2008
2008-01-30,Sabah,16,8,8,2008
2008-01-31,Sabah,139,100,39,2008
2008-02-01,Sabah,10,5,5,2008
2008-02-02,Sabah,63,29,34,2008
2008-02-03,Sabah,21,13,8,2008
2008-02-04,Sabah,73,58,15,2008
2008-02-05,Sabah,8,3,5,2008
2008-02-06,Sabah,23,8,15,2008
2008-02-07,Sabah,18,10,8,2008
2008-02-08,Sabah,11,10,1,2008
2008-02-09,Sabah,22,14,8,2008
2008-02-10,Sabah,4,1,3,2008
2008-02-11,Sabah,49,31,18,2008
2008-02-12,Sabah,25,18,7,2008
2008-02-13,Sabah,97,47,50,2008
2008-02-14,Sabah,46,17,29,2008
2008-02-15,Sabah,133,94,39,2008
2008-02-16,Sabah,49,35,14,2008
2008-02-17,Sabah,26,19,7,2008
2008-02-18,Sabah,144,114,30,2008
2008-02-19,Sabah,157,133,24,2008
2008-02-20,Sabah,21,8,13,2008
2008-02-21,Sabah,35,19,16,2008
2008-02-22,Sabah,29,23,6,2008
2008-02-23,Sabah,26,25,1,2008
2008-02-24,Sabah,94,80,14,2008
2008-02-25,Sabah,93,45,48,2008
2008-02-26,Sabah,45,23,22,2008
2008-02-27,Sabah,14,6,8,2008
2008-02-28,Sabah,47,32,15,2008
2008-02-29,Sabah,45,28,17,2008
2008-03-01,Sabah,47,32,15,2008
2008-03-02,Sabah,53,30,23,2008
2008-03-03,Sabah,150,106,44,2008
2008-03-04,Sabah,36,23,13,2008
2008-03-05,Sabah,42,25,17,2008
2008-03-06,Sabah,78,61,17,2008
2008-03-07,Sabah,58,30,28,2008
2008-03-08,Sabah,2,2,0,2008
2008-03-09,Sabah,99,49,50,2008
2008-03-10,Sabah,112,81,31,2008
2008-03-11,Sabah,30,16,14,2008
2008-03-12,Sabah,168,130,38,2008
2008-03-13,Sabah,30,15,15,2008
2008-03-14,Sabah,29,15,14,2008
2008-03-15,Sabah,179,127,52,2008
2008-03-16,Sabah,286,135,151,2008
2008-03-17,Sabah,56,31,25,2008
2008-03-18,Sabah,34,17,17,2008
2008-03-19,Sabah,228,214,14,2008
2008-03-20,Sabah,0,0,0,2008
2008-03-21,Sabah,1,1,0,2008
2008-03-22,Sabah,0,0,0,2008
2008-03-23,Sabah,80,39,41,2008
2008-03-24,Sabah,26,13,13,2008
2008-03-25,Sabah,155,132,23,2008
2008-03-26,Sabah,17,7,10,2008
2008-03-27,Sabah,37,15,22,2008
2008-03-28,Sabah,16,11,5,2008
2008-03-29,Sabah,30,22,8,2008
2008-03-30,Sabah,74,49,25,2008
2008-03-31,Sabah,14,7,7,2008
2008-04-01,Sabah,40,19,21,2008
2008-04-02,Sabah,28,11,17,2008
2008-04-03,Sabah,50,31,19,2008
2008-04-04,Sabah,71,47,24,2008
2008-04-05,Sabah,7,2,5,2008
2008-04-06,Sabah,95,70,25,2008
2008-04-07,Sabah,21,4,17,2008
2008-04-08,Sabah,60,36,24,2008
2008-04-09,Sabah,84,69,15,2008
2008-04-10,Sabah,41,28,13,2008
2008-04-11,Sabah,9,2,7,2008
2008-04-12,Sabah,36,30,6,2008
2008-04-13,Sabah,68,48,20,2008
2008-04-14,Sabah,67,33,34,2008
2008-04-15,Sabah,24,3,21,2008
2008-04-16,Sabah,85,30,55,2008
2008-04-17,Sabah,63,38,25,2008
2008-04-18,Sabah,56,47,9,2008
2008-04-19,Sabah,55,48,7,2008
2008-04-20,Sabah,58,16,42,2008
2008-04-21,Sabah,43,22,21,2008
2008-04-22,Sabah,31,19,12,2008
2008-04-23,Sabah,33,13,20,2008
2008-04-24,Sabah,8,1,7,2008
2008-04-25,Sabah,24,18,6,2008
2008-04-26,Sabah,47,42,5,2008
2008-04-27,Sabah,57,31,26,2008
2008-04-28,Sabah,15,5,10,2008
2008-04-29,Sabah,29,18,11,2008
2008-04-30,Sabah,104,52,52,2008
2008-05-01,Sabah,66,53,13,2008
2008-05-02,Sabah,16,8,8,2008
2008-05-03,Sabah,8,3,5,2008
2008-05-04,Sabah,24,17,7,2008
2008-05-05,Sabah,8,5,3,2008
2008-05-06,Sabah,19,10,9,2008
2008-05-07,Sabah,79,61,18,2008
2008-05-08,Sabah,110,60,50,2008
2008-05-09,Sabah,67,34,33,2008
2008-05-10,Sabah,84,64,20,2008
2008-05-11,Sabah,77,46,31,2008
2008-05-12,Sabah,31,16,15,2008
2008-05-13,Sabah,62,30,32,2008
2008-05-14,Sabah,117,53,64,2008
2008-05-15,Sabah,196,115,81,2008
2008-05-16,Sabah,103,63,40,2008
2008-05-17,Sabah,15,14,1,2008
2008-05-18,Sabah,22,6,16,2008
2008-05-19,Sabah,143,112,31,2008
2008-05-20,Sabah,35,19,16,2008
2008-05-21,Sabah,35,25,10,2008
2008-05-22,Sabah,27,11,16,2008
2008-05-23,Sabah,38,19,19,2008
2008-05-24,Sabah,31,12,19,2008
2008-05-25,Sabah,31,26,5,2008
2008-05-26,Sabah,32,21,11,2008
2008-05-27,Sabah,23,13,10,2008
2008-05-28,Sabah,35,34,1,2008
2008-05-29,Sabah,36,8,28,2008
2008-05-30,Sabah,20,14,6,2008
2008-05-31,Sabah,0,0,0,2008
2008-06-01,Sabah,0,0,0,2008
2008-06-02,Sabah,26,16,10,2008
2008-06-03,Sabah,76,34,42,2008
2008-06-04,Sabah,27,13,14,2008
2008-06-05,Sabah,24,16,8,2008
2008-06-06,Sabah,25,16,9,2008
2008-06-07,Sabah,8,1,7,2008
2008-06-08,Sabah,72,56,16,2008
2008-06-09,Sabah,30,14,16,2008
2008-06-10,Sabah,71,23,48,2008
2008-06-11,Sabah,40,26,14,2008
2008-06-12,Sabah,33,15,18,2008
2008-06-13,Sabah,26,7,19,2008
2008-06-14,Sabah,146,80,66,2008
2008-06-15,Sabah,214,72,142,2008
2008-06-16,Sabah,16,7,9,2008
2008-06-17,Sabah,16,7,9,2008
2008-06-18,Sabah,17,17,0,2008
2008-06-19,Sabah,29,5,24,2008
2008-06-20,Sabah,18,10,8,2008
2008-06-21,Sabah,38,26,12,2008
2008-06-22,Sabah,53,27,26,2008
2008-06-23,Sabah,37,23,14,2008
2008-06-24,Sabah,79,45,34,2008
2008-06-25,Sabah,87,78,9,2008
2008-06-26,Sabah,37,21,16,2008
2008-06-27,Sabah,42,27,15,2008
2008-06-28,Sabah,19,15,4,2008
2008-06-29,Sabah,88,50,38,2008
2008-06-30,Sabah,6,1,5,2008
2008-07-01,Sabah,21,13,8,2008
2008-07-02,Sabah,72,42,30,2008
2008-07-03,Sabah,37,13,24,2008
2008-07-04,Sabah,29,13,16,2008
2008-07-05,Sabah,23,18,5,2008
2008-07-06,Sabah,0,0,0,2008
2008-07-07,Sabah,24,9,15,2008
2008-07-08,Sabah,47,18,29,2008
2008-07-09,Sabah,44,17,27,2008
2008-07-10,Sabah,14,6,8,2008
2008-07-11,Sabah,11,2,9,2008
2008-07-12,Sabah,41,29,12,2008
2008-07-13,Sabah,29,19,10,2008
2008-07-14,Sabah,165,110,55,2008
2008-07-15,Sabah,68,33,35,2008
2008-07-16,Sabah,43,20,23,2008
2008-07-17,Sabah,76,40,36,2008
2008-07-18,Sabah,13,5,8,2008
2008-07-19,Sabah,20,19,1,2008
2008-07-20,Sabah,84,27,57,2008
2008-07-21,Sabah,28,15,13,2008
2008-07-22,Sabah,126,58,68,2008
2008-07-23,Sabah,278,169,109,2008
2008-07-24,Sabah,22,11,11,2008
2008-07-25,Sabah,33,28,5,2008
2008-07-26,Sabah,121,98,23,2008
2008-07-27,Sabah,43,23,20,2008
2008-07-28,Sabah,2,0,2,2008
2008-07-29,Sabah,32,15,17,2008
2008-07-30,Sabah,30,12,18,2008
2008-07-31,Sabah,37,15,22,2008
2008-08-01,Sabah,41,17,24,2008
2008-08-02,Sabah,66,51,15,2008
2008-08-03,Sabah,76,43,33,2008
2008-08-04,Sabah,99,48,51,2008
2008-08-05,Sabah,75,36,39,2008
2008-08-06,Sabah,86,37,49,2008
2008-08-07,Sabah,173,120,53,2008
2008-08-08,Sabah,76,49,27,2008
2008-08-09,Sabah,37,23,14,2008
2008-08-10,Sabah,14,11,3,2008
2008-08-11,Sabah,27,12,15,2008
2008-08-12,Sabah,177,149,28,2008
2008-08-13,Sabah,39,25,14,2008
2008-08-14,Sabah,12,5,7,2008
2008-08-15,Sabah,40,25,15,2008
2008-08-16,Sabah,20,14,6,2008
2008-08-17,Sabah,103,72,31,2008
2008-08-18,Sabah,7,4,3,2008
2008-08-19,Sabah,31,11,20,2008
2008-08-20,Sabah,47,35,12,2008
2008-08-21,Sabah,19,15,4,2008
2008-08-22,Sabah,75,38,37,2008
2008-08-23,Sabah,77,43,34,2008
2008-08-24,Sabah,31,7,24,2008
2008-08-25,Sabah,2,1,1,2008
2008-08-26,Sabah,29,5,24,2008
2008-08-27,Sabah,92,41,51,2008
2008-08-28,Sabah,59,30,29,2008
2008-08-29,Sabah,26,11,15,2008
2008-08-30,Sabah,951,597,354,2008
2008-08-31,Sabah,48,24,24,2008
2008-09-01,Sabah,0,0,0,2008
2008-09-02,Sabah,6,0,6,2008
2008-09-03,Sabah,14,8,6,2008
2008-09-04,Sabah,6,3,3,2008
2008-09-05,Sabah,10,2,8,2008
2008-09-06,Sabah,0,0,0,2008
2008-09-07,Sabah,83,31,52,2008
2008-09-08,Sabah,46,23,23,2008
2008-09-09,Sabah,75,40,35,2008
2008-09-10,Sabah,113,74,39,2008
2008-09-11,Sabah,24,14,10,2008
2008-09-12,Sabah,16,9,7,2008
2008-09-13,Sabah,46,21,25,2008
2008-09-14,Sabah,83,57,26,2008
2008-09-15,Sabah,23,9,14,2008
2008-09-16,Sabah,43,32,11,2008
2008-09-17,Sabah,17,2,15,2008
2008-09-18,Sabah,29,9,20,2008
2008-09-19,Sabah,14,8,6,2008
2008-09-20,Sabah,39,30,9,2008
2008-09-21,Sabah,172,65,107,2008
2008-09-22,Sabah,44,27,17,2008
2008-09-23,Sabah,17,7,10,2008
2008-09-24,Sabah,7,2,5,2008
2008-09-25,Sabah,5,1,4,2008
2008-09-26,Sabah,9,2,7,2008
2008-09-27,Sabah,104,72,32,2008
2008-09-28,Sabah,68,19,49,2008
2008-09-29,Sabah,5,1,4,2008
2008-09-30,Sabah,1,0,1,2008
2008-10-01,Sabah,0,0,0,2008
2008-10-02,Sabah,7,4,3,2008
2008-10-03,Sabah,4,1,3,2008
2008-10-04,Sabah,5,1,4,2008
2008-10-05,Sabah,28,17,11,2008
2008-10-06,Sabah,31,26,5,2008
2008-10-07,Sabah,13,3,10,2008
2008-10-08,Sabah,33,12,21,2008
2008-10-09,Sabah,44,22,22,2008
2008-10-10,Sabah,44,18,26,2008
2008-10-11,Sabah,70,50,20,2008
2008-10-12,Sabah,18,6,12,2008
2008-10-13,Sabah,23,11,12,2008
2008-10-14,Sabah,40,18,22,2008
2008-10-15,Sabah,53,20,33,2008
2008-10-16,Sabah,28,12,16,2008
2008-10-17,Sabah,60,27,33,2008
2008-10-18,Sabah,22,13,9,2008
2008-10-19,Sabah,49,7,42,2008
2008-10-20,Sabah,46,20,26,2008
2008-10-21,Sabah,64,24,40,2008
2008-10-22,Sabah,42,18,24,2008
2008-10-23,Sabah,106,89,17,2008
2008-10-24,Sabah,33,18,15,2008
2008-10-25,Sabah,82,39,43,2008
2008-10-26,Sabah,171,111,60,2008
2008-10-27,Sabah,0,0,0,2008
2008-10-28,Sabah,40,25,15,2008
2008-10-29,Sabah,47,23,24,2008
2008-10-30,Sabah,25,16,9,2008
2008-10-31,Sabah,24,10,14,2008
2008-11-01,Sabah,66,50,16,2008
2008-11-02,Sabah,223,173,50,2008
2008-11-03,Sabah,18,3,15,2008
2008-11-04,Sabah,16,7,9,2008
2008-11-05,Sabah,52,25,27,2008
2008-11-06,Sabah,32,14,18,2008
2008-11-07,Sabah,43,8,35,2008
2008-11-08,Sabah,17,5,12,2008
2008-11-09,Sabah,43,19,24,2008
2008-11-10,Sabah,18,12,6,2008
2008-11-11,Sabah,38,10,28,2008
2008-11-12,Sabah,14,11,3,2008
2008-11-13,Sabah,37,21,16,2008
2008-11-14,Sabah,21,9,12,2008
2008-11-15,Sabah,2,0,2,2008
2008-11-16,Sabah,52,32,20,2008
2008-11-17,Sabah,34,16,18,2008
2008-11-18,Sabah,39,15,24,2008
2008-11-19,Sabah,50,24,26,2008
2008-11-20,Sabah,34,17,17,2008
2008-11-21,Sabah,74,39,35,2008
2008-11-22,Sabah,83,33,50,2008
2008-11-23,Sabah,66,39,27,2008
2008-11-24,Sabah,18,7,11,2008
2008-11-25,Sabah,22,6,16,2008
2008-11-26,Sabah,78,29,49,2008
2008-11-27,Sabah,11,1,10,2008
2008-11-28,Sabah,74,19,55,2008
2008-11-29,Sabah,22,11,11,2008
2008-11-30,Sabah,12,6,6,2008
2008-12-01,Sabah,21,7,14,2008
2008-12-02,Sabah,59,29,30,2008
2008-12-03,Sabah,61,25,36,2008
2008-12-04,Sabah,17,6,11,2008
2008-12-05,Sabah,34,11,23,2008
2008-12-06,Sabah,22,13,9,2008
2008-12-07,Sabah,29,14,15,2008
2008-12-08,Sabah,0,0,0,2008
2008-12-09,Sabah,27,18,9,2008
2008-12-10,Sabah,50,32,18,2008
2008-12-11,Sabah,23,5,18,2008
2008-12-12,Sabah,38,16,22,2008
2008-12-13,Sabah,116,76,40,2008
2008-12-14,Sabah,94,38,56,2008
2008-12-15,Sabah,35,18,17,2008
2008-12-16,Sabah,23,13,10,2008
2008-12-17,Sabah,64,31,33,2008
2008-12-18,Sabah,50,29,21,2008
2008-12-19,Sabah,112,72,40,2008
2008-12-20,Sabah,40,22,18,2008
2008-12-21,Sabah,170,40,130,2008
2008-12-22,Sabah,12,6,6,2008
2008-12-23,Sabah,54,28,26,2008
2008-12-24,Sabah,14,3,11,2008
2008-12-25,Sabah,20,12,8,2008
2008-12-26,Sabah,10,2,8,2008
2008-12-27,Sabah,46,27,19,2008
2008-12-28,Sabah,56,24,32,2008
2008-12-29,Sabah,2,1,1,2008
2008-12-30,Sabah,19,7,12,2008
2008-12-31,Sabah,24,15,9,2008
2009-01-01,Sabah,0,0,0,2009
2009-01-02,Sabah,28,7,21,2009
2009-01-03,Sabah,8,3,5,2009
2009-01-04,Sabah,31,17,14,2009
2009-01-05,Sabah,12,2,10,2009
2009-01-06,Sabah,43,30,13,2009
2009-01-07,Sabah,40,22,18,2009
2009-01-08,Sabah,74,37,37,2009
2009-01-09,Sabah,23,8,15,2009
2009-01-10,Sabah,161,78,83,2009
2009-01-11,Sabah,2,0,2,2009
2009-01-12,Sabah,88,39,49,2009
2009-01-13,Sabah,31,20,11,2009
2009-01-14,Sabah,76,22,54,2009
2009-01-15,Sabah,67,53,14,2009
2009-01-16,Sabah,22,8,14,2009
2009-01-17,Sabah,157,82,75,2009
2009-01-18,Sabah,0,0,0,2009
2009-01-19,Sabah,15,5,10,2009
2009-01-20,Sabah,47,13,34,2009
2009-01-21,Sabah,95,56,39,2009
2009-01-22,Sabah,43,35,8,2009
2009-01-23,Sabah,39,18,21,2009
2009-01-24,Sabah,42,29,13,2009
2009-01-25,Sabah,31,4,27,2009
2009-01-26,Sabah,0,0,0,2009
2009-01-27,Sabah,0,0,0,2009
2009-01-28,Sabah,61,32,29,2009
2009-01-29,Sabah,90,39,51,2009
2009-01-30,Sabah,21,6,15,2009
2009-01-31,Sabah,36,27,9,2009
2009-02-01,Sabah,0,0,0,2009
2009-02-02,Sabah,19,8,11,2009
2009-02-03,Sabah,112,76,36,2009
2009-02-04,Sabah,54,28,26,2009
2009-02-05,Sabah,51,32,19,2009
2009-02-06,Sabah,23,9,14,2009
2009-02-07,Sabah,39,16,23,2009
2009-02-08,Sabah,1,0,1,2009
2009-02-09,Sabah,29,11,18,2009
2009-02-10,Sabah,81,23,58,2009
2009-02-11,Sabah,54,36,18,2009
2009-02-12,Sabah,43,21,22,2009
2009-02-13,Sabah,59,32,27,2009
2009-02-14,Sabah,32,21,11,2009
2009-02-15,Sabah,63,31,32,2009
2009-02-16,Sabah,66,26,40,2009
2009-02-17,Sabah,25,11,14,2009
2009-02-18,Sabah,50,26,24,2009
2009-02-19,Sabah,36,15,21,2009
2009-02-20,Sabah,62,37,25,2009
2009-02-21,Sabah,22,8,14,2009
2009-02-22,Sabah,91,38,53,2009
2009-02-23,Sabah,311,199,112,2009
2009-02-24,Sabah,117,62,55,2009
2009-02-25,Sabah,206,88,118,2009
2009-02-26,Sabah,43,22,21,2009
2009-02-27,Sabah,74,65,9,2009
2009-02-28,Sabah,26,17,9,2009
2009-03-01,Sabah,34,29,5,2009
2009-03-02,Sabah,31,10,21,2009
2009-03-03,Sabah,110,77,33,2009
2009-03-04,Sabah,111,80,31,2009
2009-03-05,Sabah,29,15,14,2009
2009-03-06,Sabah,29,11,18,2009
2009-03-07,Sabah,7,1,6,2009
2009-03-08,Sabah,101,55,46,2009
2009-03-09,Sabah,34,4,30,2009
2009-03-10,Sabah,66,30,36,2009
2009-03-11,Sabah,47,21,26,2009
2009-03-12,Sabah,69,23,46,2009
2009-03-13,Sabah,53,28,25,2009
2009-03-14,Sabah,8,5,3,2009
2009-03-15,Sabah,170,45,125,2009
2009-03-16,Sabah,18,9,9,2009
2009-03-17,Sabah,33,16,17,2009
2009-03-18,Sabah,130,85,45,2009
2009-03-19,Sabah,17,7,10,2009
2009-03-20,Sabah,41,25,16,2009
2009-03-21,Sabah,138,79,59,2009
2009-03-22,Sabah,86,20,66,2009
2009-03-23,Sabah,31,12,19,2009
2009-03-24,Sabah,15,5,10,2009
2009-03-25,Sabah,88,55,33,2009
2009-03-26,Sabah,57,34,23,2009
2009-03-27,Sabah,55,20,35,2009
2009-03-28,Sabah,32,17,15,2009
2009-03-29,Sabah,23,14,9,2009
2009-03-30,Sabah,34,5,29,2009
2009-03-31,Sabah,66,23,43,2009
2009-04-01,Sabah,84,58,26,2009
2009-04-02,Sabah,53,24,29,2009
2009-04-03,Sabah,43,10,33,2009
2009-04-04,Sabah,6,3,3,2009
2009-04-05,Sabah,9,4,5,2009
2009-04-06,Sabah,28,11,17,2009
2009-04-07,Sabah,87,52,35,2009
2009-04-08,Sabah,23,12,11,2009
2009-04-09,Sabah,31,18,13,2009
2009-04-10,Sabah,21,13,8,2009
2009-04-11,Sabah,60,38,22,2009
2009-04-12,Sabah,15,5,10,2009
2009-04-13,Sabah,42,8,34,2009
2009-04-14,Sabah,47,28,19,2009
2009-04-15,Sabah,58,14,44,2009
2009-04-16,Sabah,34,11,23,2009
2009-04-17,Sabah,88,68,20,2009
2009-04-18,Sabah,13,6,7,2009
2009-04-19,Sabah,57,28,29,2009
2009-04-20,Sabah,70,26,44,2009
2009-04-21,Sabah,196,126,70,2009
2009-04-22,Sabah,45,22,23,2009
2009-04-23,Sabah,21,9,12,2009
2009-04-24,Sabah,71,29,42,2009
2009-04-25,Sabah,36,22,14,2009
2009-04-26,Sabah,76,22,54,2009
2009-04-27,Sabah,133,82,51,2009
2009-04-28,Sabah,162,74,88,2009
2009-04-29,Sabah,20,8,12,2009
2009-04-30,Sabah,29,16,13,2009
2009-05-01,Sabah,70,33,37,2009
2009-05-02,Sabah,70,38,32,2009
2009-05-03,Sabah,129,52,77,2009
2009-05-04,Sabah,67,42,25,2009
2009-05-05,Sabah,20,3,17,2009
2009-05-06,Sabah,61,29,32,2009
2009-05-07,Sabah,40,30,10,2009
2009-05-08,Sabah,13,4,9,2009
2009-05-09,Sabah,209,91,118,2009
2009-05-10,Sabah,198,108,90,2009
2009-05-11,Sabah,39,14,25,2009
2009-05-12,Sabah,11,3,8,2009
2009-05-13,Sabah,36,11,25,2009
2009-05-14,Sabah,37,20,17,2009
2009-05-15,Sabah,7,1,6,2009
2009-05-16,Sabah,95,57,38,2009
2009-05-17,Sabah,0,0,0,2009
2009-05-18,Sabah,41,4,37,2009
2009-05-19,Sabah,70,49,21,2009
2009-05-20,Sabah,56,23,33,2009
2009-05-21,Sabah,67,32,35,2009
2009-05-22,Sabah,20,11,9,2009
2009-05-23,Sabah,71,38,33,2009
2009-05-24,Sabah,76,36,40,2009
2009-05-25,Sabah,25,9,16,2009
2009-05-26,Sabah,33,8,25,2009
2009-05-27,Sabah,40,9,31,2009
2009-05-28,Sabah,20,12,8,2009
2009-05-29,Sabah,6,1,5,2009
2009-05-30,Sabah,9,8,1,2009
2009-05-31,Sabah,15,10,5,2009
2009-06-01,Sabah,10,7,3,2009
2009-06-02,Sabah,39,25,14,2009
2009-06-03,Sabah,61,47,14,2009
2009-06-04,Sabah,35,11,24,2009
2009-06-05,Sabah,46,31,15,2009
2009-06-06,Sabah,6,4,2,2009
2009-06-07,Sabah,0,0,0,2009
2009-06-08,Sabah,34,20,14,2009
2009-06-09,Sabah,63,37,26,2009
2009-06-10,Sabah,115,93,22,2009
2009-06-11,Sabah,36,18,18,2009
2009-06-12,Sabah,32,15,17,2009
2009-06-13,Sabah,60,41,19,2009
2009-06-14,Sabah,41,24,17,2009
2009-06-15,Sabah,11,1,10,2009
2009-06-16,Sabah,60,29,31,2009
2009-06-17,Sabah,17,6,11,2009
2009-06-18,Sabah,61,47,14,2009
2009-06-19,Sabah,68,36,32,2009
2009-06-20,Sabah,60,36,24,2009
2009-06-21,Sabah,163,45,118,2009
2009-06-22,Sabah,40,15,25,2009
2009-06-23,Sabah,63,33,30,2009
2009-06-24,Sabah,40,26,14,2009
2009-06-25,Sabah,57,31,26,2009
2009-06-26,Sabah,12,5,7,2009
2009-06-27,Sabah,68,35,33,2009
2009-06-28,Sabah,177,70,107,2009
2009-06-29,Sabah,89,30,59,2009
2009-06-30,Sabah,48,21,27,2009
2009-07-01,Sabah,42,23,19,2009
2009-07-02,Sabah,25,13,12,2009
2009-07-03,Sabah,35,18,17,2009
2009-07-04,Sabah,24,18,6,2009
2009-07-05,Sabah,46,26,20,2009
2009-07-06,Sabah,21,13,8,2009
2009-07-07,Sabah,57,36,21,2009
2009-07-08,Sabah,104,58,46,2009
2009-07-09,Sabah,10,2,8,2009
2009-07-10,Sabah,29,11,18,2009
2009-07-11,Sabah,36,18,18,2009
2009-07-12,Sabah,56,33,23,2009
2009-07-13,Sabah,16,6,10,2009
2009-07-14,Sabah,24,12,12,2009
2009-07-15,Sabah,92,46,46,2009
2009-07-16,Sabah,98,53,45,2009
2009-07-17,Sabah,37,18,19,2009
2009-07-18,Sabah,66,44,22,2009
2009-07-19,Sabah,20,9,11,2009
2009-07-20,Sabah,14,6,8,2009
2009-07-21,Sabah,25,9,16,2009
2009-07-22,Sabah,178,149,29,2009
2009-07-23,Sabah,34,14,20,2009
2009-07-24,Sabah,21,7,14,2009
2009-07-25,Sabah,37,22,15,2009
2009-07-26,Sabah,99,34,65,2009
2009-07-27,Sabah,76,52,24,2009
2009-07-28,Sabah,38,9,29,2009
2009-07-29,Sabah,37,22,15,2009
2009-07-30,Sabah,134,79,55,2009
2009-07-31,Sabah,89,37,52,2009
2009-08-01,Sabah,55,37,18,2009
2009-08-02,Sabah,51,22,29,2009
2009-08-03,Sabah,61,39,22,2009
2009-08-04,Sabah,21,13,8,2009
2009-08-05,Sabah,221,126,95,2009
2009-08-06,Sabah,15,5,10,2009
2009-08-07,Sabah,59,20,39,2009
2009-08-08,Sabah,191,101,90,2009
2009-08-09,Sabah,0,0,0,2009
2009-08-10,Sabah,84,60,24,2009
2009-08-11,Sabah,27,12,15,2009
2009-08-12,Sabah,72,43,29,2009
2009-08-13,Sabah,65,46,19,2009
2009-08-14,Sabah,39,31,8,2009
2009-08-15,Sabah,910,417,493,2009
2009-08-16,Sabah,0,0,0,2009
2009-08-17,Sabah,10,2,8,2009
2009-08-18,Sabah,65,32,33,2009
2009-08-19,Sabah,56,30,26,2009
2009-08-20,Sabah,25,9,16,2009
2009-08-21,Sabah,60,38,22,2009
2009-08-22,Sabah,38,17,21,2009
2009-08-23,Sabah,89,45,44,2009
2009-08-24,Sabah,6,1,5,2009
2009-08-25,Sabah,5,1,4,2009
2009-08-26,Sabah,8,0,8,2009
2009-08-27,Sabah,38,22,16,2009
2009-08-28,Sabah,27,16,11,2009
2009-08-29,Sabah,40,17,23,2009
2009-08-30,Sabah,24,18,6,2009
2009-08-31,Sabah,0,0,0,2009
2009-09-01,Sabah,11,2,9,2009
2009-09-02,Sabah,65,34,31,2009
2009-09-03,Sabah,29,20,9,2009
2009-09-04,Sabah,24,10,14,2009
2009-09-05,Sabah,9,5,4,2009
2009-09-06,Sabah,63,32,31,2009
2009-09-07,Sabah,37,20,17,2009
2009-09-08,Sabah,48,15,33,2009
2009-09-09,Sabah,74,42,32,2009
2009-09-10,Sabah,27,8,19,2009
2009-09-11,Sabah,73,36,37,2009
2009-09-12,Sabah,5,1,4,2009
2009-09-13,Sabah,37,9,28,2009
2009-09-14,Sabah,30,15,15,2009
2009-09-15,Sabah,59,25,34,2009
2009-09-16,Sabah,6,4,2,2009
2009-09-17,Sabah,11,3,8,2009
2009-09-18,Sabah,12,7,5,2009
2009-09-19,Sabah,27,13,14,2009
2009-09-20,Sabah,156,32,124,2009
2009-09-21,Sabah,0,0,0,2009
2009-09-22,Sabah,1,1,0,2009
2009-09-23,Sabah,20,2,18,2009
2009-09-24,Sabah,25,15,10,2009
2009-09-25,Sabah,25,11,14,2009
2009-09-26,Sabah,39,14,25,2009
2009-09-27,Sabah,119,42,77,2009
2009-09-28,Sabah,28,11,17,2009
2009-09-29,Sabah,68,38,30,2009
2009-09-30,Sabah,53,25,28,2009
2009-10-01,Sabah,23,8,15,2009
2009-10-02,Sabah,34,16,18,2009
2009-10-03,Sabah,10,2,8,2009
2009-10-04,Sabah,42,24,18,2009
2009-10-05,Sabah,114,58,56,2009
2009-10-06,Sabah,32,9,23,2009
2009-10-07,Sabah,21,8,13,2009
2009-10-08,Sabah,109,84,25,2009
2009-10-09,Sabah,50,23,27,2009
2009-10-10,Sabah,28,16,12,2009
2009-10-11,Sabah,33,32,1,2009
2009-10-12,Sabah,73,28,45,2009
2009-10-13,Sabah,26,9,17,2009
2009-10-14,Sabah,64,25,39,2009
2009-10-15,Sabah,26,12,14,2009
2009-10-16,Sabah,32,17,15,2009
2009-10-17,Sabah,129,55,74,2009
2009-10-18,Sabah,83,44,39,2009
2009-10-19,Sabah,32,7,25,2009
2009-10-20,Sabah,72,37,35,2009
2009-10-21,Sabah,64,31,33,2009
2009-10-22,Sabah,28,16,12,2009
2009-10-23,Sabah,45,15,30,2009
2009-10-24,Sabah,59,23,36,2009
2009-10-25,Sabah,104,49,55,2009
2009-10-26,Sabah,36,17,19,2009
2009-10-27,Sabah,48,27,21,2009
2009-10-28,Sabah,48,20,28,2009
2009-10-29,Sabah,21,5,16,2009
2009-10-30,Sabah,61,31,30,2009
2009-10-31,Sabah,32,9,23,2009
2009-11-01,Sabah,187,79,108,2009
2009-11-02,Sabah,16,5,11,2009
2009-11-03,Sabah,62,31,31,2009
2009-11-04,Sabah,37,15,22,2009
2009-11-05,Sabah,46,19,27,2009
2009-11-06,Sabah,66,7,59,2009
2009-11-07,Sabah,26,17,9,2009
2009-11-08,Sabah,7,6,1,2009
2009-11-09,Sabah,52,29,23,2009
2009-11-10,Sabah,48,17,31,2009
2009-11-11,Sabah,27,12,15,2009
2009-11-12,Sabah,50,16,34,2009
2009-11-13,Sabah,72,33,39,2009
2009-11-14,Sabah,119,60,59,2009
2009-11-15,Sabah,91,42,49,2009
2009-11-16,Sabah,46,24,22,2009
2009-11-17,Sabah,43,23,20,2009
2009-11-18,Sabah,40,15,25,2009
2009-11-19,Sabah,41,12,29,2009
2009-11-20,Sabah,64,15,49,2009
2009-11-21,Sabah,114,53,61,2009
2009-11-22,Sabah,5,5,0,2009
2009-11-23,Sabah,68,26,42,2009
2009-11-24,Sabah,14,0,14,2009
2009-11-25,Sabah,22,5,17,2009
2009-11-26,Sabah,22,11,11,2009
2009-11-27,Sabah,29,24,5,2009
2009-11-28,Sabah,34,19,15,2009
2009-11-29,Sabah,20,14,6,2009
2009-11-30,Sabah,28,12,16,2009
2009-12-01,Sabah,61,32,29,2009
2009-12-02,Sabah,47,16,31,2009
2009-12-03,Sabah,19,8,11,2009
2009-12-04,Sabah,65,19,46,2009
2009-12-05,Sabah,72,32,40,2009
2009-12-06,Sabah,62,35,27,2009
2009-12-07,Sabah,14,3,11,2009
2009-12-08,Sabah,33,9,24,2009
2009-12-09,Sabah,35,15,20,2009
2009-12-10,Sabah,76,52,24,2009
2009-12-11,Sabah,58,25,33,2009
2009-12-12,Sabah,83,41,42,2009
2009-12-13,Sabah,104,22,82,2009
2009-12-14,Sabah,50,29,21,2009
2009-12-15,Sabah,37,17,20,2009
2009-12-16,Sabah,31,19,12,2009
2009-12-17,Sabah,60,51,9,2009
2009-12-18,Sabah,7,4,3,2009
2009-12-19,Sabah,56,32,24,2009
2009-12-20,Sabah,122,24,98,2009
2009-12-21,Sabah,10,2,8,2009
2009-12-22,Sabah,125,47,78,2009
2009-12-23,Sabah,35,16,19,2009
2009-12-24,Sabah,16,3,13,2009
2009-12-25,Sabah,23,12,11,2009
2009-12-26,Sabah,28,14,14,2009
2009-12-27,Sabah,24,9,15,2009
2009-12-28,Sabah,34,7,27,2009
2009-12-29,Sabah,43,25,18,2009
2009-12-30,Sabah,24,13,11,2009
2009-12-31,Sabah,23,7,16,2009
2010-01-01,Sabah,5,3,2,2010
2010-01-02,Sabah,25,14,11,2010
2010-01-03,Sabah,9,6,3,2010
2010-01-04,Sabah,64,29,35,2010
2010-01-05,Sabah,103,81,22,2010
2010-01-06,Sabah,69,31,38,2010
2010-01-07,Sabah,55,25,30,2010
2010-01-08,Sabah,46,22,24,2010
2010-01-09,Sabah,11,7,4,2010
2010-01-10,Sabah,114,45,69,2010
2010-01-11,Sabah,18,8,10,2010
2010-01-12,Sabah,92,31,61,2010
2010-01-13,Sabah,62,19,43,2010
2010-01-14,Sabah,21,6,15,2010
2010-01-15,Sabah,37,16,21,2010
2010-01-16,Sabah,101,45,56,2010
2010-01-17,Sabah,154,80,74,2010
2010-01-18,Sabah,79,29,50,2010
2010-01-19,Sabah,20,3,17,2010
2010-01-20,Sabah,58,19,39,2010
2010-01-21,Sabah,48,25,23,2010
2010-01-22,Sabah,29,12,17,2010
2010-01-23,Sabah,42,21,21,2010
2010-01-24,Sabah,20,13,7,2010
2010-01-25,Sabah,63,25,38,2010
2010-01-26,Sabah,37,9,28,2010
2010-01-27,Sabah,42,12,30,2010
2010-01-28,Sabah,51,6,45,2010
2010-01-29,Sabah,29,12,17,2010
2010-01-30,Sabah,38,13,25,2010
2010-01-31,Sabah,49,26,23,2010
2010-02-01,Sabah,56,25,31,2010
2010-02-02,Sabah,35,12,23,2010
2010-02-03,Sabah,53,44,9,2010
2010-02-04,Sabah,24,6,18,2010
2010-02-05,Sabah,53,34,19,2010
2010-02-06,Sabah,16,7,9,2010
2010-02-07,Sabah,105,28,77,2010
2010-02-08,Sabah,24,8,16,2010
2010-02-09,Sabah,50,18,32,2010
2010-02-10,Sabah,73,36,37,2010
2010-02-11,Sabah,166,74,92,2010
2010-02-12,Sabah,17,4,13,2010
2010-02-13,Sabah,53,42,11,2010
2010-02-14,Sabah,29,20,9,2010
2010-02-15,Sabah,28,15,13,2010
2010-02-16,Sabah,20,9,11,2010
2010-02-17,Sabah,21,8,13,2010
2010-02-18,Sabah,38,11,27,2010
2010-02-19,Sabah,67,34,33,2010
2010-02-20,Sabah,40,18,22,2010
2010-02-21,Sabah,18,14,4,2010
2010-02-22,Sabah,43,25,18,2010
2010-02-23,Sabah,108,58,50,2010
2010-02-24,Sabah,272,145,127,2010
2010-02-25,Sabah,57,18,39,2010
2010-02-26,Sabah,0,0,0,2010
2010-02-27,Sabah,77,43,34,2010
2010-02-28,Sabah,74,31,43,2010
2010-03-01,Sabah,28,10,18,2010
2010-03-02,Sabah,28,11,17,2010
2010-03-03,Sabah,25,13,12,2010
2010-03-04,Sabah,38,20,18,2010
2010-03-05,Sabah,9,1,8,2010
2010-03-06,Sabah,96,54,42,2010
2010-03-07,Sabah,32,23,9,2010
2010-03-08,Sabah,62,32,30,2010
2010-03-09,Sabah,185,90,95,2010
2010-03-10,Sabah,13,4,9,2010
2010-03-11,Sabah,219,111,108,2010
2010-03-12,Sabah,87,38,49,2010
2010-03-13,Sabah,34,24,10,2010
2010-03-14,Sabah,205,46,159,2010
2010-03-15,Sabah,75,45,30,2010
2010-03-16,Sabah,84,39,45,2010
2010-03-17,Sabah,37,22,15,2010
2010-03-18,Sabah,22,9,13,2010
2010-03-19,Sabah,129,82,47,2010
2010-03-20,Sabah,67,36,31,2010
2010-03-21,Sabah,147,36,111,2010
2010-03-22,Sabah,25,2,23,2010
2010-03-23,Sabah,31,11,20,2010
2010-03-24,Sabah,51,29,22,2010
2010-03-25,Sabah,20,10,10,2010
2010-03-26,Sabah,28,23,5,2010
2010-03-27,Sabah,20,11,9,2010
2010-03-28,Sabah,34,20,14,2010
2010-03-29,Sabah,40,21,19,2010
2010-03-30,Sabah,40,15,25,2010
2010-03-31,Sabah,41,9,32,2010
2010-04-01,Sabah,21,7,14,2010
2010-04-02,Sabah,0,0,0,2010
2010-04-03,Sabah,40,12,28,2010
2010-04-04,Sabah,96,42,54,2010
2010-04-05,Sabah,30,11,19,2010
2010-04-06,Sabah,41,16,25,2010
2010-04-07,Sabah,74,43,31,2010
2010-04-08,Sabah,100,48,52,2010
2010-04-09,Sabah,81,22,59,2010
2010-04-10,Sabah,93,34,59,2010
2010-04-11,Sabah,73,32,41,2010
2010-04-12,Sabah,24,9,15,2010
2010-04-13,Sabah,43,13,30,2010
2010-04-14,Sabah,38,7,31,2010
2010-04-15,Sabah,7,4,3,2010
2010-04-16,Sabah,94,25,69,2010
2010-04-17,Sabah,107,53,54,2010
2010-04-18,Sabah,66,18,48,2010
2010-04-19,Sabah,44,11,33,2010
2010-04-20,Sabah,61,27,34,2010
2010-04-21,Sabah,78,25,53,2010
2010-04-22,Sabah,112,78,34,2010
2010-04-23,Sabah,23,13,10,2010
2010-04-24,Sabah,58,29,29,2010
2010-04-25,Sabah,35,12,23,2010
2010-04-26,Sabah,8,2,6,2010
2010-04-27,Sabah,28,18,10,2010
2010-04-28,Sabah,25,2,23,2010
2010-04-29,Sabah,165,112,53,2010
2010-04-30,Sabah,39,21,18,2010
2010-05-01,Sabah,20,10,10,2010
2010-05-02,Sabah,11,7,4,2010
2010-05-03,Sabah,31,15,16,2010
2010-05-04,Sabah,0,0,0,2010
2010-05-05,Sabah,27,14,13,2010
2010-05-06,Sabah,36,16,20,2010
2010-05-07,Sabah,22,5,17,2010
2010-05-08,Sabah,11,1,10,2010
2010-05-09,Sabah,37,8,29,2010
2010-05-10,Sabah,56,33,23,2010
2010-05-11,Sabah,37,13,24,2010
2010-05-12,Sabah,114,62,52,2010
2010-05-13,Sabah,41,8,33,2010
2010-05-14,Sabah,28,11,17,2010
2010-05-15,Sabah,38,13,25,2010
2010-05-16,Sabah,76,31,45,2010
2010-05-17,Sabah,48,19,29,2010
2010-05-18,Sabah,36,5,31,2010
2010-05-19,Sabah,25,10,15,2010
2010-05-20,Sabah,49,16,33,2010
2010-05-21,Sabah,43,17,26,2010
2010-05-22,Sabah,2,1,1,2010
2010-05-23,Sabah,75,26,49,2010
2010-05-24,Sabah,168,106,62,2010
2010-05-25,Sabah,34,11,23,2010
2010-05-26,Sabah,52,36,16,2010
2010-05-27,Sabah,8,0,8,2010
2010-05-28,Sabah,147,54,93,2010
2010-05-29,Sabah,35,22,13,2010
2010-05-30,Sabah,14,9,5,2010
2010-05-31,Sabah,15,3,12,2010
2010-06-01,Sabah,0,0,0,2010
2010-06-02,Sabah,21,5,16,2010
2010-06-03,Sabah,46,33,13,2010
2010-06-04,Sabah,26,9,17,2010
2010-06-05,Sabah,12,11,1,2010
2010-06-06,Sabah,20,10,10,2010
2010-06-07,Sabah,30,10,20,2010
2010-06-08,Sabah,56,22,34,2010
2010-06-09,Sabah,34,8,26,2010
2010-06-10,Sabah,32,13,19,2010
2010-06-11,Sabah,33,10,23,2010
2010-06-12,Sabah,4,2,2,2010
2010-06-13,Sabah,134,30,104,2010
2010-06-14,Sabah,18,3,15,2010
2010-06-15,Sabah,40,9,31,2010
2010-06-16,Sabah,22,11,11,2010
2010-06-17,Sabah,26,4,22,2010
2010-06-18,Sabah,11,0,11,2010
2010-06-19,Sabah,48,20,28,2010
2010-06-20,Sabah,181,36,145,2010
2010-06-21,Sabah,24,11,13,2010
2010-06-22,Sabah,41,17,24,2010
2010-06-23,Sabah,45,11,34,2010
2010-06-24,Sabah,45,29,16,2010
2010-06-25,Sabah,39,19,20,2010
2010-06-26,Sabah,109,58,51,2010
2010-06-27,Sabah,28,9,19,2010
2010-06-28,Sabah,16,4,12,2010
2010-06-29,Sabah,76,43,33,2010
2010-06-30,Sabah,51,35,16,2010
2010-07-01,Sabah,26,7,19,2010
2010-07-02,Sabah,11,1,10,2010
2010-07-03,Sabah,45,28,17,2010
2010-07-04,Sabah,29,13,16,2010
2010-07-05,Sabah,14,4,10,2010
2010-07-06,Sabah,41,27,14,2010
2010-07-07,Sabah,34,17,17,2010
2010-07-08,Sabah,22,11,11,2010
2010-07-09,Sabah,26,6,20,2010
2010-07-10,Sabah,31,17,14,2010
2010-07-11,Sabah,7,2,5,2010
2010-07-12,Sabah,23,12,11,2010
2010-07-13,Sabah,70,52,18,2010
2010-07-14,Sabah,48,17,31,2010
2010-07-15,Sabah,75,50,25,2010
2010-07-16,Sabah,31,12,19,2010
2010-07-17,Sabah,15,4,11,2010
2010-07-18,Sabah,49,27,22,2010
2010-07-19,Sabah,98,46,52,2010
2010-07-20,Sabah,89,40,49,2010
2010-07-21,Sabah,84,42,42,2010
2010-07-22,Sabah,23,6,17,2010
2010-07-23,Sabah,32,10,22,2010
2010-07-24,Sabah,27,17,10,2010
2010-07-25,Sabah,35,11,24,2010
2010-07-26,Sabah,47,22,25,2010
2010-07-27,Sabah,47,20,27,2010
2010-07-28,Sabah,35,12,23,2010
2010-07-29,Sabah,30,7,23,2010
2010-07-30,Sabah,25,10,15,2010
2010-07-31,Sabah,66,27,39,2010
2010-08-01,Sabah,0,0,0,2010
2010-08-02,Sabah,65,41,24,2010
2010-08-03,Sabah,60,29,31,2010
2010-08-04,Sabah,77,35,42,2010
2010-08-05,Sabah,55,23,32,2010
2010-08-06,Sabah,65,15,50,2010
2010-08-07,Sabah,53,15,38,2010
2010-08-08,Sabah,49,25,24,2010
2010-08-09,Sabah,35,13,22,2010
2010-08-10,Sabah,35,15,20,2010
2010-08-11,Sabah,22,9,13,2010
2010-08-12,Sabah,15,6,9,2010
2010-08-13,Sabah,30,13,17,2010
2010-08-14,Sabah,53,22,31,2010
2010-08-15,Sabah,24,8,16,2010
2010-08-16,Sabah,38,13,25,2010
2010-08-17,Sabah,35,14,21,2010
2010-08-18,Sabah,24,10,14,2010
2010-08-19,Sabah,42,20,22,2010
2010-08-20,Sabah,38,23,15,2010
2010-08-21,Sabah,13,6,7,2010
2010-08-22,Sabah,78,28,50,2010
2010-08-23,Sabah,25,12,13,2010
2010-08-24,Sabah,24,7,17,2010
2010-08-25,Sabah,30,15,15,2010
2010-08-26,Sabah,64,29,35,2010
2010-08-27,Sabah,20,8,12,2010
2010-08-28,Sabah,25,8,17,2010
2010-08-29,Sabah,37,17,20,2010
2010-08-30,Sabah,24,11,13,2010
2010-08-31,Sabah,37,18,19,2010
2010-09-01,Sabah,26,14,12,2010
2010-09-02,Sabah,37,17,20,2010
2010-09-03,Sabah,22,2,20,2010
2010-09-04,Sabah,10,2,8,2010
2010-09-05,Sabah,0,0,0,2010
2010-09-06,Sabah,23,6,17,2010
2010-09-07,Sabah,62,20,42,2010
2010-09-08,Sabah,69,34,35,2010
2010-09-09,Sabah,38,20,18,2010
2010-09-10,Sabah,0,0,0,2010
2010-09-11,Sabah,5,2,3,2010
2010-09-12,Sabah,120,29,91,2010
2010-09-13,Sabah,41,19,22,2010
2010-09-14,Sabah,60,30,30,2010
2010-09-15,Sabah,39,17,22,2010
2010-09-16,Sabah,1,0,1,2010
2010-09-17,Sabah,20,4,16,2010
2010-09-18,Sabah,1114,464,650,2010
2010-09-19,Sabah,0,0,0,2010
2010-09-20,Sabah,25,6,19,2010
2010-09-21,Sabah,142,121,21,2010
2010-09-22,Sabah,13,3,10,2010
2010-09-23,Sabah,11,1,10,2010
2010-09-24,Sabah,63,16,47,2010
2010-09-25,Sabah,36,13,23,2010
2010-09-26,Sabah,124,19,105,2010
2010-09-27,Sabah,18,5,13,2010
2010-09-28,Sabah,38,21,17,2010
2010-09-29,Sabah,92,52,40,2010
2010-09-30,Sabah,73,38,35,2010
2010-10-01,Sabah,7,2,5,2010
2010-10-02,Sabah,32,13,19,2010
2010-10-03,Sabah,95,52,43,2010
2010-10-04,Sabah,16,3,13,2010
2010-10-05,Sabah,31,9,22,2010
2010-10-06,Sabah,158,83,75,2010
2010-10-07,Sabah,62,34,28,2010
2010-10-08,Sabah,33,8,25,2010
2010-10-09,Sabah,76,29,47,2010
2010-10-10,Sabah,34,17,17,2010
2010-10-11,Sabah,16,1,15,2010
2010-10-12,Sabah,34,5,29,2010
2010-10-13,Sabah,36,10,26,2010
2010-10-14,Sabah,58,18,40,2010
2010-10-15,Sabah,75,35,40,2010
2010-10-16,Sabah,10,4,6,2010
2010-10-17,Sabah,37,17,20,2010
2010-10-18,Sabah,43,26,17,2010
2010-10-19,Sabah,32,15,17,2010
2010-10-20,Sabah,85,35,50,2010
2010-10-21,Sabah,26,13,13,2010
2010-10-22,Sabah,33,11,22,2010
2010-10-23,Sabah,52,18,34,2010
2010-10-24,Sabah,89,46,43,2010
2010-10-25,Sabah,24,8,16,2010
2010-10-26,Sabah,31,8,23,2010
2010-10-27,Sabah,42,13,29,2010
2010-10-28,Sabah,37,13,24,2010
2010-10-29,Sabah,64,27,37,2010
2010-10-30,Sabah,45,25,20,2010
2010-10-31,Sabah,43,18,25,2010
2010-11-01,Sabah,5,3,2,2010
2010-11-02,Sabah,34,5,29,2010
2010-11-03,Sabah,25,1,24,2010
2010-11-04,Sabah,19,3,16,2010
2010-11-05,Sabah,113,64,49,2010
2010-11-06,Sabah,18,8,10,2010
2010-11-07,Sabah,97,43,54,2010
2010-11-08,Sabah,27,11,16,2010
2010-11-09,Sabah,12,2,10,2010
2010-11-10,Sabah,23,11,12,2010
2010-11-11,Sabah,32,16,16,2010
2010-11-12,Sabah,29,3,26,2010
2010-11-13,Sabah,11,4,7,2010
2010-11-14,Sabah,32,10,22,2010
2010-11-15,Sabah,72,53,19,2010
2010-11-16,Sabah,34,12,22,2010
2010-11-17,Sabah,28,14,14,2010
2010-11-18,Sabah,52,28,24,2010
2010-11-19,Sabah,77,45,32,2010
2010-11-20,Sabah,34,14,20,2010
2010-11-21,Sabah,88,30,58,2010
2010-11-22,Sabah,86,35,51,2010
2010-11-23,Sabah,44,13,31,2010
2010-11-24,Sabah,38,11,27,2010
2010-11-25,Sabah,41,12,29,2010
2010-11-26,Sabah,25,15,10,2010
2010-11-27,Sabah,75,35,40,2010
2010-11-28,Sabah,46,16,30,2010
2010-11-29,Sabah,63,30,33,2010
2010-11-30,Sabah,37,18,19,2010
2010-12-01,Sabah,35,7,28,2010
2010-12-02,Sabah,41,21,20,2010
2010-12-03,Sabah,65,8,57,2010
2010-12-04,Sabah,139,64,75,2010
2010-12-05,Sabah,117,59,58,2010
2010-12-06,Sabah,51,20,31,2010
2010-12-07,Sabah,48,18,30,2010
2010-12-08,Sabah,31,7,24,2010
2010-12-09,Sabah,22,5,17,2010
2010-12-10,Sabah,41,10,31,2010
2010-12-11,Sabah,50,17,33,2010
2010-12-12,Sabah,153,30,123,2010
2010-12-13,Sabah,13,2,11,2010
2010-12-14,Sabah,28,15,13,2010
2010-12-15,Sabah,49,27,22,2010
2010-12-16,Sabah,79,27,52,2010
2010-12-17,Sabah,28,9,19,2010
2010-12-18,Sabah,115,59,56,2010
2010-12-19,Sabah,55,5,50,2010
2010-12-20,Sabah,11,1,10,2010
2010-12-21,Sabah,16,7,9,2010
2010-12-22,Sabah,23,9,14,2010
2010-12-23,Sabah,14,6,8,2010
2010-12-24,Sabah,8,0,8,2010
2010-12-25,Sabah,3,0,3,2010
2010-12-26,Sabah,73,14,59,2010
2010-12-27,Sabah,13,1,12,2010
2010-12-28,Sabah,28,9,19,2010
2010-12-29,Sabah,80,42,38,2010
2010-12-30,Sabah,56,19,37,2010
2010-12-31,Sabah,8,5,3,2010
2011-01-01,Sabah,1,0,1,2011
2011-01-02,Sabah,12,1,11,2011
2011-01-03,Sabah,19,2,17,2011
2011-01-04,Sabah,29,8,21,2011
2011-01-05,Sabah,27,9,18,2011
2011-01-06,Sabah,65,23,42,2011
2011-01-07,Sabah,42,18,24,2011
2011-01-08,Sabah,59,30,29,2011
2011-01-09,Sabah,51,27,24,2011
2011-01-10,Sabah,37,19,18,2011
2011-01-11,Sabah,26,7,19,2011
2011-01-12,Sabah,53,11,42,2011
2011-01-13,Sabah,42,17,25,2011
2011-01-14,Sabah,24,13,11,2011
2011-01-15,Sabah,33,14,19,2011
2011-01-16,Sabah,22,8,14,2011
2011-01-17,Sabah,35,5,30,2011
2011-01-18,Sabah,38,9,29,2011
2011-01-19,Sabah,111,45,66,2011
2011-01-20,Sabah,115,59,56,2011
2011-01-21,Sabah,129,53,76,2011
2011-01-22,Sabah,44,21,23,2011
2011-01-23,Sabah,41,22,19,2011
2011-01-24,Sabah,37,11,26,2011
2011-01-25,Sabah,34,10,24,2011
2011-01-26,Sabah,225,123,102,2011
2011-01-27,Sabah,91,52,39,2011
2011-01-28,Sabah,17,1,16,2011
2011-01-29,Sabah,10,0,10,2011
2011-01-30,Sabah,103,54,49,2011
2011-01-31,Sabah,29,12,17,2011
2011-02-01,Sabah,38,27,11,2011
2011-02-02,Sabah,38,14,24,2011
2011-02-03,Sabah,10,4,6,2011
2011-02-04,Sabah,58,36,22,2011
2011-02-05,Sabah,45,33,12,2011
2011-02-06,Sabah,19,12,7,2011
2011-02-07,Sabah,17,4,13,2011
2011-02-08,Sabah,78,32,46,2011
2011-02-09,Sabah,149,72,77,2011
2011-02-10,Sabah,98,47,51,2011
2011-02-11,Sabah,17,6,11,2011
2011-02-12,Sabah,45,25,20,2011
2011-02-13,Sabah,55,23,32,2011
2011-02-14,Sabah,36,15,21,2011
2011-02-15,Sabah,34,18,16,2011
2011-02-16,Sabah,96,60,36,2011
2011-02-17,Sabah,49,26,23,2011
2011-02-18,Sabah,23,2,21,2011
2011-02-19,Sabah,2,1,1,2011
2011-02-20,Sabah,81,28,53,2011
2011-02-21,Sabah,61,10,51,2011
2011-02-22,Sabah,45,16,29,2011
2011-02-23,Sabah,85,55,30,2011
2011-02-24,Sabah,34,13,21,2011
2011-02-25,Sabah,63,25,38,2011
2011-02-26,Sabah,61,20,41,2011
2011-02-27,Sabah,69,26,43,2011
2011-02-28,Sabah,83,32,51,2011
2011-03-01,Sabah,27,5,22,2011
2011-03-02,Sabah,42,21,21,2011
2011-03-03,Sabah,50,18,32,2011
2011-03-04,Sabah,24,2,22,2011
2011-03-05,Sabah,67,15,52,2011
2011-03-06,Sabah,162,36,126,2011
2011-03-07,Sabah,24,8,16,2011
2011-03-08,Sabah,26,11,15,2011
2011-03-09,Sabah,53,18,35,2011
2011-03-10,Sabah,88,32,56,2011
2011-03-11,Sabah,18,7,11,2011
2011-03-12,Sabah,72,38,34,2011
2011-03-13,Sabah,79,21,58,2011
2011-03-14,Sabah,14,0,14,2011
2011-03-15,Sabah,45,23,22,2011
2011-03-16,Sabah,41,21,20,2011
2011-03-17,Sabah,35,8,27,2011
2011-03-18,Sabah,157,107,50,2011
2011-03-19,Sabah,121,62,59,2011
2011-03-20,Sabah,8,2,6,2011
2011-03-21,Sabah,90,47,43,2011
2011-03-22,Sabah,110,53,57,2011
2011-03-23,Sabah,92,38,54,2011
2011-03-24,Sabah,8,3,5,2011
2011-03-25,Sabah,188,118,70,2011
2011-03-26,Sabah,81,33,48,2011
2011-03-27,Sabah,186,59,127,2011
2011-03-28,Sabah,12,1,11,2011
2011-03-29,Sabah,45,19,26,2011
2011-03-30,Sabah,69,31,38,2011
2011-03-31,Sabah,52,24,28,2011
2011-04-01,Sabah,68,22,46,2011
2011-04-02,Sabah,98,47,51,2011
2011-04-03,Sabah,0,0,0,2011
2011-04-04,Sabah,39,16,23,2011
2011-04-05,Sabah,44,24,20,2011
2011-04-06,Sabah,28,12,16,2011
2011-04-07,Sabah,63,28,35,2011
2011-04-08,Sabah,64,21,43,2011
2011-04-09,Sabah,102,44,58,2011
2011-04-10,Sabah,64,22,42,2011
2011-04-11,Sabah,53,23,30,2011
2011-04-12,Sabah,31,6,25,2011
2011-04-13,Sabah,38,9,29,2011
2011-04-14,Sabah,85,32,53,2011
2011-04-15,Sabah,158,86,72,2011
2011-04-16,Sabah,88,49,39,2011
2011-04-17,Sabah,240,101,139,2011
2011-04-18,Sabah,68,18,50,2011
2011-04-19,Sabah,40,11,29,2011
2011-04-20,Sabah,17,3,14,2011
2011-04-21,Sabah,61,42,19,2011
2011-04-22,Sabah,33,21,12,2011
2011-04-23,Sabah,15,5,10,2011
2011-04-24,Sabah,95,28,67,2011
2011-04-25,Sabah,150,102,48,2011
2011-04-26,Sabah,22,11,11,2011
2011-04-27,Sabah,69,29,40,2011
2011-04-28,Sabah,100,39,61,2011
2011-04-29,Sabah,23,3,20,2011
2011-04-30,Sabah,26,10,16,2011
2011-05-01,Sabah,122,58,64,2011
2011-05-02,Sabah,9,3,6,2011
2011-05-03,Sabah,30,10,20,2011
2011-05-04,Sabah,40,11,29,2011
2011-05-05,Sabah,20,9,11,2011
2011-05-06,Sabah,45,9,36,2011
2011-05-07,Sabah,14,2,12,2011
2011-05-08,Sabah,45,15,30,2011
2011-05-09,Sabah,9,1,8,2011
2011-05-10,Sabah,70,54,16,2011
2011-05-11,Sabah,76,34,42,2011
2011-05-12,Sabah,109,46,63,2011
2011-05-13,Sabah,19,10,9,2011
2011-05-14,Sabah,27,16,11,2011
2011-05-15,Sabah,84,32,52,2011
2011-05-16,Sabah,21,4,17,2011
2011-05-17,Sabah,156,59,97,2011
2011-05-18,Sabah,50,27,23,2011
2011-05-19,Sabah,11,1,10,2011
2011-05-20,Sabah,57,20,37,2011
2011-05-21,Sabah,23,16,7,2011
2011-05-22,Sabah,72,29,43,2011
2011-05-23,Sabah,198,115,83,2011
2011-05-24,Sabah,11,2,9,2011
2011-05-25,Sabah,31,11,20,2011
2011-05-26,Sabah,53,16,37,2011
2011-05-27,Sabah,10,1,9,2011
2011-05-28,Sabah,16,8,8,2011
2011-05-29,Sabah,10,6,4,2011
2011-05-30,Sabah,19,11,8,2011
2011-05-31,Sabah,14,2,12,2011
2011-06-01,Sabah,14,6,8,2011
2011-06-02,Sabah,19,7,12,2011
2011-06-03,Sabah,22,8,14,2011
2011-06-04,Sabah,8,2,6,2011
2011-06-05,Sabah,117,22,95,2011
2011-06-06,Sabah,24,12,12,2011
2011-06-07,Sabah,36,15,21,2011
2011-06-08,Sabah,30,13,17,2011
2011-06-09,Sabah,52,9,43,2011
2011-06-10,Sabah,34,19,15,2011
2011-06-11,Sabah,45,18,27,2011
2011-06-12,Sabah,78,32,46,2011
2011-06-13,Sabah,14,9,5,2011
2011-06-14,Sabah,37,25,12,2011
2011-06-15,Sabah,109,41,68,2011
2011-06-16,Sabah,29,12,17,2011
2011-06-17,Sabah,11,4,7,2011
2011-06-18,Sabah,218,75,143,2011
2011-06-19,Sabah,111,40,71,2011
2011-06-20,Sabah,17,4,13,2011
2011-06-21,Sabah,82,49,33,2011
2011-06-22,Sabah,76,38,38,2011
2011-06-23,Sabah,35,7,28,2011
2011-06-24,Sabah,51,35,16,2011
2011-06-25,Sabah,95,41,54,2011
2011-06-26,Sabah,79,18,61,2011
2011-06-27,Sabah,19,2,17,2011
2011-06-28,Sabah,12,5,7,2011
2011-06-29,Sabah,39,22,17,2011
2011-06-30,Sabah,43,35,8,2011
2011-07-01,Sabah,43,21,22,2011
2011-07-02,Sabah,26,10,16,2011
2011-07-03,Sabah,18,9,9,2011
2011-07-04,Sabah,25,6,19,2011
2011-07-05,Sabah,40,16,24,2011
2011-07-06,Sabah,83,38,45,2011
2011-07-07,Sabah,60,16,44,2011
2011-07-08,Sabah,18,3,15,2011
2011-07-09,Sabah,31,16,15,2011
2011-07-10,Sabah,59,27,32,2011
2011-07-11,Sabah,13,2,11,2011
2011-07-12,Sabah,95,63,32,2011
2011-07-13,Sabah,115,47,68,2011
2011-07-14,Sabah,62,37,25,2011
2011-07-15,Sabah,79,38,41,2011
2011-07-16,Sabah,101,39,62,2011
2011-07-17,Sabah,0,0,0,2011
2011-07-18,Sabah,51,18,33,2011
2011-07-19,Sabah,58,28,30,2011
2011-07-20,Sabah,58,33,25,2011
2011-07-21,Sabah,11,1,10,2011
2011-07-22,Sabah,17,9,8,2011
2011-07-23,Sabah,99,55,44,2011
2011-07-24,Sabah,0,0,0,2011
2011-07-25,Sabah,43,11,32,2011
2011-07-26,Sabah,74,26,48,2011
2011-07-27,Sabah,58,32,26,2011
2011-07-28,Sabah,97,37,60,2011
2011-07-29,Sabah,16,2,14,2011
2011-07-30,Sabah,11,2,9,2011
2011-07-31,Sabah,4,1,3,2011
2011-08-01,Sabah,18,5,13,2011
2011-08-02,Sabah,11,4,7,2011
2011-08-03,Sabah,53,40,13,2011
2011-08-04,Sabah,19,8,11,2011
2011-08-05,Sabah,72,19,53,2011
2011-08-06,Sabah,31,22,9,2011
2011-08-07,Sabah,95,36,59,2011
2011-08-08,Sabah,59,38,21,2011
2011-08-09,Sabah,111,54,57,2011
2011-08-10,Sabah,104,78,26,2011
2011-08-11,Sabah,35,12,23,2011
2011-08-12,Sabah,64,19,45,2011
2011-08-13,Sabah,1,0,1,2011
2011-08-14,Sabah,45,11,34,2011
2011-08-15,Sabah,40,23,17,2011
2011-08-16,Sabah,20,4,16,2011
2011-08-17,Sabah,139,100,39,2011
2011-08-18,Sabah,23,6,17,2011
2011-08-19,Sabah,75,53,22,2011
2011-08-20,Sabah,57,30,27,2011
2011-08-21,Sabah,41,10,31,2011
2011-08-22,Sabah,42,20,22,2011
2011-08-23,Sabah,17,4,13,2011
2011-08-24,Sabah,26,2,24,2011
2011-08-25,Sabah,23,11,12,2011
2011-08-26,Sabah,21,8,13,2011
2011-08-27,Sabah,21,6,15,2011
2011-08-28,Sabah,12,6,6,2011
2011-08-29,Sabah,7,1,6,2011
2011-08-30,Sabah,17,10,7,2011
2011-08-31,Sabah,7,3,4,2011
2011-09-01,Sabah,7,6,1,2011
2011-09-02,Sabah,29,16,13,2011
2011-09-03,Sabah,36,17,19,2011
2011-09-04,Sabah,146,15,131,2011
2011-09-05,Sabah,24,9,15,2011
2011-09-06,Sabah,39,14,25,2011
2011-09-07,Sabah,72,55,17,2011
2011-09-08,Sabah,17,9,8,2011
2011-09-09,Sabah,12,2,10,2011
2011-09-10,Sabah,48,12,36,2011
2011-09-11,Sabah,33,12,21,2011
2011-09-12,Sabah,19,3,16,2011
2011-09-13,Sabah,60,19,41,2011
2011-09-14,Sabah,177,92,85,2011
2011-09-15,Sabah,50,29,21,2011
2011-09-16,Sabah,40,9,31,2011
2011-09-17,Sabah,2,1,1,2011
2011-09-18,Sabah,207,87,120,2011
2011-09-19,Sabah,29,6,23,2011
2011-09-20,Sabah,16,1,15,2011
2011-09-21,Sabah,62,26,36,2011
2011-09-22,Sabah,17,6,11,2011
2011-09-23,Sabah,37,18,19,2011
2011-09-24,Sabah,1109,395,714,2011
2011-09-25,Sabah,54,10,44,2011
2011-09-26,Sabah,14,7,7,2011
2011-09-27,Sabah,13,3,10,2011
2011-09-28,Sabah,58,20,38,2011
2011-09-29,Sabah,64,26,38,2011
2011-09-30,Sabah,93,63,30,2011
2011-10-01,Sabah,12,8,4,2011
2011-10-02,Sabah,46,41,5,2011
2011-10-03,Sabah,63,22,41,2011
2011-10-04,Sabah,36,11,25,2011
2011-10-05,Sabah,86,47,39,2011
2011-10-06,Sabah,59,38,21,2011
2011-10-07,Sabah,68,20,48,2011
2011-10-08,Sabah,37,16,21,2011
2011-10-09,Sabah,0,0,0,2011
2011-10-10,Sabah,27,6,21,2011
2011-10-11,Sabah,44,24,20,2011
2011-10-12,Sabah,71,17,54,2011
2011-10-13,Sabah,54,12,42,2011
2011-10-14,Sabah,12,3,9,2011
2011-10-15,Sabah,23,7,16,2011
2011-10-16,Sabah,10,3,7,2011
2011-10-17,Sabah,26,3,23,2011
2011-10-18,Sabah,43,12,31,2011
2011-10-19,Sabah,72,45,27,2011
2011-10-20,Sabah,95,40,55,2011
2011-10-21,Sabah,38,8,30,2011
2011-10-22,Sabah,28,10,18,2011
2011-10-23,Sabah,6,4,2,2011
2011-10-24,Sabah,26,3,23,2011
2011-10-25,Sabah,75,30,45,2011
2011-10-26,Sabah,110,41,69,2011
2011-10-27,Sabah,98,60,38,2011
2011-10-28,Sabah,68,24,44,2011
2011-10-29,Sabah,50,22,28,2011
2011-10-30,Sabah,13,2,11,2011
2011-10-31,Sabah,62,33,29,2011
2011-11-01,Sabah,55,17,38,2011
2011-11-02,Sabah,61,15,46,2011
2011-11-03,Sabah,14,0,14,2011
2011-11-04,Sabah,27,12,15,2011
2011-11-05,Sabah,45,17,28,2011
2011-11-06,Sabah,35,12,23,2011
2011-11-07,Sabah,63,31,32,2011
2011-11-08,Sabah,14,2,12,2011
2011-11-09,Sabah,29,7,22,2011
2011-11-10,Sabah,51,26,25,2011
2011-11-11,Sabah,74,37,37,2011
2011-11-12,Sabah,85,70,15,2011
2011-11-13,Sabah,101,42,59,2011
2011-11-14,Sabah,49,15,34,2011
2011-11-15,Sabah,22,7,15,2011
2011-11-16,Sabah,65,27,38,2011
2011-11-17,Sabah,94,57,37,2011
2011-11-18,Sabah,59,22,37,2011
2011-11-19,Sabah,69,27,42,2011
2011-11-20,Sabah,27,6,21,2011
2011-11-21,Sabah,32,16,16,2011
2011-11-22,Sabah,37,13,24,2011
2011-11-23,Sabah,51,22,29,2011
2011-11-24,Sabah,43,13,30,2011
2011-11-25,Sabah,32,12,20,2011
2011-11-26,Sabah,149,74,75,2011
2011-11-27,Sabah,93,49,44,2011
2011-11-28,Sabah,5,3,2,2011
2011-11-29,Sabah,42,20,22,2011
2011-11-30,Sabah,43,13,30,2011
2011-12-01,Sabah,110,43,67,2011
2011-12-02,Sabah,58,10,48,2011
2011-12-03,Sabah,45,25,20,2011
2011-12-04,Sabah,144,22,122,2011
2011-12-05,Sabah,42,11,31,2011
2011-12-06,Sabah,24,11,13,2011
2011-12-07,Sabah,32,14,18,2011
2011-12-08,Sabah,32,12,20,2011
2011-12-09,Sabah,40,14,26,2011
2011-12-10,Sabah,75,24,51,2011
2011-12-11,Sabah,66,4,62,2011
2011-12-12,Sabah,40,17,23,2011
2011-12-13,Sabah,44,11,33,2011
2011-12-14,Sabah,37,12,25,2011
2011-12-15,Sabah,38,18,20,2011
2011-12-16,Sabah,37,12,25,2011
2011-12-17,Sabah,23,11,12,2011
2011-12-18,Sabah,130,23,107,2011
2011-12-19,Sabah,98,56,42,2011
2011-12-20,Sabah,62,16,46,2011
2011-12-21,Sabah,50,15,35,2011
2011-12-22,Sabah,21,5,16,2011
2011-12-23,Sabah,23,2,21,2011
2011-12-24,Sabah,4,0,4,2011
2011-12-25,Sabah,9,6,3,2011
2011-12-26,Sabah,12,5,7,2011
2011-12-27,Sabah,49,17,32,2011
2011-12-28,Sabah,39,10,29,2011
2011-12-29,Sabah,74,43,31,2011
2011-12-30,Sabah,76,30,46,2011
2011-12-31,Sabah,155,72,83,2011
2012-01-01,Sabah,0,0,0,2012
2012-01-02,Sabah,15,7,8,2012
2012-01-03,Sabah,44,20,24,2012
2012-01-04,Sabah,34,15,19,2012
2012-01-05,Sabah,54,30,24,2012
2012-01-06,Sabah,92,53,39,2012
2012-01-07,Sabah,101,46,55,2012
2012-01-08,Sabah,80,38,42,2012
2012-01-09,Sabah,68,27,41,2012
2012-01-10,Sabah,61,15,46,2012
2012-01-11,Sabah,60,13,47,2012
2012-01-12,Sabah,53,11,42,2012
2012-01-13,Sabah,98,50,48,2012
2012-01-14,Sabah,61,19,42,2012
2012-01-15,Sabah,0,0,0,2012
2012-01-16,Sabah,52,23,29,2012
2012-01-17,Sabah,39,6,33,2012
2012-01-18,Sabah,48,17,31,2012
2012-01-19,Sabah,37,21,16,2012
2012-01-20,Sabah,28,8,20,2012
2012-01-21,Sabah,42,11,31,2012
2012-01-22,Sabah,23,11,12,2012
2012-01-23,Sabah,7,5,2,2012
2012-01-24,Sabah,11,7,4,2012
2012-01-25,Sabah,50,22,28,2012
2012-01-26,Sabah,56,17,39,2012
2012-01-27,Sabah,41,11,30,2012
2012-01-28,Sabah,139,72,67,2012
2012-01-29,Sabah,26,16,10,2012
2012-01-30,Sabah,67,23,44,2012
2012-01-31,Sabah,93,35,58,2012
2012-02-01,Sabah,90,36,54,2012
2012-02-02,Sabah,64,11,53,2012
2012-02-03,Sabah,40,15,25,2012
2012-02-04,Sabah,19,5,14,2012
2012-02-05,Sabah,82,64,18,2012
2012-02-06,Sabah,0,0,0,2012
2012-02-07,Sabah,65,22,43,2012
2012-02-08,Sabah,75,34,41,2012
2012-02-09,Sabah,142,97,45,2012
2012-02-10,Sabah,11,4,7,2012
2012-02-11,Sabah,20,9,11,2012
2012-02-12,Sabah,20,1,19,2012
2012-02-13,Sabah,56,22,34,2012
2012-02-14,Sabah,39,14,25,2012
2012-02-15,Sabah,112,68,44,2012
2012-02-16,Sabah,176,89,87,2012
2012-02-17,Sabah,110,48,62,2012
2012-02-18,Sabah,58,26,32,2012
2012-02-19,Sabah,53,26,27,2012
2012-02-20,Sabah,21,7,14,2012
2012-02-21,Sabah,45,19,26,2012
2012-02-22,Sabah,78,18,60,2012
2012-02-23,Sabah,39,17,22,2012
2012-02-24,Sabah,29,11,18,2012
2012-02-25,Sabah,57,48,9,2012
2012-02-26,Sabah,33,16,17,2012
2012-02-27,Sabah,36,11,25,2012
2012-02-28,Sabah,79,24,55,2012
2012-02-29,Sabah,64,25,39,2012
2012-03-01,Sabah,26,15,11,2012
2012-03-02,Sabah,30,12,18,2012
2012-03-03,Sabah,17,6,11,2012
2012-03-04,Sabah,260,54,206,2012
2012-03-05,Sabah,27,6,21,2012
2012-03-06,Sabah,42,13,29,2012
2012-03-07,Sabah,81,48,33,2012
2012-03-08,Sabah,62,40,22,2012
2012-03-09,Sabah,22,3,19,2012
2012-03-10,Sabah,48,14,34,2012
2012-03-11,Sabah,50,10,40,2012
2012-03-12,Sabah,54,30,24,2012
2012-03-13,Sabah,62,24,38,2012
2012-03-14,Sabah,70,29,41,2012
2012-03-15,Sabah,87,52,35,2012
2012-03-16,Sabah,107,44,63,2012
2012-03-17,Sabah,74,32,42,2012
2012-03-18,Sabah,181,48,133,2012
2012-03-19,Sabah,96,49,47,2012
2012-03-20,Sabah,127,66,61,2012
2012-03-21,Sabah,289,136,153,2012
2012-03-22,Sabah,60,27,33,2012
2012-03-23,Sabah,137,76,61,2012
2012-03-24,Sabah,46,14,32,2012
2012-03-25,Sabah,115,34,81,2012
2012-03-26,Sabah,19,5,14,2012
2012-03-27,Sabah,42,22,20,2012
2012-03-28,Sabah,114,49,65,2012
2012-03-29,Sabah,38,15,23,2012
2012-03-30,Sabah,22,9,13,2012
2012-03-31,Sabah,29,17,12,2012
2012-04-01,Sabah,29,10,19,2012
2012-04-02,Sabah,15,2,13,2012
2012-04-03,Sabah,31,12,19,2012
2012-04-04,Sabah,95,42,53,2012
2012-04-05,Sabah,54,19,35,2012
2012-04-06,Sabah,55,40,15,2012
2012-04-07,Sabah,94,45,49,2012
2012-04-08,Sabah,114,32,82,2012
2012-04-09,Sabah,65,29,36,2012
2012-04-10,Sabah,36,6,30,2012
2012-04-11,Sabah,111,50,61,2012
2012-04-12,Sabah,87,29,58,2012
2012-04-13,Sabah,99,37,62,2012
2012-04-14,Sabah,89,37,52,2012
2012-04-15,Sabah,57,33,24,2012
2012-04-16,Sabah,25,9,16,2012
2012-04-17,Sabah,49,22,27,2012
2012-04-18,Sabah,65,18,47,2012
2012-04-19,Sabah,23,10,13,2012
2012-04-20,Sabah,45,17,28,2012
2012-04-21,Sabah,60,37,23,2012
2012-04-22,Sabah,45,14,31,2012
2012-04-23,Sabah,17,3,14,2012
2012-04-24,Sabah,71,18,53,2012
2012-04-25,Sabah,43,17,26,2012
2012-04-26,Sabah,101,45,56,2012
2012-04-27,Sabah,104,44,60,2012
2012-04-28,Sabah,56,32,24,2012
2012-04-29,Sabah,45,22,23,2012
2012-04-30,Sabah,139,83,56,2012
2012-05-01,Sabah,116,36,80,2012
2012-05-02,Sabah,98,66,32,2012
2012-05-03,Sabah,145,96,49,2012
2012-05-04,Sabah,61,11,50,2012
2012-05-05,Sabah,148,50,98,2012
2012-05-06,Sabah,92,46,46,2012
2012-05-07,Sabah,17,2,15,2012
2012-05-08,Sabah,22,10,12,2012
2012-05-09,Sabah,33,5,28,2012
2012-05-10,Sabah,45,21,24,2012
2012-05-11,Sabah,48,18,30,2012
2012-05-12,Sabah,41,10,31,2012
2012-05-13,Sabah,40,9,31,2012
2012-05-14,Sabah,53,6,47,2012
2012-05-15,Sabah,35,15,20,2012
2012-05-16,Sabah,26,12,14,2012
2012-05-17,Sabah,38,17,21,2012
2012-05-18,Sabah,38,11,27,2012
2012-05-19,Sabah,55,33,22,2012
2012-05-20,Sabah,69,40,29,2012
2012-05-21,Sabah,30,7,23,2012
2012-05-22,Sabah,37,20,17,2012
2012-05-23,Sabah,157,104,53,2012
2012-05-24,Sabah,36,6,30,2012
2012-05-25,Sabah,45,23,22,2012
2012-05-26,Sabah,67,29,38,2012
2012-05-27,Sabah,0,0,0,2012
2012-05-28,Sabah,42,24,18,2012
2012-05-29,Sabah,31,13,18,2012
2012-05-30,Sabah,40,20,20,2012
2012-05-31,Sabah,45,26,19,2012
2012-06-01,Sabah,20,3,17,2012
2012-06-02,Sabah,20,11,9,2012
2012-06-03,Sabah,126,17,109,2012
2012-06-04,Sabah,30,6,24,2012
2012-06-05,Sabah,32,11,21,2012
2012-06-06,Sabah,84,43,41,2012
2012-06-07,Sabah,48,24,24,2012
2012-06-08,Sabah,40,19,21,2012
2012-06-09,Sabah,10,3,7,2012
2012-06-10,Sabah,26,3,23,2012
2012-06-11,Sabah,59,24,35,2012
2012-06-12,Sabah,58,27,31,2012
2012-06-13,Sabah,93,58,35,2012
2012-06-14,Sabah,30,7,23,2012
2012-06-15,Sabah,22,7,15,2012
2012-06-16,Sabah,185,83,102,2012
2012-06-17,Sabah,61,2,59,2012
2012-06-18,Sabah,92,45,47,2012
2012-06-19,Sabah,44,14,30,2012
2012-06-20,Sabah,35,6,29,2012
2012-06-21,Sabah,49,15,34,2012
2012-06-22,Sabah,23,5,18,2012
2012-06-23,Sabah,90,38,52,2012
2012-06-24,Sabah,102,23,79,2012
2012-06-25,Sabah,39,21,18,2012
2012-06-26,Sabah,62,34,28,2012
2012-06-27,Sabah,102,41,61,2012
2012-06-28,Sabah,60,34,26,2012
2012-06-29,Sabah,33,15,18,2012
2012-06-30,Sabah,0,0,0,2012
2012-07-01,Sabah,14,4,10,2012
2012-07-02,Sabah,28,4,24,2012
2012-07-03,Sabah,47,20,27,2012
2012-07-04,Sabah,49,30,19,2012
2012-07-05,Sabah,42,15,27,2012
2012-07-06,Sabah,116,82,34,2012
2012-07-07,Sabah,43,16,27,2012
2012-07-08,Sabah,69,40,29,2012
2012-07-09,Sabah,59,38,21,2012
2012-07-10,Sabah,95,34,61,2012
2012-07-11,Sabah,85,21,64,2012
2012-07-12,Sabah,42,12,30,2012
2012-07-13,Sabah,36,10,26,2012
2012-07-14,Sabah,40,19,21,2012
2012-07-15,Sabah,41,15,26,2012
2012-07-16,Sabah,61,7,54,2012
2012-07-17,Sabah,41,13,28,2012
2012-07-18,Sabah,151,61,90,2012
2012-07-19,Sabah,105,70,35,2012
2012-07-20,Sabah,26,6,20,2012
2012-07-21,Sabah,12,6,6,2012
2012-07-22,Sabah,80,18,62,2012
2012-07-23,Sabah,35,16,19,2012
2012-07-24,Sabah,22,9,13,2012
2012-07-25,Sabah,15,4,11,2012
2012-07-26,Sabah,57,44,13,2012
2012-07-27,Sabah,88,66,22,2012
2012-07-28,Sabah,31,15,16,2012
2012-07-29,Sabah,29,11,18,2012
2012-07-30,Sabah,59,26,33,2012
2012-07-31,Sabah,63,29,34,2012
2012-08-01,Sabah,44,27,17,2012
2012-08-02,Sabah,40,27,13,2012
2012-08-03,Sabah,30,6,24,2012
2012-08-04,Sabah,12,8,4,2012
2012-08-05,Sabah,68,45,23,2012
2012-08-06,Sabah,41,10,31,2012
2012-08-07,Sabah,32,21,11,2012
2012-08-08,Sabah,62,24,38,2012
2012-08-09,Sabah,26,14,12,2012
2012-08-10,Sabah,66,34,32,2012
2012-08-11,Sabah,58,41,17,2012
2012-08-12,Sabah,90,38,52,2012
2012-08-13,Sabah,19,3,16,2012
2012-08-14,Sabah,73,34,39,2012
2012-08-15,Sabah,29,6,23,2012
2012-08-16,Sabah,25,10,15,2012
2012-08-17,Sabah,22,10,12,2012
2012-08-18,Sabah,52,29,23,2012
2012-08-19,Sabah,26,13,13,2012
2012-08-20,Sabah,11,6,5,2012
2012-08-21,Sabah,14,6,8,2012
2012-08-22,Sabah,39,16,23,2012
2012-08-23,Sabah,38,9,29,2012
2012-08-24,Sabah,33,13,20,2012
2012-08-25,Sabah,26,8,18,2012
2012-08-26,Sabah,73,22,51,2012
2012-08-27,Sabah,42,11,31,2012
2012-08-28,Sabah,77,12,65,2012
2012-08-29,Sabah,32,7,25,2012
2012-08-30,Sabah,22,4,18,2012
2012-08-31,Sabah,3,1,2,2012
2012-09-01,Sabah,39,16,23,2012
2012-09-02,Sabah,132,29,103,2012
2012-09-03,Sabah,40,21,19,2012
2012-09-04,Sabah,35,8,27,2012
2012-09-05,Sabah,60,18,42,2012
2012-09-06,Sabah,48,21,27,2012
2012-09-07,Sabah,29,12,17,2012
2012-09-08,Sabah,1308,419,889,2012
2012-09-09,Sabah,0,0,0,2012
2012-09-10,Sabah,24,9,15,2012
2012-09-11,Sabah,235,156,79,2012
2012-09-12,Sabah,13,3,10,2012
2012-09-13,Sabah,15,3,12,2012
2012-09-14,Sabah,21,7,14,2012
2012-09-15,Sabah,46,22,24,2012
2012-09-16,Sabah,69,16,53,2012
2012-09-17,Sabah,0,0,0,2012
2012-09-18,Sabah,23,6,17,2012
2012-09-19,Sabah,38,11,27,2012
2012-09-20,Sabah,24,9,15,2012
2012-09-21,Sabah,30,6,24,2012
2012-09-22,Sabah,60,25,35,2012
2012-09-23,Sabah,78,6,72,2012
2012-09-24,Sabah,15,4,11,2012
2012-09-25,Sabah,15,0,15,2012
2012-09-26,Sabah,51,20,31,2012
2012-09-27,Sabah,27,4,23,2012
2012-09-28,Sabah,16,2,14,2012
2012-09-29,Sabah,53,32,21,2012
2012-09-30,Sabah,17,7,10,2012
2012-10-01,Sabah,85,14,71,2012
2012-10-02,Sabah,20,5,15,2012
2012-10-03,Sabah,38,12,26,2012
2012-10-04,Sabah,24,4,20,2012
2012-10-05,Sabah,59,15,44,2012
2012-10-06,Sabah,12,6,6,2012
2012-10-07,Sabah,145,50,95,2012
2012-10-08,Sabah,29,10,19,2012
2012-10-09,Sabah,36,13,23,2012
2012-10-10,Sabah,81,6,75,2012
2012-10-11,Sabah,85,18,67,2012
2012-10-12,Sabah,42,12,30,2012
2012-10-13,Sabah,45,18,27,2012
2012-10-14,Sabah,28,13,15,2012
2012-10-15,Sabah,67,24,43,2012
2012-10-16,Sabah,101,65,36,2012
2012-10-17,Sabah,59,30,29,2012
2012-10-18,Sabah,21,7,14,2012
2012-10-19,Sabah,120,48,72,2012
2012-10-20,Sabah,86,38,48,2012
2012-10-21,Sabah,54,18,36,2012
2012-10-22,Sabah,38,20,18,2012
2012-10-23,Sabah,51,21,30,2012
2012-10-24,Sabah,34,13,21,2012
2012-10-25,Sabah,40,14,26,2012
2012-10-26,Sabah,12,10,2,2012
2012-10-27,Sabah,54,30,24,2012
2012-10-28,Sabah,19,8,11,2012
2012-10-29,Sabah,32,12,20,2012
2012-10-30,Sabah,36,17,19,2012
2012-10-31,Sabah,57,12,45,2012
2012-11-01,Sabah,42,17,25,2012
2012-11-02,Sabah,7,0,7,2012
2012-11-03,Sabah,63,28,35,2012
2012-11-04,Sabah,398,171,227,2012
2012-11-05,Sabah,52,16,36,2012
2012-11-06,Sabah,38,10,28,2012
2012-11-07,Sabah,24,12,12,2012
2012-11-08,Sabah,22,6,16,2012
2012-11-09,Sabah,14,2,12,2012
2012-11-10,Sabah,57,19,38,2012
2012-11-11,Sabah,27,11,16,2012
2012-11-12,Sabah,37,11,26,2012
2012-11-13,Sabah,95,47,48,2012
2012-11-14,Sabah,17,6,11,2012
2012-11-15,Sabah,65,33,32,2012
2012-11-16,Sabah,21,5,16,2012
2012-11-17,Sabah,37,16,21,2012
2012-11-18,Sabah,100,42,58,2012
2012-11-19,Sabah,26,8,18,2012
2012-11-20,Sabah,31,13,18,2012
2012-11-21,Sabah,46,26,20,2012
2012-11-22,Sabah,115,55,60,2012
2012-11-23,Sabah,51,18,33,2012
2012-11-24,Sabah,34,10,24,2012
2012-11-25,Sabah,84,16,68,2012
2012-11-26,Sabah,56,21,35,2012
2012-11-27,Sabah,50,13,37,2012
2012-11-28,Sabah,28,11,17,2012
2012-11-29,Sabah,16,3,13,2012
2012-11-30,Sabah,42,7,35,2012
2012-12-01,Sabah,40,20,20,2012
2012-12-02,Sabah,142,34,108,2012
2012-12-03,Sabah,17,4,13,2012
2012-12-04,Sabah,17,9,8,2012
2012-12-05,Sabah,21,3,18,2012
2012-12-06,Sabah,29,7,22,2012
2012-12-07,Sabah,44,18,26,2012
2012-12-08,Sabah,53,28,25,2012
2012-12-09,Sabah,89,35,54,2012
2012-12-10,Sabah,27,4,23,2012
2012-12-11,Sabah,44,9,35,2012
2012-12-12,Sabah,120,64,56,2012
2012-12-13,Sabah,15,5,10,2012
2012-12-14,Sabah,31,6,25,2012
2012-12-15,Sabah,48,18,30,2012
2012-12-16,Sabah,94,18,76,2012
2012-12-17,Sabah,44,17,27,2012
2012-12-18,Sabah,46,9,37,2012
2012-12-19,Sabah,58,25,33,2012
2012-12-20,Sabah,52,25,27,2012
2012-12-21,Sabah,30,14,16,2012
2012-12-22,Sabah,16,2,14,2012
2012-12-23,Sabah,76,7,69,2012
2012-12-24,Sabah,25,7,18,2012
2012-12-25,Sabah,35,12,23,2012
2012-12-26,Sabah,28,7,21,2012
2012-12-27,Sabah,22,7,15,2012
2012-12-28,Sabah,34,13,21,2012
2012-12-29,Sabah,25,18,7,2012
2012-12-30,Sabah,115,51,64,2012
2012-12-31,Sabah,53,33,20,2012
2013-01-01,Sabah,9,6,3,2013
2013-01-02,Sabah,49,13,36,2013
2013-01-03,Sabah,37,12,25,2013
2013-01-04,Sabah,32,13,19,2013
2013-01-05,Sabah,49,26,23,2013
2013-01-06,Sabah,32,3,29,2013
2013-01-07,Sabah,67,30,37,2013
2013-01-08,Sabah,68,21,47,2013
2013-01-09,Sabah,132,51,81,2013
2013-01-10,Sabah,53,29,24,2013
2013-01-11,Sabah,67,29,38,2013
2013-01-12,Sabah,23,10,13,2013
2013-01-13,Sabah,4,2,2,2013
2013-01-14,Sabah,103,51,52,2013
2013-01-15,Sabah,59,29,30,2013
2013-01-16,Sabah,72,47,25,2013
2013-01-17,Sabah,81,27,54,2013
2013-01-18,Sabah,61,26,35,2013
2013-01-19,Sabah,114,60,54,2013
2013-01-20,Sabah,38,16,22,2013
2013-01-21,Sabah,51,16,35,2013
2013-01-22,Sabah,115,49,66,2013
2013-01-23,Sabah,82,34,48,2013
2013-01-24,Sabah,48,27,21,2013
2013-01-25,Sabah,22,8,14,2013
2013-01-26,Sabah,119,51,68,2013
2013-01-27,Sabah,6,2,4,2013
2013-01-28,Sabah,44,13,31,2013
2013-01-29,Sabah,89,53,36,2013
2013-01-30,Sabah,156,63,93,2013
2013-01-31,Sabah,13,2,11,2013
2013-02-01,Sabah,44,9,35,2013
2013-02-02,Sabah,44,21,23,2013
2013-02-03,Sabah,184,72,112,2013
2013-02-04,Sabah,36,12,24,2013
2013-02-05,Sabah,71,21,50,2013
2013-02-06,Sabah,93,42,51,2013
2013-02-07,Sabah,12,4,8,2013
2013-02-08,Sabah,26,17,9,2013
2013-02-09,Sabah,8,3,5,2013
2013-02-10,Sabah,51,24,27,2013
2013-02-11,Sabah,38,18,20,2013
2013-02-12,Sabah,26,14,12,2013
2013-02-13,Sabah,75,47,28,2013
2013-02-14,Sabah,32,11,21,2013
2013-02-15,Sabah,43,9,34,2013
2013-02-16,Sabah,31,12,19,2013
2013-02-17,Sabah,47,30,17,2013
2013-02-18,Sabah,74,50,24,2013
2013-02-19,Sabah,46,20,26,2013
2013-02-20,Sabah,106,68,38,2013
2013-02-21,Sabah,29,17,12,2013
2013-02-22,Sabah,72,39,33,2013
2013-02-23,Sabah,46,20,26,2013
2013-02-24,Sabah,40,12,28,2013
2013-02-25,Sabah,25,6,19,2013
2013-02-26,Sabah,75,20,55,2013
2013-02-27,Sabah,164,56,108,2013
2013-02-28,Sabah,27,8,19,2013
2013-03-01,Sabah,55,16,39,2013
2013-03-02,Sabah,46,14,32,2013
2013-03-03,Sabah,210,48,162,2013
2013-03-04,Sabah,53,26,27,2013
2013-03-05,Sabah,74,18,56,2013
2013-03-06,Sabah,135,44,91,2013
2013-03-07,Sabah,157,72,85,2013
2013-03-08,Sabah,122,66,56,2013
2013-03-09,Sabah,83,34,49,2013
2013-03-10,Sabah,0,0,0,2013
2013-03-11,Sabah,27,11,16,2013
2013-03-12,Sabah,80,17,63,2013
2013-03-13,Sabah,37,13,24,2013
2013-03-14,Sabah,63,38,25,2013
2013-03-15,Sabah,36,12,24,2013
2013-03-16,Sabah,58,27,31,2013
2013-03-17,Sabah,92,18,74,2013
2013-03-18,Sabah,40,14,26,2013
2013-03-19,Sabah,59,28,31,2013
2013-03-20,Sabah,215,141,74,2013
2013-03-21,Sabah,74,21,53,2013
2013-03-22,Sabah,26,6,20,2013
2013-03-23,Sabah,108,39,69,2013
2013-03-24,Sabah,90,17,73,2013
2013-03-25,Sabah,72,41,31,2013
2013-03-26,Sabah,32,14,18,2013
2013-03-27,Sabah,21,6,15,2013
2013-03-28,Sabah,30,9,21,2013
2013-03-29,Sabah,48,21,27,2013
2013-03-30,Sabah,38,23,15,2013
2013-03-31,Sabah,102,48,54,2013
2013-04-01,Sabah,30,10,20,2013
2013-04-02,Sabah,49,7,42,2013
2013-04-03,Sabah,26,5,21,2013
2013-04-04,Sabah,26,6,20,2013
2013-04-05,Sabah,104,30,74,2013
2013-04-06,Sabah,10,3,7,2013
2013-04-07,Sabah,61,13,48,2013
2013-04-08,Sabah,37,11,26,2013
2013-04-09,Sabah,20,4,16,2013
2013-04-10,Sabah,75,14,61,2013
2013-04-11,Sabah,13,2,11,2013
2013-04-12,Sabah,74,21,53,2013
2013-04-13,Sabah,28,13,15,2013
2013-04-14,Sabah,31,4,27,2013
2013-04-15,Sabah,47,15,32,2013
2013-04-16,Sabah,38,12,26,2013
2013-04-17,Sabah,45,20,25,2013
2013-04-18,Sabah,27,7,20,2013
2013-04-19,Sabah,32,9,23,2013
2013-04-20,Sabah,50,19,31,2013
2013-04-21,Sabah,174,57,117,2013
2013-04-22,Sabah,37,12,25,2013
2013-04-23,Sabah,44,18,26,2013
2013-04-24,Sabah,118,31,87,2013
2013-04-25,Sabah,115,54,61,2013
2013-04-26,Sabah,32,6,26,2013
2013-04-27,Sabah,70,23,47,2013
2013-04-28,Sabah,99,37,62,2013
2013-04-29,Sabah,79,19,60,2013
2013-04-30,Sabah,57,27,30,2013
2013-05-01,Sabah,321,125,196,2013
2013-05-02,Sabah,25,9,16,2013
2013-05-03,Sabah,31,4,27,2013
2013-05-04,Sabah,5,1,4,2013
2013-05-05,Sabah,0,0,0,2013
2013-05-06,Sabah,12,5,7,2013
2013-05-07,Sabah,68,15,53,2013
2013-05-08,Sabah,94,46,48,2013
2013-05-09,Sabah,74,34,40,2013
2013-05-10,Sabah,109,58,51,2013
2013-05-11,Sabah,75,28,47,2013
2013-05-12,Sabah,30,11,19,2013
2013-05-13,Sabah,18,5,13,2013
2013-05-14,Sabah,17,3,14,2013
2013-05-15,Sabah,38,11,27,2013
2013-05-16,Sabah,32,11,21,2013
2013-05-17,Sabah,19,5,14,2013
2013-05-18,Sabah,83,49,34,2013
2013-05-19,Sabah,120,36,84,2013
2013-05-20,Sabah,74,63,11,2013
2013-05-21,Sabah,11,2,9,2013
2013-05-22,Sabah,54,4,50,2013
2013-05-23,Sabah,38,9,29,2013
2013-05-24,Sabah,158,44,114,2013
2013-05-25,Sabah,75,34,41,2013
2013-05-26,Sabah,43,9,34,2013
2013-05-27,Sabah,17,3,14,2013
2013-05-28,Sabah,22,4,18,2013
2013-05-29,Sabah,37,6,31,2013
2013-05-30,Sabah,13,5,8,2013
2013-05-31,Sabah,54,24,30,2013
2013-06-01,Sabah,15,5,10,2013
2013-06-02,Sabah,167,37,130,2013
2013-06-03,Sabah,13,3,10,2013
2013-06-04,Sabah,19,6,13,2013
2013-06-05,Sabah,63,23,40,2013
2013-06-06,Sabah,28,11,17,2013
2013-06-07,Sabah,17,1,16,2013
2013-06-08,Sabah,24,10,14,2013
2013-06-09,Sabah,110,50,60,2013
2013-06-10,Sabah,38,13,25,2013
2013-06-11,Sabah,25,8,17,2013
2013-06-12,Sabah,21,3,18,2013
2013-06-13,Sabah,38,14,24,2013
2013-06-14,Sabah,25,9,16,2013
2013-06-15,Sabah,232,107,125,2013
2013-06-16,Sabah,141,15,126,2013
2013-06-17,Sabah,56,19,37,2013
2013-06-18,Sabah,53,18,35,2013
2013-06-19,Sabah,96,31,65,2013
2013-06-20,Sabah,37,9,28,2013
2013-06-21,Sabah,43,18,25,2013
2013-06-22,Sabah,89,35,54,2013
2013-06-23,Sabah,47,27,20,2013
2013-06-24,Sabah,22,4,18,2013
2013-06-25,Sabah,62,18,44,2013
2013-06-26,Sabah,46,17,29,2013
2013-06-27,Sabah,28,8,20,2013
2013-06-28,Sabah,50,19,31,2013
2013-06-29,Sabah,43,17,26,2013
2013-06-30,Sabah,26,8,18,2013
2013-07-01,Sabah,25,1,24,2013
2013-07-02,Sabah,78,36,42,2013
2013-07-03,Sabah,81,34,47,2013
2013-07-04,Sabah,103,33,70,2013
2013-07-05,Sabah,19,4,15,2013
2013-07-06,Sabah,201,103,98,2013
2013-07-07,Sabah,45,19,26,2013
2013-07-08,Sabah,80,40,40,2013
2013-07-09,Sabah,45,11,34,2013
2013-07-10,Sabah,67,13,54,2013
2013-07-11,Sabah,21,7,14,2013
2013-07-12,Sabah,23,3,20,2013
2013-07-13,Sabah,29,13,16,2013
2013-07-14,Sabah,67,40,27,2013
2013-07-15,Sabah,15,5,10,2013
2013-07-16,Sabah,48,17,31,2013
2013-07-17,Sabah,58,14,44,2013
2013-07-18,Sabah,82,39,43,2013
2013-07-19,Sabah,44,16,28,2013
2013-07-20,Sabah,25,10,15,2013
2013-07-21,Sabah,54,35,19,2013
2013-07-22,Sabah,59,29,30,2013
2013-07-23,Sabah,55,33,22,2013
2013-07-24,Sabah,83,49,34,2013
2013-07-25,Sabah,28,10,18,2013
2013-07-26,Sabah,38,19,19,2013
2013-07-27,Sabah,78,29,49,2013
2013-07-28,Sabah,50,22,28,2013
2013-07-29,Sabah,22,4,18,2013
2013-07-30,Sabah,39,25,14,2013
2013-07-31,Sabah,66,41,25,2013
2013-08-01,Sabah,104,55,49,2013
2013-08-02,Sabah,84,34,50,2013
2013-08-03,Sabah,35,16,19,2013
2013-08-04,Sabah,51,19,32,2013
2013-08-05,Sabah,26,9,17,2013
2013-08-06,Sabah,31,7,24,2013
2013-08-07,Sabah,32,13,19,2013
2013-08-08,Sabah,16,8,8,2013
2013-08-09,Sabah,13,8,5,2013
2013-08-10,Sabah,27,15,12,2013
2013-08-11,Sabah,47,8,39,2013
2013-08-12,Sabah,43,28,15,2013
2013-08-13,Sabah,75,27,48,2013
2013-08-14,Sabah,86,35,51,2013
2013-08-15,Sabah,166,96,70,2013
2013-08-16,Sabah,67,31,36,2013
2013-08-17,Sabah,98,42,56,2013
2013-08-18,Sabah,105,37,68,2013
2013-08-19,Sabah,67,25,42,2013
2013-08-20,Sabah,98,22,76,2013
2013-08-21,Sabah,84,36,48,2013
2013-08-22,Sabah,51,26,25,2013
2013-08-23,Sabah,39,16,23,2013
2013-08-24,Sabah,71,32,39,2013
2013-08-25,Sabah,39,22,17,2013
2013-08-26,Sabah,29,8,21,2013
2013-08-27,Sabah,71,22,49,2013
2013-08-28,Sabah,134,74,60,2013
2013-08-29,Sabah,68,57,11,2013
2013-08-30,Sabah,18,5,13,2013
2013-08-31,Sabah,1,0,1,2013
2013-09-01,Sabah,137,25,112,2013
2013-09-02,Sabah,20,5,15,2013
2013-09-03,Sabah,22,4,18,2013
2013-09-04,Sabah,21,4,17,2013
2013-09-05,Sabah,39,13,26,2013
2013-09-06,Sabah,21,2,19,2013
2013-09-07,Sabah,1228,368,860,2013
2013-09-08,Sabah,0,0,0,2013
2013-09-09,Sabah,25,4,21,2013
2013-09-10,Sabah,15,5,10,2013
2013-09-11,Sabah,18,2,16,2013
2013-09-12,Sabah,20,7,13,2013
2013-09-13,Sabah,39,12,27,2013
2013-09-14,Sabah,59,21,38,2013
2013-09-15,Sabah,66,12,54,2013
2013-09-16,Sabah,21,10,11,2013
2013-09-17,Sabah,33,9,24,2013
2013-09-18,Sabah,162,71,91,2013
2013-09-19,Sabah,43,25,18,2013
2013-09-20,Sabah,32,11,21,2013
2013-09-21,Sabah,42,18,24,2013
2013-09-22,Sabah,133,32,101,2013
2013-09-23,Sabah,29,14,15,2013
2013-09-24,Sabah,29,15,14,2013
2013-09-25,Sabah,51,33,18,2013
2013-09-26,Sabah,34,3,31,2013
2013-09-27,Sabah,9,1,8,2013
2013-09-28,Sabah,2,0,2,2013
2013-09-29,Sabah,70,28,42,2013
2013-09-30,Sabah,13,0,13,2013
2013-10-01,Sabah,42,12,30,2013
2013-10-02,Sabah,64,29,35,2013
2013-10-03,Sabah,55,23,32,2013
2013-10-04,Sabah,16,3,13,2013
2013-10-05,Sabah,87,35,52,2013
2013-10-06,Sabah,37,13,24,2013
2013-10-07,Sabah,53,21,32,2013
2013-10-08,Sabah,56,24,32,2013
2013-10-09,Sabah,64,17,47,2013
2013-10-10,Sabah,36,11,25,2013
2013-10-11,Sabah,75,31,44,2013
2013-10-12,Sabah,87,47,40,2013
2013-10-13,Sabah,42,27,15,2013
2013-10-14,Sabah,57,37,20,2013
2013-10-15,Sabah,23,11,12,2013
2013-10-16,Sabah,57,31,26,2013
2013-10-17,Sabah,53,11,42,2013
2013-10-18,Sabah,27,9,18,2013
2013-10-19,Sabah,38,16,22,2013
2013-10-20,Sabah,80,32,48,2013
2013-10-21,Sabah,19,9,10,2013
2013-10-22,Sabah,99,55,44,2013
2013-10-23,Sabah,84,27,57,2013
2013-10-24,Sabah,76,17,59,2013
2013-10-25,Sabah,90,19,71,2013
2013-10-26,Sabah,127,51,76,2013
2013-10-27,Sabah,116,47,69,2013
2013-10-28,Sabah,63,39,24,2013
2013-10-29,Sabah,39,16,23,2013
2013-10-30,Sabah,41,12,29,2013
2013-10-31,Sabah,44,17,27,2013
2013-11-01,Sabah,63,10,53,2013
2013-11-02,Sabah,100,53,47,2013
2013-11-03,Sabah,27,5,22,2013
2013-11-04,Sabah,54,21,33,2013
2013-11-05,Sabah,28,7,21,2013
2013-11-06,Sabah,43,12,31,2013
2013-11-07,Sabah,99,36,63,2013
2013-11-08,Sabah,31,11,20,2013
2013-11-09,Sabah,32,13,19,2013
2013-11-10,Sabah,71,14,57,2013
2013-11-11,Sabah,63,29,34,2013
2013-11-12,Sabah,37,10,27,2013
2013-11-13,Sabah,165,88,77,2013
2013-11-14,Sabah,138,83,55,2013
2013-11-15,Sabah,49,24,25,2013
2013-11-16,Sabah,90,25,65,2013
2013-11-17,Sabah,40,16,24,2013
2013-11-18,Sabah,27,12,15,2013
2013-11-19,Sabah,51,33,18,2013
2013-11-20,Sabah,37,20,17,2013
2013-11-21,Sabah,39,11,28,2013
2013-11-22,Sabah,39,9,30,2013
2013-11-23,Sabah,39,16,23,2013
2013-11-24,Sabah,84,39,45,2013
2013-11-25,Sabah,10,3,7,2013
2013-11-26,Sabah,26,9,17,2013
2013-11-27,Sabah,29,12,17,2013
2013-11-28,Sabah,115,70,45,2013
2013-11-29,Sabah,96,61,35,2013
2013-11-30,Sabah,47,22,25,2013
2013-12-01,Sabah,177,24,153,2013
2013-12-02,Sabah,19,2,17,2013
2013-12-03,Sabah,27,7,20,2013
2013-12-04,Sabah,30,11,19,2013
2013-12-05,Sabah,46,21,25,2013
2013-12-06,Sabah,93,33,60,2013
2013-12-07,Sabah,26,7,19,2013
2013-12-08,Sabah,11,4,7,2013
2013-12-09,Sabah,23,9,14,2013
2013-12-10,Sabah,43,14,29,2013
2013-12-11,Sabah,43,22,21,2013
2013-12-12,Sabah,71,27,44,2013
2013-12-13,Sabah,29,8,21,2013
2013-12-14,Sabah,135,63,72,2013
2013-12-15,Sabah,104,37,67,2013
2013-12-16,Sabah,45,17,28,2013
2013-12-17,Sabah,60,21,39,2013
2013-12-18,Sabah,248,140,108,2013
2013-12-19,Sabah,37,16,21,2013
2013-12-20,Sabah,66,23,43,2013
2013-12-21,Sabah,61,22,39,2013
2013-12-22,Sabah,105,20,85,2013
2013-12-23,Sabah,19,9,10,2013
2013-12-24,Sabah,28,3,25,2013
2013-12-25,Sabah,30,8,22,2013
2013-12-26,Sabah,7,1,6,2013
2013-12-27,Sabah,22,5,17,2013
2013-12-28,Sabah,35,11,24,2013
2013-12-29,Sabah,126,41,85,2013
2013-12-30,Sabah,28,6,22,2013
2013-12-31,Sabah,47,13,34,2013
2014-01-01,Sabah,14,3,11,2014
2014-01-02,Sabah,35,14,21,2014
2014-01-03,Sabah,17,3,14,2014
2014-01-04,Sabah,49,10,39,2014
2014-01-05,Sabah,90,25,65,2014
2014-01-06,Sabah,36,11,25,2014
2014-01-07,Sabah,58,15,43,2014
2014-01-08,Sabah,69,20,49,2014
2014-01-09,Sabah,23,8,15,2014
2014-01-10,Sabah,26,18,8,2014
2014-01-11,Sabah,129,76,53,2014
2014-01-12,Sabah,25,11,14,2014
2014-01-13,Sabah,59,14,45,2014
2014-01-14,Sabah,62,38,24,2014
2014-01-15,Sabah,51,22,29,2014
2014-01-16,Sabah,38,21,17,2014
2014-01-17,Sabah,42,9,33,2014
2014-01-18,Sabah,26,9,17,2014
2014-01-19,Sabah,34,20,14,2014
2014-01-20,Sabah,50,23,27,2014
2014-01-21,Sabah,150,82,68,2014
2014-01-22,Sabah,105,55,50,2014
2014-01-23,Sabah,59,28,31,2014
2014-01-24,Sabah,29,6,23,2014
2014-01-25,Sabah,60,35,25,2014
2014-01-26,Sabah,51,24,27,2014
2014-01-27,Sabah,35,17,18,2014
2014-01-28,Sabah,162,76,86,2014
2014-01-29,Sabah,42,17,25,2014
2014-01-30,Sabah,54,18,36,2014
2014-01-31,Sabah,20,10,10,2014
2014-02-01,Sabah,38,23,15,2014
2014-02-02,Sabah,12,5,7,2014
2014-02-03,Sabah,41,18,23,2014
2014-02-04,Sabah,60,30,30,2014
2014-02-05,Sabah,133,65,68,2014
2014-02-06,Sabah,65,28,37,2014
2014-02-07,Sabah,62,26,36,2014
2014-02-08,Sabah,65,28,37,2014
2014-02-09,Sabah,63,20,43,2014
2014-02-10,Sabah,42,25,17,2014
2014-02-11,Sabah,89,29,60,2014
2014-02-12,Sabah,105,37,68,2014
2014-02-13,Sabah,93,35,58,2014
2014-02-14,Sabah,34,16,18,2014
2014-02-15,Sabah,35,18,17,2014
2014-02-16,Sabah,54,14,40,2014
2014-02-17,Sabah,75,33,42,2014
2014-02-18,Sabah,95,59,36,2014
2014-02-19,Sabah,46,7,39,2014
2014-02-20,Sabah,40,22,18,2014
2014-02-21,Sabah,23,8,15,2014
2014-02-22,Sabah,57,39,18,2014
2014-02-23,Sabah,68,25,43,2014
2014-02-24,Sabah,68,15,53,2014
2014-02-25,Sabah,136,67,69,2014
2014-02-26,Sabah,94,45,49,2014
2014-02-27,Sabah,179,73,106,2014
2014-02-28,Sabah,44,13,31,2014
2014-03-01,Sabah,83,22,61,2014
2014-03-02,Sabah,211,53,158,2014
2014-03-03,Sabah,70,23,47,2014
2014-03-04,Sabah,63,23,40,2014
2014-03-05,Sabah,80,44,36,2014
2014-03-06,Sabah,110,64,46,2014
2014-03-07,Sabah,41,24,17,2014
2014-03-08,Sabah,84,35,49,2014
2014-03-09,Sabah,89,11,78,2014
2014-03-10,Sabah,48,6,42,2014
2014-03-11,Sabah,73,18,55,2014
2014-03-12,Sabah,83,24,59,2014
2014-03-13,Sabah,64,24,40,2014
2014-03-14,Sabah,122,53,69,2014
2014-03-15,Sabah,17,9,8,2014
2014-03-16,Sabah,44,13,31,2014
2014-03-17,Sabah,37,9,28,2014
2014-03-18,Sabah,38,10,28,2014
2014-03-19,Sabah,43,17,26,2014
2014-03-20,Sabah,17,3,14,2014
2014-03-21,Sabah,67,40,27,2014
2014-03-22,Sabah,18,3,15,2014
2014-03-23,Sabah,127,20,107,2014
2014-03-24,Sabah,49,13,36,2014
2014-03-25,Sabah,43,14,29,2014
2014-03-26,Sabah,31,9,22,2014
2014-03-27,Sabah,35,15,20,2014
2014-03-28,Sabah,33,12,21,2014
2014-03-29,Sabah,124,40,84,2014
2014-03-30,Sabah,52,12,40,2014
2014-03-31,Sabah,56,30,26,2014
2014-04-01,Sabah,41,10,31,2014
2014-04-02,Sabah,84,25,59,2014
2014-04-03,Sabah,27,11,16,2014
2014-04-04,Sabah,68,22,46,2014
2014-04-05,Sabah,31,10,21,2014
2014-04-06,Sabah,33,8,25,2014
2014-04-07,Sabah,62,23,39,2014
2014-04-08,Sabah,92,36,56,2014
2014-04-09,Sabah,93,30,63,2014
2014-04-10,Sabah,41,10,31,2014
2014-04-11,Sabah,35,18,17,2014
2014-04-12,Sabah,94,48,46,2014
2014-04-13,Sabah,133,42,91,2014
2014-04-14,Sabah,59,19,40,2014
2014-04-15,Sabah,26,9,17,2014
2014-04-16,Sabah,192,94,98,2014
2014-04-17,Sabah,105,43,62,2014
2014-04-18,Sabah,33,10,23,2014
2014-04-19,Sabah,72,25,47,2014
2014-04-20,Sabah,6,3,3,2014
2014-04-21,Sabah,23,6,17,2014
2014-04-22,Sabah,43,14,29,2014
2014-04-23,Sabah,43,10,33,2014
2014-04-24,Sabah,28,8,20,2014
2014-04-25,Sabah,61,16,45,2014
2014-04-26,Sabah,26,7,19,2014
2014-04-27,Sabah,54,21,33,2014
2014-04-28,Sabah,51,22,29,2014
2014-04-29,Sabah,148,63,85,2014
2014-04-30,Sabah,31,10,21,2014
2014-05-01,Sabah,35,16,19,2014
2014-05-02,Sabah,29,6,23,2014
2014-05-03,Sabah,88,30,58,2014
2014-05-04,Sabah,44,9,35,2014
2014-05-05,Sabah,21,11,10,2014
2014-05-06,Sabah,109,41,68,2014
2014-05-07,Sabah,61,26,35,2014
2014-05-08,Sabah,53,26,27,2014
2014-05-09,Sabah,89,27,62,2014
2014-05-10,Sabah,41,25,16,2014
2014-05-11,Sabah,113,50,63,2014
2014-05-12,Sabah,49,12,37,2014
2014-05-13,Sabah,243,72,171,2014
2014-05-14,Sabah,37,14,23,2014
2014-05-15,Sabah,31,7,24,2014
2014-05-16,Sabah,22,8,14,2014
2014-05-17,Sabah,100,36,64,2014
2014-05-18,Sabah,54,15,39,2014
2014-05-19,Sabah,39,11,28,2014
2014-05-20,Sabah,212,109,103,2014
2014-05-21,Sabah,160,60,100,2014
2014-05-22,Sabah,97,43,54,2014
2014-05-23,Sabah,51,23,28,2014
2014-05-24,Sabah,6,1,5,2014
2014-05-25,Sabah,54,30,24,2014
2014-05-26,Sabah,24,7,17,2014
2014-05-27,Sabah,53,9,44,2014
2014-05-28,Sabah,94,47,47,2014
2014-05-29,Sabah,14,0,14,2014
2014-05-30,Sabah,104,16,88,2014
2014-05-31,Sabah,14,5,9,2014
2014-06-01,Sabah,14,4,10,2014
2014-06-02,Sabah,24,11,13,2014
2014-06-03,Sabah,17,2,15,2014
2014-06-04,Sabah,33,5,28,2014
2014-06-05,Sabah,28,6,22,2014
2014-06-06,Sabah,39,13,26,2014
2014-06-07,Sabah,35,10,25,2014
2014-06-08,Sabah,42,15,27,2014
2014-06-09,Sabah,35,2,33,2014
2014-06-10,Sabah,121,41,80,2014
2014-06-11,Sabah,30,12,18,2014
2014-06-12,Sabah,60,12,48,2014
2014-06-13,Sabah,45,7,38,2014
2014-06-14,Sabah,31,28,3,2014
2014-06-15,Sabah,67,5,62,2014
2014-06-16,Sabah,27,11,16,2014
2014-06-17,Sabah,54,23,31,2014
2014-06-18,Sabah,102,43,59,2014
2014-06-19,Sabah,27,10,17,2014
2014-06-20,Sabah,43,11,32,2014
2014-06-21,Sabah,193,75,118,2014
2014-06-22,Sabah,80,16,64,2014
2014-06-23,Sabah,56,19,37,2014
2014-06-24,Sabah,109,36,73,2014
2014-06-25,Sabah,76,25,51,2014
2014-06-26,Sabah,58,15,43,2014
2014-06-27,Sabah,17,6,11,2014
2014-06-28,Sabah,80,44,36,2014
2014-06-29,Sabah,18,2,16,2014
2014-06-30,Sabah,13,6,7,2014
2014-07-01,Sabah,17,7,10,2014
2014-07-02,Sabah,35,14,21,2014
2014-07-03,Sabah,46,17,29,2014
2014-07-04,Sabah,31,9,22,2014
2014-07-05,Sabah,24,4,20,2014
2014-07-06,Sabah,73,14,59,2014
2014-07-07,Sabah,22,5,17,2014
2014-07-08,Sabah,11,3,8,2014
2014-07-09,Sabah,75,10,65,2014
2014-07-10,Sabah,43,19,24,2014
2014-07-11,Sabah,39,11,28,2014
2014-07-12,Sabah,62,28,34,2014
2014-07-13,Sabah,77,35,42,2014
2014-07-14,Sabah,24,6,18,2014
2014-07-15,Sabah,59,34,25,2014
2014-07-16,Sabah,98,34,64,2014
2014-07-17,Sabah,70,32,38,2014
2014-07-18,Sabah,11,6,5,2014
2014-07-19,Sabah,31,10,21,2014
2014-07-20,Sabah,82,25,57,2014
2014-07-21,Sabah,72,35,37,2014
2014-07-22,Sabah,48,23,25,2014
2014-07-23,Sabah,32,20,12,2014
2014-07-24,Sabah,105,42,63,2014
2014-07-25,Sabah,53,16,37,2014
2014-07-26,Sabah,26,14,12,2014
2014-07-27,Sabah,43,15,28,2014
2014-07-28,Sabah,11,5,6,2014
2014-07-29,Sabah,12,5,7,2014
2014-07-30,Sabah,86,38,48,2014
2014-07-31,Sabah,30,9,21,2014
2014-08-01,Sabah,77,21,56,2014
2014-08-02,Sabah,65,29,36,2014
2014-08-03,Sabah,25,11,14,2014
2014-08-04,Sabah,48,14,34,2014
2014-08-05,Sabah,64,29,35,2014
2014-08-06,Sabah,54,18,36,2014
2014-08-07,Sabah,35,11,24,2014
2014-08-08,Sabah,24,8,16,2014
2014-08-09,Sabah,12,4,8,2014
2014-08-10,Sabah,113,27,86,2014
2014-08-11,Sabah,23,8,15,2014
2014-08-12,Sabah,35,4,31,2014
2014-08-13,Sabah,42,21,21,2014
2014-08-14,Sabah,114,54,60,2014
2014-08-15,Sabah,22,6,16,2014
2014-08-16,Sabah,21,8,13,2014
2014-08-17,Sabah,108,44,64,2014
2014-08-18,Sabah,35,7,28,2014
2014-08-19,Sabah,37,12,25,2014
2014-08-20,Sabah,47,18,29,2014
2014-08-21,Sabah,49,17,32,2014
2014-08-22,Sabah,28,5,23,2014
2014-08-23,Sabah,81,24,57,2014
2014-08-24,Sabah,11,5,6,2014
2014-08-25,Sabah,69,33,36,2014
2014-08-26,Sabah,40,13,27,2014
2014-08-27,Sabah,94,44,50,2014
2014-08-28,Sabah,86,63,23,2014
2014-08-29,Sabah,45,20,25,2014
2014-08-30,Sabah,13,2,11,2014
2014-08-31,Sabah,14,3,11,2014
2014-09-01,Sabah,0,0,0,2014
2014-09-02,Sabah,43,22,21,2014
2014-09-03,Sabah,54,21,33,2014
2014-09-04,Sabah,37,14,23,2014
2014-09-05,Sabah,31,13,18,2014
2014-09-06,Sabah,1249,332,917,2014
2014-09-07,Sabah,102,12,90,2014
2014-09-08,Sabah,29,12,17,2014
2014-09-09,Sabah,60,31,29,2014
2014-09-10,Sabah,64,31,33,2014
2014-09-11,Sabah,27,10,17,2014
2014-09-12,Sabah,50,24,26,2014
2014-09-13,Sabah,113,27,86,2014
2014-09-14,Sabah,113,27,86,2014
2014-09-15,Sabah,24,9,15,2014
2014-09-16,Sabah,118,41,77,2014
2014-09-17,Sabah,96,24,72,2014
2014-09-18,Sabah,27,10,17,2014
2014-09-19,Sabah,32,5,27,2014
2014-09-20,Sabah,111,46,65,2014
2014-09-21,Sabah,191,45,146,2014
2014-09-22,Sabah,54,6,48,2014
2014-09-23,Sabah,19,5,14,2014
2014-09-24,Sabah,98,28,70,2014
2014-09-25,Sabah,42,6,36,2014
2014-09-26,Sabah,56,25,31,2014
2014-09-27,Sabah,58,40,18,2014
2014-09-28,Sabah,40,6,34,2014
2014-09-29,Sabah,64,23,41,2014
2014-09-30,Sabah,52,14,38,2014
2014-10-01,Sabah,63,21,42,2014
2014-10-02,Sabah,27,11,16,2014
2014-10-03,Sabah,26,9,17,2014
2014-10-04,Sabah,65,23,42,2014
2014-10-05,Sabah,13,5,8,2014
2014-10-06,Sabah,24,10,14,2014
2014-10-07,Sabah,11,2,9,2014
2014-10-08,Sabah,53,6,47,2014
2014-10-09,Sabah,32,20,12,2014
2014-10-10,Sabah,96,31,65,2014
2014-10-11,Sabah,51,19,32,2014
2014-10-12,Sabah,18,8,10,2014
2014-10-13,Sabah,25,5,20,2014
2014-10-14,Sabah,48,26,22,2014
2014-10-15,Sabah,42,19,23,2014
2014-10-16,Sabah,40,13,27,2014
2014-10-17,Sabah,68,25,43,2014
2014-10-18,Sabah,28,10,18,2014
2014-10-19,Sabah,154,65,89,2014
2014-10-20,Sabah,40,12,28,2014
2014-10-21,Sabah,76,26,50,2014
2014-10-22,Sabah,47,20,27,2014
2014-10-23,Sabah,43,15,28,2014
2014-10-24,Sabah,32,9,23,2014
2014-10-25,Sabah,20,15,5,2014
2014-10-26,Sabah,47,19,28,2014
2014-10-27,Sabah,37,15,22,2014
2014-10-28,Sabah,49,21,28,2014
2014-10-29,Sabah,73,38,35,2014
2014-10-30,Sabah,65,19,46,2014
2014-10-31,Sabah,61,32,29,2014
2014-11-01,Sabah,45,16,29,2014
2014-11-02,Sabah,131,52,79,2014
2014-11-03,Sabah,65,32,33,2014
2014-11-04,Sabah,75,35,40,2014
2014-11-05,Sabah,77,27,50,2014
2014-11-06,Sabah,42,12,30,2014
2014-11-07,Sabah,52,14,38,2014
2014-11-08,Sabah,110,44,66,2014
2014-11-09,Sabah,79,24,55,2014
2014-11-10,Sabah,32,13,19,2014
2014-11-11,Sabah,32,16,16,2014
2014-11-12,Sabah,39,19,20,2014
2014-11-13,Sabah,37,12,25,2014
2014-11-14,Sabah,48,14,34,2014
2014-11-15,Sabah,65,22,43,2014
2014-11-16,Sabah,31,11,20,2014
2014-11-17,Sabah,49,7,42,2014
2014-11-18,Sabah,61,27,34,2014
2014-11-19,Sabah,27,7,20,2014
2014-11-20,Sabah,43,22,21,2014
2014-11-21,Sabah,54,22,32,2014
2014-11-22,Sabah,0,0,0,2014
2014-11-23,Sabah,47,15,32,2014
2014-11-24,Sabah,64,24,40,2014
2014-11-25,Sabah,103,49,54,2014
2014-11-26,Sabah,120,55,65,2014
2014-11-27,Sabah,214,82,132,2014
2014-11-28,Sabah,26,9,17,2014
2014-11-29,Sabah,117,41,76,2014
2014-11-30,Sabah,67,22,45,2014
2014-12-01,Sabah,46,28,18,2014
2014-12-02,Sabah,41,14,27,2014
2014-12-03,Sabah,41,12,29,2014
2014-12-04,Sabah,61,32,29,2014
2014-12-05,Sabah,61,11,50,2014
2014-12-06,Sabah,104,36,68,2014
2014-12-07,Sabah,133,17,116,2014
2014-12-08,Sabah,55,15,40,2014
2014-12-09,Sabah,48,19,29,2014
2014-12-10,Sabah,51,15,36,2014
2014-12-11,Sabah,51,17,34,2014
2014-12-12,Sabah,66,33,33,2014
2014-12-13,Sabah,66,36,30,2014
2014-12-14,Sabah,108,21,87,2014
2014-12-15,Sabah,68,28,40,2014
2014-12-16,Sabah,36,14,22,2014
2014-12-17,Sabah,144,80,64,2014
2014-12-18,Sabah,72,36,36,2014
2014-12-19,Sabah,32,7,25,2014
2014-12-20,Sabah,77,36,41,2014
2014-12-21,Sabah,64,8,56,2014
2014-12-22,Sabah,35,13,22,2014
2014-12-23,Sabah,61,24,37,2014
2014-12-24,Sabah,33,4,29,2014
2014-12-25,Sabah,31,11,20,2014
2014-12-26,Sabah,18,2,16,2014
2014-12-27,Sabah,88,27,61,2014
2014-12-28,Sabah,0,0,0,2014
2014-12-29,Sabah,77,11,66,2014
2014-12-30,Sabah,33,12,21,2014
2014-12-31,Sabah,29,3,26,2014
2015-01-01,Sabah,17,8,9,2015
2015-01-02,Sabah,43,16,27,2015
2015-01-03,Sabah,86,36,50,2015
2015-01-04,Sabah,33,8,25,2015
2015-01-05,Sabah,54,12,42,2015
2015-01-06,Sabah,60,15,45,2015
2015-01-07,Sabah,100,17,83,2015
2015-01-08,Sabah,169,64,105,2015
2015-01-09,Sabah,58,21,37,2015
2015-01-10,Sabah,47,18,29,2015
2015-01-11,Sabah,44,26,18,2015
2015-01-12,Sabah,81,30,51,2015
2015-01-13,Sabah,29,11,18,2015
2015-01-14,Sabah,80,44,36,2015
2015-01-15,Sabah,41,14,27,2015
2015-01-16,Sabah,44,15,29,2015
2015-01-17,Sabah,116,28,88,2015
2015-01-18,Sabah,31,20,11,2015
2015-01-19,Sabah,21,5,16,2015
2015-01-20,Sabah,57,23,34,2015
2015-01-21,Sabah,47,25,22,2015
2015-01-22,Sabah,69,26,43,2015
2015-01-23,Sabah,39,12,27,2015
2015-01-24,Sabah,83,35,48,2015
2015-01-25,Sabah,57,25,32,2015
2015-01-26,Sabah,43,17,26,2015
2015-01-27,Sabah,64,23,41,2015
2015-01-28,Sabah,40,5,35,2015
2015-01-29,Sabah,94,50,44,2015
2015-01-30,Sabah,46,15,31,2015
2015-01-31,Sabah,58,21,37,2015
2015-02-01,Sabah,28,7,21,2015
2015-02-02,Sabah,37,12,25,2015
2015-02-03,Sabah,67,17,50,2015
2015-02-04,Sabah,99,52,47,2015
2015-02-05,Sabah,91,48,43,2015
2015-02-06,Sabah,71,24,47,2015
2015-02-07,Sabah,97,74,23,2015
2015-02-08,Sabah,35,9,26,2015
2015-02-09,Sabah,79,40,39,2015
2015-02-10,Sabah,48,19,29,2015
2015-02-11,Sabah,67,24,43,2015
2015-02-12,Sabah,46,23,23,2015
2015-02-13,Sabah,25,4,21,2015
2015-02-14,Sabah,244,113,131,2015
2015-02-15,Sabah,10,3,7,2015
2015-02-16,Sabah,34,14,20,2015
2015-02-17,Sabah,36,5,31,2015
2015-02-18,Sabah,17,4,13,2015
2015-02-19,Sabah,27,14,13,2015
2015-02-20,Sabah,55,42,13,2015
2015-02-21,Sabah,38,18,20,2015
2015-02-22,Sabah,43,5,38,2015
2015-02-23,Sabah,51,20,31,2015
2015-02-24,Sabah,55,11,44,2015
2015-02-25,Sabah,111,36,75,2015
2015-02-26,Sabah,127,37,90,2015
2015-02-27,Sabah,186,120,66,2015
2015-02-28,Sabah,91,42,49,2015
2015-03-01,Sabah,97,14,83,2015
2015-03-02,Sabah,78,29,49,2015
2015-03-03,Sabah,149,61,88,2015
2015-03-04,Sabah,27,5,22,2015
2015-03-05,Sabah,77,25,52,2015
2015-03-06,Sabah,45,21,24,2015
2015-03-07,Sabah,41,24,17,2015
2015-03-08,Sabah,146,40,106,2015
2015-03-09,Sabah,67,34,33,2015
2015-03-10,Sabah,20,6,14,2015
2015-03-11,Sabah,63,27,36,2015
2015-03-12,Sabah,78,19,59,2015
2015-03-13,Sabah,73,33,40,2015
2015-03-14,Sabah,26,10,16,2015
2015-03-15,Sabah,157,21,136,2015
2015-03-16,Sabah,50,9,41,2015
2015-03-17,Sabah,78,39,39,2015
2015-03-18,Sabah,48,21,27,2015
2015-03-19,Sabah,36,10,26,2015
2015-03-20,Sabah,68,13,55,2015
2015-03-21,Sabah,67,31,36,2015
2015-03-22,Sabah,134,22,112,2015
2015-03-23,Sabah,48,14,34,2015
2015-03-24,Sabah,109,32,77,2015
2015-03-25,Sabah,61,16,45,2015
2015-03-26,Sabah,132,83,49,2015
2015-03-27,Sabah,43,5,38,2015
2015-03-28,Sabah,46,20,26,2015
2015-03-29,Sabah,15,6,9,2015
2015-03-30,Sabah,55,17,38,2015
2015-03-31,Sabah,26,8,18,2015
2015-04-01,Sabah,104,37,67,2015
2015-04-02,Sabah,14,2,12,2015
2015-04-03,Sabah,28,11,17,2015
2015-04-04,Sabah,14,5,9,2015
2015-04-05,Sabah,14,1,13,2015
2015-04-06,Sabah,45,14,31,2015
2015-04-07,Sabah,21,5,16,2015
2015-04-08,Sabah,108,19,89,2015
2015-04-09,Sabah,45,13,32,2015
2015-04-10,Sabah,24,7,17,2015
2015-04-11,Sabah,79,27,52,2015
2015-04-12,Sabah,9,2,7,2015
2015-04-13,Sabah,48,12,36,2015
2015-04-14,Sabah,71,23,48,2015
2015-04-15,Sabah,56,21,35,2015
2015-04-16,Sabah,275,152,123,2015
2015-04-17,Sabah,88,18,70,2015
2015-04-18,Sabah,153,69,84,2015
2015-04-19,Sabah,68,21,47,2015
2015-04-20,Sabah,41,12,29,2015
2015-04-21,Sabah,46,14,32,2015
2015-04-22,Sabah,21,6,15,2015
2015-04-23,Sabah,29,8,21,2015
2015-04-24,Sabah,50,19,31,2015
2015-04-25,Sabah,90,40,50,2015
2015-04-26,Sabah,185,119,66,2015
2015-04-27,Sabah,18,3,15,2015
2015-04-28,Sabah,128,48,80,2015
2015-04-29,Sabah,48,15,33,2015
2015-04-30,Sabah,65,29,36,2015
2015-05-01,Sabah,101,44,57,2015
2015-05-02,Sabah,25,12,13,2015
2015-05-03,Sabah,202,52,150,2015
2015-05-04,Sabah,39,16,23,2015
2015-05-05,Sabah,32,5,27,2015
2015-05-06,Sabah,54,18,36,2015
2015-05-07,Sabah,53,17,36,2015
2015-05-08,Sabah,67,28,39,2015
2015-05-09,Sabah,0,0,0,2015
2015-05-10,Sabah,31,14,17,2015
2015-05-11,Sabah,23,7,16,2015
2015-05-12,Sabah,145,58,87,2015
2015-05-13,Sabah,29,7,22,2015
2015-05-14,Sabah,18,3,15,2015
2015-05-15,Sabah,34,12,22,2015
2015-05-16,Sabah,77,23,54,2015
2015-05-17,Sabah,83,19,64,2015
2015-05-18,Sabah,40,12,28,2015
2015-05-19,Sabah,55,18,37,2015
2015-05-20,Sabah,75,24,51,2015
2015-05-21,Sabah,144,77,67,2015
2015-05-22,Sabah,20,2,18,2015
2015-05-23,Sabah,58,22,36,2015
2015-05-24,Sabah,58,10,48,2015
2015-05-25,Sabah,82,28,54,2015
2015-05-26,Sabah,46,8,38,2015
2015-05-27,Sabah,19,4,15,2015
2015-05-28,Sabah,57,23,34,2015
2015-05-29,Sabah,27,5,22,2015
2015-05-30,Sabah,10,3,7,2015
2015-05-31,Sabah,91,29,62,2015
2015-06-01,Sabah,12,4,8,2015
2015-06-02,Sabah,10,1,9,2015
2015-06-03,Sabah,44,12,32,2015
2015-06-04,Sabah,34,8,26,2015
2015-06-05,Sabah,35,11,24,2015
2015-06-06,Sabah,24,6,18,2015
2015-06-07,Sabah,161,31,130,2015
2015-06-08,Sabah,29,6,23,2015
2015-06-09,Sabah,43,7,36,2015
2015-06-10,Sabah,90,20,70,2015
2015-06-11,Sabah,58,23,35,2015
2015-06-12,Sabah,91,32,59,2015
2015-06-13,Sabah,6,0,6,2015
2015-06-14,Sabah,99,28,71,2015
2015-06-15,Sabah,60,30,30,2015
2015-06-16,Sabah,96,34,62,2015
2015-06-17,Sabah,67,43,24,2015
2015-06-18,Sabah,17,2,15,2015
2015-06-19,Sabah,23,2,21,2015
2015-06-20,Sabah,32,11,21,2015
2015-06-21,Sabah,137,23,114,2015
2015-06-22,Sabah,35,18,17,2015
2015-06-23,Sabah,74,25,49,2015
2015-06-24,Sabah,45,12,33,2015
2015-06-25,Sabah,33,11,22,2015
2015-06-26,Sabah,25,9,16,2015
2015-06-27,Sabah,212,67,145,2015
2015-06-28,Sabah,87,19,68,2015
2015-06-29,Sabah,25,6,19,2015
2015-06-30,Sabah,35,17,18,2015
2015-07-01,Sabah,75,31,44,2015
2015-07-02,Sabah,72,27,45,2015
2015-07-03,Sabah,36,11,25,2015
2015-07-04,Sabah,27,12,15,2015
2015-07-05,Sabah,57,15,42,2015
2015-07-06,Sabah,38,11,27,2015
2015-07-07,Sabah,103,22,81,2015
2015-07-08,Sabah,105,22,83,2015
2015-07-09,Sabah,52,22,30,2015
2015-07-10,Sabah,40,18,22,2015
2015-07-11,Sabah,46,24,22,2015
2015-07-12,Sabah,31,12,19,2015
2015-07-13,Sabah,38,6,32,2015
2015-07-14,Sabah,45,12,33,2015
2015-07-15,Sabah,21,2,19,2015
2015-07-16,Sabah,32,11,21,2015
2015-07-17,Sabah,12,2,10,2015
2015-07-18,Sabah,15,6,9,2015
2015-07-19,Sabah,32,10,22,2015
2015-07-20,Sabah,56,23,33,2015
2015-07-21,Sabah,50,22,28,2015
2015-07-22,Sabah,69,22,47,2015
2015-07-23,Sabah,76,41,35,2015
2015-07-24,Sabah,42,12,30,2015
2015-07-25,Sabah,24,6,18,2015
2015-07-26,Sabah,84,41,43,2015
2015-07-27,Sabah,93,39,54,2015
2015-07-28,Sabah,158,64,94,2015
2015-07-29,Sabah,107,61,46,2015
2015-07-30,Sabah,57,27,30,2015
2015-07-31,Sabah,36,10,26,2015
2015-08-01,Sabah,34,10,24,2015
2015-08-02,Sabah,107,30,77,2015
2015-08-03,Sabah,25,12,13,2015
2015-08-04,Sabah,35,12,23,2015
2015-08-05,Sabah,31,8,23,2015
2015-08-06,Sabah,53,17,36,2015
2015-08-07,Sabah,74,11,63,2015
2015-08-08,Sabah,151,58,93,2015
2015-08-09,Sabah,111,41,70,2015
2015-08-10,Sabah,28,7,21,2015
2015-08-11,Sabah,27,3,24,2015
2015-08-12,Sabah,175,122,53,2015
2015-08-13,Sabah,51,17,34,2015
2015-08-14,Sabah,39,19,20,2015
2015-08-15,Sabah,16,4,12,2015
2015-08-16,Sabah,121,51,70,2015
2015-08-17,Sabah,56,19,37,2015
2015-08-18,Sabah,61,16,45,2015
2015-08-19,Sabah,119,38,81,2015
2015-08-20,Sabah,202,148,54,2015
2015-08-21,Sabah,80,24,56,2015
2015-08-22,Sabah,15,2,13,2015
2015-08-23,Sabah,27,1,26,2015
2015-08-24,Sabah,55,13,42,2015
2015-08-25,Sabah,20,4,16,2015
2015-08-26,Sabah,60,21,39,2015
2015-08-27,Sabah,57,21,36,2015
2015-08-28,Sabah,7,0,7,2015
2015-08-29,Sabah,30,6,24,2015
2015-08-30,Sabah,24,11,13,2015
2015-08-31,Sabah,100,38,62,2015
2015-09-01,Sabah,24,11,13,2015
2015-09-02,Sabah,45,8,37,2015
2015-09-03,Sabah,131,55,76,2015
2015-09-04,Sabah,19,3,16,2015
2015-09-05,Sabah,1249,257,992,2015
2015-09-06,Sabah,0,0,0,2015
2015-09-07,Sabah,23,3,20,2015
2015-09-08,Sabah,26,5,21,2015
2015-09-09,Sabah,42,7,35,2015
2015-09-10,Sabah,29,5,24,2015
2015-09-11,Sabah,40,21,19,2015
2015-09-12,Sabah,146,62,84,2015
2015-09-13,Sabah,166,40,126,2015
2015-09-14,Sabah,57,20,37,2015
2015-09-15,Sabah,73,44,29,2015
2015-09-16,Sabah,49,20,29,2015
2015-09-17,Sabah,28,11,17,2015
2015-09-18,Sabah,63,15,48,2015
2015-09-19,Sabah,109,42,67,2015
2015-09-20,Sabah,163,38,125,2015
2015-09-21,Sabah,59,11,48,2015
2015-09-22,Sabah,92,35,57,2015
2015-09-23,Sabah,65,21,44,2015
2015-09-24,Sabah,9,3,6,2015
2015-09-25,Sabah,19,3,16,2015
2015-09-26,Sabah,51,19,32,2015
2015-09-27,Sabah,183,24,159,2015
2015-09-28,Sabah,14,2,12,2015
2015-09-29,Sabah,31,11,20,2015
2015-09-30,Sabah,53,12,41,2015
2015-10-01,Sabah,47,9,38,2015
2015-10-02,Sabah,33,14,19,2015
2015-10-03,Sabah,45,19,26,2015
2015-10-04,Sabah,47,8,39,2015
2015-10-05,Sabah,28,6,22,2015
2015-10-06,Sabah,32,11,21,2015
2015-10-07,Sabah,84,15,69,2015
2015-10-08,Sabah,46,17,29,2015
2015-10-09,Sabah,45,16,29,2015
2015-10-10,Sabah,120,80,40,2015
2015-10-11,Sabah,46,12,34,2015
2015-10-12,Sabah,108,51,57,2015
2015-10-13,Sabah,52,18,34,2015
2015-10-14,Sabah,131,61,70,2015
2015-10-15,Sabah,82,34,48,2015
2015-10-16,Sabah,18,8,10,2015
2015-10-17,Sabah,26,7,19,2015
2015-10-18,Sabah,39,12,27,2015
2015-10-19,Sabah,48,18,30,2015
2015-10-20,Sabah,50,22,28,2015
2015-10-21,Sabah,68,22,46,2015
2015-10-22,Sabah,69,19,50,2015
2015-10-23,Sabah,10,0,10,2015
2015-10-24,Sabah,131,49,82,2015
2015-10-25,Sabah,25,8,17,2015
2015-10-26,Sabah,39,14,25,2015
2015-10-27,Sabah,40,11,29,2015
2015-10-28,Sabah,86,39,47,2015
2015-10-29,Sabah,41,16,25,2015
2015-10-30,Sabah,23,13,10,2015
2015-10-31,Sabah,122,37,85,2015
2015-11-01,Sabah,184,64,120,2015
2015-11-02,Sabah,48,12,36,2015
2015-11-03,Sabah,87,37,50,2015
2015-11-04,Sabah,50,17,33,2015
2015-11-05,Sabah,40,10,30,2015
2015-11-06,Sabah,29,13,16,2015
2015-11-07,Sabah,18,9,9,2015
2015-11-08,Sabah,35,8,27,2015
2015-11-09,Sabah,30,8,22,2015
2015-11-10,Sabah,52,13,39,2015
2015-11-11,Sabah,76,38,38,2015
2015-11-12,Sabah,76,25,51,2015
2015-11-13,Sabah,19,6,13,2015
2015-11-14,Sabah,17,4,13,2015
2015-11-15,Sabah,95,47,48,2015
2015-11-16,Sabah,37,9,28,2015
2015-11-17,Sabah,21,5,16,2015
2015-11-18,Sabah,54,14,40,2015
2015-11-19,Sabah,54,10,44,2015
2015-11-20,Sabah,56,26,30,2015
2015-11-21,Sabah,113,79,34,2015
2015-11-22,Sabah,50,19,31,2015
2015-11-23,Sabah,74,37,37,2015
2015-11-24,Sabah,87,32,55,2015
2015-11-25,Sabah,48,16,32,2015
2015-11-26,Sabah,82,21,61,2015
2015-11-27,Sabah,85,19,66,2015
2015-11-28,Sabah,34,18,16,2015
2015-11-29,Sabah,74,15,59,2015
2015-11-30,Sabah,52,17,35,2015
2015-12-01,Sabah,27,10,17,2015
2015-12-02,Sabah,102,34,68,2015
2015-12-03,Sabah,76,28,48,2015
2015-12-04,Sabah,97,26,71,2015
2015-12-05,Sabah,101,35,66,2015
2015-12-06,Sabah,117,16,101,2015
2015-12-07,Sabah,77,43,34,2015
2015-12-08,Sabah,47,17,30,2015
2015-12-09,Sabah,129,37,92,2015
2015-12-10,Sabah,78,26,52,2015
2015-12-11,Sabah,68,27,41,2015
2015-12-12,Sabah,93,45,48,2015
2015-12-13,Sabah,43,15,28,2015
2015-12-14,Sabah,60,17,43,2015
2015-12-15,Sabah,33,19,14,2015
2015-12-16,Sabah,92,40,52,2015
2015-12-17,Sabah,49,26,23,2015
2015-12-18,Sabah,19,7,12,2015
2015-12-19,Sabah,54,17,37,2015
2015-12-20,Sabah,151,12,139,2015
2015-12-21,Sabah,59,8,51,2015
2015-12-22,Sabah,37,9,28,2015
2015-12-23,Sabah,28,7,21,2015
2015-12-24,Sabah,25,11,14,2015
2015-12-25,Sabah,21,7,14,2015
2015-12-26,Sabah,20,7,13,2015
2015-12-27,Sabah,157,62,95,2015
2015-12-28,Sabah,43,11,32,2015
2015-12-29,Sabah,23,8,15,2015
2015-12-30,Sabah,47,13,34,2015
2015-12-31,Sabah,27,5,22,2015
2016-01-01,Sabah,5,1,4,2016
2016-01-02,Sabah,38,18,20,2016
2016-01-03,Sabah,144,56,88,2016
2016-01-04,Sabah,37,12,25,2016
2016-01-05,Sabah,27,8,19,2016
2016-01-06,Sabah,79,28,51,2016
2016-01-07,Sabah,70,36,34,2016
2016-01-08,Sabah,53,24,29,2016
2016-01-09,Sabah,52,18,34,2016
2016-01-10,Sabah,57,16,41,2016
2016-01-11,Sabah,42,15,27,2016
2016-01-12,Sabah,52,17,35,2016
2016-01-13,Sabah,86,25,61,2016
2016-01-14,Sabah,64,14,50,2016
2016-01-15,Sabah,67,28,39,2016
2016-01-16,Sabah,72,31,41,2016
2016-01-17,Sabah,32,10,22,2016
2016-01-18,Sabah,43,6,37,2016
2016-01-19,Sabah,106,39,67,2016
2016-01-20,Sabah,160,98,62,2016
2016-01-21,Sabah,62,24,38,2016
2016-01-22,Sabah,30,14,16,2016
2016-01-23,Sabah,47,7,40,2016
2016-01-24,Sabah,9,2,7,2016
2016-01-25,Sabah,44,26,18,2016
2016-01-26,Sabah,67,30,37,2016
2016-01-27,Sabah,96,44,52,2016
2016-01-28,Sabah,144,56,88,2016
2016-01-29,Sabah,87,35,52,2016
2016-01-30,Sabah,51,18,33,2016
2016-01-31,Sabah,10,4,6,2016
2016-02-01,Sabah,32,13,19,2016
2016-02-02,Sabah,125,59,66,2016
2016-02-03,Sabah,258,118,140,2016
2016-02-04,Sabah,67,20,47,2016
2016-02-05,Sabah,30,10,20,2016
2016-02-06,Sabah,18,4,14,2016
2016-02-07,Sabah,23,13,10,2016
2016-02-08,Sabah,17,3,14,2016
2016-02-09,Sabah,48,20,28,2016
2016-02-10,Sabah,90,19,71,2016
2016-02-11,Sabah,120,44,76,2016
2016-02-12,Sabah,50,15,35,2016
2016-02-13,Sabah,50,14,36,2016
2016-02-14,Sabah,31,12,19,2016
2016-02-15,Sabah,52,25,27,2016
2016-02-16,Sabah,94,31,63,2016
2016-02-17,Sabah,98,52,46,2016
2016-02-18,Sabah,119,29,90,2016
2016-02-19,Sabah,37,6,31,2016
2016-02-20,Sabah,167,100,67,2016
2016-02-21,Sabah,55,18,37,2016
2016-02-22,Sabah,44,9,35,2016
2016-02-23,Sabah,69,23,46,2016
2016-02-24,Sabah,89,40,49,2016
2016-02-25,Sabah,24,0,24,2016
2016-02-26,Sabah,102,34,68,2016
2016-02-27,Sabah,54,14,40,2016
2016-02-28,Sabah,129,81,48,2016
2016-02-29,Sabah,106,33,73,2016
2016-03-01,Sabah,211,111,100,2016
2016-03-02,Sabah,103,26,77,2016
2016-03-03,Sabah,101,31,70,2016
2016-03-04,Sabah,43,17,26,2016
2016-03-05,Sabah,27,8,19,2016
2016-03-06,Sabah,108,21,87,2016
2016-03-07,Sabah,27,6,21,2016
2016-03-08,Sabah,17,2,15,2016
2016-03-09,Sabah,92,23,69,2016
2016-03-10,Sabah,65,17,48,2016
2016-03-11,Sabah,17,2,15,2016
2016-03-12,Sabah,25,9,16,2016
2016-03-13,Sabah,77,19,58,2016
2016-03-14,Sabah,74,30,44,2016
2016-03-15,Sabah,47,8,39,2016
2016-03-16,Sabah,120,54,66,2016
2016-03-17,Sabah,73,37,36,2016
2016-03-18,Sabah,128,66,62,2016
2016-03-19,Sabah,88,35,53,2016
2016-03-20,Sabah,167,11,156,2016
2016-03-21,Sabah,32,7,25,2016
2016-03-22,Sabah,38,4,34,2016
2016-03-23,Sabah,53,23,30,2016
2016-03-24,Sabah,66,14,52,2016
2016-03-25,Sabah,53,22,31,2016
2016-03-26,Sabah,72,26,46,2016
2016-03-27,Sabah,83,30,53,2016
2016-03-28,Sabah,61,15,46,2016
2016-03-29,Sabah,66,31,35,2016
2016-03-30,Sabah,85,30,55,2016
2016-03-31,Sabah,55,14,41,2016
2016-04-01,Sabah,35,13,22,2016
2016-04-02,Sabah,94,37,57,2016
2016-04-03,Sabah,125,29,96,2016
2016-04-04,Sabah,63,26,37,2016
2016-04-05,Sabah,28,7,21,2016
2016-04-06,Sabah,96,31,65,2016
2016-04-07,Sabah,38,6,32,2016
2016-04-08,Sabah,86,20,66,2016
2016-04-09,Sabah,16,3,13,2016
2016-04-10,Sabah,62,24,38,2016
2016-04-11,Sabah,47,16,31,2016
2016-04-12,Sabah,86,35,51,2016
2016-04-13,Sabah,85,25,60,2016
2016-04-14,Sabah,51,24,27,2016
2016-04-15,Sabah,91,30,61,2016
2016-04-16,Sabah,32,9,23,2016
2016-04-17,Sabah,24,9,15,2016
2016-04-18,Sabah,87,38,49,2016
2016-04-19,Sabah,60,13,47,2016
2016-04-20,Sabah,43,13,30,2016
2016-04-21,Sabah,49,24,25,2016
2016-04-22,Sabah,54,22,32,2016
2016-04-23,Sabah,193,83,110,2016
2016-04-24,Sabah,132,35,97,2016
2016-04-25,Sabah,58,26,32,2016
2016-04-26,Sabah,41,13,28,2016
2016-04-27,Sabah,114,41,73,2016
2016-04-28,Sabah,83,27,56,2016
2016-04-29,Sabah,57,22,35,2016
2016-04-30,Sabah,125,49,76,2016
2016-05-01,Sabah,29,14,15,2016
2016-05-02,Sabah,76,59,17,2016
2016-05-03,Sabah,39,16,23,2016
2016-05-04,Sabah,97,32,65,2016
2016-05-05,Sabah,60,31,29,2016
2016-05-06,Sabah,8,5,3,2016
2016-05-07,Sabah,120,53,67,2016
2016-05-08,Sabah,135,104,31,2016
2016-05-09,Sabah,54,24,30,2016
2016-05-10,Sabah,79,28,51,2016
2016-05-11,Sabah,104,48,56,2016
2016-05-12,Sabah,77,41,36,2016
2016-05-13,Sabah,38,19,19,2016
2016-05-14,Sabah,57,27,30,2016
2016-05-15,Sabah,175,70,105,2016
2016-05-16,Sabah,81,22,59,2016
2016-05-17,Sabah,76,22,54,2016
2016-05-18,Sabah,48,17,31,2016
2016-05-19,Sabah,38,17,21,2016
2016-05-20,Sabah,118,62,56,2016
2016-05-21,Sabah,307,106,201,2016
2016-05-22,Sabah,71,58,13,2016
2016-05-23,Sabah,93,47,46,2016
2016-05-24,Sabah,92,36,56,2016
2016-05-25,Sabah,158,66,92,2016
2016-05-26,Sabah,145,48,97,2016
2016-05-27,Sabah,125,53,72,2016
2016-05-28,Sabah,122,78,44,2016
2016-05-29,Sabah,34,15,19,2016
2016-05-30,Sabah,84,28,56,2016
2016-05-31,Sabah,39,12,27,2016
2016-06-01,Sabah,97,30,67,2016
2016-06-02,Sabah,28,8,20,2016
2016-06-03,Sabah,32,11,21,2016
2016-06-04,Sabah,172,64,108,2016
2016-06-05,Sabah,88,48,40,2016
2016-06-06,Sabah,18,7,11,2016
2016-06-07,Sabah,37,16,21,2016
2016-06-08,Sabah,42,22,20,2016
2016-06-09,Sabah,62,16,46,2016
2016-06-10,Sabah,43,22,21,2016
2016-06-11,Sabah,46,21,25,2016
2016-06-12,Sabah,44,16,28,2016
2016-06-13,Sabah,65,28,37,2016
2016-06-14,Sabah,49,18,31,2016
2016-06-15,Sabah,62,12,50,2016
2016-06-16,Sabah,82,32,50,2016
2016-06-17,Sabah,31,10,21,2016
2016-06-18,Sabah,82,41,41,2016
2016-06-19,Sabah,180,42,138,2016
2016-06-20,Sabah,42,26,16,2016
2016-06-21,Sabah,45,17,28,2016
2016-06-22,Sabah,67,18,49,2016
2016-06-23,Sabah,30,13,17,2016
2016-06-24,Sabah,42,19,23,2016
2016-06-25,Sabah,132,89,43,2016
2016-06-26,Sabah,68,28,40,2016
2016-06-27,Sabah,91,36,55,2016
2016-06-28,Sabah,89,47,42,2016
2016-06-29,Sabah,121,67,54,2016
2016-06-30,Sabah,59,34,25,2016
2016-07-01,Sabah,92,40,52,2016
2016-07-02,Sabah,21,12,9,2016
2016-07-03,Sabah,74,40,34,2016
2016-07-04,Sabah,31,12,19,2016
2016-07-05,Sabah,41,12,29,2016
2016-07-06,Sabah,5,1,4,2016
2016-07-07,Sabah,12,1,11,2016
2016-07-08,Sabah,40,16,24,2016
2016-07-09,Sabah,33,12,21,2016
2016-07-10,Sabah,184,82,102,2016
2016-07-11,Sabah,82,30,52,2016
2016-07-12,Sabah,92,44,48,2016
2016-07-13,Sabah,67,28,39,2016
2016-07-14,Sabah,69,45,24,2016
2016-07-15,Sabah,78,28,50,2016
2016-07-16,Sabah,164,89,75,2016
2016-07-17,Sabah,78,29,49,2016
2016-07-18,Sabah,64,15,49,2016
2016-07-19,Sabah,98,33,65,2016
2016-07-20,Sabah,207,108,99,2016
2016-07-21,Sabah,133,46,87,2016
2016-07-22,Sabah,81,34,47,2016
2016-07-23,Sabah,134,71,63,2016
2016-07-24,Sabah,219,140,79,2016
2016-07-25,Sabah,63,29,34,2016
2016-07-26,Sabah,82,59,23,2016
2016-07-27,Sabah,142,71,71,2016
2016-07-28,Sabah,99,19,80,2016
2016-07-29,Sabah,54,18,36,2016
2016-07-30,Sabah,38,22,16,2016
2016-07-31,Sabah,95,35,60,2016
2016-08-01,Sabah,101,37,64,2016
2016-08-02,Sabah,73,30,43,2016
2016-08-03,Sabah,53,22,31,2016
2016-08-04,Sabah,54,15,39,2016
2016-08-05,Sabah,118,40,78,2016
2016-08-06,Sabah,138,62,76,2016
2016-08-07,Sabah,149,50,99,2016
2016-08-08,Sabah,41,16,25,2016
2016-08-09,Sabah,122,54,68,2016
2016-08-10,Sabah,173,89,84,2016
2016-08-11,Sabah,44,18,26,2016
2016-08-12,Sabah,49,18,31,2016
2016-08-13,Sabah,103,47,56,2016
2016-08-14,Sabah,118,55,63,2016
2016-08-15,Sabah,80,26,54,2016
2016-08-16,Sabah,31,10,21,2016
2016-08-17,Sabah,84,13,71,2016
2016-08-18,Sabah,83,52,31,2016
2016-08-19,Sabah,33,9,24,2016
2016-08-20,Sabah,40,26,14,2016
2016-08-21,Sabah,87,47,40,2016
2016-08-22,Sabah,56,18,38,2016
2016-08-23,Sabah,30,12,18,2016
2016-08-24,Sabah,94,43,51,2016
2016-08-25,Sabah,110,31,79,2016
2016-08-26,Sabah,136,52,84,2016
2016-08-27,Sabah,115,70,45,2016
2016-08-28,Sabah,36,13,23,2016
2016-08-29,Sabah,94,38,56,2016
2016-08-30,Sabah,96,74,22,2016
2016-08-31,Sabah,148,56,92,2016
2016-09-01,Sabah,126,49,77,2016
2016-09-02,Sabah,32,15,17,2016
2016-09-03,Sabah,88,67,21,2016
2016-09-04,Sabah,69,30,39,2016
2016-09-05,Sabah,36,5,31,2016
2016-09-06,Sabah,297,155,142,2016
2016-09-07,Sabah,107,48,59,2016
2016-09-08,Sabah,86,47,39,2016
2016-09-09,Sabah,82,24,58,2016
2016-09-10,Sabah,80,27,53,2016
2016-09-11,Sabah,104,45,59,2016
2016-09-12,Sabah,0,0,0,2016
2016-09-13,Sabah,33,13,20,2016
2016-09-14,Sabah,30,9,21,2016
2016-09-15,Sabah,26,3,23,2016
2016-09-16,Sabah,138,81,57,2016
2016-09-17,Sabah,33,14,19,2016
2016-09-18,Sabah,232,59,173,2016
2016-09-19,Sabah,55,21,34,2016
2016-09-20,Sabah,36,8,28,2016
2016-09-21,Sabah,53,16,37,2016
2016-09-22,Sabah,78,21,57,2016
2016-09-23,Sabah,22,8,14,2016
2016-09-24,Sabah,220,107,113,2016
2016-09-25,Sabah,176,117,59,2016
2016-09-26,Sabah,31,8,23,2016
2016-09-27,Sabah,193,64,129,2016
2016-09-28,Sabah,38,13,25,2016
2016-09-29,Sabah,21,4,17,2016
2016-09-30,Sabah,83,24,59,2016
2016-10-01,Sabah,53,29,24,2016
2016-10-02,Sabah,95,25,70,2016
2016-10-03,Sabah,32,18,14,2016
2016-10-04,Sabah,77,30,47,2016
2016-10-05,Sabah,85,32,53,2016
2016-10-06,Sabah,114,41,73,2016
2016-10-07,Sabah,62,27,35,2016
2016-10-08,Sabah,193,108,85,2016
2016-10-09,Sabah,269,141,128,2016
2016-10-10,Sabah,27,11,16,2016
2016-10-11,Sabah,35,11,24,2016
2016-10-12,Sabah,71,14,57,2016
2016-10-13,Sabah,32,9,23,2016
2016-10-14,Sabah,86,25,61,2016
2016-10-15,Sabah,62,28,34,2016
2016-10-16,Sabah,83,37,46,2016
2016-10-17,Sabah,116,43,73,2016
2016-10-18,Sabah,51,25,26,2016
2016-10-19,Sabah,67,31,36,2016
2016-10-20,Sabah,48,14,34,2016
2016-10-21,Sabah,40,10,30,2016
2016-10-22,Sabah,46,24,22,2016
2016-10-23,Sabah,107,54,53,2016
2016-10-24,Sabah,42,14,28,2016
2016-10-25,Sabah,58,25,33,2016
2016-10-26,Sabah,78,32,46,2016
2016-10-27,Sabah,67,16,51,2016
2016-10-28,Sabah,31,4,27,2016
2016-10-29,Sabah,89,26,63,2016
2016-10-30,Sabah,80,30,50,2016
2016-10-31,Sabah,59,24,35,2016
2016-11-01,Sabah,67,25,42,2016
2016-11-02,Sabah,16,8,8,2016
2016-11-03,Sabah,59,14,45,2016
2016-11-04,Sabah,42,14,28,2016
2016-11-05,Sabah,39,17,22,2016
2016-11-06,Sabah,145,77,68,2016
2016-11-07,Sabah,126,44,82,2016
2016-11-08,Sabah,93,42,51,2016
2016-11-09,Sabah,76,20,56,2016
2016-11-10,Sabah,39,12,27,2016
2016-11-11,Sabah,43,18,25,2016
2016-11-12,Sabah,43,18,25,2016
2016-11-13,Sabah,35,11,24,2016
2016-11-14,Sabah,56,18,38,2016
2016-11-15,Sabah,73,28,45,2016
2016-11-16,Sabah,90,37,53,2016
2016-11-17,Sabah,124,53,71,2016
2016-11-18,Sabah,47,9,38,2016
2016-11-19,Sabah,1423,338,1085,2016
2016-11-20,Sabah,46,44,2,2016
2016-11-21,Sabah,28,9,19,2016
2016-11-22,Sabah,24,7,17,2016
2016-11-23,Sabah,73,22,51,2016
2016-11-24,Sabah,46,9,37,2016
2016-11-25,Sabah,65,28,37,2016
2016-11-26,Sabah,9,3,6,2016
2016-11-27,Sabah,111,74,37,2016
2016-11-28,Sabah,54,25,29,2016
2016-11-29,Sabah,92,43,49,2016
2016-11-30,Sabah,65,13,52,2016
2016-12-01,Sabah,70,18,52,2016
2016-12-02,Sabah,67,13,54,2016
2016-12-03,Sabah,194,106,88,2016
2016-12-04,Sabah,164,105,59,2016
2016-12-05,Sabah,80,21,59,2016
2016-12-06,Sabah,78,13,65,2016
2016-12-07,Sabah,44,15,29,2016
2016-12-08,Sabah,32,7,25,2016
2016-12-09,Sabah,41,8,33,2016
2016-12-10,Sabah,126,69,57,2016
2016-12-11,Sabah,121,48,73,2016
2016-12-12,Sabah,53,20,33,2016
2016-12-13,Sabah,44,4,40,2016
2016-12-14,Sabah,59,15,44,2016
2016-12-15,Sabah,85,48,37,2016
2016-12-16,Sabah,31,15,16,2016
2016-12-17,Sabah,114,71,43,2016
2016-12-18,Sabah,183,32,151,2016
2016-12-19,Sabah,46,8,38,2016
2016-12-20,Sabah,21,3,18,2016
2016-12-21,Sabah,54,8,46,2016
2016-12-22,Sabah,129,48,81,2016
2016-12-23,Sabah,34,11,23,2016
2016-12-24,Sabah,55,27,28,2016
2016-12-25,Sabah,17,4,13,2016
2016-12-26,Sabah,34,10,24,2016
2016-12-27,Sabah,25,10,15,2016
2016-12-28,Sabah,63,25,38,2016
2016-12-29,Sabah,53,19,34,2016
2016-12-30,Sabah,55,17,38,2016
2016-12-31,Sabah,142,59,83,2016
2017-01-01,Sabah,35,7,28,2017
2017-01-02,Sabah,45,23,22,2017
2017-01-03,Sabah,46,12,34,2017
2017-01-04,Sabah,84,36,48,2017
2017-01-05,Sabah,117,31,86,2017
2017-01-06,Sabah,105,23,82,2017
2017-01-07,Sabah,65,18,47,2017
2017-01-08,Sabah,157,36,121,2017
2017-01-09,Sabah,64,24,40,2017
2017-01-10,Sabah,120,40,80,2017
2017-01-11,Sabah,77,31,46,2017
2017-01-12,Sabah,81,28,53,2017
2017-01-13,Sabah,150,71,79,2017
2017-01-14,Sabah,70,34,36,2017
2017-01-15,Sabah,154,60,94,2017
2017-01-16,Sabah,70,21,49,2017
2017-01-17,Sabah,60,16,44,2017
2017-01-18,Sabah,61,19,42,2017
2017-01-19,Sabah,101,55,46,2017
2017-01-20,Sabah,65,14,51,2017
2017-01-21,Sabah,274,232,42,2017
2017-01-22,Sabah,40,26,14,2017
2017-01-23,Sabah,44,11,33,2017
2017-01-24,Sabah,102,53,49,2017
2017-01-25,Sabah,145,64,81,2017
2017-01-26,Sabah,104,32,72,2017
2017-01-27,Sabah,58,16,42,2017
2017-01-28,Sabah,69,26,43,2017
2017-01-29,Sabah,53,22,31,2017
2017-01-30,Sabah,53,18,35,2017
2017-01-31,Sabah,55,20,35,2017
2017-02-01,Sabah,81,39,42,2017
2017-02-02,Sabah,116,66,50,2017
2017-02-03,Sabah,28,7,21,2017
2017-02-04,Sabah,89,56,33,2017
2017-02-05,Sabah,34,11,23,2017
2017-02-06,Sabah,106,63,43,2017
2017-02-07,Sabah,154,81,73,2017
2017-02-08,Sabah,42,19,23,2017
2017-02-09,Sabah,224,138,86,2017
2017-02-10,Sabah,109,41,68,2017
2017-02-11,Sabah,73,18,55,2017
2017-02-12,Sabah,85,28,57,2017
2017-02-13,Sabah,43,15,28,2017
2017-02-14,Sabah,120,43,77,2017
2017-02-15,Sabah,191,59,132,2017
2017-02-16,Sabah,52,11,41,2017
2017-02-17,Sabah,73,23,50,2017
2017-02-18,Sabah,136,98,38,2017
2017-02-19,Sabah,148,34,114,2017
2017-02-20,Sabah,98,47,51,2017
2017-02-21,Sabah,65,13,52,2017
2017-02-22,Sabah,109,20,89,2017
2017-02-23,Sabah,145,41,104,2017
2017-02-24,Sabah,51,20,31,2017
2017-02-25,Sabah,123,62,61,2017
2017-02-26,Sabah,176,42,134,2017
2017-02-27,Sabah,51,7,44,2017
2017-02-28,Sabah,47,3,44,2017
2017-03-01,Sabah,101,40,61,2017
2017-03-02,Sabah,65,20,45,2017
2017-03-03,Sabah,61,11,50,2017
2017-03-04,Sabah,92,30,62,2017
2017-03-05,Sabah,85,31,54,2017
2017-03-06,Sabah,44,9,35,2017
2017-03-07,Sabah,100,21,79,2017
2017-03-08,Sabah,93,50,43,2017
2017-03-09,Sabah,45,6,39,2017
2017-03-10,Sabah,51,23,28,2017
2017-03-11,Sabah,93,47,46,2017
2017-03-12,Sabah,241,85,156,2017
2017-03-13,Sabah,116,41,75,2017
2017-03-14,Sabah,97,22,75,2017
2017-03-15,Sabah,46,14,32,2017
2017-03-16,Sabah,88,28,60,2017
2017-03-17,Sabah,76,24,52,2017
2017-03-18,Sabah,36,18,18,2017
2017-03-19,Sabah,78,15,63,2017
2017-03-20,Sabah,123,51,72,2017
2017-03-21,Sabah,130,41,89,2017
2017-03-22,Sabah,78,24,54,2017
2017-03-23,Sabah,93,43,50,2017
2017-03-24,Sabah,36,9,27,2017
2017-03-25,Sabah,166,65,101,2017
2017-03-26,Sabah,152,32,120,2017
2017-03-27,Sabah,48,13,35,2017
2017-03-28,Sabah,80,21,59,2017
2017-03-29,Sabah,222,130,92,2017
2017-03-30,Sabah,65,32,33,2017
2017-03-31,Sabah,89,32,57,2017
2017-04-01,Sabah,77,41,36,2017
2017-04-02,Sabah,188,97,91,2017
2017-04-03,Sabah,106,65,41,2017
2017-04-04,Sabah,7,2,5,2017
2017-04-05,Sabah,151,81,70,2017
2017-04-06,Sabah,49,19,30,2017
2017-04-07,Sabah,67,14,53,2017
2017-04-08,Sabah,87,37,50,2017
2017-04-09,Sabah,24,12,12,2017
2017-04-10,Sabah,47,16,31,2017
2017-04-11,Sabah,41,7,34,2017
2017-04-12,Sabah,128,74,54,2017
2017-04-13,Sabah,112,60,52,2017
2017-04-14,Sabah,40,7,33,2017
2017-04-15,Sabah,88,33,55,2017
2017-04-16,Sabah,129,47,82,2017
2017-04-17,Sabah,96,21,75,2017
2017-04-18,Sabah,72,21,51,2017
2017-04-19,Sabah,38,10,28,2017
2017-04-20,Sabah,73,10,63,2017
2017-04-21,Sabah,67,29,38,2017
2017-04-22,Sabah,114,64,50,2017
2017-04-23,Sabah,149,52,97,2017
2017-04-24,Sabah,67,18,49,2017
2017-04-25,Sabah,73,29,44,2017
2017-04-26,Sabah,112,17,95,2017
2017-04-27,Sabah,37,11,26,2017
2017-04-28,Sabah,56,13,43,2017
2017-04-29,Sabah,122,37,85,2017
2017-04-30,Sabah,102,26,76,2017
2017-05-01,Sabah,165,60,105,2017
2017-05-02,Sabah,47,8,39,2017
2017-05-03,Sabah,68,22,46,2017
2017-05-04,Sabah,88,31,57,2017
2017-05-05,Sabah,33,13,20,2017
2017-05-06,Sabah,106,44,62,2017
2017-05-07,Sabah,15,10,5,2017
2017-05-08,Sabah,61,13,48,2017
2017-05-09,Sabah,77,16,61,2017
2017-05-10,Sabah,414,103,311,2017
2017-05-11,Sabah,73,9,64,2017
2017-05-12,Sabah,68,23,45,2017
2017-05-13,Sabah,80,52,28,2017
2017-05-14,Sabah,197,82,115,2017
2017-05-15,Sabah,48,12,36,2017
2017-05-16,Sabah,55,18,37,2017
2017-05-17,Sabah,189,63,126,2017
2017-05-18,Sabah,117,47,70,2017
2017-05-19,Sabah,59,17,42,2017
2017-05-20,Sabah,287,127,160,2017
2017-05-21,Sabah,239,65,174,2017
2017-05-22,Sabah,26,4,22,2017
2017-05-23,Sabah,33,4,29,2017
2017-05-24,Sabah,116,46,70,2017
2017-05-25,Sabah,82,25,57,2017
2017-05-26,Sabah,103,27,76,2017
2017-05-27,Sabah,2,0,2,2017
2017-05-28,Sabah,131,34,97,2017
2017-05-29,Sabah,23,5,18,2017
2017-05-30,Sabah,26,6,20,2017
2017-05-31,Sabah,31,9,22,2017
2017-06-01,Sabah,33,13,20,2017
2017-06-02,Sabah,31,12,19,2017
2017-06-03,Sabah,81,26,55,2017
2017-06-04,Sabah,95,26,69,2017
2017-06-05,Sabah,14,7,7,2017
2017-06-06,Sabah,109,39,70,2017
2017-06-07,Sabah,65,14,51,2017
2017-06-08,Sabah,31,5,26,2017
2017-06-09,Sabah,82,32,50,2017
2017-06-10,Sabah,153,84,69,2017
2017-06-11,Sabah,105,51,54,2017
2017-06-12,Sabah,60,16,44,2017
2017-06-13,Sabah,62,18,44,2017
2017-06-14,Sabah,51,18,33,2017
2017-06-15,Sabah,64,24,40,2017
2017-06-16,Sabah,61,19,42,2017
2017-06-17,Sabah,25,5,20,2017
2017-06-18,Sabah,137,26,111,2017
2017-06-19,Sabah,72,33,39,2017
2017-06-20,Sabah,75,31,44,2017
2017-06-21,Sabah,42,11,31,2017
2017-06-22,Sabah,56,22,34,2017
2017-06-23,Sabah,146,56,90,2017
2017-06-24,Sabah,50,18,32,2017
2017-06-25,Sabah,70,11,59,2017
2017-06-26,Sabah,24,7,17,2017
2017-06-27,Sabah,37,16,21,2017
2017-06-28,Sabah,65,18,47,2017
2017-06-29,Sabah,70,25,45,2017
2017-06-30,Sabah,103,37,66,2017
2017-07-01,Sabah,196,81,115,2017
2017-07-02,Sabah,109,32,77,2017
2017-07-03,Sabah,82,30,52,2017
2017-07-04,Sabah,88,26,62,2017
2017-07-05,Sabah,164,65,99,2017
2017-07-06,Sabah,141,70,71,2017
2017-07-07,Sabah,123,45,78,2017
2017-07-08,Sabah,98,35,63,2017
2017-07-09,Sabah,143,45,98,2017
2017-07-10,Sabah,69,29,40,2017
2017-07-11,Sabah,89,30,59,2017
2017-07-12,Sabah,68,23,45,2017
2017-07-13,Sabah,70,12,58,2017
2017-07-14,Sabah,38,10,28,2017
2017-07-15,Sabah,101,33,68,2017
2017-07-16,Sabah,52,19,33,2017
2017-07-17,Sabah,115,32,83,2017
2017-07-18,Sabah,71,19,52,2017
2017-07-19,Sabah,101,41,60,2017
2017-07-20,Sabah,66,23,43,2017
2017-07-21,Sabah,83,33,50,2017
2017-07-22,Sabah,48,14,34,2017
2017-07-23,Sabah,84,24,60,2017
2017-07-24,Sabah,121,48,73,2017
2017-07-25,Sabah,100,31,69,2017
2017-07-26,Sabah,82,15,67,2017
2017-07-27,Sabah,90,67,23,2017
2017-07-28,Sabah,87,40,47,2017
2017-07-29,Sabah,243,63,180,2017
2017-07-30,Sabah,109,32,77,2017
2017-07-31,Sabah,53,16,37,2017
2017-08-01,Sabah,68,13,55,2017
2017-08-02,Sabah,110,31,79,2017
2017-08-03,Sabah,76,29,47,2017
2017-08-04,Sabah,100,30,70,2017
2017-08-05,Sabah,278,88,190,2017
2017-08-06,Sabah,227,55,172,2017
2017-08-07,Sabah,117,35,82,2017
2017-08-08,Sabah,67,24,43,2017
2017-08-09,Sabah,147,81,66,2017
2017-08-10,Sabah,64,16,48,2017
2017-08-11,Sabah,62,18,44,2017
2017-08-12,Sabah,64,40,24,2017
2017-08-13,Sabah,115,32,83,2017
2017-08-14,Sabah,120,59,61,2017
2017-08-15,Sabah,42,12,30,2017
2017-08-16,Sabah,112,49,63,2017
2017-08-17,Sabah,86,28,58,2017
2017-08-18,Sabah,37,14,23,2017
2017-08-19,Sabah,118,87,31,2017
2017-08-20,Sabah,297,138,159,2017
2017-08-21,Sabah,73,15,58,2017
2017-08-22,Sabah,93,37,56,2017
2017-08-23,Sabah,120,33,87,2017
2017-08-24,Sabah,62,23,39,2017
2017-08-25,Sabah,54,19,35,2017
2017-08-26,Sabah,68,24,44,2017
2017-08-27,Sabah,75,30,45,2017
2017-08-28,Sabah,44,12,32,2017
2017-08-29,Sabah,90,50,40,2017
2017-08-30,Sabah,124,51,73,2017
2017-08-31,Sabah,152,44,108,2017
2017-09-01,Sabah,17,7,10,2017
2017-09-02,Sabah,46,23,23,2017
2017-09-03,Sabah,83,37,46,2017
2017-09-04,Sabah,18,12,6,2017
2017-09-05,Sabah,86,26,60,2017
2017-09-06,Sabah,155,71,84,2017
2017-09-07,Sabah,44,13,31,2017
2017-09-08,Sabah,87,27,60,2017
2017-09-09,Sabah,55,8,47,2017
2017-09-10,Sabah,117,44,73,2017
2017-09-11,Sabah,33,11,22,2017
2017-09-12,Sabah,66,31,35,2017
2017-09-13,Sabah,140,89,51,2017
2017-09-14,Sabah,63,43,20,2017
2017-09-15,Sabah,83,32,51,2017
2017-09-16,Sabah,96,41,55,2017
2017-09-17,Sabah,101,14,87,2017
2017-09-18,Sabah,62,18,44,2017
2017-09-19,Sabah,58,15,43,2017
2017-09-20,Sabah,99,42,57,2017
2017-09-21,Sabah,45,17,28,2017
2017-09-22,Sabah,65,23,42,2017
2017-09-23,Sabah,132,60,72,2017
2017-09-24,Sabah,182,57,125,2017
2017-09-25,Sabah,73,32,41,2017
2017-09-26,Sabah,64,25,39,2017
2017-09-27,Sabah,89,30,59,2017
2017-09-28,Sabah,85,47,38,2017
2017-09-29,Sabah,42,15,27,2017
2017-09-30,Sabah,76,22,54,2017
2017-10-01,Sabah,177,81,96,2017
2017-10-02,Sabah,26,6,20,2017
2017-10-03,Sabah,50,6,44,2017
2017-10-04,Sabah,117,30,87,2017
2017-10-05,Sabah,70,27,43,2017
2017-10-06,Sabah,91,34,57,2017
2017-10-07,Sabah,99,30,69,2017
2017-10-08,Sabah,58,11,47,2017
2017-10-09,Sabah,76,30,46,2017
2017-10-10,Sabah,117,49,68,2017
2017-10-11,Sabah,77,37,40,2017
2017-10-12,Sabah,81,33,48,2017
2017-10-13,Sabah,140,77,63,2017
2017-10-14,Sabah,149,71,78,2017
2017-10-15,Sabah,140,37,103,2017
2017-10-16,Sabah,52,13,39,2017
2017-10-17,Sabah,69,22,47,2017
2017-10-18,Sabah,60,25,35,2017
2017-10-19,Sabah,79,22,57,2017
2017-10-20,Sabah,51,11,40,2017
2017-10-21,Sabah,85,49,36,2017
2017-10-22,Sabah,87,29,58,2017
2017-10-23,Sabah,75,16,59,2017
2017-10-24,Sabah,76,15,61,2017
2017-10-25,Sabah,83,48,35,2017
2017-10-26,Sabah,113,26,87,2017
2017-10-27,Sabah,59,16,43,2017
2017-10-28,Sabah,81,25,56,2017
2017-10-29,Sabah,147,49,98,2017
2017-10-30,Sabah,34,15,19,2017
2017-10-31,Sabah,96,45,51,2017
2017-11-01,Sabah,88,34,54,2017
2017-11-02,Sabah,62,20,42,2017
2017-11-03,Sabah,114,39,75,2017
2017-11-04,Sabah,121,50,71,2017
2017-11-05,Sabah,101,34,67,2017
2017-11-06,Sabah,55,12,43,2017
2017-11-07,Sabah,100,38,62,2017
2017-11-08,Sabah,47,13,34,2017
2017-11-09,Sabah,28,5,23,2017
2017-11-10,Sabah,34,7,27,2017
2017-11-11,Sabah,1416,320,1096,2017
2017-11-12,Sabah,158,59,99,2017
2017-11-13,Sabah,34,9,25,2017
2017-11-14,Sabah,35,5,30,2017
2017-11-15,Sabah,51,20,31,2017
2017-11-16,Sabah,72,47,25,2017
2017-11-17,Sabah,42,11,31,2017
2017-11-18,Sabah,138,76,62,2017
2017-11-19,Sabah,107,12,95,2017
2017-11-20,Sabah,89,27,62,2017
2017-11-21,Sabah,94,20,74,2017
2017-11-22,Sabah,58,15,43,2017
2017-11-23,Sabah,108,65,43,2017
2017-11-24,Sabah,69,27,42,2017
2017-11-25,Sabah,64,25,39,2017
2017-11-26,Sabah,131,31,100,2017
2017-11-27,Sabah,30,7,23,2017
2017-11-28,Sabah,59,16,43,2017
2017-11-29,Sabah,67,16,51,2017
2017-11-30,Sabah,41,16,25,2017
2017-12-01,Sabah,20,4,16,2017
2017-12-02,Sabah,30,11,19,2017
2017-12-03,Sabah,171,56,115,2017
2017-12-04,Sabah,47,16,31,2017
2017-12-05,Sabah,71,22,49,2017
2017-12-06,Sabah,99,37,62,2017
2017-12-07,Sabah,55,13,42,2017
2017-12-08,Sabah,111,33,78,2017
2017-12-09,Sabah,96,43,53,2017
2017-12-10,Sabah,186,79,107,2017
2017-12-11,Sabah,50,15,35,2017
2017-12-12,Sabah,78,9,69,2017
2017-12-13,Sabah,66,17,49,2017
2017-12-14,Sabah,45,7,38,2017
2017-12-15,Sabah,154,89,65,2017
2017-12-16,Sabah,87,26,61,2017
2017-12-17,Sabah,121,15,106,2017
2017-12-18,Sabah,67,19,48,2017
2017-12-19,Sabah,87,16,71,2017
2017-12-20,Sabah,184,121,63,2017
2017-12-21,Sabah,124,66,58,2017
2017-12-22,Sabah,53,23,30,2017
2017-12-23,Sabah,155,115,40,2017
2017-12-24,Sabah,75,28,47,2017
2017-12-25,Sabah,21,3,18,2017
2017-12-26,Sabah,49,9,40,2017
2017-12-27,Sabah,49,8,41,2017
2017-12-28,Sabah,64,32,32,2017
2017-12-29,Sabah,55,13,42,2017
2017-12-30,Sabah,178,60,118,2017
2017-12-31,Sabah,53,18,35,2017
2018-01-01,Sabah,0,0,0,2018
2018-01-02,Sabah,47,14,33,2018
2018-01-03,Sabah,50,10,40,2018
2018-01-04,Sabah,46,9,37,2018
2018-01-05,Sabah,73,18,55,2018
2018-01-06,Sabah,36,8,28,2018
2018-01-07,Sabah,155,73,82,2018
2018-01-08,Sabah,56,15,41,2018
2018-01-09,Sabah,64,17,47,2018
2018-01-10,Sabah,68,22,46,2018
2018-01-11,Sabah,62,29,33,2018
2018-01-12,Sabah,83,28,55,2018
2018-01-13,Sabah,68,18,50,2018
2018-01-14,Sabah,150,49,101,2018
2018-01-15,Sabah,111,45,66,2018
2018-01-16,Sabah,90,52,38,2018
2018-01-17,Sabah,102,32,70,2018
2018-01-18,Sabah,112,44,68,2018
2018-01-19,Sabah,64,32,32,2018
2018-01-20,Sabah,39,17,22,2018
2018-01-21,Sabah,45,11,34,2018
2018-01-22,Sabah,88,30,58,2018
2018-01-23,Sabah,73,26,47,2018
2018-01-24,Sabah,127,59,68,2018
2018-01-25,Sabah,174,79,95,2018
2018-01-26,Sabah,90,16,74,2018
2018-01-27,Sabah,131,47,84,2018
2018-01-28,Sabah,139,31,108,2018
2018-01-29,Sabah,102,43,59,2018
2018-01-30,Sabah,79,22,57,2018
2018-01-31,Sabah,116,58,58,2018
2018-02-01,Sabah,58,13,45,2018
2018-02-02,Sabah,59,21,38,2018
2018-02-03,Sabah,37,5,32,2018
2018-02-04,Sabah,182,55,127,2018
2018-02-05,Sabah,48,7,41,2018
2018-02-06,Sabah,95,19,76,2018
2018-02-07,Sabah,129,52,77,2018
2018-02-08,Sabah,159,66,93,2018
2018-02-09,Sabah,82,25,57,2018
2018-02-10,Sabah,108,45,63,2018
2018-02-11,Sabah,251,145,106,2018
2018-02-12,Sabah,53,19,34,2018
2018-02-13,Sabah,144,66,78,2018
2018-02-14,Sabah,95,52,43,2018
2018-02-15,Sabah,63,19,44,2018
2018-02-16,Sabah,43,13,30,2018
2018-02-17,Sabah,76,16,60,2018
2018-02-18,Sabah,41,16,25,2018
2018-02-19,Sabah,65,22,43,2018
2018-02-20,Sabah,68,17,51,2018
2018-02-21,Sabah,127,73,54,2018
2018-02-22,Sabah,78,20,58,2018
2018-02-23,Sabah,134,44,90,2018
2018-02-24,Sabah,134,66,68,2018
2018-02-25,Sabah,89,43,46,2018
2018-02-26,Sabah,95,27,68,2018
2018-02-27,Sabah,137,48,89,2018
2018-02-28,Sabah,138,41,97,2018
2018-03-01,Sabah,52,13,39,2018
2018-03-02,Sabah,71,24,47,2018
2018-03-03,Sabah,125,65,60,2018
2018-03-04,Sabah,90,44,46,2018
2018-03-05,Sabah,36,7,29,2018
2018-03-06,Sabah,77,36,41,2018
2018-03-07,Sabah,162,35,127,2018
2018-03-08,Sabah,280,168,112,2018
2018-03-09,Sabah,50,16,34,2018
2018-03-10,Sabah,146,72,74,2018
2018-03-11,Sabah,157,52,105,2018
2018-03-12,Sabah,89,43,46,2018
2018-03-13,Sabah,88,31,57,2018
2018-03-14,Sabah,58,10,48,2018
2018-03-15,Sabah,102,50,52,2018
2018-03-16,Sabah,54,11,43,2018
2018-03-17,Sabah,155,59,96,2018
2018-03-18,Sabah,176,30,146,2018
2018-03-19,Sabah,59,17,42,2018
2018-03-20,Sabah,42,13,29,2018
2018-03-21,Sabah,31,13,18,2018
2018-03-22,Sabah,39,9,30,2018
2018-03-23,Sabah,39,9,30,2018
2018-03-24,Sabah,53,17,36,2018
2018-03-25,Sabah,296,85,211,2018
2018-03-26,Sabah,52,18,34,2018
2018-03-27,Sabah,68,14,54,2018
2018-03-28,Sabah,57,14,43,2018
2018-03-29,Sabah,69,16,53,2018
2018-03-30,Sabah,160,55,105,2018
2018-03-31,Sabah,63,29,34,2018
2018-04-01,Sabah,39,14,25,2018
2018-04-02,Sabah,71,21,50,2018
2018-04-03,Sabah,51,16,35,2018
2018-04-04,Sabah,59,6,53,2018
2018-04-05,Sabah,51,11,40,2018
2018-04-06,Sabah,115,23,92,2018
2018-04-07,Sabah,68,28,40,2018
2018-04-08,Sabah,80,28,52,2018
2018-04-09,Sabah,42,10,32,2018
2018-04-10,Sabah,66,18,48,2018
2018-04-11,Sabah,95,16,79,2018
2018-04-12,Sabah,118,26,92,2018
2018-04-13,Sabah,52,13,39,2018
2018-04-14,Sabah,49,22,27,2018
2018-04-15,Sabah,80,24,56,2018
2018-04-16,Sabah,42,5,37,2018
2018-04-17,Sabah,40,9,31,2018
2018-04-18,Sabah,142,59,83,2018
2018-04-19,Sabah,89,43,46,2018
2018-04-20,Sabah,39,11,28,2018
2018-04-21,Sabah,128,49,79,2018
2018-04-22,Sabah,159,48,111,2018
2018-04-23,Sabah,98,40,58,2018
2018-04-24,Sabah,73,26,47,2018
2018-04-25,Sabah,64,18,46,2018
2018-04-26,Sabah,86,26,60,2018
2018-04-27,Sabah,43,11,32,2018
2018-04-28,Sabah,38,11,27,2018
2018-04-29,Sabah,134,53,81,2018
2018-04-30,Sabah,55,15,40,2018
2018-05-01,Sabah,193,63,130,2018
2018-05-02,Sabah,85,26,59,2018
2018-05-03,Sabah,71,12,59,2018
2018-05-04,Sabah,18,3,15,2018
2018-05-05,Sabah,78,21,57,2018
2018-05-06,Sabah,112,43,69,2018
2018-05-07,Sabah,143,73,70,2018
2018-05-08,Sabah,65,8,57,2018
2018-05-09,Sabah,0,0,0,2018
2018-05-10,Sabah,26,14,12,2018
2018-05-11,Sabah,39,13,26,2018
2018-05-12,Sabah,192,77,115,2018
2018-05-13,Sabah,150,44,106,2018
2018-05-14,Sabah,86,15,71,2018
2018-05-15,Sabah,166,53,113,2018
2018-05-16,Sabah,95,17,78,2018
2018-05-17,Sabah,56,12,44,2018
2018-05-18,Sabah,48,11,37,2018
2018-05-19,Sabah,76,26,50,2018
2018-05-20,Sabah,122,25,97,2018
2018-05-21,Sabah,47,6,41,2018
2018-05-22,Sabah,68,15,53,2018
2018-05-23,Sabah,108,26,82,2018
2018-05-24,Sabah,99,32,67,2018
2018-05-25,Sabah,80,16,64,2018
2018-05-26,Sabah,158,51,107,2018
2018-05-27,Sabah,131,22,109,2018
2018-05-28,Sabah,53,13,40,2018
2018-05-29,Sabah,351,67,284,2018
2018-05-30,Sabah,25,17,8,2018
2018-05-31,Sabah,34,15,19,2018
2018-06-01,Sabah,81,39,42,2018
2018-06-02,Sabah,160,74,86,2018
2018-06-03,Sabah,24,13,11,2018
2018-06-04,Sabah,77,20,57,2018
2018-06-05,Sabah,88,27,61,2018
2018-06-06,Sabah,136,44,92,2018
2018-06-07,Sabah,66,29,37,2018
2018-06-08,Sabah,53,15,38,2018
2018-06-09,Sabah,62,23,39,2018
2018-06-10,Sabah,140,28,112,2018
2018-06-11,Sabah,65,23,42,2018
2018-06-12,Sabah,62,24,38,2018
2018-06-13,Sabah,41,15,26,2018
2018-06-14,Sabah,40,6,34,2018
2018-06-15,Sabah,0,0,0,2018
2018-06-16,Sabah,23,5,18,2018
2018-06-17,Sabah,84,31,53,2018
2018-06-18,Sabah,47,7,40,2018
2018-06-19,Sabah,62,8,54,2018
2018-06-20,Sabah,50,9,41,2018
2018-06-21,Sabah,83,25,58,2018
2018-06-22,Sabah,89,18,71,2018
2018-06-23,Sabah,50,27,23,2018
2018-06-24,Sabah,169,37,132,2018
2018-06-25,Sabah,60,14,46,2018
2018-06-26,Sabah,139,49,90,2018
2018-06-27,Sabah,62,14,48,2018
2018-06-28,Sabah,141,34,107,2018
2018-06-29,Sabah,76,23,53,2018
2018-06-30,Sabah,104,38,66,2018
2018-07-01,Sabah,153,67,86,2018
2018-07-02,Sabah,111,53,58,2018
2018-07-03,Sabah,65,22,43,2018
2018-07-04,Sabah,124,45,79,2018
2018-07-05,Sabah,94,19,75,2018
2018-07-06,Sabah,115,27,88,2018
2018-07-07,Sabah,73,34,39,2018
2018-07-08,Sabah,213,56,157,2018
2018-07-09,Sabah,43,4,39,2018
2018-07-10,Sabah,132,60,72,2018
2018-07-11,Sabah,92,43,49,2018
2018-07-12,Sabah,80,18,62,2018
2018-07-13,Sabah,74,10,64,2018
2018-07-14,Sabah,138,39,99,2018
2018-07-15,Sabah,47,17,30,2018
2018-07-16,Sabah,128,36,92,2018
2018-07-17,Sabah,60,13,47,2018
2018-07-18,Sabah,125,50,75,2018
2018-07-19,Sabah,128,49,79,2018
2018-07-20,Sabah,88,38,50,2018
2018-07-21,Sabah,50,12,38,2018
2018-07-22,Sabah,86,28,58,2018
2018-07-23,Sabah,60,12,48,2018
2018-07-24,Sabah,69,15,54,2018
2018-07-25,Sabah,118,41,77,2018
2018-07-26,Sabah,42,10,32,2018
2018-07-27,Sabah,87,21,66,2018
2018-07-28,Sabah,65,20,45,2018
2018-07-29,Sabah,77,23,54,2018
2018-07-30,Sabah,122,25,97,2018
2018-07-31,Sabah,176,39,137,2018
2018-08-01,Sabah,50,15,35,2018
2018-08-02,Sabah,88,31,57,2018
2018-08-03,Sabah,109,19,90,2018
2018-08-04,Sabah,158,59,99,2018
2018-08-05,Sabah,86,36,50,2018
2018-08-06,Sabah,58,16,42,2018
2018-08-07,Sabah,72,16,56,2018
2018-08-08,Sabah,55,12,43,2018
2018-08-09,Sabah,75,29,46,2018
2018-08-10,Sabah,29,2,27,2018
2018-08-11,Sabah,245,92,153,2018
2018-08-12,Sabah,103,22,81,2018
2018-08-13,Sabah,64,19,45,2018
2018-08-14,Sabah,79,17,62,2018
2018-08-15,Sabah,21,3,18,2018
2018-08-16,Sabah,50,6,44,2018
2018-08-17,Sabah,68,21,47,2018
2018-08-18,Sabah,335,105,230,2018
2018-08-19,Sabah,371,154,217,2018
2018-08-20,Sabah,25,3,22,2018
2018-08-21,Sabah,52,14,38,2018
2018-08-22,Sabah,24,8,16,2018
2018-08-23,Sabah,64,25,39,2018
2018-08-24,Sabah,130,58,72,2018
2018-08-25,Sabah,174,60,114,2018
2018-08-26,Sabah,142,38,104,2018
2018-08-27,Sabah,53,11,42,2018
2018-08-28,Sabah,125,54,71,2018
2018-08-29,Sabah,84,25,59,2018
2018-08-30,Sabah,36,4,32,2018
2018-08-31,Sabah,121,68,53,2018
2018-09-01,Sabah,179,61,118,2018
2018-09-02,Sabah,124,33,91,2018
2018-09-03,Sabah,34,6,28,2018
2018-09-04,Sabah,39,11,28,2018
2018-09-05,Sabah,70,13,57,2018
2018-09-06,Sabah,72,17,55,2018
2018-09-07,Sabah,33,7,26,2018
2018-09-08,Sabah,53,26,27,2018
2018-09-09,Sabah,122,27,95,2018
2018-09-10,Sabah,34,7,27,2018
2018-09-11,Sabah,112,34,78,2018
2018-09-12,Sabah,74,22,52,2018
2018-09-13,Sabah,148,60,88,2018
2018-09-14,Sabah,36,7,29,2018
2018-09-15,Sabah,113,50,63,2018
2018-09-16,Sabah,113,32,81,2018
2018-09-17,Sabah,75,35,40,2018
2018-09-18,Sabah,55,16,39,2018
2018-09-19,Sabah,68,16,52,2018
2018-09-20,Sabah,40,13,27,2018
2018-09-21,Sabah,45,8,37,2018
2018-09-22,Sabah,109,50,59,2018
2018-09-23,Sabah,133,35,98,2018
2018-09-24,Sabah,74,27,47,2018
2018-09-25,Sabah,48,18,30,2018
2018-09-26,Sabah,128,61,67,2018
2018-09-27,Sabah,89,42,47,2018
2018-09-28,Sabah,73,19,54,2018
2018-09-29,Sabah,160,74,86,2018
2018-09-30,Sabah,113,47,66,2018
2018-10-01,Sabah,125,38,87,2018
2018-10-02,Sabah,45,18,27,2018
2018-10-03,Sabah,60,10,50,2018
2018-10-04,Sabah,51,11,40,2018
2018-10-05,Sabah,89,41,48,2018
2018-10-06,Sabah,77,42,35,2018
2018-10-07,Sabah,30,14,16,2018
2018-10-08,Sabah,58,12,46,2018
2018-10-09,Sabah,69,16,53,2018
2018-10-10,Sabah,80,24,56,2018
2018-10-11,Sabah,233,80,153,2018
2018-10-12,Sabah,110,28,82,2018
2018-10-13,Sabah,71,24,47,2018
2018-10-14,Sabah,276,105,171,2018
2018-10-15,Sabah,84,9,75,2018
2018-10-16,Sabah,68,25,43,2018
2018-10-17,Sabah,39,7,32,2018
2018-10-18,Sabah,53,21,32,2018
2018-10-19,Sabah,81,28,53,2018
2018-10-20,Sabah,134,67,67,2018
2018-10-21,Sabah,189,56,133,2018
2018-10-22,Sabah,57,12,45,2018
2018-10-23,Sabah,112,35,77,2018
2018-10-24,Sabah,129,51,78,2018
2018-10-25,Sabah,148,73,75,2018
2018-10-26,Sabah,60,18,42,2018
2018-10-27,Sabah,126,57,69,2018
2018-10-28,Sabah,82,29,53,2018
2018-10-29,Sabah,42,13,29,2018
2018-10-30,Sabah,40,12,28,2018
2018-10-31,Sabah,36,15,21,2018
2018-11-01,Sabah,84,21,63,2018
2018-11-02,Sabah,21,5,16,2018
2018-11-03,Sabah,36,14,22,2018
2018-11-04,Sabah,121,33,88,2018
2018-11-05,Sabah,58,14,44,2018
2018-11-06,Sabah,98,32,66,2018
2018-11-07,Sabah,70,14,56,2018
2018-11-08,Sabah,74,20,54,2018
2018-11-09,Sabah,42,10,32,2018
2018-11-10,Sabah,1380,265,1115,2018
2018-11-11,Sabah,26,2,24,2018
2018-11-12,Sabah,23,3,20,2018
2018-11-13,Sabah,32,3,29,2018
2018-11-14,Sabah,37,5,32,2018
2018-11-15,Sabah,76,32,44,2018
2018-11-16,Sabah,38,12,26,2018
2018-11-17,Sabah,225,139,86,2018
2018-11-18,Sabah,202,40,162,2018
2018-11-19,Sabah,86,27,59,2018
2018-11-20,Sabah,50,25,25,2018
2018-11-21,Sabah,150,57,93,2018
2018-11-22,Sabah,96,28,68,2018
2018-11-23,Sabah,167,51,116,2018
2018-11-24,Sabah,36,9,27,2018
2018-11-25,Sabah,119,36,83,2018
2018-11-26,Sabah,128,35,93,2018
2018-11-27,Sabah,57,10,47,2018
2018-11-28,Sabah,59,15,44,2018
2018-11-29,Sabah,96,29,67,2018
2018-11-30,Sabah,30,4,26,2018
2018-12-01,Sabah,118,35,83,2018
2018-12-02,Sabah,147,50,97,2018
2018-12-03,Sabah,27,9,18,2018
2018-12-04,Sabah,55,11,44,2018
2018-12-05,Sabah,42,7,35,2018
2018-12-06,Sabah,50,13,37,2018
2018-12-07,Sabah,138,35,103,2018
2018-12-08,Sabah,159,67,92,2018
2018-12-09,Sabah,75,27,48,2018
2018-12-10,Sabah,35,4,31,2018
2018-12-11,Sabah,77,21,56,2018
2018-12-12,Sabah,60,13,47,2018
2018-12-13,Sabah,80,29,51,2018
2018-12-14,Sabah,35,8,27,2018
2018-12-15,Sabah,109,43,66,2018
2018-12-16,Sabah,122,51,71,2018
2018-12-17,Sabah,140,60,80,2018
2018-12-18,Sabah,125,21,104,2018
2018-12-19,Sabah,59,11,48,2018
2018-12-20,Sabah,52,7,45,2018
2018-12-21,Sabah,72,15,57,2018
2018-12-22,Sabah,88,54,34,2018
2018-12-23,Sabah,109,19,90,2018
2018-12-24,Sabah,59,11,48,2018
2018-12-25,Sabah,66,43,23,2018
2018-12-26,Sabah,57,9,48,2018
2018-12-27,Sabah,29,4,25,2018
2018-12-28,Sabah,75,17,58,2018
2018-12-29,Sabah,111,59,52,2018
2018-12-30,Sabah,89,51,38,2018
2018-12-31,Sabah,73,22,51,2018
2019-01-01,Sabah,16,11,5,2019
2019-01-02,Sabah,66,14,52,2019
2019-01-03,Sabah,105,49,56,2019
2019-01-04,Sabah,47,17,30,2019
2019-01-05,Sabah,27,5,22,2019
2019-01-06,Sabah,32,7,25,2019
2019-01-07,Sabah,40,7,33,2019
2019-01-08,Sabah,89,25,64,2019
2019-01-09,Sabah,124,54,70,2019
2019-01-10,Sabah,196,83,113,2019
2019-01-11,Sabah,153,64,89,2019
2019-01-12,Sabah,48,6,42,2019
2019-01-13,Sabah,34,4,30,2019
2019-01-14,Sabah,57,14,43,2019
2019-01-15,Sabah,133,33,100,2019
2019-01-16,Sabah,90,27,63,2019
2019-01-17,Sabah,61,19,42,2019
2019-01-18,Sabah,88,23,65,2019
2019-01-19,Sabah,106,49,57,2019
2019-01-20,Sabah,71,19,52,2019
2019-01-21,Sabah,69,21,48,2019
2019-01-22,Sabah,70,16,54,2019
2019-01-23,Sabah,61,14,47,2019
2019-01-24,Sabah,44,14,30,2019
2019-01-25,Sabah,121,45,76,2019
2019-01-26,Sabah,187,83,104,2019
2019-01-27,Sabah,107,60,47,2019
2019-01-28,Sabah,52,19,33,2019
2019-01-29,Sabah,60,14,46,2019
2019-01-30,Sabah,64,14,50,2019
2019-01-31,Sabah,127,34,93,2019
2019-02-01,Sabah,114,46,68,2019
2019-02-02,Sabah,36,16,20,2019
2019-02-03,Sabah,67,16,51,2019
2019-02-04,Sabah,58,9,49,2019
2019-02-05,Sabah,169,46,123,2019
2019-02-06,Sabah,109,38,71,2019
2019-02-07,Sabah,75,38,37,2019
2019-02-08,Sabah,49,14,35,2019
2019-02-09,Sabah,92,32,60,2019
2019-02-10,Sabah,50,11,39,2019
2019-02-11,Sabah,154,60,94,2019
2019-02-12,Sabah,68,31,37,2019
2019-02-13,Sabah,129,38,91,2019
2019-02-14,Sabah,48,16,32,2019
2019-02-15,Sabah,148,63,85,2019
2019-02-16,Sabah,174,61,113,2019
2019-02-17,Sabah,102,36,66,2019
2019-02-18,Sabah,76,34,42,2019
2019-02-19,Sabah,149,51,98,2019
2019-02-20,Sabah,96,14,82,2019
2019-02-21,Sabah,68,13,55,2019
2019-02-22,Sabah,108,15,93,2019
2019-02-23,Sabah,134,37,97,2019
2019-02-24,Sabah,218,53,165,2019
2019-02-25,Sabah,64,18,46,2019
2019-02-26,Sabah,135,26,109,2019
2019-02-27,Sabah,151,55,96,2019
2019-02-28,Sabah,84,24,60,2019
2019-03-01,Sabah,88,25,63,2019
2019-03-02,Sabah,30,10,20,2019
2019-03-03,Sabah,142,39,103,2019
2019-03-04,Sabah,47,15,32,2019
2019-03-05,Sabah,126,38,88,2019
2019-03-06,Sabah,65,12,53,2019
2019-03-07,Sabah,138,48,90,2019
2019-03-08,Sabah,79,11,68,2019
2019-03-09,Sabah,181,68,113,2019
2019-03-10,Sabah,187,38,149,2019
2019-03-11,Sabah,69,17,52,2019
2019-03-12,Sabah,118,55,63,2019
2019-03-13,Sabah,123,29,94,2019
2019-03-14,Sabah,93,20,73,2019
2019-03-15,Sabah,55,17,38,2019
2019-03-16,Sabah,67,16,51,2019
2019-03-17,Sabah,181,29,152,2019
2019-03-18,Sabah,27,3,24,2019
2019-03-19,Sabah,104,17,87,2019
2019-03-20,Sabah,73,14,59,2019
2019-03-21,Sabah,53,16,37,2019
2019-03-22,Sabah,73,20,53,2019
2019-03-23,Sabah,95,37,58,2019
2019-03-24,Sabah,211,66,145,2019
2019-03-25,Sabah,141,43,98,2019
2019-03-26,Sabah,38,10,28,2019
2019-03-27,Sabah,88,17,71,2019
2019-03-28,Sabah,79,22,57,2019
2019-03-29,Sabah,66,19,47,2019
2019-03-30,Sabah,67,17,50,2019
2019-03-31,Sabah,39,15,24,2019
2019-04-01,Sabah,99,47,52,2019
2019-04-02,Sabah,64,15,49,2019
2019-04-03,Sabah,94,17,77,2019
2019-04-04,Sabah,73,25,48,2019
2019-04-05,Sabah,97,26,71,2019
2019-04-06,Sabah,205,90,115,2019
2019-04-07,Sabah,106,21,85,2019
2019-04-08,Sabah,81,19,62,2019
2019-04-09,Sabah,60,22,38,2019
2019-04-10,Sabah,52,12,40,2019
2019-04-11,Sabah,100,23,77,2019
2019-04-12,Sabah,53,16,37,2019
2019-04-13,Sabah,145,62,83,2019
2019-04-14,Sabah,60,24,36,2019
2019-04-15,Sabah,99,27,72,2019
2019-04-16,Sabah,82,20,62,2019
2019-04-17,Sabah,52,10,42,2019
2019-04-18,Sabah,70,16,54,2019
2019-04-19,Sabah,109,35,74,2019
2019-04-20,Sabah,100,40,60,2019
2019-04-21,Sabah,92,14,78,2019
2019-04-22,Sabah,39,3,36,2019
2019-04-23,Sabah,44,4,40,2019
2019-04-24,Sabah,51,7,44,2019
2019-04-25,Sabah,96,20,76,2019
2019-04-26,Sabah,37,4,33,2019
2019-04-27,Sabah,145,48,97,2019
2019-04-28,Sabah,109,31,78,2019
2019-04-29,Sabah,92,20,72,2019
2019-04-30,Sabah,200,82,118,2019
2019-05-01,Sabah,514,168,346,2019
2019-05-02,Sabah,95,29,66,2019
2019-05-03,Sabah,99,20,79,2019
2019-05-04,Sabah,119,48,71,2019
2019-05-05,Sabah,131,14,117,2019
2019-05-06,Sabah,23,1,22,2019
2019-05-07,Sabah,45,11,34,2019
2019-05-08,Sabah,30,10,20,2019
2019-05-09,Sabah,59,12,47,2019
2019-05-10,Sabah,87,31,56,2019
2019-05-11,Sabah,85,22,63,2019
2019-05-12,Sabah,99,24,75,2019
2019-05-13,Sabah,63,11,52,2019
2019-05-14,Sabah,51,15,36,2019
2019-05-15,Sabah,137,55,82,2019
2019-05-16,Sabah,53,16,37,2019
2019-05-17,Sabah,61,14,47,2019
2019-05-18,Sabah,111,30,81,2019
2019-05-19,Sabah,360,62,298,2019
2019-05-20,Sabah,35,5,30,2019
2019-05-21,Sabah,64,24,40,2019
2019-05-22,Sabah,83,23,60,2019
2019-05-23,Sabah,105,31,74,2019
2019-05-24,Sabah,99,32,67,2019
2019-05-25,Sabah,14,2,12,2019
2019-05-26,Sabah,107,39,68,2019
2019-05-27,Sabah,100,40,60,2019
2019-05-28,Sabah,71,21,50,2019
2019-05-29,Sabah,38,8,30,2019
2019-05-30,Sabah,65,11,54,2019
2019-05-31,Sabah,47,15,32,2019
2019-06-01,Sabah,17,7,10,2019
2019-06-02,Sabah,29,11,18,2019
2019-06-03,Sabah,41,5,36,2019
2019-06-04,Sabah,28,6,22,2019
2019-06-05,Sabah,9,1,8,2019
2019-06-06,Sabah,90,40,50,2019
2019-06-07,Sabah,43,9,34,2019
2019-06-08,Sabah,25,9,16,2019
2019-06-09,Sabah,126,33,93,2019
2019-06-10,Sabah,74,29,45,2019
2019-06-11,Sabah,85,20,65,2019
2019-06-12,Sabah,83,29,54,2019
2019-06-13,Sabah,43,13,30,2019
2019-06-14,Sabah,202,48,154,2019
2019-06-15,Sabah,155,61,94,2019
2019-06-16,Sabah,191,49,142,2019
2019-06-17,Sabah,62,12,50,2019
2019-06-18,Sabah,39,9,30,2019
2019-06-19,Sabah,132,34,98,2019
2019-06-20,Sabah,61,24,37,2019
2019-06-21,Sabah,102,35,67,2019
2019-06-22,Sabah,248,56,192,2019
2019-06-23,Sabah,150,30,120,2019
2019-06-24,Sabah,86,18,68,2019
2019-06-25,Sabah,126,42,84,2019
2019-06-26,Sabah,104,27,77,2019
2019-06-27,Sabah,91,25,66,2019
2019-06-28,Sabah,65,10,55,2019
2019-06-29,Sabah,70,23,47,2019
2019-06-30,Sabah,127,42,85,2019
2019-07-01,Sabah,32,6,26,2019
2019-07-02,Sabah,50,5,45,2019
2019-07-03,Sabah,131,55,76,2019
2019-07-04,Sabah,73,20,53,2019
2019-07-05,Sabah,45,19,26,2019
2019-07-06,Sabah,47,8,39,2019
2019-07-07,Sabah,43,12,31,2019
2019-07-08,Sabah,25,2,23,2019
2019-07-09,Sabah,73,10,63,2019
2019-07-10,Sabah,128,51,77,2019
2019-07-11,Sabah,92,17,75,2019
2019-07-12,Sabah,51,8,43,2019
2019-07-13,Sabah,57,16,41,2019
2019-07-14,Sabah,42,5,37,2019
2019-07-15,Sabah,49,8,41,2019
2019-07-16,Sabah,40,7,33,2019
2019-07-17,Sabah,42,8,34,2019
2019-07-18,Sabah,45,6,39,2019
2019-07-19,Sabah,60,10,50,2019
2019-07-20,Sabah,23,4,19,2019
2019-07-21,Sabah,90,26,64,2019
2019-07-22,Sabah,51,11,40,2019
2019-07-23,Sabah,93,42,51,2019
2019-07-24,Sabah,164,69,95,2019
2019-07-25,Sabah,106,51,55,2019
2019-07-26,Sabah,47,10,37,2019
2019-07-27,Sabah,70,13,57,2019
2019-07-28,Sabah,83,41,42,2019
2019-07-29,Sabah,73,27,46,2019
2019-07-30,Sabah,93,24,69,2019
2019-07-31,Sabah,65,18,47,2019
2019-08-01,Sabah,87,33,54,2019
2019-08-02,Sabah,100,45,55,2019
2019-08-03,Sabah,167,96,71,2019
2019-08-04,Sabah,262,117,145,2019
2019-08-05,Sabah,52,18,34,2019
2019-08-06,Sabah,40,8,32,2019
2019-08-07,Sabah,124,63,61,2019
2019-08-08,Sabah,176,99,77,2019
2019-08-09,Sabah,67,34,33,2019
2019-08-10,Sabah,67,16,51,2019
2019-08-11,Sabah,67,44,23,2019
2019-08-12,Sabah,49,14,35,2019
2019-08-13,Sabah,78,31,47,2019
2019-08-14,Sabah,71,25,46,2019
2019-08-15,Sabah,82,44,38,2019
2019-08-16,Sabah,51,15,36,2019
2019-08-17,Sabah,98,30,68,2019
2019-08-18,Sabah,246,119,127,2019
2019-08-19,Sabah,86,35,51,2019
2019-08-20,Sabah,109,41,68,2019
2019-08-21,Sabah,47,13,34,2019
2019-08-22,Sabah,114,41,73,2019
2019-08-23,Sabah,102,43,59,2019
2019-08-24,Sabah,461,167,294,2019
2019-08-25,Sabah,394,161,233,2019
2019-08-26,Sabah,104,53,51,2019
2019-08-27,Sabah,73,29,44,2019
2019-08-28,Sabah,92,34,58,2019
2019-08-29,Sabah,97,31,66,2019
2019-08-30,Sabah,58,17,41,2019
2019-08-31,Sabah,157,40,117,2019
2019-09-01,Sabah,73,24,49,2019
2019-09-02,Sabah,46,24,22,2019
2019-09-03,Sabah,42,13,29,2019
2019-09-04,Sabah,61,27,34,2019
2019-09-05,Sabah,142,66,76,2019
2019-09-06,Sabah,77,21,56,2019
2019-09-07,Sabah,126,82,44,2019
2019-09-08,Sabah,346,264,82,2019
2019-09-09,Sabah,49,17,32,2019
2019-09-10,Sabah,81,18,63,2019
2019-09-11,Sabah,66,10,56,2019
2019-09-12,Sabah,166,96,70,2019
2019-09-13,Sabah,50,14,36,2019
2019-09-14,Sabah,156,61,95,2019
2019-09-15,Sabah,155,33,122,2019
2019-09-16,Sabah,190,74,116,2019
2019-09-17,Sabah,37,6,31,2019
2019-09-18,Sabah,45,9,36,2019
2019-09-19,Sabah,98,36,62,2019
2019-09-20,Sabah,54,20,34,2019
2019-09-21,Sabah,223,82,141,2019
2019-09-22,Sabah,272,130,142,2019
2019-09-23,Sabah,82,20,62,2019
2019-09-24,Sabah,116,68,48,2019
2019-09-25,Sabah,92,20,72,2019
2019-09-26,Sabah,62,19,43,2019
2019-09-27,Sabah,60,15,45,2019
2019-09-28,Sabah,294,106,188,2019
2019-09-29,Sabah,157,62,95,2019
2019-09-30,Sabah,46,9,37,2019
2019-10-01,Sabah,72,36,36,2019
2019-10-02,Sabah,61,18,43,2019
2019-10-03,Sabah,98,43,55,2019
2019-10-04,Sabah,96,39,57,2019
2019-10-05,Sabah,195,42,153,2019
2019-10-06,Sabah,155,46,109,2019
2019-10-07,Sabah,46,14,32,2019
2019-10-08,Sabah,68,27,41,2019
2019-10-09,Sabah,60,16,44,2019
2019-10-10,Sabah,68,24,44,2019
2019-10-11,Sabah,93,25,68,2019
2019-10-12,Sabah,83,45,38,2019
2019-10-13,Sabah,196,80,116,2019
2019-10-14,Sabah,59,23,36,2019
2019-10-15,Sabah,74,31,43,2019
2019-10-16,Sabah,61,27,34,2019
2019-10-17,Sabah,54,26,28,2019
2019-10-18,Sabah,77,18,59,2019
2019-10-19,Sabah,167,81,86,2019
2019-10-20,Sabah,186,103,83,2019
2019-10-21,Sabah,49,11,38,2019
2019-10-22,Sabah,100,67,33,2019
2019-10-23,Sabah,68,17,51,2019
2019-10-24,Sabah,93,28,65,2019
2019-10-25,Sabah,148,59,89,2019
2019-10-26,Sabah,103,34,69,2019
2019-10-27,Sabah,87,48,39,2019
2019-10-28,Sabah,214,121,93,2019
2019-10-29,Sabah,41,15,26,2019
2019-10-30,Sabah,103,46,57,2019
2019-10-31,Sabah,107,37,70,2019
2019-11-01,Sabah,66,25,41,2019
2019-11-02,Sabah,139,49,90,2019
2019-11-03,Sabah,246,157,89,2019
2019-11-04,Sabah,39,8,31,2019
2019-11-05,Sabah,71,25,46,2019
2019-11-06,Sabah,35,11,24,2019
2019-11-07,Sabah,70,20,50,2019
2019-11-08,Sabah,49,15,34,2019
2019-11-09,Sabah,1276,201,1075,2019
2019-11-10,Sabah,143,51,92,2019
2019-11-11,Sabah,33,9,24,2019
2019-11-12,Sabah,59,13,46,2019
2019-11-13,Sabah,40,5,35,2019
2019-11-14,Sabah,84,35,49,2019
2019-11-15,Sabah,71,22,49,2019
2019-11-16,Sabah,189,108,81,2019
2019-11-17,Sabah,325,114,211,2019
2019-11-18,Sabah,32,8,24,2019
2019-11-19,Sabah,38,9,29,2019
2019-11-20,Sabah,60,14,46,2019
2019-11-21,Sabah,33,13,20,2019
2019-11-22,Sabah,121,28,93,2019
2019-11-23,Sabah,99,61,38,2019
2019-11-24,Sabah,98,50,48,2019
2019-11-25,Sabah,72,35,37,2019
2019-11-26,Sabah,59,7,52,2019
2019-11-27,Sabah,137,40,97,2019
2019-11-28,Sabah,69,18,51,2019
2019-11-29,Sabah,48,16,32,2019
2019-11-30,Sabah,176,135,41,2019
2019-12-01,Sabah,128,56,72,2019
2019-12-02,Sabah,47,17,30,2019
2019-12-03,Sabah,44,6,38,2019
2019-12-04,Sabah,59,17,42,2019
2019-12-05,Sabah,85,29,56,2019
2019-12-06,Sabah,63,15,48,2019
2019-12-07,Sabah,55,23,32,2019
2019-12-08,Sabah,162,51,111,2019
2019-12-09,Sabah,30,3,27,2019
2019-12-10,Sabah,65,27,38,2019
2019-12-11,Sabah,61,20,41,2019
2019-12-12,Sabah,166,59,107,2019
2019-12-13,Sabah,145,78,67,2019
2019-12-14,Sabah,278,95,183,2019
2019-12-15,Sabah,318,79,239,2019
2019-12-16,Sabah,32,8,24,2019
2019-12-17,Sabah,67,23,44,2019
2019-12-18,Sabah,98,22,76,2019
2019-12-19,Sabah,116,33,83,2019
2019-12-20,Sabah,71,33,38,2019
2019-12-21,Sabah,101,45,56,2019
2019-12-22,Sabah,131,44,87,2019
2019-12-23,Sabah,47,9,38,2019
2019-12-24,Sabah,41,10,31,2019
2019-12-25,Sabah,25,9,16,2019
2019-12-26,Sabah,70,15,55,2019
2019-12-27,Sabah,71,18,53,2019
2019-12-28,Sabah,38,14,24,2019
2019-12-29,Sabah,148,45,103,2019
2019-12-30,Sabah,53,14,39,2019
2019-12-31,Sabah,84,16,68,2019
2020-01-01,Sabah,22,9,13,2020
2020-01-02,Sabah,81,14,67,2020
2020-01-03,Sabah,45,6,39,2020
2020-01-04,Sabah,44,8,36,2020
2020-01-05,Sabah,131,46,85,2020
2020-01-06,Sabah,72,16,56,2020
2020-01-07,Sabah,128,39,89,2020
2020-01-08,Sabah,97,32,65,2020
2020-01-09,Sabah,89,24,65,2020
2020-01-10,Sabah,110,31,79,2020
2020-01-11,Sabah,123,58,65,2020
2020-01-12,Sabah,158,62,96,2020
2020-01-13,Sabah,70,16,54,2020
2020-01-14,Sabah,103,27,76,2020
2020-01-15,Sabah,73,22,51,2020
2020-01-16,Sabah,78,39,39,2020
2020-01-17,Sabah,99,27,72,2020
2020-01-18,Sabah,80,33,47,2020
2020-01-19,Sabah,194,47,147,2020
2020-01-20,Sabah,66,18,48,2020
2020-01-21,Sabah,55,18,37,2020
2020-01-22,Sabah,190,98,92,2020
2020-01-23,Sabah,49,10,39,2020
2020-01-24,Sabah,103,29,74,2020
2020-01-25,Sabah,202,80,122,2020
2020-01-26,Sabah,113,47,66,2020
2020-01-27,Sabah,51,14,37,2020
2020-01-28,Sabah,80,21,59,2020
2020-01-29,Sabah,101,24,77,2020
2020-01-30,Sabah,116,37,79,2020
2020-01-31,Sabah,57,18,39,2020
2020-02-01,Sabah,148,64,84,2020
2020-02-02,Sabah,103,42,61,2020
2020-02-03,Sabah,44,18,26,2020
2020-02-04,Sabah,79,28,51,2020
2020-02-05,Sabah,58,17,41,2020
2020-02-06,Sabah,114,34,80,2020
2020-02-07,Sabah,44,14,30,2020
2020-02-08,Sabah,135,69,66,2020
2020-02-09,Sabah,66,30,36,2020
2020-02-10,Sabah,57,9,48,2020
2020-02-11,Sabah,71,20,51,2020
2020-02-12,Sabah,130,52,78,2020
2020-02-13,Sabah,78,21,57,2020
2020-02-14,Sabah,93,25,68,2020
2020-02-15,Sabah,156,110,46,2020
2020-02-16,Sabah,258,84,174,2020
2020-02-17,Sabah,55,16,39,2020
2020-02-18,Sabah,53,11,42,2020
2020-02-19,Sabah,127,61,66,2020
2020-02-20,Sabah,80,21,59,2020
2020-02-21,Sabah,136,37,99,2020
2020-02-22,Sabah,480,200,280,2020
2020-02-23,Sabah,209,40,169,2020
2020-02-24,Sabah,73,25,48,2020
2020-02-25,Sabah,124,48,76,2020
2020-02-26,Sabah,161,53,108,2020
2020-02-27,Sabah,72,30,42,2020
2020-02-28,Sabah,109,55,54,2020
2020-02-29,Sabah,230,93,137,2020
2020-03-01,Sabah,103,50,53,2020
2020-03-02,Sabah,56,9,47,2020
2020-03-03,Sabah,42,8,34,2020
2020-03-04,Sabah,54,13,41,2020
2020-03-05,Sabah,88,17,71,2020
2020-03-06,Sabah,99,33,66,2020
2020-03-07,Sabah,152,56,96,2020
2020-03-08,Sabah,213,44,169,2020
2020-03-09,Sabah,130,81,49,2020
2020-03-10,Sabah,305,101,204,2020
2020-03-11,Sabah,73,38,35,2020
2020-03-12,Sabah,139,49,90,2020
2020-03-13,Sabah,38,11,27,2020
2020-03-14,Sabah,77,53,24,2020
2020-03-15,Sabah,45,26,19,2020
2020-03-16,Sabah,42,6,36,2020
2020-03-17,Sabah,30,11,19,2020
2020-03-18,Sabah,32,5,27,2020
2020-03-19,Sabah,47,13,34,2020
2020-03-20,Sabah,47,8,39,2020
2020-03-21,Sabah,50,8,42,2020
2020-03-22,Sabah,16,6,10,2020
2020-03-23,Sabah,77,16,61,2020
2020-03-24,Sabah,82,25,57,2020
2020-03-25,Sabah,83,28,55,2020
2020-03-26,Sabah,85,38,47,2020
2020-03-27,Sabah,75,13,62,2020
2020-03-28,Sabah,64,17,47,2020
2020-03-29,Sabah,33,6,27,2020
2020-03-30,Sabah,84,13,71,2020
2020-03-31,Sabah,113,49,64,2020
2020-04-01,Sabah,102,34,68,2020
2020-04-02,Sabah,84,29,55,2020
2020-04-03,Sabah,33,10,23,2020
2020-04-04,Sabah,70,20,50,2020
2020-04-05,Sabah,41,11,30,2020
2020-04-06,Sabah,59,21,38,2020
2020-04-07,Sabah,62,8,54,2020
2020-04-08,Sabah,62,15,47,2020
2020-04-09,Sabah,66,12,54,2020
2020-04-10,Sabah,35,10,25,2020
2020-04-11,Sabah,68,18,50,2020
2020-04-12,Sabah,49,19,30,2020
2020-04-13,Sabah,73,32,41,2020
2020-04-14,Sabah,39,8,31,2020
2020-04-15,Sabah,62,19,43,2020
2020-04-16,Sabah,74,25,49,2020
2020-04-17,Sabah,61,21,40,2020
2020-04-18,Sabah,81,39,42,2020
2020-04-19,Sabah,53,14,39,2020
2020-04-20,Sabah,65,18,47,2020
2020-04-21,Sabah,80,23,57,2020
2020-04-22,Sabah,139,26,113,2020
2020-04-23,Sabah,178,60,118,2020
2020-04-24,Sabah,20,6,14,2020
2020-04-25,Sabah,40,19,21,2020
2020-04-26,Sabah,76,22,54,2020
2020-04-27,Sabah,59,27,32,2020
2020-04-28,Sabah,45,21,24,2020
2020-04-29,Sabah,61,9,52,2020
2020-04-30,Sabah,73,10,63,2020
2020-05-01,Sabah,66,19,47,2020
2020-05-02,Sabah,80,29,51,2020
2020-05-03,Sabah,107,28,79,2020
2020-05-04,Sabah,119,32,87,2020
2020-05-05,Sabah,82,22,60,2020
2020-05-06,Sabah,71,22,49,2020
2020-05-07,Sabah,119,28,91,2020
2020-05-08,Sabah,143,34,109,2020
2020-05-09,Sabah,130,37,93,2020
2020-05-10,Sabah,130,25,105,2020
2020-05-11,Sabah,76,25,51,2020
2020-05-12,Sabah,45,7,38,2020
2020-05-13,Sabah,81,20,61,2020
2020-05-14,Sabah,55,16,39,2020
2020-05-15,Sabah,72,21,51,2020
2020-05-16,Sabah,131,21,110,2020
2020-05-17,Sabah,156,55,101,2020
2020-05-18,Sabah,100,43,57,2020
2020-05-19,Sabah,77,13,64,2020
2020-05-20,Sabah,42,10,32,2020
2020-05-21,Sabah,113,33,80,2020
2020-05-22,Sabah,79,24,55,2020
2020-05-23,Sabah,94,17,77,2020
2020-05-24,Sabah,11,4,7,2020
2020-05-25,Sabah,122,29,93,2020
2020-05-26,Sabah,33,14,19,2020
2020-05-27,Sabah,41,12,29,2020
2020-05-28,Sabah,71,19,52,2020
2020-05-29,Sabah,91,32,59,2020
2020-05-30,Sabah,94,31,63,2020
2020-05-31,Sabah,57,21,36,2020
2020-06-01,Sabah,12,1,11,2020
2020-06-02,Sabah,81,19,62,2020
2020-06-03,Sabah,47,11,36,2020
2020-06-04,Sabah,127,43,84,2020
2020-06-05,Sabah,87,21,66,2020
2020-06-06,Sabah,179,52,127,2020
2020-06-07,Sabah,226,84,142,2020
2020-06-08,Sabah,97,25,72,2020
2020-06-09,Sabah,135,49,86,2020
2020-06-10,Sabah,62,15,47,2020
2020-06-11,Sabah,62,19,43,2020
2020-06-12,Sabah,98,34,64,2020
2020-06-13,Sabah,186,53,133,2020
2020-06-14,Sabah,74,12,62,2020
2020-06-15,Sabah,122,32,90,2020
2020-06-16,Sabah,96,20,76,2020
2020-06-17,Sabah,137,59,78,2020
2020-06-18,Sabah,103,32,71,2020
2020-06-19,Sabah,173,66,107,2020
2020-06-20,Sabah,236,70,166,2020
2020-06-21,Sabah,419,116,303,2020
2020-06-22,Sabah,70,23,47,2020
2020-06-23,Sabah,135,51,84,2020
2020-06-24,Sabah,57,6,51,2020
2020-06-25,Sabah,141,46,95,2020
2020-06-26,Sabah,42,11,31,2020
2020-06-27,Sabah,155,47,108,2020
2020-06-28,Sabah,110,61,49,2020
2020-06-29,Sabah,57,22,35,2020
2020-06-30,Sabah,99,20,79,2020
2020-07-01,Sabah,60,21,39,2020
2020-07-02,Sabah,49,14,35,2020
2020-07-03,Sabah,99,26,73,2020
2020-07-04,Sabah,145,50,95,2020
2020-07-05,Sabah,178,44,134,2020
2020-07-06,Sabah,29,4,25,2020
2020-07-07,Sabah,79,34,45,2020
2020-07-08,Sabah,98,12,86,2020
2020-07-09,Sabah,126,46,80,2020
2020-07-10,Sabah,49,7,42,2020
2020-07-11,Sabah,92,38,54,2020
2020-07-12,Sabah,248,97,151,2020
2020-07-13,Sabah,109,39,70,2020
2020-07-14,Sabah,80,29,51,2020
2020-07-15,Sabah,199,32,167,2020
2020-07-16,Sabah,61,22,39,2020
2020-07-17,Sabah,71,18,53,2020
2020-07-18,Sabah,207,56,151,2020
2020-07-19,Sabah,193,56,137,2020
2020-07-20,Sabah,61,15,46,2020
2020-07-21,Sabah,115,43,72,2020
2020-07-22,Sabah,73,16,57,2020
2020-07-23,Sabah,84,36,48,2020
2020-07-24,Sabah,124,49,75,2020
2020-07-25,Sabah,106,38,68,2020
2020-07-26,Sabah,115,37,78,2020
2020-07-27,Sabah,32,8,24,2020
2020-07-28,Sabah,70,30,40,2020
2020-07-29,Sabah,94,38,56,2020
2020-07-30,Sabah,36,4,32,2020
2020-07-31,Sabah,32,7,25,2020
2020-08-01,Sabah,38,16,22,2020
2020-08-02,Sabah,86,32,54,2020
2020-08-03,Sabah,58,15,43,2020
2020-08-04,Sabah,103,41,62,2020
2020-08-05,Sabah,80,35,45,2020
2020-08-06,Sabah,85,23,62,2020
2020-08-07,Sabah,55,8,47,2020
2020-08-08,Sabah,150,55,95,2020
2020-08-09,Sabah,187,38,149,2020
2020-08-10,Sabah,35,7,28,2020
2020-08-11,Sabah,134,57,77,2020
2020-08-12,Sabah,69,15,54,2020
2020-08-13,Sabah,51,8,43,2020
2020-08-14,Sabah,59,19,40,2020
2020-08-15,Sabah,81,31,50,2020
2020-08-16,Sabah,219,39,180,2020
2020-08-17,Sabah,46,11,35,2020
2020-08-18,Sabah,93,32,61,2020
2020-08-19,Sabah,74,21,53,2020
2020-08-20,Sabah,42,14,28,2020
2020-08-21,Sabah,94,19,75,2020
2020-08-22,Sabah,119,29,90,2020
2020-08-23,Sabah,347,92,255,2020
2020-08-24,Sabah,93,32,61,2020
2020-08-25,Sabah,63,26,37,2020
2020-08-26,Sabah,104,36,68,2020
2020-08-27,Sabah,104,23,81,2020
2020-08-28,Sabah,91,39,52,2020
2020-08-29,Sabah,267,64,203,2020
2020-08-30,Sabah,146,80,66,2020
2020-08-31,Sabah,197,70,127,2020
2020-09-01,Sabah,46,10,36,2020
2020-09-02,Sabah,122,32,90,2020
2020-09-03,Sabah,27,2,25,2020
2020-09-04,Sabah,86,19,67,2020
2020-09-05,Sabah,109,27,82,2020
2020-09-06,Sabah,72,9,63,2020
2020-09-07,Sabah,59,13,46,2020
2020-09-08,Sabah,57,20,37,2020
2020-09-09,Sabah,99,49,50,2020
2020-09-10,Sabah,40,4,36,2020
2020-09-11,Sabah,77,16,61,2020
2020-09-12,Sabah,93,31,62,2020
2020-09-13,Sabah,133,29,104,2020
2020-09-14,Sabah,89,42,47,2020
2020-09-15,Sabah,61,14,47,2020
2020-09-16,Sabah,279,63,216,2020
2020-09-17,Sabah,48,13,35,2020
2020-09-18,Sabah,92,20,72,2020
2020-09-19,Sabah,107,38,69,2020
2020-09-20,Sabah,101,29,72,2020
2020-09-21,Sabah,50,5,45,2020
2020-09-22,Sabah,54,15,39,2020
2020-09-23,Sabah,116,31,85,2020
2020-09-24,Sabah,100,32,68,2020
2020-09-25,Sabah,61,22,39,2020
2020-09-26,Sabah,0,0,0,2020
2020-09-27,Sabah,71,20,51,2020
2020-09-28,Sabah,44,12,32,2020
2020-09-29,Sabah,19,1,18,2020
2020-09-30,Sabah,81,23,58,2020
2020-10-01,Sabah,41,2,39,2020
2020-10-02,Sabah,61,18,43,2020
2020-10-03,Sabah,57,20,37,2020
2020-10-04,Sabah,102,25,77,2020
2020-10-05,Sabah,17,5,12,2020
2020-10-06,Sabah,41,14,27,2020
2020-10-07,Sabah,46,10,36,2020
2020-10-08,Sabah,89,36,53,2020
2020-10-09,Sabah,59,7,52,2020
2020-10-10,Sabah,64,16,48,2020
2020-10-11,Sabah,139,41,98,2020
2020-10-12,Sabah,19,5,14,2020
2020-10-13,Sabah,36,8,28,2020
2020-10-14,Sabah,40,10,30,2020
2020-10-15,Sabah,50,18,32,2020
2020-10-16,Sabah,56,11,45,2020
2020-10-17,Sabah,115,31,84,2020
2020-10-18,Sabah,170,23,147,2020
2020-10-19,Sabah,59,10,49,2020
2020-10-20,Sabah,65,14,51,2020
2020-10-21,Sabah,68,12,56,2020
2020-10-22,Sabah,60,9,51,2020
2020-10-23,Sabah,117,36,81,2020
2020-10-24,Sabah,108,26,82,2020
2020-10-25,Sabah,156,33,123,2020
2020-10-26,Sabah,26,2,24,2020
2020-10-27,Sabah,73,18,55,2020
2020-10-28,Sabah,92,15,77,2020
2020-10-29,Sabah,112,18,94,2020
2020-10-30,Sabah,120,20,100,2020
2020-10-31,Sabah,96,10,86,2020
2020-11-01,Sabah,116,16,100,2020
2020-11-02,Sabah,42,7,35,2020
2020-11-03,Sabah,50,10,40,2020
2020-11-04,Sabah,27,5,22,2020
2020-11-05,Sabah,33,5,28,2020
2020-11-06,Sabah,87,12,75,2020
2020-11-07,Sabah,186,37,149,2020
2020-11-08,Sabah,144,22,122,2020
2020-11-09,Sabah,43,12,31,2020
2020-11-10,Sabah,67,13,54,2020
2020-11-11,Sabah,60,13,47,2020
2020-11-12,Sabah,102,35,67,2020
2020-11-13,Sabah,60,16,44,2020
2020-11-14,Sabah,209,50,159,2020
2020-11-15,Sabah,127,34,93,2020
2020-11-16,Sabah,50,6,44,2020
2020-11-17,Sabah,51,9,42,2020
2020-11-18,Sabah,77,25,52,2020
2020-11-19,Sabah,48,13,35,2020
2020-11-20,Sabah,60,16,44,2020
2020-11-21,Sabah,143,37,106,2020
2020-11-22,Sabah,123,20,103,2020
2020-11-23,Sabah,43,7,36,2020
2020-11-24,Sabah,51,12,39,2020
2020-11-25,Sabah,90,14,76,2020
2020-11-26,Sabah,45,9,36,2020
2020-11-27,Sabah,38,4,34,2020
2020-11-28,Sabah,149,29,120,2020
2020-11-29,Sabah,369,59,310,2020
2020-11-30,Sabah,32,9,23,2020
2020-12-01,Sabah,48,7,41,2020
2020-12-02,Sabah,46,7,39,2020
2020-12-03,Sabah,94,34,60,2020
2020-12-04,Sabah,20,1,19,2020
2020-12-05,Sabah,119,16,103,2020
2020-12-06,Sabah,248,84,164,2020
2020-12-07,Sabah,42,10,32,2020
2020-12-08,Sabah,44,11,33,2020
2020-12-09,Sabah,58,20,38,2020
2020-12-10,Sabah,38,8,30,2020
2020-12-11,Sabah,46,8,38,2020
2020-12-12,Sabah,176,43,133,2020
2020-12-13,Sabah,135,30,105,2020
2020-12-14,Sabah,26,5,21,2020
2020-12-15,Sabah,74,20,54,2020
2020-12-16,Sabah,84,30,54,2020
2020-12-17,Sabah,50,10,40,2020
2020-12-18,Sabah,131,19,112,2020
2020-12-19,Sabah,221,50,171,2020
2020-12-20,Sabah,275,41,234,2020
2020-12-21,Sabah,41,16,25,2020
2020-12-22,Sabah,47,9,38,2020
2020-12-23,Sabah,83,18,65,2020
2020-12-24,Sabah,55,19,36,2020
2020-12-25,Sabah,31,9,22,2020
2020-12-26,Sabah,105,34,71,2020
2020-12-27,Sabah,145,31,114,2020
2020-12-28,Sabah,56,15,41,2020
2020-12-29,Sabah,66,15,51,2020
2020-12-30,Sabah,46,7,39,2020
2020-12-31,Sabah,46,10,36,2020
2021-01-01,Sabah,33,9,24,2021
2021-01-02,Sabah,54,12,42,2021
2021-01-03,Sabah,87,21,66,2021
2021-01-04,Sabah,58,9,49,2021
2021-01-05,Sabah,45,8,37,2021
2021-01-06,Sabah,52,5,47,2021
2021-01-07,Sabah,32,3,29,2021
2021-01-08,Sabah,45,1,44,2021
2021-01-09,Sabah,90,22,68,2021
2021-01-10,Sabah,173,38,135,2021
2021-01-11,Sabah,35,2,33,2021
2021-01-12,Sabah,42,6,36,2021
2021-01-13,Sabah,27,8,19,2021
2021-01-14,Sabah,59,12,47,2021
2021-01-15,Sabah,91,14,77,2021
2021-01-16,Sabah,223,72,151,2021
2021-01-17,Sabah,166,56,110,2021
2021-01-18,Sabah,49,9,40,2021
2021-01-19,Sabah,77,12,65,2021
2021-01-20,Sabah,99,22,77,2021
2021-01-21,Sabah,63,12,51,2021
2021-01-22,Sabah,111,26,85,2021
2021-01-23,Sabah,110,21,89,2021
2021-01-24,Sabah,187,34,153,2021
2021-01-25,Sabah,71,9,62,2021
2021-01-26,Sabah,66,14,52,2021
2021-01-27,Sabah,94,24,70,2021
2021-01-28,Sabah,87,27,60,2021
2021-01-29,Sabah,73,24,49,2021
2021-01-30,Sabah,148,38,110,2021
2021-01-31,Sabah,101,23,78,2021
2021-02-01,Sabah,56,7,49,2021
2021-02-02,Sabah,106,21,85,2021
2021-02-03,Sabah,72,14,58,2021
2021-02-04,Sabah,79,27,52,2021
2021-02-05,Sabah,86,28,58,2021
2021-02-06,Sabah,147,40,107,2021
2021-02-07,Sabah,277,60,217,2021
2021-02-08,Sabah,87,24,63,2021
2021-02-09,Sabah,99,41,58,2021
2021-02-10,Sabah,101,28,73,2021
2021-02-11,Sabah,46,4,42,2021
2021-02-12,Sabah,48,23,25,2021
2021-02-13,Sabah,65,12,53,2021
2021-02-14,Sabah,72,16,56,2021
2021-02-15,Sabah,48,11,37,2021
2021-02-16,Sabah,76,15,61,2021
2021-02-17,Sabah,57,9,48,2021
2021-02-18,Sabah,95,28,67,2021
2021-02-19,Sabah,91,39,52,2021
2021-02-20,Sabah,151,22,129,2021
2021-02-21,Sabah,114,18,96,2021
2021-02-22,Sabah,80,20,60,2021
2021-02-23,Sabah,77,16,61,2021
2021-02-24,Sabah,35,6,29,2021
2021-02-25,Sabah,114,33,81,2021
2021-02-26,Sabah,107,25,82,2021
2021-02-27,Sabah,181,41,140,2021
2021-02-28,Sabah,244,61,183,2021
2021-03-01,Sabah,108,17,91,2021
2021-03-02,Sabah,79,20,59,2021
2021-03-03,Sabah,84,12,72,2021
2021-03-04,Sabah,220,95,125,2021
2021-03-05,Sabah,93,37,56,2021
2021-03-06,Sabah,81,23,58,2021
2021-03-07,Sabah,134,22,112,2021
2021-03-08,Sabah,27,3,24,2021
2021-03-09,Sabah,53,8,45,2021
2021-03-10,Sabah,74,19,55,2021
2021-03-11,Sabah,62,15,47,2021
2021-03-12,Sabah,21,1,20,2021
2021-03-13,Sabah,122,19,103,2021
2021-03-14,Sabah,192,24,168,2021
2021-03-15,Sabah,26,3,23,2021
2021-03-16,Sabah,47,9,38,2021
2021-03-17,Sabah,62,18,44,2021
2021-03-18,Sabah,33,3,30,2021
2021-03-19,Sabah,23,3,20,2021
2021-03-20,Sabah,228,59,169,2021
2021-03-21,Sabah,311,73,238,2021
2021-03-22,Sabah,32,8,24,2021
2021-03-23,Sabah,84,17,67,2021
2021-03-24,Sabah,82,10,72,2021
2021-03-25,Sabah,110,29,81,2021
2021-03-26,Sabah,39,6,33,2021
2021-03-27,Sabah,127,41,86,2021
2021-03-28,Sabah,245,86,159,2021
2021-03-29,Sabah,44,6,38,2021
2021-03-30,Sabah,37,6,31,2021
2021-03-31,Sabah,54,16,38,2021
2021-04-01,Sabah,40,17,23,2021
2021-04-02,Sabah,23,5,18,2021
2021-04-03,Sabah,39,2,37,2021
2021-04-04,Sabah,132,47,85,2021
2021-04-05,Sabah,26,7,19,2021
2021-04-06,Sabah,43,4,39,2021
2021-04-07,Sabah,36,4,32,2021
2021-04-08,Sabah,77,12,65,2021
2021-04-09,Sabah,102,21,81,2021
2021-04-10,Sabah,82,20,62,2021
2021-04-11,Sabah,171,37,134,2021
2021-04-12,Sabah,124,32,92,2021
2021-04-13,Sabah,22,3,19,2021
2021-04-14,Sabah,54,10,44,2021
2021-04-15,Sabah,30,2,28,2021
2021-04-16,Sabah,66,10,56,2021
2021-04-17,Sabah,142,57,85,2021
2021-04-18,Sabah,225,32,193,2021
2021-04-19,Sabah,70,20,50,2021
2021-04-20,Sabah,37,12,25,2021
2021-04-21,Sabah,64,12,52,2021
2021-04-22,Sabah,65,9,56,2021
2021-04-23,Sabah,38,4,34,2021
2021-04-24,Sabah,42,6,36,2021
2021-04-25,Sabah,149,42,107,2021
2021-04-26,Sabah,49,7,42,2021
2021-04-27,Sabah,64,18,46,2021
2021-04-28,Sabah,67,17,50,2021
2021-04-29,Sabah,41,9,32,2021
2021-04-30,Sabah,53,13,40,2021
2021-05-01,Sabah,219,66,153,2021
2021-05-02,Sabah,185,30,155,2021
2021-05-03,Sabah,56,8,48,2021
2021-05-04,Sabah,77,14,63,2021
2021-05-05,Sabah,57,10,47,2021
2021-05-06,Sabah,68,23,45,2021
2021-05-07,Sabah,77,22,55,2021
2021-05-08,Sabah,34,9,25,2021
2021-05-09,Sabah,135,27,108,2021
2021-05-10,Sabah,70,16,54,2021
2021-05-11,Sabah,67,16,51,2021
2021-05-12,Sabah,66,5,61,2021
2021-05-13,Sabah,0,0,0,2021
2021-05-14,Sabah,16,5,11,2021
2021-05-15,Sabah,116,22,94,2021
2021-05-16,Sabah,219,51,168,2021
2021-05-17,Sabah,61,13,48,2021
2021-05-18,Sabah,59,10,49,2021
2021-05-19,Sabah,53,14,39,2021
2021-05-20,Sabah,52,10,42,2021
2021-05-21,Sabah,51,11,40,2021
2021-05-22,Sabah,91,15,76,2021
2021-05-23,Sabah,313,56,257,2021
2021-05-24,Sabah,61,9,52,2021
2021-05-25,Sabah,166,38,128,2021
2021-05-26,Sabah,137,20,117,2021
2021-05-27,Sabah,105,17,88,2021
2021-05-28,Sabah,184,69,115,2021
2021-05-29,Sabah,104,25,79,2021
2021-05-30,Sabah,160,45,115,2021
2021-05-31,Sabah,90,20,70,2021
2021-06-01,Sabah,154,118,36,2021
2021-06-02,Sabah,45,9,36,2021
2021-06-03,Sabah,115,44,71,2021
2021-06-04,Sabah,57,11,46,2021
2021-06-05,Sabah,78,24,54,2021
2021-06-06,Sabah,56,8,48,2021
2021-06-07,Sabah,49,12,37,2021
2021-06-08,Sabah,55,9,46,2021
2021-06-09,Sabah,44,11,33,2021
2021-06-10,Sabah,80,30,50,2021
2021-06-11,Sabah,59,16,43,2021
2021-06-12,Sabah,77,18,59,2021
2021-06-13,Sabah,135,18,117,2021
2021-06-14,Sabah,173,20,153,2021
2021-06-15,Sabah,223,38,185,2021
2021-06-16,Sabah,97,25,72,2021
2021-06-17,Sabah,96,24,72,2021
2021-06-18,Sabah,42,5,37,2021
2021-06-19,Sabah,125,21,104,2021
2021-06-20,Sabah,90,15,75,2021
2021-06-21,Sabah,46,6,40,2021
2021-06-22,Sabah,53,4,49,2021
2021-06-23,Sabah,161,50,111,2021
2021-06-24,Sabah,40,6,34,2021
2021-06-25,Sabah,68,16,52,2021
2021-06-26,Sabah,88,18,70,2021
2021-06-27,Sabah,214,35,179,2021
2021-06-28,Sabah,50,10,40,2021
2021-06-29,Sabah,78,20,58,2021
2021-06-30,Sabah,69,15,54,2021
2021-07-01,Sabah,37,11,26,2021
2021-07-02,Sabah,28,7,21,2021
2021-07-03,Sabah,137,29,108,2021
2021-07-04,Sabah,149,32,117,2021
2021-07-05,Sabah,29,7,22,2021
2021-07-06,Sabah,60,8,52,2021
2021-07-07,Sabah,93,16,77,2021
2021-07-08,Sabah,51,6,45,2021
2021-07-09,Sabah,89,28,61,2021
2021-07-10,Sabah,175,29,146,2021
2021-07-11,Sabah,224,62,162,2021
2021-07-12,Sabah,63,15,48,2021
2021-07-13,Sabah,73,14,59,2021
2021-07-14,Sabah,83,23,60,2021
2021-07-15,Sabah,44,15,29,2021
2021-07-16,Sabah,36,9,27,2021
2021-07-17,Sabah,119,19,100,2021
2021-07-18,Sabah,209,45,164,2021
2021-07-19,Sabah,23,2,21,2021
2021-07-20,Sabah,1,0,1,2021
2021-07-21,Sabah,30,7,23,2021
2021-07-22,Sabah,166,39,127,2021
2021-07-23,Sabah,28,2,26,2021
2021-07-24,Sabah,172,41,131,2021
2021-07-25,Sabah,83,14,69,2021
2021-07-26,Sabah,22,2,20,2021
2021-07-27,Sabah,48,8,40,2021
2021-07-28,Sabah,150,56,94,2021
2021-07-29,Sabah,41,10,31,2021
2021-07-30,Sabah,67,13,54,2021
2021-07-31,Sabah,68,25,43,2021
2021-08-01,Sabah,226,28,198,2021
2021-08-02,Sabah,30,5,25,2021
2021-08-03,Sabah,22,3,19,2021
2021-08-04,Sabah,34,5,29,2021
2021-08-05,Sabah,32,8,24,2021
2021-08-06,Sabah,38,3,35,2021
2021-08-07,Sabah,57,24,33,2021
2021-08-08,Sabah,109,34,75,2021
2021-08-09,Sabah,25,2,23,2021
2021-08-10,Sabah,33,8,25,2021
2021-08-11,Sabah,63,24,39,2021
2021-08-12,Sabah,60,15,45,2021
2021-08-13,Sabah,70,16,54,2021
2021-08-14,Sabah,93,26,67,2021
2021-08-15,Sabah,69,20,49,2021
2021-08-16,Sabah,59,15,44,2021
2021-08-17,Sabah,38,9,29,2021
2021-08-18,Sabah,52,10,42,2021
2021-08-19,Sabah,38,10,28,2021
2021-08-20,Sabah,34,6,28,2021
2021-08-21,Sabah,100,17,83,2021
2021-08-22,Sabah,182,46,136,2021
2021-08-23,Sabah,43,7,36,2021
2021-08-24,Sabah,73,12,61,2021
2021-08-25,Sabah,35,9,26,2021
2021-08-26,Sabah,44,5,39,2021
2021-08-27,Sabah,63,6,57,2021
2021-08-28,Sabah,63,7,56,2021
2021-08-29,Sabah,57,12,45,2021
2021-08-30,Sabah,97,54,43,2021
2021-08-31,Sabah,201,98,103,2021
2021-09-01,Sabah,53,7,46,2021
2021-09-02,Sabah,65,8,57,2021
2021-09-03,Sabah,30,4,26,2021
2021-09-04,Sabah,63,10,53,2021
2021-09-05,Sabah,39,2,37,2021
2021-09-06,Sabah,38,8,30,2021
2021-09-07,Sabah,21,4,17,2021
2021-09-08,Sabah,32,5,27,2021
2021-09-09,Sabah,38,5,33,2021
2021-09-10,Sabah,34,2,32,2021
2021-09-11,Sabah,76,18,58,2021
2021-09-12,Sabah,151,19,132,2021
2021-09-13,Sabah,67,10,57,2021
2021-09-14,Sabah,71,8,63,2021
2021-09-15,Sabah,62,6,56,2021
2021-09-16,Sabah,138,27,111,2021
2021-09-17,Sabah,67,8,59,2021
2021-09-18,Sabah,68,11,57,2021
2021-09-19,Sabah,102,13,89,2021
2021-09-20,Sabah,43,5,38,2021
2021-09-21,Sabah,31,2,29,2021
2021-09-22,Sabah,50,11,39,2021
2021-09-23,Sabah,59,11,48,2021
2021-09-24,Sabah,68,9,59,2021
2021-09-25,Sabah,78,9,69,2021
2021-09-26,Sabah,251,38,213,2021
2021-09-27,Sabah,44,7,37,2021
2021-09-28,Sabah,55,10,45,2021
2021-09-29,Sabah,67,16,51,2021
2021-09-30,Sabah,73,26,47,2021
2021-10-01,Sabah,48,10,38,2021
2021-10-02,Sabah,161,48,113,2021
2021-10-03,Sabah,109,27,82,2021
2021-10-04,Sabah,43,7,36,2021
2021-10-05,Sabah,48,13,35,2021
2021-10-06,Sabah,43,4,39,2021
2021-10-07,Sabah,42,3,39,2021
2021-10-08,Sabah,47,6,41,2021
2021-10-09,Sabah,113,21,92,2021
2021-10-10,Sabah,184,29,155,2021
2021-10-11,Sabah,38,5,33,2021
2021-10-12,Sabah,45,7,38,2021
2021-10-13,Sabah,85,21,64,2021
2021-10-14,Sabah,79,21,58,2021
2021-10-15,Sabah,76,19,57,2021
2021-10-16,Sabah,119,38,81,2021
2021-10-17,Sabah,136,23,113,2021
2021-10-18,Sabah,61,9,52,2021
2021-10-19,Sabah,87,22,65,2021
2021-10-20,Sabah,114,15,99,2021
2021-10-21,Sabah,37,4,33,2021
2021-10-22,Sabah,32,6,26,2021
2021-10-23,Sabah,118,28,90,2021
2021-10-24,Sabah,226,31,195,2021
2021-10-25,Sabah,27,6,21,2021
2021-10-26,Sabah,92,24,68,2021
2021-10-27,Sabah,99,28,71,2021
2021-10-28,Sabah,51,11,40,2021
2021-10-29,Sabah,33,9,24,2021
2021-10-30,Sabah,136,23,113,2021
2021-10-31,Sabah,118,32,86,2021
2021-11-01,Sabah,26,1,25,2021
2021-11-02,Sabah,77,23,54,2021
2021-11-03,Sabah,97,28,69,2021
2021-11-04,Sabah,60,15,45,2021
2021-11-05,Sabah,30,8,22,2021
2021-11-06,Sabah,34,6,28,2021
2021-11-07,Sabah,431,67,364,2021
2021-11-08,Sabah,26,3,23,2021
2021-11-09,Sabah,28,4,24,2021
2021-11-10,Sabah,69,11,58,2021
2021-11-11,Sabah,60,12,48,2021
2021-11-12,Sabah,30,3,27,2021
2021-11-13,Sabah,224,57,167,2021
2021-11-14,Sabah,105,27,78,2021
2021-11-15,Sabah,26,2,24,2021
2021-11-16,Sabah,50,3,47,2021
2021-11-17,Sabah,118,46,72,2021
2021-11-18,Sabah,38,6,32,2021
2021-11-19,Sabah,38,7,31,2021
2021-11-20,Sabah,204,83,121,2021
2021-11-21,Sabah,113,22,91,2021
2021-11-22,Sabah,46,8,38,2021
2021-11-23,Sabah,63,13,50,2021
2021-11-24,Sabah,36,3,33,2021
2021-11-25,Sabah,31,3,28,2021
2021-11-26,Sabah,41,8,33,2021
2021-11-27,Sabah,87,20,67,2021
2021-11-28,Sabah,394,84,310,2021
2021-11-29,Sabah,62,16,46,2021
2021-11-30,Sabah,82,11,71,2021
2021-12-01,Sabah,51,11,40,2021
2021-12-02,Sabah,27,6,21,2021
2021-12-03,Sabah,75,14,61,2021
2021-12-04,Sabah,114,41,73,2021
2021-12-05,Sabah,213,41,172,2021
2021-12-06,Sabah,64,23,41,2021
2021-12-07,Sabah,109,37,72,2021
2021-12-08,Sabah,57,12,45,2021
2021-12-09,Sabah,49,15,34,2021
2021-12-10,Sabah,81,21,60,2021
2021-12-11,Sabah,140,40,100,2021
2021-12-12,Sabah,88,23,65,2021
2021-12-13,Sabah,52,15,37,2021
2021-12-14,Sabah,98,20,78,2021
2021-12-15,Sabah,57,17,40,2021
2021-12-16,Sabah,79,27,52,2021
2021-12-17,Sabah,175,40,135,2021
2021-12-18,Sabah,93,26,67,2021
2021-12-19,Sabah,295,55,240,2021
2021-12-20,Sabah,76,15,61,2021
2021-12-21,Sabah,46,7,39,2021
2021-12-22,Sabah,69,8,61,2021
2021-12-23,Sabah,47,8,39,2021
2021-12-24,Sabah,30,6,24,2021
2021-12-25,Sabah,25,4,21,2021
2021-12-26,Sabah,68,11,57,2021
2021-12-27,Sabah,12,0,12,2021
2021-12-28,Sabah,51,7,44,2021
2021-12-29,Sabah,147,29,118,2021
2021-12-30,Sabah,83,29,54,2021
2021-12-31,Sabah,62,2,60,2021
2022-01-01,Sabah,31,9,22,2022
2022-01-02,Sabah,53,3,50,2022
2022-01-03,Sabah,34,5,29,2022
2022-01-04,Sabah,79,14,65,2022
2022-01-05,Sabah,75,21,54,2022
2022-01-06,Sabah,74,14,60,2022
2022-01-07,Sabah,33,7,26,2022
2022-01-08,Sabah,128,25,103,2022
2022-01-09,Sabah,197,39,158,2022
2022-01-10,Sabah,54,7,47,2022
2022-01-11,Sabah,53,15,38,2022
2022-01-12,Sabah,51,8,43,2022
2022-01-13,Sabah,53,7,46,2022
2022-01-14,Sabah,115,28,87,2022
2022-01-15,Sabah,96,23,73,2022
2022-01-16,Sabah,201,47,154,2022
2022-01-17,Sabah,82,31,51,2022
2022-01-18,Sabah,60,22,38,2022
2022-01-19,Sabah,55,21,34,2022
2022-01-20,Sabah,48,6,42,2022
2022-01-21,Sabah,60,10,50,2022
2022-01-22,Sabah,130,50,80,2022
2022-01-23,Sabah,95,26,69,2022
2022-01-24,Sabah,78,17,61,2022
2022-01-25,Sabah,123,14,109,2022
2022-01-26,Sabah,84,25,59,2022
2022-01-27,Sabah,73,15,58,2022
2022-01-28,Sabah,62,17,45,2022
2022-01-29,Sabah,97,18,79,2022
2022-01-30,Sabah,98,22,76,2022
2022-01-31,Sabah,43,8,35,2022
2022-02-01,Sabah,23,8,15,2022
2022-02-02,Sabah,24,3,21,2022
2022-02-03,Sabah,62,9,53,2022
2022-02-04,Sabah,30,7,23,2022
2022-02-05,Sabah,150,51,99,2022
2022-02-06,Sabah,115,20,95,2022
2022-02-07,Sabah,34,6,28,2022
2022-02-08,Sabah,54,14,40,2022
2022-02-09,Sabah,32,5,27,2022
2022-02-10,Sabah,79,22,57,2022
2022-02-11,Sabah,62,9,53,2022
2022-02-12,Sabah,51,9,42,2022
2022-02-13,Sabah,99,13,86,2022
2022-02-14,Sabah,34,11,23,2022
2022-02-15,Sabah,36,4,32,2022
2022-02-16,Sabah,42,6,36,2022
2022-02-17,Sabah,66,17,49,2022
2022-02-18,Sabah,52,10,42,2022
2022-02-19,Sabah,96,18,78,2022
2022-02-20,Sabah,85,17,68,2022
2022-02-21,Sabah,21,3,18,2022
2022-02-22,Sabah,39,5,34,2022
2022-02-23,Sabah,66,20,46,2022
2022-02-24,Sabah,35,4,31,2022
2022-02-25,Sabah,46,6,40,2022
2022-02-26,Sabah,51,5,46,2022
2022-02-27,Sabah,164,16,148,2022
2022-02-28,Sabah,54,7,47,2022
2022-03-01,Sabah,87,17,70,2022
2022-03-02,Sabah,62,18,44,2022
2022-03-03,Sabah,62,11,51,2022
2022-03-04,Sabah,58,14,44,2022
2022-03-05,Sabah,198,59,139,2022
2022-03-06,Sabah,118,20,98,2022
2022-03-07,Sabah,87,24,63,2022
2022-03-08,Sabah,110,25,85,2022
2022-03-09,Sabah,88,32,56,2022
2022-03-10,Sabah,158,54,104,2022
2022-03-11,Sabah,57,6,51,2022
2022-03-12,Sabah,123,24,99,2022
2022-03-13,Sabah,186,40,146,2022
2022-03-14,Sabah,43,6,37,2022
2022-03-15,Sabah,105,19,86,2022
2022-03-16,Sabah,178,75,103,2022
2022-03-17,Sabah,166,54,112,2022
2022-03-18,Sabah,57,13,44,2022
2022-03-19,Sabah,203,40,163,2022
2022-03-20,Sabah,296,68,228,2022
2022-03-21,Sabah,47,12,35,2022
2022-03-22,Sabah,108,22,86,2022
2022-03-23,Sabah,52,12,40,2022
2022-03-24,Sabah,132,23,109,2022
2022-03-25,Sabah,165,45,120,2022
2022-03-26,Sabah,147,56,91,2022
2022-03-27,Sabah,288,93,195,2022
2022-03-28,Sabah,78,11,67,2022
2022-03-29,Sabah,116,36,80,2022
2022-03-30,Sabah,229,66,163,2022
2022-03-31,Sabah,90,38,52,2022
2022-04-01,Sabah,170,66,104,2022
2022-04-02,Sabah,127,64,63,2022
2022-04-03,Sabah,118,17,101,2022
2022-04-04,Sabah,22,2,20,2022
2022-04-05,Sabah,29,6,23,2022
2022-04-06,Sabah,70,16,54,2022
2022-04-07,Sabah,65,18,47,2022
2022-04-08,Sabah,56,15,41,2022
2022-04-09,Sabah,100,38,62,2022
2022-04-10,Sabah,246,61,185,2022
2022-04-11,Sabah,33,6,27,2022
2022-04-12,Sabah,49,12,37,2022
2022-04-13,Sabah,56,18,38,2022
2022-04-14,Sabah,73,22,51,2022
2022-04-15,Sabah,71,22,49,2022
2022-04-16,Sabah,109,32,77,2022
2022-04-17,Sabah,182,33,149,2022
2022-04-18,Sabah,65,22,43,2022
2022-04-19,Sabah,67,16,51,2022
2022-04-20,Sabah,47,17,30,2022
2022-04-21,Sabah,56,14,42,2022
2022-04-22,Sabah,69,17,52,2022
2022-04-23,Sabah,114,45,69,2022
2022-04-24,Sabah,172,36,136,2022
2022-04-25,Sabah,23,5,18,2022
2022-04-26,Sabah,33,5,28,2022
2022-04-27,Sabah,58,6,52,2022
2022-04-28,Sabah,50,12,38,2022
2022-04-29,Sabah,55,16,39,2022
2022-04-30,Sabah,57,19,38,2022
2022-05-01,Sabah,128,18,110,2022
2022-05-02,Sabah,14,3,11,2022
2022-05-03,Sabah,5,0,5,2022
2022-05-04,Sabah,26,6,20,2022
2022-05-05,Sabah,79,25,54,2022
2022-05-06,Sabah,84,22,62,2022
2022-05-07,Sabah,78,20,58,2022
2022-05-08,Sabah,129,36,93,2022
2022-05-09,Sabah,57,13,44,2022
2022-05-10,Sabah,72,17,55,2022
2022-05-11,Sabah,68,15,53,2022
2022-05-12,Sabah,127,32,95,2022
2022-05-13,Sabah,107,25,82,2022
2022-05-14,Sabah,83,19,64,2022
2022-05-15,Sabah,330,43,287,2022
2022-05-16,Sabah,53,4,49,2022
2022-05-17,Sabah,101,29,72,2022
2022-05-18,Sabah,123,73,50,2022
2022-05-19,Sabah,86,25,61,2022
2022-05-20,Sabah,75,11,64,2022
2022-05-21,Sabah,159,32,127,2022
2022-05-22,Sabah,133,25,108,2022
2022-05-23,Sabah,113,52,61,2022
2022-05-24,Sabah,103,31,72,2022
2022-05-25,Sabah,41,5,36,2022
2022-05-26,Sabah,38,4,34,2022
2022-05-27,Sabah,60,9,51,2022
2022-05-28,Sabah,90,19,71,2022
2022-05-29,Sabah,145,25,120,2022
2022-05-30,Sabah,85,20,65,2022
2022-05-31,Sabah,52,5,47,2022
2022-06-01,Sabah,55,12,43,2022
2022-06-02,Sabah,46,14,32,2022
2022-06-03,Sabah,98,43,55,2022
2022-06-04,Sabah,98,29,69,2022
2022-06-05,Sabah,282,58,224,2022
2022-06-06,Sabah,6,1,5,2022
2022-06-07,Sabah,64,23,41,2022
2022-06-08,Sabah,73,25,48,2022
2022-06-09,Sabah,163,61,102,2022
2022-06-10,Sabah,40,5,35,2022
2022-06-11,Sabah,324,103,221,2022
2022-06-12,Sabah,200,28,172,2022
2022-06-13,Sabah,56,9,47,2022
2022-06-14,Sabah,305,51,254,2022
2022-06-15,Sabah,81,19,62,2022
2022-06-16,Sabah,131,73,58,2022
2022-06-17,Sabah,274,54,220,2022
2022-06-18,Sabah,115,34,81,2022
2022-06-19,Sabah,219,35,184,2022
2022-06-20,Sabah,53,9,44,2022
2022-06-21,Sabah,81,18,63,2022
2022-06-22,Sabah,96,41,55,2022
2022-06-23,Sabah,149,33,116,2022
2022-06-24,Sabah,113,40,73,2022
2022-06-25,Sabah,194,64,130,2022
2022-06-26,Sabah,200,41,159,2022
2022-06-27,Sabah,43,7,36,2022
2022-06-28,Sabah,69,20,49,2022
2022-06-29,Sabah,85,15,70,2022
2022-06-30,Sabah,50,12,38,2022
2022-07-01,Sabah,26,3,23,2022
2022-07-02,Sabah,97,34,63,2022
2022-07-03,Sabah,77,15,62,2022
2022-07-04,Sabah,45,13,32,2022
2022-07-05,Sabah,41,5,36,2022
2022-07-06,Sabah,67,15,52,2022
2022-07-07,Sabah,85,16,69,2022
2022-07-08,Sabah,126,32,94,2022
2022-07-09,Sabah,147,38,109,2022
2022-07-10,Sabah,35,4,31,2022
2022-07-11,Sabah,44,9,35,2022
2022-07-12,Sabah,31,8,23,2022
2022-07-13,Sabah,50,6,44,2022
2022-07-14,Sabah,54,11,43,2022
2022-07-15,Sabah,45,6,39,2022
2022-07-16,Sabah,192,45,147,2022
2022-07-17,Sabah,278,47,231,2022
2022-07-18,Sabah,36,6,30,2022
2022-07-19,Sabah,63,14,49,2022
2022-07-20,Sabah,83,30,53,2022
2022-07-21,Sabah,96,24,72,2022
2022-07-22,Sabah,17,1,16,2022
2022-07-23,Sabah,162,26,136,2022
2022-07-24,Sabah,296,66,230,2022
2022-07-25,Sabah,19,0,19,2022
2022-07-26,Sabah,46,6,40,2022
2022-07-27,Sabah,130,51,79,2022
2022-07-28,Sabah,82,21,61,2022
2022-07-29,Sabah,38,13,25,2022
2022-07-30,Sabah,58,14,44,2022
2022-07-31,Sabah,186,30,156,2022
2022-08-01,Sabah,28,3,25,2022
2022-08-02,Sabah,66,17,49,2022
2022-08-03,Sabah,65,15,50,2022
2022-08-04,Sabah,92,29,63,2022
2022-08-05,Sabah,88,16,72,2022
2022-08-06,Sabah,85,34,51,2022
2022-08-07,Sabah,128,22,106,2022
2022-08-08,Sabah,43,8,35,2022
2022-08-09,Sabah,94,56,38,2022
2022-08-10,Sabah,15,2,13,2022
2022-08-11,Sabah,43,21,22,2022
2022-08-12,Sabah,46,6,40,2022
2022-08-13,Sabah,83,31,52,2022
2022-08-14,Sabah,251,45,206,2022
2022-08-15,Sabah,51,12,39,2022
2022-08-16,Sabah,67,15,52,2022
2022-08-17,Sabah,114,45,69,2022
2022-08-18,Sabah,66,13,53,2022
2022-08-19,Sabah,41,2,39,2022
2022-08-20,Sabah,153,29,124,2022
2022-08-21,Sabah,184,37,147,2022
2022-08-22,Sabah,25,7,18,2022
2022-08-23,Sabah,45,4,41,2022
2022-08-24,Sabah,127,58,69,2022
2022-08-25,Sabah,126,37,89,2022
2022-08-26,Sabah,77,23,54,2022
2022-08-27,Sabah,84,19,65,2022
2022-08-28,Sabah,236,68,168,2022
2022-08-29,Sabah,69,27,42,2022
2022-08-30,Sabah,154,82,72,2022
2022-08-31,Sabah,244,51,193,2022
2022-09-01,Sabah,71,12,59,2022
2022-09-02,Sabah,33,5,28,2022
2022-09-03,Sabah,86,12,74,2022
2022-09-04,Sabah,199,29,170,2022
2022-09-05,Sabah,99,35,64,2022
2022-09-06,Sabah,39,6,33,2022
2022-09-07,Sabah,82,14,68,2022
2022-09-08,Sabah,38,10,28,2022
2022-09-09,Sabah,38,3,35,2022
2022-09-10,Sabah,209,53,156,2022
2022-09-11,Sabah,294,69,225,2022
2022-09-12,Sabah,28,8,20,2022
2022-09-13,Sabah,118,26,92,2022
2022-09-14,Sabah,64,21,43,2022
2022-09-15,Sabah,155,69,86,2022
2022-09-16,Sabah,114,21,93,2022
2022-09-17,Sabah,127,21,106,2022
2022-09-18,Sabah,236,54,182,2022
2022-09-19,Sabah,29,6,23,2022
2022-09-20,Sabah,46,10,36,2022
2022-09-21,Sabah,166,68,98,2022
2022-09-22,Sabah,68,36,32,2022
2022-09-23,Sabah,83,14,69,2022
2022-09-24,Sabah,222,114,108,2022
2022-09-25,Sabah,164,32,132,2022
2022-09-26,Sabah,48,11,37,2022
2022-09-27,Sabah,159,24,135,2022
2022-09-28,Sabah,132,46,86,2022
2022-09-29,Sabah,42,7,35,2022
2022-09-30,Sabah,134,40,94,2022
2022-10-01,Sabah,88,26,62,2022
2022-10-02,Sabah,123,33,90,2022
2022-10-03,Sabah,35,2,33,2022
2022-10-04,Sabah,39,1,38,2022
2022-10-05,Sabah,92,15,77,2022
2022-10-06,Sabah,91,17,74,2022
2022-10-07,Sabah,93,23,70,2022
2022-10-08,Sabah,115,17,98,2022
2022-10-09,Sabah,154,33,121,2022
2022-10-10,Sabah,107,15,92,2022
2022-10-11,Sabah,76,13,63,2022
2022-10-12,Sabah,76,21,55,2022
2022-10-13,Sabah,102,36,66,2022
2022-10-14,Sabah,63,15,48,2022
2022-10-15,Sabah,228,51,177,2022
2022-10-16,Sabah,174,31,143,2022
2022-10-17,Sabah,39,5,34,2022
2022-10-18,Sabah,129,36,93,2022
2022-10-19,Sabah,83,26,57,2022
2022-10-20,Sabah,61,27,34,2022
2022-10-21,Sabah,51,8,43,2022
2022-10-22,Sabah,167,46,121,2022
2022-10-23,Sabah,292,68,224,2022
2022-10-24,Sabah,180,47,133,2022
2022-10-25,Sabah,32,6,26,2022
2022-10-26,Sabah,73,18,55,2022
2022-10-27,Sabah,133,63,70,2022
2022-10-28,Sabah,124,47,77,2022
2022-10-29,Sabah,164,46,118,2022
2022-10-30,Sabah,308,151,157,2022
2022-10-31,Sabah,42,5,37,2022
2022-11-01,Sabah,21,5,16,2022
2022-11-02,Sabah,65,14,51,2022
2022-11-03,Sabah,41,11,30,2022
2022-11-04,Sabah,37,6,31,2022
2022-11-05,Sabah,102,29,73,2022
2022-11-06,Sabah,150,20,130,2022
2022-11-07,Sabah,40,0,40,2022
2022-11-08,Sabah,35,2,33,2022
2022-11-09,Sabah,98,16,82,2022
2022-11-10,Sabah,109,18,91,2022
2022-11-11,Sabah,40,7,33,2022
2022-11-12,Sabah,1020,188,832,2022
2022-11-13,Sabah,91,14,77,2022
2022-11-14,Sabah,24,6,18,2022
2022-11-15,Sabah,26,10,16,2022
2022-11-16,Sabah,82,36,46,2022
2022-11-17,Sabah,51,13,38,2022
2022-11-18,Sabah,17,6,11,2022
2022-11-19,Sabah,0,0,0,2022
2022-11-20,Sabah,149,23,126,2022
2022-11-21,Sabah,40,8,32,2022
2022-11-22,Sabah,67,19,48,2022
2022-11-23,Sabah,194,101,93,2022
2022-11-24,Sabah,81,17,64,2022
2022-11-25,Sabah,72,18,54,2022
2022-11-26,Sabah,73,19,54,2022
2022-11-27,Sabah,116,31,85,2022
2022-11-28,Sabah,2,0,2,2022
2022-11-29,Sabah,57,8,49,2022
2022-11-30,Sabah,95,50,45,2022
2022-12-01,Sabah,83,33,50,2022
2022-12-02,Sabah,122,27,95,2022
2022-12-03,Sabah,56,12,44,2022
2022-12-04,Sabah,72,10,62,2022
2022-12-05,Sabah,36,6,30,2022
2022-12-06,Sabah,62,14,48,2022
2022-12-07,Sabah,81,10,71,2022
2022-12-08,Sabah,85,15,70,2022
2022-12-09,Sabah,88,23,65,2022
2022-12-10,Sabah,87,19,68,2022
2022-12-11,Sabah,216,28,188,2022
2022-12-12,Sabah,32,4,28,2022
2022-12-13,Sabah,62,7,55,2022
2022-12-14,Sabah,83,20,63,2022
2022-12-15,Sabah,87,21,66,2022
2022-12-16,Sabah,86,16,70,2022
2022-12-17,Sabah,195,49,146,2022
2022-12-18,Sabah,123,27,96,2022
2022-12-19,Sabah,53,10,43,2022
2022-12-20,Sabah,149,42,107,2022
2022-12-21,Sabah,67,16,51,2022
2022-12-22,Sabah,73,15,58,2022
2022-12-23,Sabah,63,8,55,2022
2022-12-24,Sabah,46,5,41,2022
2022-12-25,Sabah,29,7,22,2022
2022-12-26,Sabah,122,25,97,2022
2022-12-27,Sabah,44,9,35,2022
2022-12-28,Sabah,102,31,71,2022
2022-12-29,Sabah,100,22,78,2022
2022-12-30,Sabah,113,21,92,2022
2022-12-31,Sabah,159,28,131,2022
2023-01-01,Sabah,0,0,0,2023
2023-01-02,Sabah,46,8,38,2023
2023-01-03,Sabah,51,9,42,2023
2023-01-04,Sabah,67,10,57,2023
2023-01-05,Sabah,134,34,100,2023
2023-01-06,Sabah,156,54,102,2023
2023-01-07,Sabah,107,27,80,2023
2023-01-08,Sabah,142,22,120,2023
2023-01-09,Sabah,76,20,56,2023
2023-01-10,Sabah,35,9,26,2023
2023-01-11,Sabah,92,28,64,2023
2023-01-12,Sabah,116,26,90,2023
2023-01-13,Sabah,61,11,50,2023
2023-01-14,Sabah,136,36,100,2023
2023-01-15,Sabah,158,38,120,2023
2023-01-16,Sabah,72,32,40,2023
2023-01-17,Sabah,59,18,41,2023
2023-01-18,Sabah,112,51,61,2023
2023-01-19,Sabah,44,4,40,2023
2023-01-20,Sabah,71,10,61,2023
2023-01-21,Sabah,87,12,75,2023
2023-01-22,Sabah,71,22,49,2023
2023-01-23,Sabah,52,11,41,2023
2023-01-24,Sabah,116,18,98,2023
2023-01-25,Sabah,94,16,78,2023
2023-01-26,Sabah,121,21,100,2023
2023-01-27,Sabah,57,23,34,2023
2023-01-28,Sabah,114,34,80,2023
2023-01-29,Sabah,165,24,141,2023
2023-01-30,Sabah,44,6,38,2023
2023-01-31,Sabah,56,10,46,2023
2023-02-01,Sabah,45,3,42,2023
2023-02-02,Sabah,99,21,78,2023
2023-02-03,Sabah,37,6,31,2023
2023-02-04,Sabah,274,75,199,2023
2023-02-05,Sabah,119,21,98,2023
2023-02-06,Sabah,40,6,34,2023
2023-02-07,Sabah,80,14,66,2023
2023-02-08,Sabah,59,12,47,2023
2023-02-09,Sabah,147,43,104,2023
2023-02-10,Sabah,38,2,36,2023
2023-02-11,Sabah,152,54,98,2023
2023-02-12,Sabah,177,37,140,2023
2023-02-13,Sabah,64,17,47,2023
2023-02-14,Sabah,54,7,47,2023
2023-02-15,Sabah,96,14,82,2023
2023-02-16,Sabah,82,30,52,2023
2023-02-17,Sabah,29,4,25,2023
2023-02-18,Sabah,84,26,58,2023
2023-02-19,Sabah,195,58,137,2023
2023-02-20,Sabah,57,18,39,2023
2023-02-21,Sabah,59,6,53,2023
2023-02-22,Sabah,76,19,57,2023
2023-02-23,Sabah,162,39,123,2023
2023-02-24,Sabah,76,25,51,2023
2023-02-25,Sabah,196,38,158,2023
2023-02-26,Sabah,315,33,282,2023
2023-02-27,Sabah,71,17,54,2023
2023-02-28,Sabah,97,16,81,2023
2023-03-01,Sabah,120,37,83,2023
2023-03-02,Sabah,80,19,61,2023
2023-03-03,Sabah,64,3,61,2023
2023-03-04,Sabah,150,53,97,2023
2023-03-05,Sabah,232,39,193,2023
2023-03-06,Sabah,71,9,62,2023
2023-03-07,Sabah,146,26,120,2023
2023-03-08,Sabah,70,15,55,2023
2023-03-09,Sabah,93,13,80,2023
2023-03-10,Sabah,175,40,135,2023
2023-03-11,Sabah,94,42,52,2023
2023-03-12,Sabah,338,40,298,2023
2023-03-13,Sabah,85,30,55,2023
2023-03-14,Sabah,61,9,52,2023
2023-03-15,Sabah,65,16,49,2023
2023-03-16,Sabah,69,32,37,2023
2023-03-17,Sabah,49,7,42,2023
2023-03-18,Sabah,210,63,147,2023
2023-03-19,Sabah,402,96,306,2023
2023-03-20,Sabah,92,25,67,2023
2023-03-21,Sabah,119,26,93,2023
2023-03-22,Sabah,104,16,88,2023
2023-03-23,Sabah,21,3,18,2023
2023-03-24,Sabah,30,4,26,2023
2023-03-25,Sabah,116,23,93,2023
2023-03-26,Sabah,287,45,242,2023
2023-03-27,Sabah,56,11,45,2023
2023-03-28,Sabah,43,7,36,2023
2023-03-29,Sabah,61,12,49,2023
2023-03-30,Sabah,61,12,49,2023
2023-03-31,Sabah,60,19,41,2023
2023-04-01,Sabah,147,61,86,2023
2023-04-02,Sabah,103,23,80,2023
2023-04-03,Sabah,96,23,73,2023
2023-04-04,Sabah,102,47,55,2023
2023-04-05,Sabah,73,18,55,2023
2023-04-06,Sabah,88,24,64,2023
2023-04-07,Sabah,82,16,66,2023
2023-04-08,Sabah,79,21,58,2023
2023-04-09,Sabah,155,34,121,2023
2023-04-10,Sabah,54,9,45,2023
2023-04-11,Sabah,39,4,35,2023
2023-04-12,Sabah,23,4,19,2023
2023-04-13,Sabah,109,45,64,2023
2023-04-14,Sabah,50,11,39,2023
2023-04-15,Sabah,164,55,109,2023
2023-04-16,Sabah,168,36,132,2023
2023-04-17,Sabah,69,6,63,2023
2023-04-18,Sabah,68,25,43,2023
2023-04-19,Sabah,52,6,46,2023
2023-04-20,Sabah,51,5,46,2023
2023-04-21,Sabah,23,4,19,2023
2023-04-22,Sabah,4,2,2,2023
2023-04-23,Sabah,75,27,48,2023
2023-04-24,Sabah,38,3,35,2023
2023-04-25,Sabah,73,16,57,2023
2023-04-26,Sabah,102,19,83,2023
2023-04-27,Sabah,88,20,68,2023
2023-04-28,Sabah,89,17,72,2023
2023-04-29,Sabah,105,21,84,2023
2023-04-30,Sabah,288,57,231,2023
2023-05-01,Sabah,266,59,207,2023
2023-05-02,Sabah,45,3,42,2023
2023-05-03,Sabah,58,11,47,2023
2023-05-04,Sabah,316,57,259,2023
2023-05-05,Sabah,22,2,20,2023
2023-05-06,Sabah,58,8,50,2023
2023-05-07,Sabah,126,19,107,2023
2023-05-08,Sabah,109,31,78,2023
2023-05-09,Sabah,38,5,33,2023
2023-05-10,Sabah,124,14,110,2023
2023-05-11,Sabah,114,21,93,2023
2023-05-12,Sabah,50,11,39,2023
2023-05-13,Sabah,49,10,39,2023
2023-05-14,Sabah,216,39,177,2023
2023-05-15,Sabah,27,3,24,2023
2023-05-16,Sabah,48,8,40,2023
2023-05-17,Sabah,66,10,56,2023
2023-05-18,Sabah,94,23,71,2023
2023-05-19,Sabah,59,23,36,2023
2023-05-20,Sabah,162,49,113,2023
2023-05-21,Sabah,224,42,182,2023
2023-05-22,Sabah,33,2,31,2023
2023-05-23,Sabah,81,19,62,2023
2023-05-24,Sabah,79,33,46,2023
2023-05-25,Sabah,128,43,85,2023
2023-05-26,Sabah,83,14,69,2023
2023-05-27,Sabah,146,35,111,2023
2023-05-28,Sabah,122,21,101,2023
2023-05-29,Sabah,94,19,75,2023
2023-05-30,Sabah,35,8,27,2023
2023-05-31,Sabah,67,11,56,2023
2023-06-01,Sabah,101,13,88,2023
2023-06-02,Sabah,36,5,31,2023
2023-06-03,Sabah,60,18,42,2023
2023-06-04,Sabah,244,37,207,2023
2023-06-05,Sabah,82,17,65,2023
2023-06-06,Sabah,39,6,33,2023
2023-06-07,Sabah,47,5,42,2023
2023-06-08,Sabah,77,20,57,2023
2023-06-09,Sabah,154,41,113,2023
2023-06-10,Sabah,164,44,120,2023
2023-06-11,Sabah,458,82,376,2023
2023-06-12,Sabah,51,10,41,2023
2023-06-13,Sabah,56,8,48,2023
2023-06-14,Sabah,331,51,280,2023
2023-06-15,Sabah,95,20,75,2023
2023-06-16,Sabah,347,58,289,2023
2023-06-17,Sabah,238,67,171,2023
2023-06-18,Sabah,565,116,449,2023
2023-06-19,Sabah,28,3,25,2023
2023-06-20,Sabah,59,11,48,2023
2023-06-21,Sabah,118,25,93,2023
2023-06-22,Sabah,97,14,83,2023
2023-06-23,Sabah,123,32,91,2023
2023-06-24,Sabah,239,56,183,2023
2023-06-25,Sabah,235,56,179,2023
2023-06-26,Sabah,105,34,71,2023
2023-06-27,Sabah,48,9,39,2023
2023-06-28,Sabah,69,11,58,2023
2023-06-29,Sabah,54,5,49,2023
2023-06-30,Sabah,48,4,44,2023
2023-07-01,Sabah,161,110,51,2023
2023-07-02,Sabah,238,47,191,2023
2023-07-03,Sabah,54,19,35,2023
2023-07-04,Sabah,53,21,32,2023
2023-07-05,Sabah,66,8,58,2023
2023-07-06,Sabah,119,38,81,2023
2023-07-07,Sabah,74,8,66,2023
2023-07-08,Sabah,149,72,77,2023
2023-07-09,Sabah,128,21,107,2023
2023-07-10,Sabah,29,4,25,2023
2023-07-11,Sabah,49,8,41,2023
2023-07-12,Sabah,31,5,26,2023
2023-07-13,Sabah,61,19,42,2023
2023-07-14,Sabah,41,5,36,2023
2023-07-15,Sabah,278,102,176,2023
2023-07-16,Sabah,184,29,155,2023
2023-07-17,Sabah,52,30,22,2023
2023-07-18,Sabah,45,5,40,2023
2023-07-19,Sabah,100,26,74,2023
2023-07-20,Sabah,71,16,55,2023
2023-07-21,Sabah,53,13,40,2023
2023-07-22,Sabah,235,64,171,2023
2023-07-23,Sabah,224,45,179,2023
2023-07-24,Sabah,77,32,45,2023
2023-07-25,Sabah,44,11,33,2023
2023-07-26,Sabah,105,59,46,2023
2023-07-27,Sabah,62,11,51,2023
2023-07-28,Sabah,71,15,56,2023
2023-07-29,Sabah,106,44,62,2023
2023-07-30,Sabah,163,40,123,2023
2023-07-31,Sabah,36,4,32,2023
2023-08-01,Sabah,52,16,36,2023
2023-08-02,Sabah,58,16,42,2023
2023-08-03,Sabah,71,14,57,2023
2023-08-04,Sabah,83,8,75,2023
2023-08-05,Sabah,65,16,49,2023
2023-08-06,Sabah,284,45,239,2023
2023-08-07,Sabah,37,7,30,2023
2023-08-08,Sabah,45,13,32,2023
2023-08-09,Sabah,114,43,71,2023
2023-08-10,Sabah,40,5,35,2023
2023-08-11,Sabah,56,10,46,2023
2023-08-12,Sabah,113,31,82,2023
2023-08-13,Sabah,220,60,160,2023
2023-08-14,Sabah,51,9,42,2023
2023-08-15,Sabah,100,19,81,2023
2023-08-16,Sabah,151,61,90,2023
2023-08-17,Sabah,169,23,146,2023
2023-08-18,Sabah,52,11,41,2023
2023-08-19,Sabah,67,16,51,2023
2023-08-20,Sabah,208,46,162,2023
2023-08-21,Sabah,31,4,27,2023
2023-08-22,Sabah,125,38,87,2023
2023-08-23,Sabah,124,62,62,2023
2023-08-24,Sabah,68,25,43,2023
2023-08-25,Sabah,32,2,30,2023
2023-08-26,Sabah,118,71,47,2023
2023-08-27,Sabah,136,26,110,2023
2023-08-28,Sabah,31,6,25,2023
2023-08-29,Sabah,94,26,68,2023
2023-08-30,Sabah,54,9,45,2023
2023-08-31,Sabah,220,52,168,2023
2023-09-01,Sabah,24,3,21,2023
2023-09-02,Sabah,88,16,72,2023
2023-09-03,Sabah,178,36,142,2023
2023-09-04,Sabah,30,2,28,2023
2023-09-05,Sabah,54,7,47,2023
2023-09-06,Sabah,78,29,49,2023
2023-09-07,Sabah,155,79,76,2023
2023-09-08,Sabah,23,3,20,2023
2023-09-09,Sabah,136,37,99,2023
2023-09-10,Sabah,387,98,289,2023
2023-09-11,Sabah,45,8,37,2023
2023-09-12,Sabah,72,13,59,2023
2023-09-13,Sabah,105,45,60,2023
2023-09-14,Sabah,62,7,55,2023
2023-09-15,Sabah,57,7,50,2023
2023-09-16,Sabah,333,83,250,2023
2023-09-17,Sabah,404,89,315,2023
2023-09-18,Sabah,77,36,41,2023
2023-09-19,Sabah,155,36,119,2023
2023-09-20,Sabah,121,35,86,2023
2023-09-21,Sabah,121,28,93,2023
2023-09-22,Sabah,128,18,110,2023
2023-09-23,Sabah,309,129,180,2023
2023-09-24,Sabah,298,49,249,2023
2023-09-25,Sabah,46,9,37,2023
2023-09-26,Sabah,55,17,38,2023
2023-09-27,Sabah,42,6,36,2023
2023-09-28,Sabah,182,38,144,2023
2023-09-29,Sabah,65,12,53,2023
2023-09-30,Sabah,100,26,74,2023
2023-10-01,Sabah,176,42,134,2023
2023-10-02,Sabah,36,2,34,2023
2023-10-03,Sabah,29,2,27,2023
2023-10-04,Sabah,73,25,48,2023
2023-10-05,Sabah,129,39,90,2023
2023-10-06,Sabah,52,14,38,2023
2023-10-07,Sabah,151,45,106,2023
2023-10-08,Sabah,265,57,208,2023
2023-10-09,Sabah,33,6,27,2023
2023-10-10,Sabah,41,3,38,2023
2023-10-11,Sabah,63,11,52,2023
2023-10-12,Sabah,58,11,47,2023
2023-10-13,Sabah,53,5,48,2023
2023-10-14,Sabah,145,61,84,2023
2023-10-15,Sabah,182,48,134,2023
2023-10-16,Sabah,51,6,45,2023
2023-10-17,Sabah,69,9,60,2023
2023-10-18,Sabah,103,15,88,2023
2023-10-19,Sabah,105,25,80,2023
2023-10-20,Sabah,47,25,22,2023
2023-10-21,Sabah,129,43,86,2023
2023-10-22,Sabah,138,24,114,2023
2023-10-23,Sabah,25,3,22,2023
2023-10-24,Sabah,75,26,49,2023
2023-10-25,Sabah,78,17,61,2023
2023-10-26,Sabah,142,46,96,2023
2023-10-27,Sabah,49,22,27,2023
2023-10-28,Sabah,187,91,96,2023
2023-10-29,Sabah,452,71,381,2023
2023-10-30,Sabah,31,3,28,2023
2023-10-31,Sabah,46,4,42,2023
2023-11-01,Sabah,71,14,57,2023
2023-11-02,Sabah,79,28,51,2023
2023-11-03,Sabah,91,45,46,2023
2023-11-04,Sabah,268,163,105,2023
2023-11-05,Sabah,229,33,196,2023
2023-11-06,Sabah,39,8,31,2023
2023-11-07,Sabah,32,2,30,2023
2023-11-08,Sabah,79,21,58,2023
2023-11-09,Sabah,159,24,135,2023
2023-11-10,Sabah,25,3,22,2023
2023-11-11,Sabah,1187,205,982,2023
2023-11-12,Sabah,0,0,0,2023
2023-11-13,Sabah,191,59,132,2023
2023-11-14,Sabah,36,11,25,2023
2023-11-15,Sabah,77,9,68,2023
2023-11-16,Sabah,108,47,61,2023
2023-11-17,Sabah,124,23,101,2023
2023-11-18,Sabah,141,53,88,2023
2023-11-19,Sabah,172,26,146,2023
2023-11-20,Sabah,102,24,78,2023
2023-11-21,Sabah,69,6,63,2023
2023-11-22,Sabah,95,28,67,2023
2023-11-23,Sabah,60,11,49,2023
2023-11-24,Sabah,31,3,28,2023
2023-11-25,Sabah,133,26,107,2023
2023-11-26,Sabah,407,59,348,2023
2023-11-27,Sabah,29,5,24,2023
2023-11-28,Sabah,28,5,23,2023
2023-11-29,Sabah,68,19,49,2023
2023-11-30,Sabah,66,17,49,2023
2023-12-01,Sabah,87,10,77,2023
2023-12-02,Sabah,119,35,84,2023
2023-12-03,Sabah,180,21,159,2023
2023-12-04,Sabah,42,7,35,2023
2023-12-05,Sabah,30,1,29,2023
2023-12-06,Sabah,63,11,52,2023
2023-12-07,Sabah,114,33,81,2023
2023-12-08,Sabah,62,17,45,2023
2023-12-09,Sabah,142,25,117,2023
2023-12-10,Sabah,257,44,213,2023
2023-12-11,Sabah,18,0,18,2023
2023-12-12,Sabah,101,35,66,2023
2023-12-13,Sabah,51,10,41,2023
2023-12-14,Sabah,34,5,29,2023
2023-12-15,Sabah,42,9,33,2023
2023-12-16,Sabah,118,28,90,2023
2023-12-17,Sabah,265,65,200,2023
2023-12-18,Sabah,42,6,36,2023
2023-12-19,Sabah,54,7,47,2023
2023-12-20,Sabah,100,21,79,2023
2023-12-21,Sabah,59,15,44,2023
2023-12-22,Sabah,81,13,68,2023
2023-12-23,Sabah,82,19,63,2023
2023-12-24,Sabah,38,8,30,2023
2023-12-25,Sabah,40,7,33,2023
2023-12-26,Sabah,53,9,44,2023
2023-12-27,Sabah,61,15,46,2023
2023-12-28,Sabah,100,23,77,2023
2023-12-29,Sabah,76,11,65,2023
2023-12-30,Sabah,96,20,76,2023
2023-12-31,Sabah,172,23,149,2023
2024-01-01,Sabah,19,2,17,2024
2024-01-02,Sabah,47,7,40,2024
2024-01-03,Sabah,92,15,77,2024
2024-01-04,Sabah,46,8,38,2024
2024-01-05,Sabah,52,8,44,2024
2024-01-06,Sabah,103,20,83,2024
2024-01-07,Sabah,116,23,93,2024
2024-01-08,Sabah,58,3,55,2024
2024-01-09,Sabah,56,14,42,2024
2024-01-10,Sabah,103,29,74,2024
2024-01-11,Sabah,93,15,78,2024
2024-01-12,Sabah,208,70,138,2024
2024-01-13,Sabah,170,26,144,2024
2024-01-14,Sabah,211,30,181,2024
2024-01-15,Sabah,83,14,69,2024
2024-01-16,Sabah,92,5,87,2024
2024-01-17,Sabah,162,37,125,2024
2024-01-18,Sabah,75,26,49,2024
2024-01-19,Sabah,25,2,23,2024
2024-01-20,Sabah,151,58,93,2024
2024-01-21,Sabah,144,26,118,2024
2024-01-22,Sabah,58,5,53,2024
2024-01-23,Sabah,104,15,89,2024
2024-01-24,Sabah,73,16,57,2024
2024-01-25,Sabah,104,15,89,2024
2024-01-26,Sabah,66,15,51,2024
2024-01-27,Sabah,110,16,94,2024
2024-01-28,Sabah,193,36,157,2024
2024-01-29,Sabah,65,15,50,2024
2024-01-30,Sabah,65,10,55,2024
2024-01-31,Sabah,82,26,56,2024
2024-02-01,Sabah,29,3,26,2024
2024-02-02,Sabah,77,28,49,2024
2006-01-01,Sarawak,0,0,0,2006
2006-01-02,Sarawak,0,0,0,2006
2006-01-03,Sarawak,0,0,0,2006
2006-01-04,Sarawak,1,0,1,2006
2006-01-05,Sarawak,0,0,0,2006
2006-01-06,Sarawak,1,0,1,2006
2006-01-07,Sarawak,3,2,1,2006
2006-01-08,Sarawak,0,0,0,2006
2006-01-09,Sarawak,0,0,0,2006
2006-01-10,Sarawak,0,0,0,2006
2006-01-11,Sarawak,0,0,0,2006
2006-01-12,Sarawak,0,0,0,2006
2006-01-13,Sarawak,0,0,0,2006
2006-01-14,Sarawak,0,0,0,2006
2006-01-15,Sarawak,0,0,0,2006
2006-01-16,Sarawak,0,0,0,2006
2006-01-17,Sarawak,1,1,0,2006
2006-01-18,Sarawak,0,0,0,2006
2006-01-19,Sarawak,0,0,0,2006
2006-01-20,Sarawak,1,0,1,2006
2006-01-21,Sarawak,0,0,0,2006
2006-01-22,Sarawak,1,1,0,2006
2006-01-23,Sarawak,0,0,0,2006
2006-01-24,Sarawak,0,0,0,2006
2006-01-25,Sarawak,0,0,0,2006
2006-01-26,Sarawak,0,0,0,2006
2006-01-27,Sarawak,0,0,0,2006
2006-01-28,Sarawak,0,0,0,2006
2006-01-29,Sarawak,0,0,0,2006
2006-01-30,Sarawak,0,0,0,2006
2006-01-31,Sarawak,0,0,0,2006
2006-02-01,Sarawak,1,0,1,2006
2006-02-02,Sarawak,0,0,0,2006
2006-02-03,Sarawak,0,0,0,2006
2006-02-04,Sarawak,1,0,1,2006
2006-02-05,Sarawak,0,0,0,2006
2006-02-06,Sarawak,0,0,0,2006
2006-02-07,Sarawak,0,0,0,2006
2006-02-08,Sarawak,2,2,0,2006
2006-02-09,Sarawak,0,0,0,2006
2006-02-10,Sarawak,1,0,1,2006
2006-02-11,Sarawak,0,0,0,2006
2006-02-12,Sarawak,0,0,0,2006
2006-02-13,Sarawak,1,0,1,2006
2006-02-14,Sarawak,0,0,0,2006
2006-02-15,Sarawak,1,1,0,2006
2006-02-16,Sarawak,1,0,1,2006
2006-02-17,Sarawak,0,0,0,2006
2006-02-18,Sarawak,0,0,0,2006
2006-02-19,Sarawak,2,1,1,2006
2006-02-20,Sarawak,0,0,0,2006
2006-02-21,Sarawak,2,1,1,2006
2006-02-22,Sarawak,0,0,0,2006
2006-02-23,Sarawak,1,0,1,2006
2006-02-24,Sarawak,0,0,0,2006
2006-02-25,Sarawak,0,0,0,2006
2006-02-26,Sarawak,0,0,0,2006
2006-02-27,Sarawak,0,0,0,2006
2006-02-28,Sarawak,0,0,0,2006
2006-03-01,Sarawak,1,1,0,2006
2006-03-02,Sarawak,0,0,0,2006
2006-03-03,Sarawak,0,0,0,2006
2006-03-04,Sarawak,1,1,0,2006
2006-03-05,Sarawak,0,0,0,2006
2006-03-06,Sarawak,1,0,1,2006
2006-03-07,Sarawak,0,0,0,2006
2006-03-08,Sarawak,0,0,0,2006
2006-03-09,Sarawak,0,0,0,2006
2006-03-10,Sarawak,1,1,0,2006
2006-03-11,Sarawak,0,0,0,2006
2006-03-12,Sarawak,1,1,0,2006
2006-03-13,Sarawak,0,0,0,2006
2006-03-14,Sarawak,0,0,0,2006
2006-03-15,Sarawak,0,0,0,2006
2006-03-16,Sarawak,0,0,0,2006
2006-03-17,Sarawak,0,0,0,2006
2006-03-18,Sarawak,0,0,0,2006
2006-03-19,Sarawak,0,0,0,2006
2006-03-20,Sarawak,0,0,0,2006
2006-03-21,Sarawak,0,0,0,2006
2006-03-22,Sarawak,0,0,0,2006
2006-03-23,Sarawak,1,0,1,2006
2006-03-24,Sarawak,0,0,0,2006
2006-03-25,Sarawak,0,0,0,2006
2006-03-26,Sarawak,1,0,1,2006
2006-03-27,Sarawak,0,0,0,2006
2006-03-28,Sarawak,0,0,0,2006
2006-03-29,Sarawak,0,0,0,2006
2006-03-30,Sarawak,0,0,0,2006
2006-03-31,Sarawak,0,0,0,2006
2006-04-01,Sarawak,0,0,0,2006
2006-04-02,Sarawak,0,0,0,2006
2006-04-03,Sarawak,0,0,0,2006
2006-04-04,Sarawak,0,0,0,2006
2006-04-05,Sarawak,0,0,0,2006
2006-04-06,Sarawak,0,0,0,2006
2006-04-07,Sarawak,1,0,1,2006
2006-04-08,Sarawak,0,0,0,2006
2006-04-09,Sarawak,0,0,0,2006
2006-04-10,Sarawak,0,0,0,2006
2006-04-11,Sarawak,1,0,1,2006
2006-04-12,Sarawak,0,0,0,2006
2006-04-13,Sarawak,0,0,0,2006
2006-04-14,Sarawak,0,0,0,2006
2006-04-15,Sarawak,0,0,0,2006
2006-04-16,Sarawak,1,1,0,2006
2006-04-17,Sarawak,0,0,0,2006
2006-04-18,Sarawak,0,0,0,2006
2006-04-19,Sarawak,0,0,0,2006
2006-04-20,Sarawak,0,0,0,2006
2006-04-21,Sarawak,0,0,0,2006
2006-04-22,Sarawak,1,0,1,2006
2006-04-23,Sarawak,0,0,0,2006
2006-04-24,Sarawak,0,0,0,2006
2006-04-25,Sarawak,0,0,0,2006
2006-04-26,Sarawak,1,1,0,2006
2006-04-27,Sarawak,0,0,0,2006
2006-04-28,Sarawak,0,0,0,2006
2006-04-29,Sarawak,0,0,0,2006
2006-04-30,Sarawak,0,0,0,2006
2006-05-01,Sarawak,0,0,0,2006
2006-05-02,Sarawak,0,0,0,2006
2006-05-03,Sarawak,0,0,0,2006
2006-05-04,Sarawak,0,0,0,2006
2006-05-05,Sarawak,0,0,0,2006
2006-05-06,Sarawak,1,1,0,2006
2006-05-07,Sarawak,0,0,0,2006
2006-05-08,Sarawak,0,0,0,2006
2006-05-09,Sarawak,0,0,0,2006
2006-05-10,Sarawak,0,0,0,2006
2006-05-11,Sarawak,0,0,0,2006
2006-05-12,Sarawak,0,0,0,2006
2006-05-13,Sarawak,0,0,0,2006
2006-05-14,Sarawak,0,0,0,2006
2006-05-15,Sarawak,1,1,0,2006
2006-05-16,Sarawak,0,0,0,2006
2006-05-17,Sarawak,0,0,0,2006
2006-05-18,Sarawak,0,0,0,2006
2006-05-19,Sarawak,1,0,1,2006
2006-05-20,Sarawak,0,0,0,2006
2006-05-21,Sarawak,1,0,1,2006
2006-05-22,Sarawak,0,0,0,2006
2006-05-23,Sarawak,0,0,0,2006
2006-05-24,Sarawak,1,0,1,2006
2006-05-25,Sarawak,1,0,1,2006
2006-05-26,Sarawak,0,0,0,2006
2006-05-27,Sarawak,0,0,0,2006
2006-05-28,Sarawak,0,0,0,2006
2006-05-29,Sarawak,0,0,0,2006
2006-05-30,Sarawak,1,0,1,2006
2006-05-31,Sarawak,0,0,0,2006
2006-06-01,Sarawak,0,0,0,2006
2006-06-02,Sarawak,0,0,0,2006
2006-06-03,Sarawak,0,0,0,2006
2006-06-04,Sarawak,1,0,1,2006
2006-06-05,Sarawak,0,0,0,2006
2006-06-06,Sarawak,0,0,0,2006
2006-06-07,Sarawak,0,0,0,2006
2006-06-08,Sarawak,0,0,0,2006
2006-06-09,Sarawak,1,0,1,2006
2006-06-10,Sarawak,0,0,0,2006
2006-06-11,Sarawak,0,0,0,2006
2006-06-12,Sarawak,1,0,1,2006
2006-06-13,Sarawak,1,0,1,2006
2006-06-14,Sarawak,1,0,1,2006
2006-06-15,Sarawak,0,0,0,2006
2006-06-16,Sarawak,0,0,0,2006
2006-06-17,Sarawak,0,0,0,2006
2006-06-18,Sarawak,0,0,0,2006
2006-06-19,Sarawak,0,0,0,2006
2006-06-20,Sarawak,1,1,0,2006
2006-06-21,Sarawak,0,0,0,2006
2006-06-22,Sarawak,0,0,0,2006
2006-06-23,Sarawak,0,0,0,2006
2006-06-24,Sarawak,0,0,0,2006
2006-06-25,Sarawak,0,0,0,2006
2006-06-26,Sarawak,0,0,0,2006
2006-06-27,Sarawak,1,0,1,2006
2006-06-28,Sarawak,0,0,0,2006
2006-06-29,Sarawak,0,0,0,2006
2006-06-30,Sarawak,3,2,1,2006
2006-07-01,Sarawak,0,0,0,2006
2006-07-02,Sarawak,1,0,1,2006
2006-07-03,Sarawak,1,0,1,2006
2006-07-04,Sarawak,0,0,0,2006
2006-07-05,Sarawak,1,1,0,2006
2006-07-06,Sarawak,1,1,0,2006
2006-07-07,Sarawak,0,0,0,2006
2006-07-08,Sarawak,1,1,0,2006
2006-07-09,Sarawak,0,0,0,2006
2006-07-10,Sarawak,1,0,1,2006
2006-07-11,Sarawak,0,0,0,2006
2006-07-12,Sarawak,0,0,0,2006
2006-07-13,Sarawak,1,1,0,2006
2006-07-14,Sarawak,0,0,0,2006
2006-07-15,Sarawak,0,0,0,2006
2006-07-16,Sarawak,3,3,0,2006
2006-07-17,Sarawak,0,0,0,2006
2006-07-18,Sarawak,0,0,0,2006
2006-07-19,Sarawak,0,0,0,2006
2006-07-20,Sarawak,0,0,0,2006
2006-07-21,Sarawak,0,0,0,2006
2006-07-22,Sarawak,0,0,0,2006
2006-07-23,Sarawak,0,0,0,2006
2006-07-24,Sarawak,0,0,0,2006
2006-07-25,Sarawak,0,0,0,2006
2006-07-26,Sarawak,0,0,0,2006
2006-07-27,Sarawak,1,0,1,2006
2006-07-28,Sarawak,0,0,0,2006
2006-07-29,Sarawak,1,1,0,2006
2006-07-30,Sarawak,1,0,1,2006
2006-07-31,Sarawak,0,0,0,2006
2006-08-01,Sarawak,0,0,0,2006
2006-08-02,Sarawak,0,0,0,2006
2006-08-03,Sarawak,0,0,0,2006
2006-08-04,Sarawak,0,0,0,2006
2006-08-05,Sarawak,0,0,0,2006
2006-08-06,Sarawak,0,0,0,2006
2006-08-07,Sarawak,1,0,1,2006
2006-08-08,Sarawak,0,0,0,2006
2006-08-09,Sarawak,0,0,0,2006
2006-08-10,Sarawak,0,0,0,2006
2006-08-11,Sarawak,0,0,0,2006
2006-08-12,Sarawak,0,0,0,2006
2006-08-13,Sarawak,0,0,0,2006
2006-08-14,Sarawak,0,0,0,2006
2006-08-15,Sarawak,0,0,0,2006
2006-08-16,Sarawak,0,0,0,2006
2006-08-17,Sarawak,0,0,0,2006
2006-08-18,Sarawak,0,0,0,2006
2006-08-19,Sarawak,0,0,0,2006
2006-08-20,Sarawak,0,0,0,2006
2006-08-21,Sarawak,0,0,0,2006
2006-08-22,Sarawak,0,0,0,2006
2006-08-23,Sarawak,0,0,0,2006
2006-08-24,Sarawak,0,0,0,2006
2006-08-25,Sarawak,1,1,0,2006
2006-08-26,Sarawak,0,0,0,2006
2006-08-27,Sarawak,0,0,0,2006
2006-08-28,Sarawak,1,0,1,2006
2006-08-29,Sarawak,0,0,0,2006
2006-08-30,Sarawak,1,1,0,2006
2006-08-31,Sarawak,0,0,0,2006
2006-09-01,Sarawak,0,0,0,2006
2006-09-02,Sarawak,0,0,0,2006
2006-09-03,Sarawak,1,1,0,2006
2006-09-04,Sarawak,0,0,0,2006
2006-09-05,Sarawak,1,0,1,2006
2006-09-06,Sarawak,0,0,0,2006
2006-09-07,Sarawak,1,1,0,2006
2006-09-08,Sarawak,0,0,0,2006
2006-09-09,Sarawak,0,0,0,2006
2006-09-10,Sarawak,0,0,0,2006
2006-09-11,Sarawak,0,0,0,2006
2006-09-12,Sarawak,0,0,0,2006
2006-09-13,Sarawak,0,0,0,2006
2006-09-14,Sarawak,0,0,0,2006
2006-09-15,Sarawak,2,2,0,2006
2006-09-16,Sarawak,2,2,0,2006
2006-09-17,Sarawak,0,0,0,2006
2006-09-18,Sarawak,1,1,0,2006
2006-09-19,Sarawak,0,0,0,2006
2006-09-20,Sarawak,1,1,0,2006
2006-09-21,Sarawak,1,1,0,2006
2006-09-22,Sarawak,1,0,1,2006
2006-09-23,Sarawak,1,0,1,2006
2006-09-24,Sarawak,0,0,0,2006
2006-09-25,Sarawak,0,0,0,2006
2006-09-26,Sarawak,2,0,2,2006
2006-09-27,Sarawak,0,0,0,2006
2006-09-28,Sarawak,0,0,0,2006
2006-09-29,Sarawak,0,0,0,2006
2006-09-30,Sarawak,0,0,0,2006
2006-10-01,Sarawak,1,0,1,2006
2006-10-02,Sarawak,0,0,0,2006
2006-10-03,Sarawak,0,0,0,2006
2006-10-04,Sarawak,1,1,0,2006
2006-10-05,Sarawak,0,0,0,2006
2006-10-06,Sarawak,0,0,0,2006
2006-10-07,Sarawak,0,0,0,2006
2006-10-08,Sarawak,1,1,0,2006
2006-10-09,Sarawak,0,0,0,2006
2006-10-10,Sarawak,2,1,1,2006
2006-10-11,Sarawak,0,0,0,2006
2006-10-12,Sarawak,0,0,0,2006
2006-10-13,Sarawak,1,1,0,2006
2006-10-14,Sarawak,1,0,1,2006
2006-10-15,Sarawak,0,0,0,2006
2006-10-16,Sarawak,0,0,0,2006
2006-10-17,Sarawak,1,0,1,2006
2006-10-18,Sarawak,0,0,0,2006
2006-10-19,Sarawak,1,0,1,2006
2006-10-20,Sarawak,0,0,0,2006
2006-10-21,Sarawak,0,0,0,2006
2006-10-22,Sarawak,0,0,0,2006
2006-10-23,Sarawak,0,0,0,2006
2006-10-24,Sarawak,0,0,0,2006
2006-10-25,Sarawak,0,0,0,2006
2006-10-26,Sarawak,0,0,0,2006
2006-10-27,Sarawak,1,0,1,2006
2006-10-28,Sarawak,0,0,0,2006
2006-10-29,Sarawak,0,0,0,2006
2006-10-30,Sarawak,0,0,0,2006
2006-10-31,Sarawak,1,0,1,2006
2006-11-01,Sarawak,0,0,0,2006
2006-11-02,Sarawak,1,0,1,2006
2006-11-03,Sarawak,1,1,0,2006
2006-11-04,Sarawak,0,0,0,2006
2006-11-05,Sarawak,1,1,0,2006
2006-11-06,Sarawak,1,1,0,2006
2006-11-07,Sarawak,2,0,2,2006
2006-11-08,Sarawak,0,0,0,2006
2006-11-09,Sarawak,2,1,1,2006
2006-11-10,Sarawak,2,1,1,2006
2006-11-11,Sarawak,0,0,0,2006
2006-11-12,Sarawak,0,0,0,2006
2006-11-13,Sarawak,0,0,0,2006
2006-11-14,Sarawak,0,0,0,2006
2006-11-15,Sarawak,2,1,1,2006
2006-11-16,Sarawak,0,0,0,2006
2006-11-17,Sarawak,1,0,1,2006
2006-11-18,Sarawak,0,0,0,2006
2006-11-19,Sarawak,1,0,1,2006
2006-11-20,Sarawak,0,0,0,2006
2006-11-21,Sarawak,0,0,0,2006
2006-11-22,Sarawak,0,0,0,2006
2006-11-23,Sarawak,2,0,2,2006
2006-11-24,Sarawak,0,0,0,2006
2006-11-25,Sarawak,0,0,0,2006
2006-11-26,Sarawak,1,1,0,2006
2006-11-27,Sarawak,0,0,0,2006
2006-11-28,Sarawak,0,0,0,2006
2006-11-29,Sarawak,1,1,0,2006
2006-11-30,Sarawak,1,0,1,2006
2006-12-01,Sarawak,0,0,0,2006
2006-12-02,Sarawak,0,0,0,2006
2006-12-03,Sarawak,0,0,0,2006
2006-12-04,Sarawak,1,0,1,2006
2006-12-05,Sarawak,0,0,0,2006
2006-12-06,Sarawak,0,0,0,2006
2006-12-07,Sarawak,0,0,0,2006
2006-12-08,Sarawak,1,0,1,2006
2006-12-09,Sarawak,1,0,1,2006
2006-12-10,Sarawak,0,0,0,2006
2006-12-11,Sarawak,0,0,0,2006
2006-12-12,Sarawak,0,0,0,2006
2006-12-13,Sarawak,2,1,1,2006
2006-12-14,Sarawak,1,1,0,2006
2006-12-15,Sarawak,0,0,0,2006
2006-12-16,Sarawak,0,0,0,2006
2006-12-17,Sarawak,0,0,0,2006
2006-12-18,Sarawak,0,0,0,2006
2006-12-19,Sarawak,0,0,0,2006
2006-12-20,Sarawak,2,0,2,2006
2006-12-21,Sarawak,0,0,0,2006
2006-12-22,Sarawak,2,1,1,2006
2006-12-23,Sarawak,0,0,0,2006
2006-12-24,Sarawak,0,0,0,2006
2006-12-25,Sarawak,0,0,0,2006
2006-12-26,Sarawak,0,0,0,2006
2006-12-27,Sarawak,0,0,0,2006
2006-12-28,Sarawak,0,0,0,2006
2006-12-29,Sarawak,0,0,0,2006
2006-12-30,Sarawak,0,0,0,2006
2006-12-31,Sarawak,0,0,0,2006
2007-01-01,Sarawak,1,1,0,2007
2007-01-02,Sarawak,0,0,0,2007
2007-01-03,Sarawak,0,0,0,2007
2007-01-04,Sarawak,1,1,0,2007
2007-01-05,Sarawak,1,1,0,2007
2007-01-06,Sarawak,0,0,0,2007
2007-01-07,Sarawak,0,0,0,2007
2007-01-08,Sarawak,0,0,0,2007
2007-01-09,Sarawak,1,0,1,2007
2007-01-10,Sarawak,1,0,1,2007
2007-01-11,Sarawak,0,0,0,2007
2007-01-12,Sarawak,1,0,1,2007
2007-01-13,Sarawak,0,0,0,2007
2007-01-14,Sarawak,1,0,1,2007
2007-01-15,Sarawak,1,1,0,2007
2007-01-16,Sarawak,0,0,0,2007
2007-01-17,Sarawak,1,0,1,2007
2007-01-18,Sarawak,1,0,1,2007
2007-01-19,Sarawak,0,0,0,2007
2007-01-20,Sarawak,2,2,0,2007
2007-01-21,Sarawak,0,0,0,2007
2007-01-22,Sarawak,1,1,0,2007
2007-01-23,Sarawak,0,0,0,2007
2007-01-24,Sarawak,1,1,0,2007
2007-01-25,Sarawak,0,0,0,2007
2007-01-26,Sarawak,0,0,0,2007
2007-01-27,Sarawak,0,0,0,2007
2007-01-28,Sarawak,0,0,0,2007
2007-01-29,Sarawak,1,1,0,2007
2007-01-30,Sarawak,0,0,0,2007
2007-01-31,Sarawak,0,0,0,2007
2007-02-01,Sarawak,0,0,0,2007
2007-02-02,Sarawak,0,0,0,2007
2007-02-03,Sarawak,0,0,0,2007
2007-02-04,Sarawak,0,0,0,2007
2007-02-05,Sarawak,0,0,0,2007
2007-02-06,Sarawak,1,0,1,2007
2007-02-07,Sarawak,2,0,2,2007
2007-02-08,Sarawak,0,0,0,2007
2007-02-09,Sarawak,0,0,0,2007
2007-02-10,Sarawak,1,0,1,2007
2007-02-11,Sarawak,0,0,0,2007
2007-02-12,Sarawak,1,1,0,2007
2007-02-13,Sarawak,0,0,0,2007
2007-02-14,Sarawak,1,0,1,2007
2007-02-15,Sarawak,1,0,1,2007
2007-02-16,Sarawak,0,0,0,2007
2007-02-17,Sarawak,0,0,0,2007
2007-02-18,Sarawak,0,0,0,2007
2007-02-19,Sarawak,2,1,1,2007
2007-02-20,Sarawak,0,0,0,2007
2007-02-21,Sarawak,1,0,1,2007
2007-02-22,Sarawak,0,0,0,2007
2007-02-23,Sarawak,1,1,0,2007
2007-02-24,Sarawak,0,0,0,2007
2007-02-25,Sarawak,0,0,0,2007
2007-02-26,Sarawak,0,0,0,2007
2007-02-27,Sarawak,1,0,1,2007
2007-02-28,Sarawak,0,0,0,2007
2007-03-01,Sarawak,3,0,3,2007
2007-03-02,Sarawak,1,0,1,2007
2007-03-03,Sarawak,0,0,0,2007
2007-03-04,Sarawak,0,0,0,2007
2007-03-05,Sarawak,0,0,0,2007
2007-03-06,Sarawak,0,0,0,2007
2007-03-07,Sarawak,0,0,0,2007
2007-03-08,Sarawak,0,0,0,2007
2007-03-09,Sarawak,0,0,0,2007
2007-03-10,Sarawak,0,0,0,2007
2007-03-11,Sarawak,0,0,0,2007
2007-03-12,Sarawak,2,0,2,2007
2007-03-13,Sarawak,0,0,0,2007
2007-03-14,Sarawak,0,0,0,2007
2007-03-15,Sarawak,0,0,0,2007
2007-03-16,Sarawak,0,0,0,2007
2007-03-17,Sarawak,2,0,2,2007
2007-03-18,Sarawak,2,2,0,2007
2007-03-19,Sarawak,0,0,0,2007
2007-03-20,Sarawak,0,0,0,2007
2007-03-21,Sarawak,0,0,0,2007
2007-03-22,Sarawak,1,0,1,2007
2007-03-23,Sarawak,0,0,0,2007
2007-03-24,Sarawak,1,1,0,2007
2007-03-25,Sarawak,1,1,0,2007
2007-03-26,Sarawak,0,0,0,2007
2007-03-27,Sarawak,0,0,0,2007
2007-03-28,Sarawak,1,1,0,2007
2007-03-29,Sarawak,0,0,0,2007
2007-03-30,Sarawak,0,0,0,2007
2007-03-31,Sarawak,0,0,0,2007
2007-04-01,Sarawak,2,1,1,2007
2007-04-02,Sarawak,0,0,0,2007
2007-04-03,Sarawak,0,0,0,2007
2007-04-04,Sarawak,1,1,0,2007
2007-04-05,Sarawak,0,0,0,2007
2007-04-06,Sarawak,0,0,0,2007
2007-04-07,Sarawak,0,0,0,2007
2007-04-08,Sarawak,0,0,0,2007
2007-04-09,Sarawak,0,0,0,2007
2007-04-10,Sarawak,0,0,0,2007
2007-04-11,Sarawak,0,0,0,2007
2007-04-12,Sarawak,0,0,0,2007
2007-04-13,Sarawak,0,0,0,2007
2007-04-14,Sarawak,0,0,0,2007
2007-04-15,Sarawak,0,0,0,2007
2007-04-16,Sarawak,0,0,0,2007
2007-04-17,Sarawak,1,0,1,2007
2007-04-18,Sarawak,0,0,0,2007
2007-04-19,Sarawak,0,0,0,2007
2007-04-20,Sarawak,1,0,1,2007
2007-04-21,Sarawak,0,0,0,2007
2007-04-22,Sarawak,1,0,1,2007
2007-04-23,Sarawak,1,0,1,2007
2007-04-24,Sarawak,0,0,0,2007
2007-04-25,Sarawak,2,1,1,2007
2007-04-26,Sarawak,0,0,0,2007
2007-04-27,Sarawak,1,0,1,2007
2007-04-28,Sarawak,0,0,0,2007
2007-04-29,Sarawak,2,1,1,2007
2007-04-30,Sarawak,0,0,0,2007
2007-05-01,Sarawak,0,0,0,2007
2007-05-02,Sarawak,0,0,0,2007
2007-05-03,Sarawak,0,0,0,2007
2007-05-04,Sarawak,0,0,0,2007
2007-05-05,Sarawak,0,0,0,2007
2007-05-06,Sarawak,0,0,0,2007
2007-05-07,Sarawak,0,0,0,2007
2007-05-08,Sarawak,2,2,0,2007
2007-05-09,Sarawak,0,0,0,2007
2007-05-10,Sarawak,2,1,1,2007
2007-05-11,Sarawak,0,0,0,2007
2007-05-12,Sarawak,0,0,0,2007
2007-05-13,Sarawak,1,0,1,2007
2007-05-14,Sarawak,1,0,1,2007
2007-05-15,Sarawak,1,1,0,2007
2007-05-16,Sarawak,0,0,0,2007
2007-05-17,Sarawak,0,0,0,2007
2007-05-18,Sarawak,0,0,0,2007
2007-05-19,Sarawak,1,1,0,2007
2007-05-20,Sarawak,1,1,0,2007
2007-05-21,Sarawak,0,0,0,2007
2007-05-22,Sarawak,0,0,0,2007
2007-05-23,Sarawak,0,0,0,2007
2007-05-24,Sarawak,0,0,0,2007
2007-05-25,Sarawak,0,0,0,2007
2007-05-26,Sarawak,0,0,0,2007
2007-05-27,Sarawak,0,0,0,2007
2007-05-28,Sarawak,0,0,0,2007
2007-05-29,Sarawak,0,0,0,2007
2007-05-30,Sarawak,0,0,0,2007
2007-05-31,Sarawak,2,1,1,2007
2007-06-01,Sarawak,0,0,0,2007
2007-06-02,Sarawak,0,0,0,2007
2007-06-03,Sarawak,0,0,0,2007
2007-06-04,Sarawak,0,0,0,2007
2007-06-05,Sarawak,0,0,0,2007
2007-06-06,Sarawak,0,0,0,2007
2007-06-07,Sarawak,0,0,0,2007
2007-06-08,Sarawak,2,0,2,2007
2007-06-09,Sarawak,0,0,0,2007
2007-06-10,Sarawak,2,2,0,2007
2007-06-11,Sarawak,1,0,1,2007
2007-06-12,Sarawak,0,0,0,2007
2007-06-13,Sarawak,0,0,0,2007
2007-06-14,Sarawak,0,0,0,2007
2007-06-15,Sarawak,0,0,0,2007
2007-06-16,Sarawak,0,0,0,2007
2007-06-17,Sarawak,0,0,0,2007
2007-06-18,Sarawak,0,0,0,2007
2007-06-19,Sarawak,0,0,0,2007
2007-06-20,Sarawak,0,0,0,2007
2007-06-21,Sarawak,0,0,0,2007
2007-06-22,Sarawak,0,0,0,2007
2007-06-23,Sarawak,1,0,1,2007
2007-06-24,Sarawak,0,0,0,2007
2007-06-25,Sarawak,0,0,0,2007
2007-06-26,Sarawak,0,0,0,2007
2007-06-27,Sarawak,0,0,0,2007
2007-06-28,Sarawak,1,0,1,2007
2007-06-29,Sarawak,1,1,0,2007
2007-06-30,Sarawak,0,0,0,2007
2007-07-01,Sarawak,1,1,0,2007
2007-07-02,Sarawak,1,1,0,2007
2007-07-03,Sarawak,0,0,0,2007
2007-07-04,Sarawak,0,0,0,2007
2007-07-05,Sarawak,2,0,2,2007
2007-07-06,Sarawak,1,1,0,2007
2007-07-07,Sarawak,0,0,0,2007
2007-07-08,Sarawak,0,0,0,2007
2007-07-09,Sarawak,1,1,0,2007
2007-07-10,Sarawak,1,0,1,2007
2007-07-11,Sarawak,0,0,0,2007
2007-07-12,Sarawak,0,0,0,2007
2007-07-13,Sarawak,1,1,0,2007
2007-07-14,Sarawak,0,0,0,2007
2007-07-15,Sarawak,2,1,1,2007
2007-07-16,Sarawak,1,0,1,2007
2007-07-17,Sarawak,0,0,0,2007
2007-07-18,Sarawak,0,0,0,2007
2007-07-19,Sarawak,3,0,3,2007
2007-07-20,Sarawak,0,0,0,2007
2007-07-21,Sarawak,0,0,0,2007
2007-07-22,Sarawak,1,1,0,2007
2007-07-23,Sarawak,0,0,0,2007
2007-07-24,Sarawak,0,0,0,2007
2007-07-25,Sarawak,2,1,1,2007
2007-07-26,Sarawak,0,0,0,2007
2007-07-27,Sarawak,0,0,0,2007
2007-07-28,Sarawak,0,0,0,2007
2007-07-29,Sarawak,0,0,0,2007
2007-07-30,Sarawak,0,0,0,2007
2007-07-31,Sarawak,0,0,0,2007
2007-08-01,Sarawak,0,0,0,2007
2007-08-02,Sarawak,0,0,0,2007
2007-08-03,Sarawak,2,1,1,2007
2007-08-04,Sarawak,0,0,0,2007
2007-08-05,Sarawak,0,0,0,2007
2007-08-06,Sarawak,0,0,0,2007
2007-08-07,Sarawak,1,1,0,2007
2007-08-08,Sarawak,0,0,0,2007
2007-08-09,Sarawak,0,0,0,2007
2007-08-10,Sarawak,1,0,1,2007
2007-08-11,Sarawak,0,0,0,2007
2007-08-12,Sarawak,1,1,0,2007
2007-08-13,Sarawak,0,0,0,2007
2007-08-14,Sarawak,0,0,0,2007
2007-08-15,Sarawak,2,1,1,2007
2007-08-16,Sarawak,1,0,1,2007
2007-08-17,Sarawak,2,1,1,2007
2007-08-18,Sarawak,1,1,0,2007
2007-08-19,Sarawak,2,0,2,2007
2007-08-20,Sarawak,1,0,1,2007
2007-08-21,Sarawak,2,0,2,2007
2007-08-22,Sarawak,1,0,1,2007
2007-08-23,Sarawak,1,0,1,2007
2007-08-24,Sarawak,0,0,0,2007
2007-08-25,Sarawak,1,1,0,2007
2007-08-26,Sarawak,0,0,0,2007
2007-08-27,Sarawak,2,0,2,2007
2007-08-28,Sarawak,0,0,0,2007
2007-08-29,Sarawak,4,2,2,2007
2007-08-30,Sarawak,1,0,1,2007
2007-08-31,Sarawak,0,0,0,2007
2007-09-01,Sarawak,0,0,0,2007
2007-09-02,Sarawak,0,0,0,2007
2007-09-03,Sarawak,0,0,0,2007
2007-09-04,Sarawak,0,0,0,2007
2007-09-05,Sarawak,0,0,0,2007
2007-09-06,Sarawak,1,0,1,2007
2007-09-07,Sarawak,1,0,1,2007
2007-09-08,Sarawak,1,1,0,2007
2007-09-09,Sarawak,2,0,2,2007
2007-09-10,Sarawak,1,1,0,2007
2007-09-11,Sarawak,0,0,0,2007
2007-09-12,Sarawak,0,0,0,2007
2007-09-13,Sarawak,0,0,0,2007
2007-09-14,Sarawak,0,0,0,2007
2007-09-15,Sarawak,2,0,2,2007
2007-09-16,Sarawak,1,0,1,2007
2007-09-17,Sarawak,0,0,0,2007
2007-09-18,Sarawak,0,0,0,2007
2007-09-19,Sarawak,1,1,0,2007
2007-09-20,Sarawak,0,0,0,2007
2007-09-21,Sarawak,0,0,0,2007
2007-09-22,Sarawak,0,0,0,2007
2007-09-23,Sarawak,1,1,0,2007
2007-09-24,Sarawak,0,0,0,2007
2007-09-25,Sarawak,0,0,0,2007
2007-09-26,Sarawak,0,0,0,2007
2007-09-27,Sarawak,0,0,0,2007
2007-09-28,Sarawak,0,0,0,2007
2007-09-29,Sarawak,1,0,1,2007
2007-09-30,Sarawak,4,3,1,2007
2007-10-01,Sarawak,1,1,0,2007
2007-10-02,Sarawak,0,0,0,2007
2007-10-03,Sarawak,0,0,0,2007
2007-10-04,Sarawak,0,0,0,2007
2007-10-05,Sarawak,1,1,0,2007
2007-10-06,Sarawak,0,0,0,2007
2007-10-07,Sarawak,1,0,1,2007
2007-10-08,Sarawak,0,0,0,2007
2007-10-09,Sarawak,0,0,0,2007
2007-10-10,Sarawak,3,1,2,2007
2007-10-11,Sarawak,0,0,0,2007
2007-10-12,Sarawak,0,0,0,2007
2007-10-13,Sarawak,1,1,0,2007
2007-10-14,Sarawak,0,0,0,2007
2007-10-15,Sarawak,0,0,0,2007
2007-10-16,Sarawak,0,0,0,2007
2007-10-17,Sarawak,1,1,0,2007
2007-10-18,Sarawak,0,0,0,2007
2007-10-19,Sarawak,1,1,0,2007
2007-10-20,Sarawak,0,0,0,2007
2007-10-21,Sarawak,1,1,0,2007
2007-10-22,Sarawak,1,0,1,2007
2007-10-23,Sarawak,1,0,1,2007
2007-10-24,Sarawak,0,0,0,2007
2007-10-25,Sarawak,2,0,2,2007
2007-10-26,Sarawak,0,0,0,2007
2007-10-27,Sarawak,0,0,0,2007
2007-10-28,Sarawak,0,0,0,2007
2007-10-29,Sarawak,0,0,0,2007
2007-10-30,Sarawak,1,0,1,2007
2007-10-31,Sarawak,2,1,1,2007
2007-11-01,Sarawak,1,0,1,2007
2007-11-02,Sarawak,0,0,0,2007
2007-11-03,Sarawak,2,1,1,2007
2007-11-04,Sarawak,0,0,0,2007
2007-11-05,Sarawak,0,0,0,2007
2007-11-06,Sarawak,1,0,1,2007
2007-11-07,Sarawak,1,0,1,2007
2007-11-08,Sarawak,1,0,1,2007
2007-11-09,Sarawak,0,0,0,2007
2007-11-10,Sarawak,0,0,0,2007
2007-11-11,Sarawak,0,0,0,2007
2007-11-12,Sarawak,0,0,0,2007
2007-11-13,Sarawak,1,0,1,2007
2007-11-14,Sarawak,1,1,0,2007
2007-11-15,Sarawak,0,0,0,2007
2007-11-16,Sarawak,1,0,1,2007
2007-11-17,Sarawak,0,0,0,2007
2007-11-18,Sarawak,0,0,0,2007
2007-11-19,Sarawak,0,0,0,2007
2007-11-20,Sarawak,0,0,0,2007
2007-11-21,Sarawak,0,0,0,2007
2007-11-22,Sarawak,1,1,0,2007
2007-11-23,Sarawak,1,0,1,2007
2007-11-24,Sarawak,0,0,0,2007
2007-11-25,Sarawak,0,0,0,2007
2007-11-26,Sarawak,1,0,1,2007
2007-11-27,Sarawak,1,0,1,2007
2007-11-28,Sarawak,4,1,3,2007
2007-11-29,Sarawak,0,0,0,2007
2007-11-30,Sarawak,0,0,0,2007
2007-12-01,Sarawak,1,0,1,2007
2007-12-02,Sarawak,0,0,0,2007
2007-12-03,Sarawak,1,0,1,2007
2007-12-04,Sarawak,0,0,0,2007
2007-12-05,Sarawak,0,0,0,2007
2007-12-06,Sarawak,0,0,0,2007
2007-12-07,Sarawak,2,0,2,2007
2007-12-08,Sarawak,1,1,0,2007
2007-12-09,Sarawak,0,0,0,2007
2007-12-10,Sarawak,1,1,0,2007
2007-12-11,Sarawak,0,0,0,2007
2007-12-12,Sarawak,2,0,2,2007
2007-12-13,Sarawak,0,0,0,2007
2007-12-14,Sarawak,0,0,0,2007
2007-12-15,Sarawak,1,0,1,2007
2007-12-16,Sarawak,0,0,0,2007
2007-12-17,Sarawak,0,0,0,2007
2007-12-18,Sarawak,0,0,0,2007
2007-12-19,Sarawak,1,0,1,2007
2007-12-20,Sarawak,1,0,1,2007
2007-12-21,Sarawak,0,0,0,2007
2007-12-22,Sarawak,0,0,0,2007
2007-12-23,Sarawak,0,0,0,2007
2007-12-24,Sarawak,0,0,0,2007
2007-12-25,Sarawak,0,0,0,2007
2007-12-26,Sarawak,0,0,0,2007
2007-12-27,Sarawak,0,0,0,2007
2007-12-28,Sarawak,0,0,0,2007
2007-12-29,Sarawak,0,0,0,2007
2007-12-30,Sarawak,3,1,2,2007
2007-12-31,Sarawak,1,0,1,2007
2008-01-01,Sarawak,1,1,0,2008
2008-01-02,Sarawak,0,0,0,2008
2008-01-03,Sarawak,0,0,0,2008
2008-01-04,Sarawak,0,0,0,2008
2008-01-05,Sarawak,2,0,2,2008
2008-01-06,Sarawak,2,0,2,2008
2008-01-07,Sarawak,1,0,1,2008
2008-01-08,Sarawak,0,0,0,2008
2008-01-09,Sarawak,1,0,1,2008
2008-01-10,Sarawak,0,0,0,2008
2008-01-11,Sarawak,1,0,1,2008
2008-01-12,Sarawak,1,0,1,2008
2008-01-13,Sarawak,0,0,0,2008
2008-01-14,Sarawak,0,0,0,2008
2008-01-15,Sarawak,1,0,1,2008
2008-01-16,Sarawak,2,1,1,2008
2008-01-17,Sarawak,22,19,3,2008
2008-01-18,Sarawak,29,29,0,2008
2008-01-19,Sarawak,23,22,1,2008
2008-01-20,Sarawak,64,63,1,2008
2008-01-21,Sarawak,37,33,4,2008
2008-01-22,Sarawak,24,24,0,2008
2008-01-23,Sarawak,74,72,2,2008
2008-01-24,Sarawak,115,108,7,2008
2008-01-25,Sarawak,27,25,2,2008
2008-01-26,Sarawak,21,21,0,2008
2008-01-27,Sarawak,20,19,1,2008
2008-01-28,Sarawak,62,59,3,2008
2008-01-29,Sarawak,19,19,0,2008
2008-01-30,Sarawak,28,25,3,2008
2008-01-31,Sarawak,28,27,1,2008
2008-02-01,Sarawak,30,27,3,2008
2008-02-02,Sarawak,37,36,1,2008
2008-02-03,Sarawak,74,71,3,2008
2008-02-04,Sarawak,35,31,4,2008
2008-02-05,Sarawak,105,99,6,2008
2008-02-06,Sarawak,98,81,17,2008
2008-02-07,Sarawak,0,0,0,2008
2008-02-08,Sarawak,2,1,1,2008
2008-02-09,Sarawak,1,1,0,2008
2008-02-10,Sarawak,1,1,0,2008
2008-02-11,Sarawak,27,27,0,2008
2008-02-12,Sarawak,40,39,1,2008
2008-02-13,Sarawak,46,44,2,2008
2008-02-14,Sarawak,50,49,1,2008
2008-02-15,Sarawak,32,27,5,2008
2008-02-16,Sarawak,11,11,0,2008
2008-02-17,Sarawak,5,5,0,2008
2008-02-18,Sarawak,20,18,2,2008
2008-02-19,Sarawak,35,33,2,2008
2008-02-20,Sarawak,58,55,3,2008
2008-02-21,Sarawak,16,16,0,2008
2008-02-22,Sarawak,20,20,0,2008
2008-02-23,Sarawak,80,80,0,2008
2008-02-24,Sarawak,0,0,0,2008
2008-02-25,Sarawak,21,21,0,2008
2008-02-26,Sarawak,52,48,4,2008
2008-02-27,Sarawak,20,18,2,2008
2008-02-28,Sarawak,20,18,2,2008
2008-02-29,Sarawak,25,22,3,2008
2008-03-01,Sarawak,40,39,1,2008
2008-03-02,Sarawak,76,69,7,2008
2008-03-03,Sarawak,26,24,2,2008
2008-03-04,Sarawak,78,71,7,2008
2008-03-05,Sarawak,69,68,1,2008
2008-03-06,Sarawak,39,38,1,2008
2008-03-07,Sarawak,22,20,2,2008
2008-03-08,Sarawak,0,0,0,2008
2008-03-09,Sarawak,8,7,1,2008
2008-03-10,Sarawak,62,60,2,2008
2008-03-11,Sarawak,26,24,2,2008
2008-03-12,Sarawak,48,47,1,2008
2008-03-13,Sarawak,51,51,0,2008
2008-03-14,Sarawak,42,38,4,2008
2008-03-15,Sarawak,23,23,0,2008
2008-03-16,Sarawak,80,79,1,2008
2008-03-17,Sarawak,36,34,2,2008
2008-03-18,Sarawak,35,35,0,2008
2008-03-19,Sarawak,41,39,2,2008
2008-03-20,Sarawak,1,0,1,2008
2008-03-21,Sarawak,9,8,1,2008
2008-03-22,Sarawak,7,7,0,2008
2008-03-23,Sarawak,49,48,1,2008
2008-03-24,Sarawak,37,34,3,2008
2008-03-25,Sarawak,40,40,0,2008
2008-03-26,Sarawak,25,23,2,2008
2008-03-27,Sarawak,55,54,1,2008
2008-03-28,Sarawak,37,36,1,2008
2008-03-29,Sarawak,47,47,0,2008
2008-03-30,Sarawak,15,13,2,2008
2008-03-31,Sarawak,27,27,0,2008
2008-04-01,Sarawak,50,46,4,2008
2008-04-02,Sarawak,32,30,2,2008
2008-04-03,Sarawak,32,29,3,2008
2008-04-04,Sarawak,19,17,2,2008
2008-04-05,Sarawak,36,34,2,2008
2008-04-06,Sarawak,147,141,6,2008
2008-04-07,Sarawak,19,19,0,2008
2008-04-08,Sarawak,57,55,2,2008
2008-04-09,Sarawak,62,62,0,2008
2008-04-10,Sarawak,19,16,3,2008
2008-04-11,Sarawak,28,26,2,2008
2008-04-12,Sarawak,18,18,0,2008
2008-04-13,Sarawak,78,77,1,2008
2008-04-14,Sarawak,17,16,1,2008
2008-04-15,Sarawak,40,40,0,2008
2008-04-16,Sarawak,49,47,2,2008
2008-04-17,Sarawak,30,26,4,2008
2008-04-18,Sarawak,44,36,8,2008
2008-04-19,Sarawak,52,52,0,2008
2008-04-20,Sarawak,103,80,23,2008
2008-04-21,Sarawak,21,20,1,2008
2008-04-22,Sarawak,52,45,7,2008
2008-04-23,Sarawak,45,39,6,2008
2008-04-24,Sarawak,49,43,6,2008
2008-04-25,Sarawak,23,19,4,2008
2008-04-26,Sarawak,32,30,2,2008
2008-04-27,Sarawak,22,15,7,2008
2008-04-28,Sarawak,21,14,7,2008
2008-04-29,Sarawak,57,51,6,2008
2008-04-30,Sarawak,21,7,14,2008
2008-05-01,Sarawak,29,23,6,2008
2008-05-02,Sarawak,27,18,9,2008
2008-05-03,Sarawak,64,58,6,2008
2008-05-04,Sarawak,80,56,24,2008
2008-05-05,Sarawak,21,8,13,2008
2008-05-06,Sarawak,35,27,8,2008
2008-05-07,Sarawak,21,13,8,2008
2008-05-08,Sarawak,23,16,7,2008
2008-05-09,Sarawak,38,28,10,2008
2008-05-10,Sarawak,0,0,0,2008
2008-05-11,Sarawak,17,13,4,2008
2008-05-12,Sarawak,43,36,7,2008
2008-05-13,Sarawak,88,70,18,2008
2008-05-14,Sarawak,25,17,8,2008
2008-05-15,Sarawak,20,10,10,2008
2008-05-16,Sarawak,24,18,6,2008
2008-05-17,Sarawak,33,30,3,2008
2008-05-18,Sarawak,9,9,0,2008
2008-05-19,Sarawak,15,12,3,2008
2008-05-20,Sarawak,80,62,18,2008
2008-05-21,Sarawak,24,13,11,2008
2008-05-22,Sarawak,37,32,5,2008
2008-05-23,Sarawak,17,8,9,2008
2008-05-24,Sarawak,26,24,2,2008
2008-05-25,Sarawak,41,37,4,2008
2008-05-26,Sarawak,28,11,17,2008
2008-05-27,Sarawak,18,9,9,2008
2008-05-28,Sarawak,42,21,21,2008
2008-05-29,Sarawak,22,12,10,2008
2008-05-30,Sarawak,29,18,11,2008
2008-05-31,Sarawak,11,6,5,2008
2008-06-01,Sarawak,0,0,0,2008
2008-06-02,Sarawak,12,5,7,2008
2008-06-03,Sarawak,8,7,1,2008
2008-06-04,Sarawak,17,10,7,2008
2008-06-05,Sarawak,10,6,4,2008
2008-06-06,Sarawak,16,6,10,2008
2008-06-07,Sarawak,25,25,0,2008
2008-06-08,Sarawak,72,56,16,2008
2008-06-09,Sarawak,19,9,10,2008
2008-06-10,Sarawak,16,6,10,2008
2008-06-11,Sarawak,13,3,10,2008
2008-06-12,Sarawak,23,14,9,2008
2008-06-13,Sarawak,19,6,13,2008
2008-06-14,Sarawak,33,25,8,2008
2008-06-15,Sarawak,79,54,25,2008
2008-06-16,Sarawak,31,15,16,2008
2008-06-17,Sarawak,34,15,19,2008
2008-06-18,Sarawak,34,16,18,2008
2008-06-19,Sarawak,34,26,8,2008
2008-06-20,Sarawak,11,3,8,2008
2008-06-21,Sarawak,70,51,19,2008
2008-06-22,Sarawak,78,54,24,2008
2008-06-23,Sarawak,30,23,7,2008
2008-06-24,Sarawak,10,6,4,2008
2008-06-25,Sarawak,21,6,15,2008
2008-06-26,Sarawak,55,44,11,2008
2008-06-27,Sarawak,19,11,8,2008
2008-06-28,Sarawak,20,16,4,2008
2008-06-29,Sarawak,77,57,20,2008
2008-06-30,Sarawak,19,10,9,2008
2008-07-01,Sarawak,34,17,17,2008
2008-07-02,Sarawak,77,59,18,2008
2008-07-03,Sarawak,23,10,13,2008
2008-07-04,Sarawak,18,6,12,2008
2008-07-05,Sarawak,8,4,4,2008
2008-07-06,Sarawak,193,108,85,2008
2008-07-07,Sarawak,10,2,8,2008
2008-07-08,Sarawak,18,7,11,2008
2008-07-09,Sarawak,39,30,9,2008
2008-07-10,Sarawak,11,4,7,2008
2008-07-11,Sarawak,17,7,10,2008
2008-07-12,Sarawak,36,28,8,2008
2008-07-13,Sarawak,107,70,37,2008
2008-07-14,Sarawak,34,13,21,2008
2008-07-15,Sarawak,31,15,16,2008
2008-07-16,Sarawak,23,11,12,2008
2008-07-17,Sarawak,29,17,12,2008
2008-07-18,Sarawak,23,11,12,2008
2008-07-19,Sarawak,54,41,13,2008
2008-07-20,Sarawak,10,7,3,2008
2008-07-21,Sarawak,43,27,16,2008
2008-07-22,Sarawak,31,16,15,2008
2008-07-23,Sarawak,48,25,23,2008
2008-07-24,Sarawak,41,31,10,2008
2008-07-25,Sarawak,25,10,15,2008
2008-07-26,Sarawak,5,2,3,2008
2008-07-27,Sarawak,79,56,23,2008
2008-07-28,Sarawak,49,33,16,2008
2008-07-29,Sarawak,32,18,14,2008
2008-07-30,Sarawak,30,18,12,2008
2008-07-31,Sarawak,66,49,17,2008
2008-08-01,Sarawak,19,6,13,2008
2008-08-02,Sarawak,3,2,1,2008
2008-08-03,Sarawak,59,23,36,2008
2008-08-04,Sarawak,32,23,9,2008
2008-08-05,Sarawak,34,17,17,2008
2008-08-06,Sarawak,59,32,27,2008
2008-08-07,Sarawak,21,13,8,2008
2008-08-08,Sarawak,23,11,12,2008
2008-08-09,Sarawak,34,24,10,2008
2008-08-10,Sarawak,55,35,20,2008
2008-08-11,Sarawak,33,9,24,2008
2008-08-12,Sarawak,32,17,15,2008
2008-08-13,Sarawak,11,4,7,2008
2008-08-14,Sarawak,23,14,9,2008
2008-08-15,Sarawak,32,15,17,2008
2008-08-16,Sarawak,27,18,9,2008
2008-08-17,Sarawak,39,24,15,2008
2008-08-18,Sarawak,49,42,7,2008
2008-08-19,Sarawak,30,16,14,2008
2008-08-20,Sarawak,30,18,12,2008
2008-08-21,Sarawak,36,17,19,2008
2008-08-22,Sarawak,28,15,13,2008
2008-08-23,Sarawak,46,18,28,2008
2008-08-24,Sarawak,85,43,42,2008
2008-08-25,Sarawak,52,21,31,2008
2008-08-26,Sarawak,18,7,11,2008
2008-08-27,Sarawak,12,4,8,2008
2008-08-28,Sarawak,37,20,17,2008
2008-08-29,Sarawak,32,12,20,2008
2008-08-30,Sarawak,10,4,6,2008
2008-08-31,Sarawak,35,12,23,2008
2008-09-01,Sarawak,0,0,0,2008
2008-09-02,Sarawak,4,1,3,2008
2008-09-03,Sarawak,15,6,9,2008
2008-09-04,Sarawak,22,14,8,2008
2008-09-05,Sarawak,12,4,8,2008
2008-09-06,Sarawak,94,66,28,2008
2008-09-07,Sarawak,49,31,18,2008
2008-09-08,Sarawak,20,16,4,2008
2008-09-09,Sarawak,25,10,15,2008
2008-09-10,Sarawak,25,4,21,2008
2008-09-11,Sarawak,16,6,10,2008
2008-09-12,Sarawak,8,3,5,2008
2008-09-13,Sarawak,20,13,7,2008
2008-09-14,Sarawak,34,26,8,2008
2008-09-15,Sarawak,21,11,10,2008
2008-09-16,Sarawak,38,22,16,2008
2008-09-17,Sarawak,45,30,15,2008
2008-09-18,Sarawak,20,13,7,2008
2008-09-19,Sarawak,52,32,20,2008
2008-09-20,Sarawak,16,14,2,2008
2008-09-21,Sarawak,24,14,10,2008
2008-09-22,Sarawak,24,10,14,2008
2008-09-23,Sarawak,38,22,16,2008
2008-09-24,Sarawak,46,24,22,2008
2008-09-25,Sarawak,40,26,14,2008
2008-09-26,Sarawak,37,23,14,2008
2008-09-27,Sarawak,54,37,17,2008
2008-09-28,Sarawak,28,14,14,2008
2008-09-29,Sarawak,14,10,4,2008
2008-09-30,Sarawak,28,13,15,2008
2008-10-01,Sarawak,1,1,0,2008
2008-10-02,Sarawak,12,4,8,2008
2008-10-03,Sarawak,23,10,13,2008
2008-10-04,Sarawak,9,6,3,2008
2008-10-05,Sarawak,56,11,45,2008
2008-10-06,Sarawak,29,15,14,2008
2008-10-07,Sarawak,35,18,17,2008
2008-10-08,Sarawak,26,13,13,2008
2008-10-09,Sarawak,55,32,23,2008
2008-10-10,Sarawak,51,29,22,2008
2008-10-11,Sarawak,75,29,46,2008
2008-10-12,Sarawak,35,23,12,2008
2008-10-13,Sarawak,30,6,24,2008
2008-10-14,Sarawak,28,8,20,2008
2008-10-15,Sarawak,72,22,50,2008
2008-10-16,Sarawak,41,19,22,2008
2008-10-17,Sarawak,38,14,24,2008
2008-10-18,Sarawak,66,43,23,2008
2008-10-19,Sarawak,106,46,60,2008
2008-10-20,Sarawak,28,12,16,2008
2008-10-21,Sarawak,32,11,21,2008
2008-10-22,Sarawak,29,8,21,2008
2008-10-23,Sarawak,47,24,23,2008
2008-10-24,Sarawak,27,8,19,2008
2008-10-25,Sarawak,69,50,19,2008
2008-10-26,Sarawak,68,23,45,2008
2008-10-27,Sarawak,49,24,25,2008
2008-10-28,Sarawak,63,39,24,2008
2008-10-29,Sarawak,48,25,23,2008
2008-10-30,Sarawak,68,42,26,2008
2008-10-31,Sarawak,30,9,21,2008
2008-11-01,Sarawak,31,18,13,2008
2008-11-02,Sarawak,12,3,9,2008
2008-11-03,Sarawak,22,6,16,2008
2008-11-04,Sarawak,9,3,6,2008
2008-11-05,Sarawak,31,19,12,2008
2008-11-06,Sarawak,37,11,26,2008
2008-11-07,Sarawak,29,9,20,2008
2008-11-08,Sarawak,30,15,15,2008
2008-11-09,Sarawak,67,24,43,2008
2008-11-10,Sarawak,32,13,19,2008
2008-11-11,Sarawak,35,12,23,2008
2008-11-12,Sarawak,36,22,14,2008
2008-11-13,Sarawak,42,11,31,2008
2008-11-14,Sarawak,20,8,12,2008
2008-11-15,Sarawak,33,29,4,2008
2008-11-16,Sarawak,0,0,0,2008
2008-11-17,Sarawak,13,3,10,2008
2008-11-18,Sarawak,21,4,17,2008
2008-11-19,Sarawak,55,16,39,2008
2008-11-20,Sarawak,70,46,24,2008
2008-11-21,Sarawak,23,6,17,2008
2008-11-22,Sarawak,2,0,2,2008
2008-11-23,Sarawak,15,1,14,2008
2008-11-24,Sarawak,39,15,24,2008
2008-11-25,Sarawak,48,15,33,2008
2008-11-26,Sarawak,67,30,37,2008
2008-11-27,Sarawak,26,9,17,2008
2008-11-28,Sarawak,52,28,24,2008
2008-11-29,Sarawak,1,0,1,2008
2008-11-30,Sarawak,9,3,6,2008
2008-12-01,Sarawak,53,31,22,2008
2008-12-02,Sarawak,18,5,13,2008
2008-12-03,Sarawak,42,23,19,2008
2008-12-04,Sarawak,18,4,14,2008
2008-12-05,Sarawak,19,6,13,2008
2008-12-06,Sarawak,51,29,22,2008
2008-12-07,Sarawak,3,1,2,2008
2008-12-08,Sarawak,0,0,0,2008
2008-12-09,Sarawak,56,34,22,2008
2008-12-10,Sarawak,36,13,23,2008
2008-12-11,Sarawak,62,34,28,2008
2008-12-12,Sarawak,54,30,24,2008
2008-12-13,Sarawak,53,35,18,2008
2008-12-14,Sarawak,5,0,5,2008
2008-12-15,Sarawak,69,36,33,2008
2008-12-16,Sarawak,98,55,43,2008
2008-12-17,Sarawak,64,30,34,2008
2008-12-18,Sarawak,79,48,31,2008
2008-12-19,Sarawak,124,89,35,2008
2008-12-20,Sarawak,20,11,9,2008
2008-12-21,Sarawak,3,2,1,2008
2008-12-22,Sarawak,22,4,18,2008
2008-12-23,Sarawak,35,22,13,2008
2008-12-24,Sarawak,41,21,20,2008
2008-12-25,Sarawak,10,10,0,2008
2008-12-26,Sarawak,33,13,20,2008
2008-12-27,Sarawak,0,0,0,2008
2008-12-28,Sarawak,42,26,16,2008
2008-12-29,Sarawak,54,46,8,2008
2008-12-30,Sarawak,42,29,13,2008
2008-12-31,Sarawak,40,19,21,2008
2009-01-01,Sarawak,181,81,100,2009
2009-01-02,Sarawak,32,15,17,2009
2009-01-03,Sarawak,2,1,1,2009
2009-01-04,Sarawak,177,59,118,2009
2009-01-05,Sarawak,20,4,16,2009
2009-01-06,Sarawak,27,7,20,2009
2009-01-07,Sarawak,21,9,12,2009
2009-01-08,Sarawak,23,9,14,2009
2009-01-09,Sarawak,43,16,27,2009
2009-01-10,Sarawak,22,16,6,2009
2009-01-11,Sarawak,24,7,17,2009
2009-01-12,Sarawak,20,9,11,2009
2009-01-13,Sarawak,22,9,13,2009
2009-01-14,Sarawak,24,10,14,2009
2009-01-15,Sarawak,56,33,23,2009
2009-01-16,Sarawak,47,27,20,2009
2009-01-17,Sarawak,95,88,7,2009
2009-01-18,Sarawak,83,25,58,2009
2009-01-19,Sarawak,27,14,13,2009
2009-01-20,Sarawak,32,7,25,2009
2009-01-21,Sarawak,47,14,33,2009
2009-01-22,Sarawak,104,47,57,2009
2009-01-23,Sarawak,22,5,17,2009
2009-01-24,Sarawak,29,10,19,2009
2009-01-25,Sarawak,4,1,3,2009
2009-01-26,Sarawak,0,0,0,2009
2009-01-27,Sarawak,9,1,8,2009
2009-01-28,Sarawak,26,8,18,2009
2009-01-29,Sarawak,20,10,10,2009
2009-01-30,Sarawak,92,42,50,2009
2009-01-31,Sarawak,16,13,3,2009
2009-02-01,Sarawak,100,46,54,2009
2009-02-02,Sarawak,31,15,16,2009
2009-02-03,Sarawak,42,20,22,2009
2009-02-04,Sarawak,64,54,10,2009
2009-02-05,Sarawak,53,29,24,2009
2009-02-06,Sarawak,55,27,28,2009
2009-02-07,Sarawak,59,23,36,2009
2009-02-08,Sarawak,28,17,11,2009
2009-02-09,Sarawak,58,29,29,2009
2009-02-10,Sarawak,67,28,39,2009
2009-02-11,Sarawak,48,25,23,2009
2009-02-12,Sarawak,111,54,57,2009
2009-02-13,Sarawak,38,21,17,2009
2009-02-14,Sarawak,49,29,20,2009
2009-02-15,Sarawak,118,40,78,2009
2009-02-16,Sarawak,42,17,25,2009
2009-02-17,Sarawak,75,57,18,2009
2009-02-18,Sarawak,74,53,21,2009
2009-02-19,Sarawak,73,42,31,2009
2009-02-20,Sarawak,30,5,25,2009
2009-02-21,Sarawak,77,24,53,2009
2009-02-22,Sarawak,181,70,111,2009
2009-02-23,Sarawak,109,56,53,2009
2009-02-24,Sarawak,294,235,59,2009
2009-02-25,Sarawak,58,22,36,2009
2009-02-26,Sarawak,14,4,10,2009
2009-02-27,Sarawak,15,2,13,2009
2009-02-28,Sarawak,52,22,30,2009
2009-03-01,Sarawak,23,5,18,2009
2009-03-02,Sarawak,25,8,17,2009
2009-03-03,Sarawak,22,6,16,2009
2009-03-04,Sarawak,53,12,41,2009
2009-03-05,Sarawak,57,23,34,2009
2009-03-06,Sarawak,18,0,18,2009
2009-03-07,Sarawak,34,24,10,2009
2009-03-08,Sarawak,97,45,52,2009
2009-03-09,Sarawak,1,0,1,2009
2009-03-10,Sarawak,40,10,30,2009
2009-03-11,Sarawak,19,2,17,2009
2009-03-12,Sarawak,14,2,12,2009
2009-03-13,Sarawak,16,2,14,2009
2009-03-14,Sarawak,2,0,2,2009
2009-03-15,Sarawak,122,49,73,2009
2009-03-16,Sarawak,17,3,14,2009
2009-03-17,Sarawak,13,0,13,2009
2009-03-18,Sarawak,23,2,21,2009
2009-03-19,Sarawak,14,5,9,2009
2009-03-20,Sarawak,18,1,17,2009
2009-03-21,Sarawak,0,0,0,2009
2009-03-22,Sarawak,142,50,92,2009
2009-03-23,Sarawak,14,3,11,2009
2009-03-24,Sarawak,39,18,21,2009
2009-03-25,Sarawak,17,3,14,2009
2009-03-26,Sarawak,6,1,5,2009
2009-03-27,Sarawak,19,5,14,2009
2009-03-28,Sarawak,95,69,26,2009
2009-03-29,Sarawak,81,31,50,2009
2009-03-30,Sarawak,21,4,17,2009
2009-03-31,Sarawak,37,22,15,2009
2009-04-01,Sarawak,22,7,15,2009
2009-04-02,Sarawak,35,12,23,2009
2009-04-03,Sarawak,9,1,8,2009
2009-04-04,Sarawak,39,9,30,2009
2009-04-05,Sarawak,180,56,124,2009
2009-04-06,Sarawak,6,0,6,2009
2009-04-07,Sarawak,43,23,20,2009
2009-04-08,Sarawak,80,47,33,2009
2009-04-09,Sarawak,19,3,16,2009
2009-04-10,Sarawak,0,0,0,2009
2009-04-11,Sarawak,0,0,0,2009
2009-04-12,Sarawak,0,0,0,2009
2009-04-13,Sarawak,33,6,27,2009
2009-04-14,Sarawak,31,6,25,2009
2009-04-15,Sarawak,46,26,20,2009
2009-04-16,Sarawak,36,14,22,2009
2009-04-17,Sarawak,22,5,17,2009
2009-04-18,Sarawak,26,14,12,2009
2009-04-19,Sarawak,180,62,118,2009
2009-04-20,Sarawak,13,3,10,2009
2009-04-21,Sarawak,20,7,13,2009
2009-04-22,Sarawak,14,0,14,2009
2009-04-23,Sarawak,13,3,10,2009
2009-04-24,Sarawak,37,9,28,2009
2009-04-25,Sarawak,21,11,10,2009
2009-04-26,Sarawak,75,34,41,2009
2009-04-27,Sarawak,29,5,24,2009
2009-04-28,Sarawak,17,7,10,2009
2009-04-29,Sarawak,29,10,19,2009
2009-04-30,Sarawak,26,6,20,2009
2009-05-01,Sarawak,0,0,0,2009
2009-05-02,Sarawak,49,18,31,2009
2009-05-03,Sarawak,49,27,22,2009
2009-05-04,Sarawak,52,21,31,2009
2009-05-05,Sarawak,81,45,36,2009
2009-05-06,Sarawak,65,13,52,2009
2009-05-07,Sarawak,19,6,13,2009
2009-05-08,Sarawak,22,2,20,2009
2009-05-09,Sarawak,41,17,24,2009
2009-05-10,Sarawak,29,22,7,2009
2009-05-11,Sarawak,29,4,25,2009
2009-05-12,Sarawak,15,5,10,2009
2009-05-13,Sarawak,30,5,25,2009
2009-05-14,Sarawak,50,15,35,2009
2009-05-15,Sarawak,12,0,12,2009
2009-05-16,Sarawak,46,24,22,2009
2009-05-17,Sarawak,83,13,70,2009
2009-05-18,Sarawak,43,7,36,2009
2009-05-19,Sarawak,18,3,15,2009
2009-05-20,Sarawak,35,13,22,2009
2009-05-21,Sarawak,28,2,26,2009
2009-05-22,Sarawak,12,2,10,2009
2009-05-23,Sarawak,68,44,24,2009
2009-05-24,Sarawak,130,46,84,2009
2009-05-25,Sarawak,30,9,21,2009
2009-05-26,Sarawak,79,18,61,2009
2009-05-27,Sarawak,17,3,14,2009
2009-05-28,Sarawak,8,2,6,2009
2009-05-29,Sarawak,18,3,15,2009
2009-05-30,Sarawak,38,15,23,2009
2009-05-31,Sarawak,18,4,14,2009
2009-06-01,Sarawak,0,0,0,2009
2009-06-02,Sarawak,0,0,0,2009
2009-06-03,Sarawak,23,1,22,2009
2009-06-04,Sarawak,17,2,15,2009
2009-06-05,Sarawak,24,8,16,2009
2009-06-06,Sarawak,0,0,0,2009
2009-06-07,Sarawak,9,1,8,2009
2009-06-08,Sarawak,19,2,17,2009
2009-06-09,Sarawak,25,8,17,2009
2009-06-10,Sarawak,17,2,15,2009
2009-06-11,Sarawak,14,4,10,2009
2009-06-12,Sarawak,39,17,22,2009
2009-06-13,Sarawak,97,35,62,2009
2009-06-14,Sarawak,211,59,152,2009
2009-06-15,Sarawak,17,1,16,2009
2009-06-16,Sarawak,36,14,22,2009
2009-06-17,Sarawak,71,60,11,2009
2009-06-18,Sarawak,38,20,18,2009
2009-06-19,Sarawak,20,7,13,2009
2009-06-20,Sarawak,66,20,46,2009
2009-06-21,Sarawak,86,27,59,2009
2009-06-22,Sarawak,13,2,11,2009
2009-06-23,Sarawak,41,18,23,2009
2009-06-24,Sarawak,19,1,18,2009
2009-06-25,Sarawak,11,2,9,2009
2009-06-26,Sarawak,15,1,14,2009
2009-06-27,Sarawak,20,14,6,2009
2009-06-28,Sarawak,124,35,89,2009
2009-06-29,Sarawak,11,0,11,2009
2009-06-30,Sarawak,15,2,13,2009
2009-07-01,Sarawak,17,1,16,2009
2009-07-02,Sarawak,20,2,18,2009
2009-07-03,Sarawak,15,0,15,2009
2009-07-04,Sarawak,1,0,1,2009
2009-07-05,Sarawak,160,37,123,2009
2009-07-06,Sarawak,19,2,17,2009
2009-07-07,Sarawak,57,31,26,2009
2009-07-08,Sarawak,39,10,29,2009
2009-07-09,Sarawak,11,1,10,2009
2009-07-10,Sarawak,21,3,18,2009
2009-07-11,Sarawak,30,16,14,2009
2009-07-12,Sarawak,158,73,85,2009
2009-07-13,Sarawak,11,3,8,2009
2009-07-14,Sarawak,16,3,13,2009
2009-07-15,Sarawak,17,2,15,2009
2009-07-16,Sarawak,37,21,16,2009
2009-07-17,Sarawak,35,8,27,2009
2009-07-18,Sarawak,45,32,13,2009
2009-07-19,Sarawak,96,24,72,2009
2009-07-20,Sarawak,19,0,19,2009
2009-07-21,Sarawak,23,6,17,2009
2009-07-22,Sarawak,15,5,10,2009
2009-07-23,Sarawak,87,35,52,2009
2009-07-24,Sarawak,31,7,24,2009
2009-07-25,Sarawak,20,12,8,2009
2009-07-26,Sarawak,107,39,68,2009
2009-07-27,Sarawak,16,2,14,2009
2009-07-28,Sarawak,17,1,16,2009
2009-07-29,Sarawak,122,91,31,2009
2009-07-30,Sarawak,8,1,7,2009
2009-07-31,Sarawak,25,3,22,2009
2009-08-01,Sarawak,30,12,18,2009
2009-08-02,Sarawak,83,18,65,2009
2009-08-03,Sarawak,15,4,11,2009
2009-08-04,Sarawak,20,5,15,2009
2009-08-05,Sarawak,54,18,36,2009
2009-08-06,Sarawak,13,2,11,2009
2009-08-07,Sarawak,16,0,16,2009
2009-08-08,Sarawak,99,62,37,2009
2009-08-09,Sarawak,71,32,39,2009
2009-08-10,Sarawak,10,1,9,2009
2009-08-11,Sarawak,56,14,42,2009
2009-08-12,Sarawak,25,7,18,2009
2009-08-13,Sarawak,65,42,23,2009
2009-08-14,Sarawak,9,1,8,2009
2009-08-15,Sarawak,126,92,34,2009
2009-08-16,Sarawak,63,24,39,2009
2009-08-17,Sarawak,17,0,17,2009
2009-08-18,Sarawak,47,27,20,2009
2009-08-19,Sarawak,28,4,24,2009
2009-08-20,Sarawak,25,6,19,2009
2009-08-21,Sarawak,43,7,36,2009
2009-08-22,Sarawak,0,0,0,2009
2009-08-23,Sarawak,71,23,48,2009
2009-08-24,Sarawak,10,1,9,2009
2009-08-25,Sarawak,9,1,8,2009
2009-08-26,Sarawak,8,0,8,2009
2009-08-27,Sarawak,66,28,38,2009
2009-08-28,Sarawak,4,0,4,2009
2009-08-29,Sarawak,21,13,8,2009
2009-08-30,Sarawak,50,7,43,2009
2009-08-31,Sarawak,0,0,0,2009
2009-09-01,Sarawak,7,0,7,2009
2009-09-02,Sarawak,6,0,6,2009
2009-09-03,Sarawak,8,1,7,2009
2009-09-04,Sarawak,18,5,13,2009
2009-09-05,Sarawak,103,54,49,2009
2009-09-06,Sarawak,271,123,148,2009
2009-09-07,Sarawak,9,3,6,2009
2009-09-08,Sarawak,26,16,10,2009
2009-09-09,Sarawak,18,5,13,2009
2009-09-10,Sarawak,18,2,16,2009
2009-09-11,Sarawak,10,3,7,2009
2009-09-12,Sarawak,97,59,38,2009
2009-09-13,Sarawak,86,33,53,2009
2009-09-14,Sarawak,20,6,14,2009
2009-09-15,Sarawak,27,8,19,2009
2009-09-16,Sarawak,45,20,25,2009
2009-09-17,Sarawak,22,5,17,2009
2009-09-18,Sarawak,17,2,15,2009
2009-09-19,Sarawak,9,3,6,2009
2009-09-20,Sarawak,0,0,0,2009
2009-09-21,Sarawak,6,4,2,2009
2009-09-22,Sarawak,11,3,8,2009
2009-09-23,Sarawak,34,6,28,2009
2009-09-24,Sarawak,29,4,25,2009
2009-09-25,Sarawak,19,5,14,2009
2009-09-26,Sarawak,52,34,18,2009
2009-09-27,Sarawak,157,24,133,2009
2009-09-28,Sarawak,44,17,27,2009
2009-09-29,Sarawak,28,5,23,2009
2009-09-30,Sarawak,56,17,39,2009
2009-10-01,Sarawak,37,16,21,2009
2009-10-02,Sarawak,54,14,40,2009
2009-10-03,Sarawak,96,74,22,2009
2009-10-04,Sarawak,128,37,91,2009
2009-10-05,Sarawak,33,11,22,2009
2009-10-06,Sarawak,68,17,51,2009
2009-10-07,Sarawak,94,51,43,2009
2009-10-08,Sarawak,30,13,17,2009
2009-10-09,Sarawak,23,4,19,2009
2009-10-10,Sarawak,62,14,48,2009
2009-10-11,Sarawak,115,22,93,2009
2009-10-12,Sarawak,11,0,11,2009
2009-10-13,Sarawak,14,4,10,2009
2009-10-14,Sarawak,38,15,23,2009
2009-10-15,Sarawak,65,31,34,2009
2009-10-16,Sarawak,18,3,15,2009
2009-10-17,Sarawak,130,69,61,2009
2009-10-18,Sarawak,88,21,67,2009
2009-10-19,Sarawak,26,2,24,2009
2009-10-20,Sarawak,19,1,18,2009
2009-10-21,Sarawak,13,1,12,2009
2009-10-22,Sarawak,23,13,10,2009
2009-10-23,Sarawak,25,3,22,2009
2009-10-24,Sarawak,13,10,3,2009
2009-10-25,Sarawak,94,26,68,2009
2009-10-26,Sarawak,15,0,15,2009
2009-10-27,Sarawak,82,39,43,2009
2009-10-28,Sarawak,43,19,24,2009
2009-10-29,Sarawak,75,24,51,2009
2009-10-30,Sarawak,16,2,14,2009
2009-10-31,Sarawak,34,15,19,2009
2009-11-01,Sarawak,211,42,169,2009
2009-11-02,Sarawak,26,4,22,2009
2009-11-03,Sarawak,39,25,14,2009
2009-11-04,Sarawak,43,26,17,2009
2009-11-05,Sarawak,12,3,9,2009
2009-11-06,Sarawak,22,2,20,2009
2009-11-07,Sarawak,61,27,34,2009
2009-11-08,Sarawak,25,4,21,2009
2009-11-09,Sarawak,18,5,13,2009
2009-11-10,Sarawak,15,5,10,2009
2009-11-11,Sarawak,240,140,100,2009
2009-11-12,Sarawak,25,7,18,2009
2009-11-13,Sarawak,17,4,13,2009
2009-11-14,Sarawak,82,35,47,2009
2009-11-15,Sarawak,146,33,113,2009
2009-11-16,Sarawak,7,1,6,2009
2009-11-17,Sarawak,43,6,37,2009
2009-11-18,Sarawak,15,1,14,2009
2009-11-19,Sarawak,32,9,23,2009
2009-11-20,Sarawak,11,1,10,2009
2009-11-21,Sarawak,33,11,22,2009
2009-11-22,Sarawak,93,22,71,2009
2009-11-23,Sarawak,19,2,17,2009
2009-11-24,Sarawak,48,27,21,2009
2009-11-25,Sarawak,25,11,14,2009
2009-11-26,Sarawak,40,16,24,2009
2009-11-27,Sarawak,0,0,0,2009
2009-11-28,Sarawak,3,0,3,2009
2009-11-29,Sarawak,66,12,54,2009
2009-11-30,Sarawak,32,6,26,2009
2009-12-01,Sarawak,13,3,10,2009
2009-12-02,Sarawak,41,12,29,2009
2009-12-03,Sarawak,62,15,47,2009
2009-12-04,Sarawak,21,1,20,2009
2009-12-05,Sarawak,20,14,6,2009
2009-12-06,Sarawak,90,23,67,2009
2009-12-07,Sarawak,22,5,17,2009
2009-12-08,Sarawak,19,5,14,2009
2009-12-09,Sarawak,55,14,41,2009
2009-12-10,Sarawak,11,0,11,2009
2009-12-11,Sarawak,16,6,10,2009
2009-12-12,Sarawak,79,40,39,2009
2009-12-13,Sarawak,108,32,76,2009
2009-12-14,Sarawak,6,2,4,2009
2009-12-15,Sarawak,31,11,20,2009
2009-12-16,Sarawak,56,31,25,2009
2009-12-17,Sarawak,59,22,37,2009
2009-12-18,Sarawak,32,19,13,2009
2009-12-19,Sarawak,31,16,15,2009
2009-12-20,Sarawak,133,34,99,2009
2009-12-21,Sarawak,13,2,11,2009
2009-12-22,Sarawak,11,2,9,2009
2009-12-23,Sarawak,20,4,16,2009
2009-12-24,Sarawak,26,4,22,2009
2009-12-25,Sarawak,0,0,0,2009
2009-12-26,Sarawak,12,5,7,2009
2009-12-27,Sarawak,127,17,110,2009
2009-12-28,Sarawak,44,19,25,2009
2009-12-29,Sarawak,26,10,16,2009
2009-12-30,Sarawak,28,5,23,2009
2009-12-31,Sarawak,24,4,20,2009
2010-01-01,Sarawak,155,45,110,2010
2010-01-02,Sarawak,0,0,0,2010
2010-01-03,Sarawak,128,19,109,2010
2010-01-04,Sarawak,18,3,15,2010
2010-01-05,Sarawak,15,2,13,2010
2010-01-06,Sarawak,21,3,18,2010
2010-01-07,Sarawak,34,24,10,2010
2010-01-08,Sarawak,39,9,30,2010
2010-01-09,Sarawak,29,10,19,2010
2010-01-10,Sarawak,66,27,39,2010
2010-01-11,Sarawak,26,4,22,2010
2010-01-12,Sarawak,27,5,22,2010
2010-01-13,Sarawak,37,27,10,2010
2010-01-14,Sarawak,64,25,39,2010
2010-01-15,Sarawak,47,9,38,2010
2010-01-16,Sarawak,10,1,9,2010
2010-01-17,Sarawak,45,8,37,2010
2010-01-18,Sarawak,46,22,24,2010
2010-01-19,Sarawak,7,2,5,2010
2010-01-20,Sarawak,87,46,41,2010
2010-01-21,Sarawak,31,6,25,2010
2010-01-22,Sarawak,26,8,18,2010
2010-01-23,Sarawak,141,72,69,2010
2010-01-24,Sarawak,122,30,92,2010
2010-01-25,Sarawak,81,13,68,2010
2010-01-26,Sarawak,21,5,16,2010
2010-01-27,Sarawak,19,4,15,2010
2010-01-28,Sarawak,74,24,50,2010
2010-01-29,Sarawak,24,8,16,2010
2010-01-30,Sarawak,0,0,0,2010
2010-01-31,Sarawak,130,44,86,2010
2010-02-01,Sarawak,13,1,12,2010
2010-02-02,Sarawak,60,33,27,2010
2010-02-03,Sarawak,11,2,9,2010
2010-02-04,Sarawak,226,159,67,2010
2010-02-05,Sarawak,16,2,14,2010
2010-02-06,Sarawak,183,128,55,2010
2010-02-07,Sarawak,92,38,54,2010
2010-02-08,Sarawak,119,76,43,2010
2010-02-09,Sarawak,45,14,31,2010
2010-02-10,Sarawak,112,70,42,2010
2010-02-11,Sarawak,75,37,38,2010
2010-02-12,Sarawak,20,1,19,2010
2010-02-13,Sarawak,30,22,8,2010
2010-02-14,Sarawak,0,0,0,2010
2010-02-15,Sarawak,2,0,2,2010
2010-02-16,Sarawak,3,1,2,2010
2010-02-17,Sarawak,38,21,17,2010
2010-02-18,Sarawak,24,4,20,2010
2010-02-19,Sarawak,15,3,12,2010
2010-02-20,Sarawak,77,26,51,2010
2010-02-21,Sarawak,44,13,31,2010
2010-02-22,Sarawak,21,9,12,2010
2010-02-23,Sarawak,22,3,19,2010
2010-02-24,Sarawak,16,3,13,2010
2010-02-25,Sarawak,44,12,32,2010
2010-02-26,Sarawak,0,0,0,2010
2010-02-27,Sarawak,124,55,69,2010
2010-02-28,Sarawak,53,16,37,2010
2010-03-01,Sarawak,23,9,14,2010
2010-03-02,Sarawak,17,0,17,2010
2010-03-03,Sarawak,27,7,20,2010
2010-03-04,Sarawak,14,1,13,2010
2010-03-05,Sarawak,20,2,18,2010
2010-03-06,Sarawak,52,32,20,2010
2010-03-07,Sarawak,48,21,27,2010
2010-03-08,Sarawak,19,3,16,2010
2010-03-09,Sarawak,139,117,22,2010
2010-03-10,Sarawak,80,33,47,2010
2010-03-11,Sarawak,76,41,35,2010
2010-03-12,Sarawak,18,0,18,2010
2010-03-13,Sarawak,56,21,35,2010
2010-03-14,Sarawak,120,26,94,2010
2010-03-15,Sarawak,21,3,18,2010
2010-03-16,Sarawak,15,2,13,2010
2010-03-17,Sarawak,31,8,23,2010
2010-03-18,Sarawak,16,3,13,2010
2010-03-19,Sarawak,35,4,31,2010
2010-03-20,Sarawak,27,7,20,2010
2010-03-21,Sarawak,173,25,148,2010
2010-03-22,Sarawak,17,2,15,2010
2010-03-23,Sarawak,45,20,25,2010
2010-03-24,Sarawak,14,1,13,2010
2010-03-25,Sarawak,55,22,33,2010
2010-03-26,Sarawak,16,7,9,2010
2010-03-27,Sarawak,115,60,55,2010
2010-03-28,Sarawak,148,27,121,2010
2010-03-29,Sarawak,19,0,19,2010
2010-03-30,Sarawak,65,17,48,2010
2010-03-31,Sarawak,177,94,83,2010
2010-04-01,Sarawak,13,2,11,2010
2010-04-02,Sarawak,0,0,0,2010
2010-04-03,Sarawak,40,28,12,2010
2010-04-04,Sarawak,208,41,167,2010
2010-04-05,Sarawak,30,0,30,2010
2010-04-06,Sarawak,50,16,34,2010
2010-04-07,Sarawak,87,53,34,2010
2010-04-08,Sarawak,51,17,34,2010
2010-04-09,Sarawak,23,4,19,2010
2010-04-10,Sarawak,22,13,9,2010
2010-04-11,Sarawak,160,40,120,2010
2010-04-12,Sarawak,30,5,25,2010
2010-04-13,Sarawak,38,17,21,2010
2010-04-14,Sarawak,50,20,30,2010
2010-04-15,Sarawak,65,15,50,2010
2010-04-16,Sarawak,18,0,18,2010
2010-04-17,Sarawak,33,9,24,2010
2010-04-18,Sarawak,155,42,113,2010
2010-04-19,Sarawak,19,2,17,2010
2010-04-20,Sarawak,37,16,21,2010
2010-04-21,Sarawak,15,2,13,2010
2010-04-22,Sarawak,49,9,40,2010
2010-04-23,Sarawak,12,2,10,2010
2010-04-24,Sarawak,18,6,12,2010
2010-04-25,Sarawak,99,27,72,2010
2010-04-26,Sarawak,34,15,19,2010
2010-04-27,Sarawak,50,7,43,2010
2010-04-28,Sarawak,37,10,27,2010
2010-04-29,Sarawak,15,4,11,2010
2010-04-30,Sarawak,17,2,15,2010
2010-05-01,Sarawak,10,3,7,2010
2010-05-02,Sarawak,101,20,81,2010
2010-05-03,Sarawak,20,4,16,2010
2010-05-04,Sarawak,28,7,21,2010
2010-05-05,Sarawak,23,3,20,2010
2010-05-06,Sarawak,43,22,21,2010
2010-05-07,Sarawak,24,6,18,2010
2010-05-08,Sarawak,4,3,1,2010
2010-05-09,Sarawak,40,11,29,2010
2010-05-10,Sarawak,16,2,14,2010
2010-05-11,Sarawak,7,1,6,2010
2010-05-12,Sarawak,8,1,7,2010
2010-05-13,Sarawak,54,14,40,2010
2010-05-14,Sarawak,22,8,14,2010
2010-05-15,Sarawak,27,15,12,2010
2010-05-16,Sarawak,139,45,94,2010
2010-05-17,Sarawak,11,2,9,2010
2010-05-18,Sarawak,15,1,14,2010
2010-05-19,Sarawak,33,12,21,2010
2010-05-20,Sarawak,28,9,19,2010
2010-05-21,Sarawak,7,0,7,2010
2010-05-22,Sarawak,20,12,8,2010
2010-05-23,Sarawak,92,30,62,2010
2010-05-24,Sarawak,194,110,84,2010
2010-05-25,Sarawak,11,1,10,2010
2010-05-26,Sarawak,41,30,11,2010
2010-05-27,Sarawak,75,30,45,2010
2010-05-28,Sarawak,25,7,18,2010
2010-05-29,Sarawak,0,0,0,2010
2010-05-30,Sarawak,94,23,71,2010
2010-05-31,Sarawak,16,2,14,2010
2010-06-01,Sarawak,0,0,0,2010
2010-06-02,Sarawak,0,0,0,2010
2010-06-03,Sarawak,13,2,11,2010
2010-06-04,Sarawak,12,0,12,2010
2010-06-05,Sarawak,3,0,3,2010
2010-06-06,Sarawak,103,35,68,2010
2010-06-07,Sarawak,12,3,9,2010
2010-06-08,Sarawak,23,7,16,2010
2010-06-09,Sarawak,13,2,11,2010
2010-06-10,Sarawak,14,1,13,2010
2010-06-11,Sarawak,14,1,13,2010
2010-06-12,Sarawak,32,10,22,2010
2010-06-13,Sarawak,129,49,80,2010
2010-06-14,Sarawak,24,6,18,2010
2010-06-15,Sarawak,21,2,19,2010
2010-06-16,Sarawak,11,1,10,2010
2010-06-17,Sarawak,13,1,12,2010
2010-06-18,Sarawak,15,2,13,2010
2010-06-19,Sarawak,30,16,14,2010
2010-06-20,Sarawak,114,19,95,2010
2010-06-21,Sarawak,15,2,13,2010
2010-06-22,Sarawak,27,7,20,2010
2010-06-23,Sarawak,16,4,12,2010
2010-06-24,Sarawak,31,16,15,2010
2010-06-25,Sarawak,32,5,27,2010
2010-06-26,Sarawak,52,20,32,2010
2010-06-27,Sarawak,127,37,90,2010
2010-06-28,Sarawak,15,1,14,2010
2010-06-29,Sarawak,13,1,12,2010
2010-06-30,Sarawak,31,9,22,2010
2010-07-01,Sarawak,18,1,17,2010
2010-07-02,Sarawak,11,1,10,2010
2010-07-03,Sarawak,34,19,15,2010
2010-07-04,Sarawak,188,30,158,2010
2010-07-05,Sarawak,20,0,20,2010
2010-07-06,Sarawak,10,0,10,2010
2010-07-07,Sarawak,13,1,12,2010
2010-07-08,Sarawak,60,35,25,2010
2010-07-09,Sarawak,32,2,30,2010
2010-07-10,Sarawak,62,30,32,2010
2010-07-11,Sarawak,160,22,138,2010
2010-07-12,Sarawak,14,1,13,2010
2010-07-13,Sarawak,60,13,47,2010
2010-07-14,Sarawak,54,29,25,2010
2010-07-15,Sarawak,57,18,39,2010
2010-07-16,Sarawak,20,5,15,2010
2010-07-17,Sarawak,43,8,35,2010
2010-07-18,Sarawak,65,25,40,2010
2010-07-19,Sarawak,32,8,24,2010
2010-07-20,Sarawak,79,10,69,2010
2010-07-21,Sarawak,34,11,23,2010
2010-07-22,Sarawak,45,27,18,2010
2010-07-23,Sarawak,22,6,16,2010
2010-07-24,Sarawak,47,17,30,2010
2010-07-25,Sarawak,83,13,70,2010
2010-07-26,Sarawak,52,19,33,2010
2010-07-27,Sarawak,111,46,65,2010
2010-07-28,Sarawak,97,37,60,2010
2010-07-29,Sarawak,30,2,28,2010
2010-07-30,Sarawak,14,0,14,2010
2010-07-31,Sarawak,61,22,39,2010
2010-08-01,Sarawak,97,11,86,2010
2010-08-02,Sarawak,11,3,8,2010
2010-08-03,Sarawak,68,50,18,2010
2010-08-04,Sarawak,128,68,60,2010
2010-08-05,Sarawak,98,74,24,2010
2010-08-06,Sarawak,16,2,14,2010
2010-08-07,Sarawak,177,111,66,2010
2010-08-08,Sarawak,59,41,18,2010
2010-08-09,Sarawak,50,14,36,2010
2010-08-10,Sarawak,44,27,17,2010
2010-08-11,Sarawak,4,2,2,2010
2010-08-12,Sarawak,2,0,2,2010
2010-08-13,Sarawak,9,3,6,2010
2010-08-14,Sarawak,25,10,15,2010
2010-08-15,Sarawak,210,32,178,2010
2010-08-16,Sarawak,10,1,9,2010
2010-08-17,Sarawak,36,13,23,2010
2010-08-18,Sarawak,4,0,4,2010
2010-08-19,Sarawak,10,0,10,2010
2010-08-20,Sarawak,7,0,7,2010
2010-08-21,Sarawak,26,15,11,2010
2010-08-22,Sarawak,57,16,41,2010
2010-08-23,Sarawak,10,0,10,2010
2010-08-24,Sarawak,8,3,5,2010
2010-08-25,Sarawak,10,1,9,2010
2010-08-26,Sarawak,17,4,13,2010
2010-08-27,Sarawak,16,6,10,2010
2010-08-28,Sarawak,21,10,11,2010
2010-08-29,Sarawak,61,22,39,2010
2010-08-30,Sarawak,11,0,11,2010
2010-08-31,Sarawak,99,45,54,2010
2010-09-01,Sarawak,44,22,22,2010
2010-09-02,Sarawak,3,0,3,2010
2010-09-03,Sarawak,9,0,9,2010
2010-09-04,Sarawak,94,93,1,2010
2010-09-05,Sarawak,110,22,88,2010
2010-09-06,Sarawak,85,45,40,2010
2010-09-07,Sarawak,4,0,4,2010
2010-09-08,Sarawak,10,1,9,2010
2010-09-09,Sarawak,4,0,4,2010
2010-09-10,Sarawak,0,0,0,2010
2010-09-11,Sarawak,0,0,0,2010
2010-09-12,Sarawak,60,7,53,2010
2010-09-13,Sarawak,27,3,24,2010
2010-09-14,Sarawak,19,7,12,2010
2010-09-15,Sarawak,20,2,18,2010
2010-09-16,Sarawak,20,16,4,2010
2010-09-17,Sarawak,25,0,25,2010
2010-09-18,Sarawak,12,3,9,2010
2010-09-19,Sarawak,208,50,158,2010
2010-09-20,Sarawak,27,5,22,2010
2010-09-21,Sarawak,34,7,27,2010
2010-09-22,Sarawak,21,2,19,2010
2010-09-23,Sarawak,16,2,14,2010
2010-09-24,Sarawak,25,3,22,2010
2010-09-25,Sarawak,44,16,28,2010
2010-09-26,Sarawak,106,26,80,2010
2010-09-27,Sarawak,20,0,20,2010
2010-09-28,Sarawak,51,20,31,2010
2010-09-29,Sarawak,15,2,13,2010
2010-09-30,Sarawak,70,25,45,2010
2010-10-01,Sarawak,21,1,20,2010
2010-10-02,Sarawak,39,24,15,2010
2010-10-03,Sarawak,177,47,130,2010
2010-10-04,Sarawak,27,5,22,2010
2010-10-05,Sarawak,23,6,17,2010
2010-10-06,Sarawak,28,8,20,2010
2010-10-07,Sarawak,51,13,38,2010
2010-10-08,Sarawak,28,2,26,2010
2010-10-09,Sarawak,45,24,21,2010
2010-10-10,Sarawak,266,71,195,2010
2010-10-11,Sarawak,25,3,22,2010
2010-10-12,Sarawak,54,22,32,2010
2010-10-13,Sarawak,17,2,15,2010
2010-10-14,Sarawak,23,3,20,2010
2010-10-15,Sarawak,23,1,22,2010
2010-10-16,Sarawak,94,78,16,2010
2010-10-17,Sarawak,156,38,118,2010
2010-10-18,Sarawak,17,2,15,2010
2010-10-19,Sarawak,28,10,18,2010
2010-10-20,Sarawak,15,0,15,2010
2010-10-21,Sarawak,18,1,17,2010
2010-10-22,Sarawak,20,3,17,2010
2010-10-23,Sarawak,95,40,55,2010
2010-10-24,Sarawak,213,41,172,2010
2010-10-25,Sarawak,12,1,11,2010
2010-10-26,Sarawak,28,5,23,2010
2010-10-27,Sarawak,10,0,10,2010
2010-10-28,Sarawak,36,13,23,2010
2010-10-29,Sarawak,32,2,30,2010
2010-10-30,Sarawak,19,5,14,2010
2010-10-31,Sarawak,61,15,46,2010
2010-11-01,Sarawak,47,26,21,2010
2010-11-02,Sarawak,45,23,22,2010
2010-11-03,Sarawak,16,3,13,2010
2010-11-04,Sarawak,28,9,19,2010
2010-11-05,Sarawak,22,3,19,2010
2010-11-06,Sarawak,17,2,15,2010
2010-11-07,Sarawak,155,28,127,2010
2010-11-08,Sarawak,25,3,22,2010
2010-11-09,Sarawak,58,7,51,2010
2010-11-10,Sarawak,38,13,25,2010
2010-11-11,Sarawak,64,21,43,2010
2010-11-12,Sarawak,20,4,16,2010
2010-11-13,Sarawak,118,41,77,2010
2010-11-14,Sarawak,117,31,86,2010
2010-11-15,Sarawak,20,4,16,2010
2010-11-16,Sarawak,84,17,67,2010
2010-11-17,Sarawak,0,0,0,2010
2010-11-18,Sarawak,48,12,36,2010
2010-11-19,Sarawak,17,1,16,2010
2010-11-20,Sarawak,40,16,24,2010
2010-11-21,Sarawak,96,28,68,2010
2010-11-22,Sarawak,23,7,16,2010
2010-11-23,Sarawak,40,16,24,2010
2010-11-24,Sarawak,8,1,7,2010
2010-11-25,Sarawak,13,3,10,2010
2010-11-26,Sarawak,8,2,6,2010
2010-11-27,Sarawak,42,17,25,2010
2010-11-28,Sarawak,52,13,39,2010
2010-11-29,Sarawak,47,11,36,2010
2010-11-30,Sarawak,152,87,65,2010
2010-12-01,Sarawak,10,1,9,2010
2010-12-02,Sarawak,32,10,22,2010
2010-12-03,Sarawak,11,2,9,2010
2010-12-04,Sarawak,3,2,1,2010
2010-12-05,Sarawak,166,34,132,2010
2010-12-06,Sarawak,10,1,9,2010
2010-12-07,Sarawak,53,25,28,2010
2010-12-08,Sarawak,12,3,9,2010
2010-12-09,Sarawak,16,0,16,2010
2010-12-10,Sarawak,18,6,12,2010
2010-12-11,Sarawak,18,9,9,2010
2010-12-12,Sarawak,120,62,58,2010
2010-12-13,Sarawak,9,1,8,2010
2010-12-14,Sarawak,25,7,18,2010
2010-12-15,Sarawak,18,2,16,2010
2010-12-16,Sarawak,11,0,11,2010
2010-12-17,Sarawak,14,2,12,2010
2010-12-18,Sarawak,31,5,26,2010
2010-12-19,Sarawak,168,44,124,2010
2010-12-20,Sarawak,21,4,17,2010
2010-12-21,Sarawak,23,4,19,2010
2010-12-22,Sarawak,18,4,14,2010
2010-12-23,Sarawak,39,7,32,2010
2010-12-24,Sarawak,19,3,16,2010
2010-12-25,Sarawak,0,0,0,2010
2010-12-26,Sarawak,65,13,52,2010
2010-12-27,Sarawak,20,2,18,2010
2010-12-28,Sarawak,15,2,13,2010
2010-12-29,Sarawak,22,3,19,2010
2010-12-30,Sarawak,22,5,17,2010
2010-12-31,Sarawak,5,0,5,2010
2011-01-01,Sarawak,154,33,121,2011
2011-01-02,Sarawak,98,9,89,2011
2011-01-03,Sarawak,12,2,10,2011
2011-01-04,Sarawak,21,3,18,2011
2011-01-05,Sarawak,28,3,25,2011
2011-01-06,Sarawak,38,19,19,2011
2011-01-07,Sarawak,23,1,22,2011
2011-01-08,Sarawak,8,8,0,2011
2011-01-09,Sarawak,240,65,175,2011
2011-01-10,Sarawak,26,3,23,2011
2011-01-11,Sarawak,15,2,13,2011
2011-01-12,Sarawak,35,8,27,2011
2011-01-13,Sarawak,15,3,12,2011
2011-01-14,Sarawak,42,12,30,2011
2011-01-15,Sarawak,51,34,17,2011
2011-01-16,Sarawak,133,37,96,2011
2011-01-17,Sarawak,14,1,13,2011
2011-01-18,Sarawak,25,8,17,2011
2011-01-19,Sarawak,40,16,24,2011
2011-01-20,Sarawak,72,19,53,2011
2011-01-21,Sarawak,31,8,23,2011
2011-01-22,Sarawak,50,22,28,2011
2011-01-23,Sarawak,107,30,77,2011
2011-01-24,Sarawak,49,14,35,2011
2011-01-25,Sarawak,68,38,30,2011
2011-01-26,Sarawak,31,14,17,2011
2011-01-27,Sarawak,49,28,21,2011
2011-01-28,Sarawak,30,1,29,2011
2011-01-29,Sarawak,38,16,22,2011
2011-01-30,Sarawak,76,31,45,2011
2011-01-31,Sarawak,38,5,33,2011
2011-02-01,Sarawak,25,5,20,2011
2011-02-02,Sarawak,30,2,28,2011
2011-02-03,Sarawak,0,0,0,2011
2011-02-04,Sarawak,0,0,0,2011
2011-02-05,Sarawak,127,94,33,2011
2011-02-06,Sarawak,30,25,5,2011
2011-02-07,Sarawak,27,3,24,2011
2011-02-08,Sarawak,20,2,18,2011
2011-02-09,Sarawak,40,17,23,2011
2011-02-10,Sarawak,137,73,64,2011
2011-02-11,Sarawak,28,4,24,2011
2011-02-12,Sarawak,13,7,6,2011
2011-02-13,Sarawak,27,6,21,2011
2011-02-14,Sarawak,43,8,35,2011
2011-02-15,Sarawak,0,0,0,2011
2011-02-16,Sarawak,47,19,28,2011
2011-02-17,Sarawak,46,27,19,2011
2011-02-18,Sarawak,19,2,17,2011
2011-02-19,Sarawak,194,110,84,2011
2011-02-20,Sarawak,86,18,68,2011
2011-02-21,Sarawak,50,18,32,2011
2011-02-22,Sarawak,50,9,41,2011
2011-02-23,Sarawak,52,15,37,2011
2011-02-24,Sarawak,35,6,29,2011
2011-02-25,Sarawak,16,2,14,2011
2011-02-26,Sarawak,0,0,0,2011
2011-02-27,Sarawak,169,21,148,2011
2011-02-28,Sarawak,52,5,47,2011
2011-03-01,Sarawak,69,27,42,2011
2011-03-02,Sarawak,101,50,51,2011
2011-03-03,Sarawak,70,15,55,2011
2011-03-04,Sarawak,18,3,15,2011
2011-03-05,Sarawak,43,14,29,2011
2011-03-06,Sarawak,37,5,32,2011
2011-03-07,Sarawak,14,3,11,2011
2011-03-08,Sarawak,17,4,13,2011
2011-03-09,Sarawak,46,3,43,2011
2011-03-10,Sarawak,40,17,23,2011
2011-03-11,Sarawak,26,11,15,2011
2011-03-12,Sarawak,92,43,49,2011
2011-03-13,Sarawak,131,16,115,2011
2011-03-14,Sarawak,35,19,16,2011
2011-03-15,Sarawak,88,51,37,2011
2011-03-16,Sarawak,63,35,28,2011
2011-03-17,Sarawak,32,18,14,2011
2011-03-18,Sarawak,19,1,18,2011
2011-03-19,Sarawak,38,17,21,2011
2011-03-20,Sarawak,182,21,161,2011
2011-03-21,Sarawak,18,0,18,2011
2011-03-22,Sarawak,56,9,47,2011
2011-03-23,Sarawak,31,4,27,2011
2011-03-24,Sarawak,39,6,33,2011
2011-03-25,Sarawak,22,6,16,2011
2011-03-26,Sarawak,27,11,16,2011
2011-03-27,Sarawak,48,11,37,2011
2011-03-28,Sarawak,63,34,29,2011
2011-03-29,Sarawak,15,1,14,2011
2011-03-30,Sarawak,17,2,15,2011
2011-03-31,Sarawak,18,1,17,2011
2011-04-01,Sarawak,16,2,14,2011
2011-04-02,Sarawak,13,6,7,2011
2011-04-03,Sarawak,174,25,149,2011
2011-04-04,Sarawak,15,3,12,2011
2011-04-05,Sarawak,24,6,18,2011
2011-04-06,Sarawak,31,9,22,2011
2011-04-07,Sarawak,15,0,15,2011
2011-04-08,Sarawak,26,5,21,2011
2011-04-09,Sarawak,23,15,8,2011
2011-04-10,Sarawak,65,21,44,2011
2011-04-11,Sarawak,16,2,14,2011
2011-04-12,Sarawak,12,0,12,2011
2011-04-13,Sarawak,10,0,10,2011
2011-04-14,Sarawak,34,13,21,2011
2011-04-15,Sarawak,20,1,19,2011
2011-04-16,Sarawak,9,5,4,2011
2011-04-17,Sarawak,91,30,61,2011
2011-04-18,Sarawak,26,1,25,2011
2011-04-19,Sarawak,18,9,9,2011
2011-04-20,Sarawak,12,1,11,2011
2011-04-21,Sarawak,30,1,29,2011
2011-04-22,Sarawak,118,14,104,2011
2011-04-23,Sarawak,61,12,49,2011
2011-04-24,Sarawak,62,8,54,2011
2011-04-25,Sarawak,24,1,23,2011
2011-04-26,Sarawak,45,16,29,2011
2011-04-27,Sarawak,38,5,33,2011
2011-04-28,Sarawak,41,10,31,2011
2011-04-29,Sarawak,20,3,17,2011
2011-04-30,Sarawak,25,9,16,2011
2011-05-01,Sarawak,129,8,121,2011
2011-05-02,Sarawak,56,22,34,2011
2011-05-03,Sarawak,12,1,11,2011
2011-05-04,Sarawak,57,20,37,2011
2011-05-05,Sarawak,19,3,16,2011
2011-05-06,Sarawak,31,4,27,2011
2011-05-07,Sarawak,138,67,71,2011
2011-05-08,Sarawak,49,14,35,2011
2011-05-09,Sarawak,25,4,21,2011
2011-05-10,Sarawak,47,18,29,2011
2011-05-11,Sarawak,17,4,13,2011
2011-05-12,Sarawak,51,7,44,2011
2011-05-13,Sarawak,20,2,18,2011
2011-05-14,Sarawak,7,0,7,2011
2011-05-15,Sarawak,52,17,35,2011
2011-05-16,Sarawak,66,16,50,2011
2011-05-17,Sarawak,37,9,28,2011
2011-05-18,Sarawak,65,20,45,2011
2011-05-19,Sarawak,29,10,19,2011
2011-05-20,Sarawak,19,5,14,2011
2011-05-21,Sarawak,32,21,11,2011
2011-05-22,Sarawak,156,27,129,2011
2011-05-23,Sarawak,26,14,12,2011
2011-05-24,Sarawak,14,0,14,2011
2011-05-25,Sarawak,80,25,55,2011
2011-05-26,Sarawak,29,6,23,2011
2011-05-27,Sarawak,18,0,18,2011
2011-05-28,Sarawak,5,0,5,2011
2011-05-29,Sarawak,40,12,28,2011
2011-05-30,Sarawak,18,2,16,2011
2011-05-31,Sarawak,17,0,17,2011
2011-06-01,Sarawak,3,0,3,2011
2011-06-02,Sarawak,0,0,0,2011
2011-06-03,Sarawak,14,1,13,2011
2011-06-04,Sarawak,6,1,5,2011
2011-06-05,Sarawak,99,18,81,2011
2011-06-06,Sarawak,18,9,9,2011
2011-06-07,Sarawak,11,1,10,2011
2011-06-08,Sarawak,13,0,13,2011
2011-06-09,Sarawak,39,14,25,2011
2011-06-10,Sarawak,13,1,12,2011
2011-06-11,Sarawak,78,55,23,2011
2011-06-12,Sarawak,264,35,229,2011
2011-06-13,Sarawak,15,5,10,2011
2011-06-14,Sarawak,24,3,21,2011
2011-06-15,Sarawak,49,23,26,2011
2011-06-16,Sarawak,19,1,18,2011
2011-06-17,Sarawak,18,2,16,2011
2011-06-18,Sarawak,0,0,0,2011
2011-06-19,Sarawak,84,24,60,2011
2011-06-20,Sarawak,26,3,23,2011
2011-06-21,Sarawak,35,17,18,2011
2011-06-22,Sarawak,98,22,76,2011
2011-06-23,Sarawak,37,17,20,2011
2011-06-24,Sarawak,12,1,11,2011
2011-06-25,Sarawak,50,16,34,2011
2011-06-26,Sarawak,170,27,143,2011
2011-06-27,Sarawak,25,4,21,2011
2011-06-28,Sarawak,30,10,20,2011
2011-06-29,Sarawak,67,18,49,2011
2011-06-30,Sarawak,47,15,32,2011
2011-07-01,Sarawak,13,3,10,2011
2011-07-02,Sarawak,10,3,7,2011
2011-07-03,Sarawak,193,32,161,2011
2011-07-04,Sarawak,33,6,27,2011
2011-07-05,Sarawak,13,1,12,2011
2011-07-06,Sarawak,23,5,18,2011
2011-07-07,Sarawak,51,14,37,2011
2011-07-08,Sarawak,18,1,17,2011
2011-07-09,Sarawak,29,2,27,2011
2011-07-10,Sarawak,54,7,47,2011
2011-07-11,Sarawak,21,1,20,2011
2011-07-12,Sarawak,14,1,13,2011
2011-07-13,Sarawak,70,17,53,2011
2011-07-14,Sarawak,13,0,13,2011
2011-07-15,Sarawak,26,1,25,2011
2011-07-16,Sarawak,64,43,21,2011
2011-07-17,Sarawak,114,21,93,2011
2011-07-18,Sarawak,21,2,19,2011
2011-07-19,Sarawak,67,23,44,2011
2011-07-20,Sarawak,90,32,58,2011
2011-07-21,Sarawak,73,20,53,2011
2011-07-22,Sarawak,21,5,16,2011
2011-07-23,Sarawak,64,28,36,2011
2011-07-24,Sarawak,139,27,112,2011
2011-07-25,Sarawak,25,2,23,2011
2011-07-26,Sarawak,90,37,53,2011
2011-07-27,Sarawak,87,10,77,2011
2011-07-28,Sarawak,50,8,42,2011
2011-07-29,Sarawak,32,4,28,2011
2011-07-30,Sarawak,205,129,76,2011
2011-07-31,Sarawak,103,24,79,2011
2011-08-01,Sarawak,13,5,8,2011
2011-08-02,Sarawak,7,1,6,2011
2011-08-03,Sarawak,21,11,10,2011
2011-08-04,Sarawak,6,0,6,2011
2011-08-05,Sarawak,12,1,11,2011
2011-08-06,Sarawak,0,0,0,2011
2011-08-07,Sarawak,208,25,183,2011
2011-08-08,Sarawak,11,0,11,2011
2011-08-09,Sarawak,12,1,11,2011
2011-08-10,Sarawak,10,4,6,2011
2011-08-11,Sarawak,31,7,24,2011
2011-08-12,Sarawak,12,1,11,2011
2011-08-13,Sarawak,21,12,9,2011
2011-08-14,Sarawak,103,25,78,2011
2011-08-15,Sarawak,8,1,7,2011
2011-08-16,Sarawak,13,2,11,2011
2011-08-17,Sarawak,8,0,8,2011
2011-08-18,Sarawak,15,4,11,2011
2011-08-19,Sarawak,12,0,12,2011
2011-08-20,Sarawak,33,15,18,2011
2011-08-21,Sarawak,139,24,115,2011
2011-08-22,Sarawak,4,0,4,2011
2011-08-23,Sarawak,24,8,16,2011
2011-08-24,Sarawak,65,55,10,2011
2011-08-25,Sarawak,27,7,20,2011
2011-08-26,Sarawak,13,5,8,2011
2011-08-27,Sarawak,17,6,11,2011
2011-08-28,Sarawak,17,1,16,2011
2011-08-29,Sarawak,22,1,21,2011
2011-08-30,Sarawak,0,0,0,2011
2011-08-31,Sarawak,0,0,0,2011
2011-09-01,Sarawak,2,0,2,2011
2011-09-02,Sarawak,34,5,29,2011
2011-09-03,Sarawak,0,0,0,2011
2011-09-04,Sarawak,22,5,17,2011
2011-09-05,Sarawak,26,1,25,2011
2011-09-06,Sarawak,21,2,19,2011
2011-09-07,Sarawak,19,1,18,2011
2011-09-08,Sarawak,52,14,38,2011
2011-09-09,Sarawak,12,1,11,2011
2011-09-10,Sarawak,68,30,38,2011
2011-09-11,Sarawak,202,26,176,2011
2011-09-12,Sarawak,18,2,16,2011
2011-09-13,Sarawak,18,4,14,2011
2011-09-14,Sarawak,25,4,21,2011
2011-09-15,Sarawak,16,1,15,2011
2011-09-16,Sarawak,91,30,61,2011
2011-09-17,Sarawak,24,5,19,2011
2011-09-18,Sarawak,170,22,148,2011
2011-09-19,Sarawak,36,11,25,2011
2011-09-20,Sarawak,19,3,16,2011
2011-09-21,Sarawak,40,13,27,2011
2011-09-22,Sarawak,78,27,51,2011
2011-09-23,Sarawak,27,0,27,2011
2011-09-24,Sarawak,44,11,33,2011
2011-09-25,Sarawak,161,15,146,2011
2011-09-26,Sarawak,16,1,15,2011
2011-09-27,Sarawak,58,28,30,2011
2011-09-28,Sarawak,26,3,23,2011
2011-09-29,Sarawak,32,2,30,2011
2011-09-30,Sarawak,29,2,27,2011
2011-10-01,Sarawak,0,0,0,2011
2011-10-02,Sarawak,147,31,116,2011
2011-10-03,Sarawak,21,2,19,2011
2011-10-04,Sarawak,22,2,20,2011
2011-10-05,Sarawak,39,12,27,2011
2011-10-06,Sarawak,21,4,17,2011
2011-10-07,Sarawak,20,0,20,2011
2011-10-08,Sarawak,3,0,3,2011
2011-10-09,Sarawak,226,56,170,2011
2011-10-10,Sarawak,29,7,22,2011
2011-10-11,Sarawak,28,3,25,2011
2011-10-12,Sarawak,12,2,10,2011
2011-10-13,Sarawak,30,13,17,2011
2011-10-14,Sarawak,12,1,11,2011
2011-10-15,Sarawak,84,56,28,2011
2011-10-16,Sarawak,136,18,118,2011
2011-10-17,Sarawak,17,1,16,2011
2011-10-18,Sarawak,64,8,56,2011
2011-10-19,Sarawak,31,6,25,2011
2011-10-20,Sarawak,18,4,14,2011
2011-10-21,Sarawak,28,7,21,2011
2011-10-22,Sarawak,81,35,46,2011
2011-10-23,Sarawak,68,14,54,2011
2011-10-24,Sarawak,22,2,20,2011
2011-10-25,Sarawak,16,1,15,2011
2011-10-26,Sarawak,14,2,12,2011
2011-10-27,Sarawak,17,0,17,2011
2011-10-28,Sarawak,46,11,35,2011
2011-10-29,Sarawak,52,22,30,2011
2011-10-30,Sarawak,158,29,129,2011
2011-10-31,Sarawak,17,6,11,2011
2011-11-01,Sarawak,47,5,42,2011
2011-11-02,Sarawak,17,1,16,2011
2011-11-03,Sarawak,87,38,49,2011
2011-11-04,Sarawak,22,7,15,2011
2011-11-05,Sarawak,37,28,9,2011
2011-11-06,Sarawak,70,23,47,2011
2011-11-07,Sarawak,21,8,13,2011
2011-11-08,Sarawak,18,1,17,2011
2011-11-09,Sarawak,27,17,10,2011
2011-11-10,Sarawak,42,7,35,2011
2011-11-11,Sarawak,25,3,22,2011
2011-11-12,Sarawak,29,11,18,2011
2011-11-13,Sarawak,127,6,121,2011
2011-11-14,Sarawak,19,3,16,2011
2011-11-15,Sarawak,9,0,9,2011
2011-11-16,Sarawak,15,1,14,2011
2011-11-17,Sarawak,64,28,36,2011
2011-11-18,Sarawak,12,4,8,2011
2011-11-19,Sarawak,45,12,33,2011
2011-11-20,Sarawak,167,34,133,2011
2011-11-21,Sarawak,62,29,33,2011
2011-11-22,Sarawak,83,36,47,2011
2011-11-23,Sarawak,35,8,27,2011
2011-11-24,Sarawak,52,14,38,2011
2011-11-25,Sarawak,22,2,20,2011
2011-11-26,Sarawak,69,30,39,2011
2011-11-27,Sarawak,110,52,58,2011
2011-11-28,Sarawak,24,5,19,2011
2011-11-29,Sarawak,110,52,58,2011
2011-11-30,Sarawak,29,4,25,2011
2011-12-01,Sarawak,24,7,17,2011
2011-12-02,Sarawak,19,5,14,2011
2011-12-03,Sarawak,20,10,10,2011
2011-12-04,Sarawak,140,27,113,2011
2011-12-05,Sarawak,20,4,16,2011
2011-12-06,Sarawak,6,1,5,2011
2011-12-07,Sarawak,59,24,35,2011
2011-12-08,Sarawak,29,2,27,2011
2011-12-09,Sarawak,13,3,10,2011
2011-12-10,Sarawak,28,11,17,2011
2011-12-11,Sarawak,43,9,34,2011
2011-12-12,Sarawak,19,1,18,2011
2011-12-13,Sarawak,22,2,20,2011
2011-12-14,Sarawak,53,24,29,2011
2011-12-15,Sarawak,61,7,54,2011
2011-12-16,Sarawak,17,0,17,2011
2011-12-17,Sarawak,184,113,71,2011
2011-12-18,Sarawak,55,5,50,2011
2011-12-19,Sarawak,46,6,40,2011
2011-12-20,Sarawak,31,14,17,2011
2011-12-21,Sarawak,31,17,14,2011
2011-12-22,Sarawak,20,3,17,2011
2011-12-23,Sarawak,25,0,25,2011
2011-12-24,Sarawak,10,0,10,2011
2011-12-25,Sarawak,0,0,0,2011
2011-12-26,Sarawak,1,0,1,2011
2011-12-27,Sarawak,29,7,22,2011
2011-12-28,Sarawak,14,0,14,2011
2011-12-29,Sarawak,41,0,41,2011
2011-12-30,Sarawak,37,3,34,2011
2011-12-31,Sarawak,0,0,0,2011
2012-01-01,Sarawak,237,32,205,2012
2012-01-02,Sarawak,0,0,0,2012
2012-01-03,Sarawak,10,0,10,2012
2012-01-04,Sarawak,13,1,12,2012
2012-01-05,Sarawak,9,2,7,2012
2012-01-06,Sarawak,21,0,21,2012
2012-01-07,Sarawak,11,6,5,2012
2012-01-08,Sarawak,180,20,160,2012
2012-01-09,Sarawak,17,1,16,2012
2012-01-10,Sarawak,25,2,23,2012
2012-01-11,Sarawak,26,3,23,2012
2012-01-12,Sarawak,15,3,12,2012
2012-01-13,Sarawak,24,5,19,2012
2012-01-14,Sarawak,71,58,13,2012
2012-01-15,Sarawak,61,15,46,2012
2012-01-16,Sarawak,13,2,11,2012
2012-01-17,Sarawak,75,24,51,2012
2012-01-18,Sarawak,35,3,32,2012
2012-01-19,Sarawak,19,0,19,2012
2012-01-20,Sarawak,46,3,43,2012
2012-01-21,Sarawak,15,0,15,2012
2012-01-22,Sarawak,0,0,0,2012
2012-01-23,Sarawak,2,0,2,2012
2012-01-24,Sarawak,4,2,2,2012
2012-01-25,Sarawak,21,0,21,2012
2012-01-26,Sarawak,44,17,27,2012
2012-01-27,Sarawak,45,4,41,2012
2012-01-28,Sarawak,116,75,41,2012
2012-01-29,Sarawak,59,10,49,2012
2012-01-30,Sarawak,26,1,25,2012
2012-01-31,Sarawak,18,0,18,2012
2012-02-01,Sarawak,22,1,21,2012
2012-02-02,Sarawak,32,2,30,2012
2012-02-03,Sarawak,39,7,32,2012
2012-02-04,Sarawak,15,2,13,2012
2012-02-05,Sarawak,50,12,38,2012
2012-02-06,Sarawak,0,0,0,2012
2012-02-07,Sarawak,41,9,32,2012
2012-02-08,Sarawak,41,7,34,2012
2012-02-09,Sarawak,40,7,33,2012
2012-02-10,Sarawak,14,2,12,2012
2012-02-11,Sarawak,27,6,21,2012
2012-02-12,Sarawak,51,20,31,2012
2012-02-13,Sarawak,35,5,30,2012
2012-02-14,Sarawak,65,24,41,2012
2012-02-15,Sarawak,76,19,57,2012
2012-02-16,Sarawak,16,2,14,2012
2012-02-17,Sarawak,19,2,17,2012
2012-02-18,Sarawak,92,47,45,2012
2012-02-19,Sarawak,258,25,233,2012
2012-02-20,Sarawak,21,3,18,2012
2012-02-21,Sarawak,61,14,47,2012
2012-02-22,Sarawak,30,5,25,2012
2012-02-23,Sarawak,34,18,16,2012
2012-02-24,Sarawak,16,2,14,2012
2012-02-25,Sarawak,13,7,6,2012
2012-02-26,Sarawak,103,22,81,2012
2012-02-27,Sarawak,38,25,13,2012
2012-02-28,Sarawak,43,11,32,2012
2012-02-29,Sarawak,29,9,20,2012
2012-03-01,Sarawak,32,11,21,2012
2012-03-02,Sarawak,25,3,22,2012
2012-03-03,Sarawak,26,7,19,2012
2012-03-04,Sarawak,215,25,190,2012
2012-03-05,Sarawak,15,4,11,2012
2012-03-06,Sarawak,54,10,44,2012
2012-03-07,Sarawak,61,36,25,2012
2012-03-08,Sarawak,30,8,22,2012
2012-03-09,Sarawak,16,1,15,2012
2012-03-10,Sarawak,0,0,0,2012
2012-03-11,Sarawak,51,20,31,2012
2012-03-12,Sarawak,18,4,14,2012
2012-03-13,Sarawak,50,11,39,2012
2012-03-14,Sarawak,21,1,20,2012
2012-03-15,Sarawak,26,2,24,2012
2012-03-16,Sarawak,16,3,13,2012
2012-03-17,Sarawak,32,5,27,2012
2012-03-18,Sarawak,261,23,238,2012
2012-03-19,Sarawak,47,7,40,2012
2012-03-20,Sarawak,54,6,48,2012
2012-03-21,Sarawak,82,30,52,2012
2012-03-22,Sarawak,83,22,61,2012
2012-03-23,Sarawak,20,2,18,2012
2012-03-24,Sarawak,17,2,15,2012
2012-03-25,Sarawak,206,55,151,2012
2012-03-26,Sarawak,4,0,4,2012
2012-03-27,Sarawak,89,36,53,2012
2012-03-28,Sarawak,19,4,15,2012
2012-03-29,Sarawak,30,2,28,2012
2012-03-30,Sarawak,24,3,21,2012
2012-03-31,Sarawak,39,20,19,2012
2012-04-01,Sarawak,204,35,169,2012
2012-04-02,Sarawak,14,2,12,2012
2012-04-03,Sarawak,40,24,16,2012
2012-04-04,Sarawak,36,16,20,2012
2012-04-05,Sarawak,58,7,51,2012
2012-04-06,Sarawak,18,16,2,2012
2012-04-07,Sarawak,78,34,44,2012
2012-04-08,Sarawak,49,13,36,2012
2012-04-09,Sarawak,28,3,25,2012
2012-04-10,Sarawak,37,17,20,2012
2012-04-11,Sarawak,63,24,39,2012
2012-04-12,Sarawak,36,12,24,2012
2012-04-13,Sarawak,23,0,23,2012
2012-04-14,Sarawak,26,9,17,2012
2012-04-15,Sarawak,236,22,214,2012
2012-04-16,Sarawak,20,2,18,2012
2012-04-17,Sarawak,35,10,25,2012
2012-04-18,Sarawak,13,0,13,2012
2012-04-19,Sarawak,19,2,17,2012
2012-04-20,Sarawak,17,2,15,2012
2012-04-21,Sarawak,38,21,17,2012
2012-04-22,Sarawak,84,29,55,2012
2012-04-23,Sarawak,7,0,7,2012
2012-04-24,Sarawak,54,19,35,2012
2012-04-25,Sarawak,45,7,38,2012
2012-04-26,Sarawak,24,9,15,2012
2012-04-27,Sarawak,17,3,14,2012
2012-04-28,Sarawak,29,16,13,2012
2012-04-29,Sarawak,39,14,25,2012
2012-04-30,Sarawak,38,18,20,2012
2012-05-01,Sarawak,52,33,19,2012
2012-05-02,Sarawak,50,29,21,2012
2012-05-03,Sarawak,44,1,43,2012
2012-05-04,Sarawak,29,0,29,2012
2012-05-05,Sarawak,43,14,29,2012
2012-05-06,Sarawak,224,43,181,2012
2012-05-07,Sarawak,17,1,16,2012
2012-05-08,Sarawak,76,26,50,2012
2012-05-09,Sarawak,29,9,20,2012
2012-05-10,Sarawak,30,9,21,2012
2012-05-11,Sarawak,18,3,15,2012
2012-05-12,Sarawak,73,46,27,2012
2012-05-13,Sarawak,35,7,28,2012
2012-05-14,Sarawak,17,0,17,2012
2012-05-15,Sarawak,211,138,73,2012
2012-05-16,Sarawak,29,12,17,2012
2012-05-17,Sarawak,13,0,13,2012
2012-05-18,Sarawak,17,5,12,2012
2012-05-19,Sarawak,40,12,28,2012
2012-05-20,Sarawak,181,25,156,2012
2012-05-21,Sarawak,73,25,48,2012
2012-05-22,Sarawak,86,33,53,2012
2012-05-23,Sarawak,14,1,13,2012
2012-05-24,Sarawak,17,3,14,2012
2012-05-25,Sarawak,17,2,15,2012
2012-05-26,Sarawak,50,21,29,2012
2012-05-27,Sarawak,28,7,21,2012
2012-05-28,Sarawak,19,2,17,2012
2012-05-29,Sarawak,18,1,17,2012
2012-05-30,Sarawak,14,1,13,2012
2012-05-31,Sarawak,19,2,17,2012
2012-06-01,Sarawak,1,0,1,2012
2012-06-02,Sarawak,2,0,2,2012
2012-06-03,Sarawak,4,0,4,2012
2012-06-04,Sarawak,0,0,0,2012
2012-06-05,Sarawak,19,4,15,2012
2012-06-06,Sarawak,16,0,16,2012
2012-06-07,Sarawak,31,7,24,2012
2012-06-08,Sarawak,15,2,13,2012
2012-06-09,Sarawak,18,7,11,2012
2012-06-10,Sarawak,172,23,149,2012
2012-06-11,Sarawak,19,2,17,2012
2012-06-12,Sarawak,56,19,37,2012
2012-06-13,Sarawak,36,11,25,2012
2012-06-14,Sarawak,27,3,24,2012
2012-06-15,Sarawak,22,4,18,2012
2012-06-16,Sarawak,69,25,44,2012
2012-06-17,Sarawak,179,30,149,2012
2012-06-18,Sarawak,19,1,18,2012
2012-06-19,Sarawak,14,2,12,2012
2012-06-20,Sarawak,23,3,20,2012
2012-06-21,Sarawak,36,12,24,2012
2012-06-22,Sarawak,25,2,23,2012
2012-06-23,Sarawak,44,28,16,2012
2012-06-24,Sarawak,133,18,115,2012
2012-06-25,Sarawak,41,6,35,2012
2012-06-26,Sarawak,29,9,20,2012
2012-06-27,Sarawak,39,7,32,2012
2012-06-28,Sarawak,25,5,20,2012
2012-06-29,Sarawak,25,2,23,2012
2012-06-30,Sarawak,84,50,34,2012
2012-07-01,Sarawak,268,39,229,2012
2012-07-02,Sarawak,38,14,24,2012
2012-07-03,Sarawak,83,22,61,2012
2012-07-04,Sarawak,15,7,8,2012
2012-07-05,Sarawak,43,5,38,2012
2012-07-06,Sarawak,20,0,20,2012
2012-07-07,Sarawak,84,36,48,2012
2012-07-08,Sarawak,104,12,92,2012
2012-07-09,Sarawak,45,6,39,2012
2012-07-10,Sarawak,46,27,19,2012
2012-07-11,Sarawak,8,2,6,2012
2012-07-12,Sarawak,52,11,41,2012
2012-07-13,Sarawak,20,2,18,2012
2012-07-14,Sarawak,210,103,107,2012
2012-07-15,Sarawak,95,25,70,2012
2012-07-16,Sarawak,51,19,32,2012
2012-07-17,Sarawak,26,4,22,2012
2012-07-18,Sarawak,21,2,19,2012
2012-07-19,Sarawak,43,10,33,2012
2012-07-20,Sarawak,28,0,28,2012
2012-07-21,Sarawak,13,3,10,2012
2012-07-22,Sarawak,164,14,150,2012
2012-07-23,Sarawak,4,0,4,2012
2012-07-24,Sarawak,12,1,11,2012
2012-07-25,Sarawak,19,1,18,2012
2012-07-26,Sarawak,21,4,17,2012
2012-07-27,Sarawak,14,1,13,2012
2012-07-28,Sarawak,97,36,61,2012
2012-07-29,Sarawak,57,19,38,2012
2012-07-30,Sarawak,16,1,15,2012
2012-07-31,Sarawak,9,2,7,2012
2012-08-01,Sarawak,16,2,14,2012
2012-08-02,Sarawak,20,4,16,2012
2012-08-03,Sarawak,15,1,14,2012
2012-08-04,Sarawak,12,2,10,2012
2012-08-05,Sarawak,110,11,99,2012
2012-08-06,Sarawak,6,2,4,2012
2012-08-07,Sarawak,30,20,10,2012
2012-08-08,Sarawak,8,2,6,2012
2012-08-09,Sarawak,9,0,9,2012
2012-08-10,Sarawak,11,0,11,2012
2012-08-11,Sarawak,11,2,9,2012
2012-08-12,Sarawak,84,10,74,2012
2012-08-13,Sarawak,10,1,9,2012
2012-08-14,Sarawak,13,0,13,2012
2012-08-15,Sarawak,7,0,7,2012
2012-08-16,Sarawak,13,1,12,2012
2012-08-17,Sarawak,20,2,18,2012
2012-08-18,Sarawak,20,6,14,2012
2012-08-19,Sarawak,0,0,0,2012
2012-08-20,Sarawak,0,0,0,2012
2012-08-21,Sarawak,0,0,0,2012
2012-08-22,Sarawak,21,1,20,2012
2012-08-23,Sarawak,23,2,21,2012
2012-08-24,Sarawak,14,1,13,2012
2012-08-25,Sarawak,42,18,24,2012
2012-08-26,Sarawak,54,8,46,2012
2012-08-27,Sarawak,24,2,22,2012
2012-08-28,Sarawak,51,6,45,2012
2012-08-29,Sarawak,25,4,21,2012
2012-08-30,Sarawak,44,11,33,2012
2012-08-31,Sarawak,110,9,101,2012
2012-09-01,Sarawak,40,11,29,2012
2012-09-02,Sarawak,106,27,79,2012
2012-09-03,Sarawak,20,2,18,2012
2012-09-04,Sarawak,27,7,20,2012
2012-09-05,Sarawak,16,0,16,2012
2012-09-06,Sarawak,22,3,19,2012
2012-09-07,Sarawak,19,3,16,2012
2012-09-08,Sarawak,34,14,20,2012
2012-09-09,Sarawak,157,13,144,2012
2012-09-10,Sarawak,51,20,31,2012
2012-09-11,Sarawak,141,100,41,2012
2012-09-12,Sarawak,25,3,22,2012
2012-09-13,Sarawak,46,22,24,2012
2012-09-14,Sarawak,19,3,16,2012
2012-09-15,Sarawak,78,56,22,2012
2012-09-16,Sarawak,68,14,54,2012
2012-09-17,Sarawak,0,0,0,2012
2012-09-18,Sarawak,86,14,72,2012
2012-09-19,Sarawak,24,6,18,2012
2012-09-20,Sarawak,65,24,41,2012
2012-09-21,Sarawak,36,4,32,2012
2012-09-22,Sarawak,116,71,45,2012
2012-09-23,Sarawak,194,26,168,2012
2012-09-24,Sarawak,25,2,23,2012
2012-09-25,Sarawak,28,5,23,2012
2012-09-26,Sarawak,24,4,20,2012
2012-09-27,Sarawak,33,11,22,2012
2012-09-28,Sarawak,25,0,25,2012
2012-09-29,Sarawak,55,15,40,2012
2012-09-30,Sarawak,49,29,20,2012
2012-10-01,Sarawak,38,3,35,2012
2012-10-02,Sarawak,23,4,19,2012
2012-10-03,Sarawak,70,36,34,2012
2012-10-04,Sarawak,15,3,12,2012
2012-10-05,Sarawak,16,2,14,2012
2012-10-06,Sarawak,101,47,54,2012
2012-10-07,Sarawak,268,46,222,2012
2012-10-08,Sarawak,60,7,53,2012
2012-10-09,Sarawak,60,15,45,2012
2012-10-10,Sarawak,17,3,14,2012
2012-10-11,Sarawak,49,8,41,2012
2012-10-12,Sarawak,21,3,18,2012
2012-10-13,Sarawak,62,24,38,2012
2012-10-14,Sarawak,152,28,124,2012
2012-10-15,Sarawak,16,1,15,2012
2012-10-16,Sarawak,36,18,18,2012
2012-10-17,Sarawak,52,9,43,2012
2012-10-18,Sarawak,55,29,26,2012
2012-10-19,Sarawak,12,0,12,2012
2012-10-20,Sarawak,20,9,11,2012
2012-10-21,Sarawak,191,30,161,2012
2012-10-22,Sarawak,25,1,24,2012
2012-10-23,Sarawak,29,15,14,2012
2012-10-24,Sarawak,9,1,8,2012
2012-10-25,Sarawak,17,3,14,2012
2012-10-26,Sarawak,0,0,0,2012
2012-10-27,Sarawak,57,28,29,2012
2012-10-28,Sarawak,167,83,84,2012
2012-10-29,Sarawak,15,0,15,2012
2012-10-30,Sarawak,21,2,19,2012
2012-10-31,Sarawak,46,17,29,2012
2012-11-01,Sarawak,41,3,38,2012
2012-11-02,Sarawak,14,1,13,2012
2012-11-03,Sarawak,9,3,6,2012
2012-11-04,Sarawak,187,14,173,2012
2012-11-05,Sarawak,13,0,13,2012
2012-11-06,Sarawak,16,2,14,2012
2012-11-07,Sarawak,17,4,13,2012
2012-11-08,Sarawak,18,1,17,2012
2012-11-09,Sarawak,20,2,18,2012
2012-11-10,Sarawak,43,21,22,2012
2012-11-11,Sarawak,49,9,40,2012
2012-11-12,Sarawak,21,1,20,2012
2012-11-13,Sarawak,22,6,16,2012
2012-11-14,Sarawak,96,45,51,2012
2012-11-15,Sarawak,45,16,29,2012
2012-11-16,Sarawak,21,2,19,2012
2012-11-17,Sarawak,49,22,27,2012
2012-11-18,Sarawak,192,44,148,2012
2012-11-19,Sarawak,24,7,17,2012
2012-11-20,Sarawak,66,9,57,2012
2012-11-21,Sarawak,36,7,29,2012
2012-11-22,Sarawak,15,2,13,2012
2012-11-23,Sarawak,15,0,15,2012
2012-11-24,Sarawak,10,5,5,2012
2012-11-25,Sarawak,116,16,100,2012
2012-11-26,Sarawak,48,23,25,2012
2012-11-27,Sarawak,47,12,35,2012
2012-11-28,Sarawak,91,43,48,2012
2012-11-29,Sarawak,50,14,36,2012
2012-11-30,Sarawak,20,1,19,2012
2012-12-01,Sarawak,36,9,27,2012
2012-12-02,Sarawak,154,26,128,2012
2012-12-03,Sarawak,16,6,10,2012
2012-12-04,Sarawak,72,35,37,2012
2012-12-05,Sarawak,13,0,13,2012
2012-12-06,Sarawak,63,15,48,2012
2012-12-07,Sarawak,19,4,15,2012
2012-12-08,Sarawak,3,3,0,2012
2012-12-09,Sarawak,45,23,22,2012
2012-12-10,Sarawak,20,0,20,2012
2012-12-11,Sarawak,26,7,19,2012
2012-12-12,Sarawak,116,27,89,2012
2012-12-13,Sarawak,28,8,20,2012
2012-12-14,Sarawak,18,3,15,2012
2012-12-15,Sarawak,47,11,36,2012
2012-12-16,Sarawak,172,17,155,2012
2012-12-17,Sarawak,22,2,20,2012
2012-12-18,Sarawak,25,4,21,2012
2012-12-19,Sarawak,53,6,47,2012
2012-12-20,Sarawak,19,2,17,2012
2012-12-21,Sarawak,32,5,27,2012
2012-12-22,Sarawak,33,14,19,2012
2012-12-23,Sarawak,39,5,34,2012
2012-12-24,Sarawak,27,2,25,2012
2012-12-25,Sarawak,0,0,0,2012
2012-12-26,Sarawak,13,0,13,2012
2012-12-27,Sarawak,21,4,17,2012
2012-12-28,Sarawak,35,2,33,2012
2012-12-29,Sarawak,33,13,20,2012
2012-12-30,Sarawak,62,21,41,2012
2012-12-31,Sarawak,28,4,24,2012
2013-01-01,Sarawak,194,35,159,2013
2013-01-02,Sarawak,17,2,15,2013
2013-01-03,Sarawak,20,2,18,2013
2013-01-04,Sarawak,23,3,20,2013
2013-01-05,Sarawak,0,0,0,2013
2013-01-06,Sarawak,190,21,169,2013
2013-01-07,Sarawak,25,6,19,2013
2013-01-08,Sarawak,49,14,35,2013
2013-01-09,Sarawak,40,7,33,2013
2013-01-10,Sarawak,33,2,31,2013
2013-01-11,Sarawak,18,0,18,2013
2013-01-12,Sarawak,173,70,103,2013
2013-01-13,Sarawak,202,16,186,2013
2013-01-14,Sarawak,54,5,49,2013
2013-01-15,Sarawak,23,6,17,2013
2013-01-16,Sarawak,34,10,24,2013
2013-01-17,Sarawak,67,10,57,2013
2013-01-18,Sarawak,15,2,13,2013
2013-01-19,Sarawak,29,12,17,2013
2013-01-20,Sarawak,37,10,27,2013
2013-01-21,Sarawak,16,2,14,2013
2013-01-22,Sarawak,38,12,26,2013
2013-01-23,Sarawak,29,6,23,2013
2013-01-24,Sarawak,0,0,0,2013
2013-01-25,Sarawak,25,0,25,2013
2013-01-26,Sarawak,31,20,11,2013
2013-01-27,Sarawak,68,17,51,2013
2013-01-28,Sarawak,27,10,17,2013
2013-01-29,Sarawak,39,6,33,2013
2013-01-30,Sarawak,58,10,48,2013
2013-01-31,Sarawak,75,15,60,2013
2013-02-01,Sarawak,29,3,26,2013
2013-02-02,Sarawak,19,8,11,2013
2013-02-03,Sarawak,51,26,25,2013
2013-02-04,Sarawak,20,4,16,2013
2013-02-05,Sarawak,48,20,28,2013
2013-02-06,Sarawak,58,30,28,2013
2013-02-07,Sarawak,66,24,42,2013
2013-02-08,Sarawak,31,6,25,2013
2013-02-09,Sarawak,19,5,14,2013
2013-02-10,Sarawak,0,0,0,2013
2013-02-11,Sarawak,0,0,0,2013
2013-02-12,Sarawak,7,1,6,2013
2013-02-13,Sarawak,26,6,20,2013
2013-02-14,Sarawak,24,2,22,2013
2013-02-15,Sarawak,38,6,32,2013
2013-02-16,Sarawak,39,14,25,2013
2013-02-17,Sarawak,37,14,23,2013
2013-02-18,Sarawak,31,4,27,2013
2013-02-19,Sarawak,42,8,34,2013
2013-02-20,Sarawak,19,4,15,2013
2013-02-21,Sarawak,46,10,36,2013
2013-02-22,Sarawak,40,6,34,2013
2013-02-23,Sarawak,99,57,42,2013
2013-02-24,Sarawak,89,25,64,2013
2013-02-25,Sarawak,25,1,24,2013
2013-02-26,Sarawak,59,13,46,2013
2013-02-27,Sarawak,29,7,22,2013
2013-02-28,Sarawak,75,25,50,2013
2013-03-01,Sarawak,31,5,26,2013
2013-03-02,Sarawak,72,35,37,2013
2013-03-03,Sarawak,223,22,201,2013
2013-03-04,Sarawak,22,1,21,2013
2013-03-05,Sarawak,225,82,143,2013
2013-03-06,Sarawak,50,15,35,2013
2013-03-07,Sarawak,33,6,27,2013
2013-03-08,Sarawak,28,3,25,2013
2013-03-09,Sarawak,41,16,25,2013
2013-03-10,Sarawak,258,46,212,2013
2013-03-11,Sarawak,34,5,29,2013
2013-03-12,Sarawak,20,2,18,2013
2013-03-13,Sarawak,50,34,16,2013
2013-03-14,Sarawak,25,3,22,2013
2013-03-15,Sarawak,18,2,16,2013
2013-03-16,Sarawak,51,26,25,2013
2013-03-17,Sarawak,96,19,77,2013
2013-03-18,Sarawak,24,2,22,2013
2013-03-19,Sarawak,87,43,44,2013
2013-03-20,Sarawak,41,21,20,2013
2013-03-21,Sarawak,56,14,42,2013
2013-03-22,Sarawak,26,4,22,2013
2013-03-23,Sarawak,64,13,51,2013
2013-03-24,Sarawak,200,26,174,2013
2013-03-25,Sarawak,21,1,20,2013
2013-03-26,Sarawak,38,8,30,2013
2013-03-27,Sarawak,45,18,27,2013
2013-03-28,Sarawak,21,1,20,2013
2013-03-29,Sarawak,38,24,14,2013
2013-03-30,Sarawak,95,44,51,2013
2013-03-31,Sarawak,30,9,21,2013
2013-04-01,Sarawak,32,3,29,2013
2013-04-02,Sarawak,24,3,21,2013
2013-04-03,Sarawak,119,56,63,2013
2013-04-04,Sarawak,20,0,20,2013
2013-04-05,Sarawak,18,3,15,2013
2013-04-06,Sarawak,28,18,10,2013
2013-04-07,Sarawak,266,26,240,2013
2013-04-08,Sarawak,27,3,24,2013
2013-04-09,Sarawak,52,7,45,2013
2013-04-10,Sarawak,19,4,15,2013
2013-04-11,Sarawak,40,13,27,2013
2013-04-12,Sarawak,21,2,19,2013
2013-04-13,Sarawak,29,11,18,2013
2013-04-14,Sarawak,305,29,276,2013
2013-04-15,Sarawak,86,39,47,2013
2013-04-16,Sarawak,35,2,33,2013
2013-04-17,Sarawak,28,0,28,2013
2013-04-18,Sarawak,22,3,19,2013
2013-04-19,Sarawak,24,0,24,2013
2013-04-20,Sarawak,25,7,18,2013
2013-04-21,Sarawak,128,18,110,2013
2013-04-22,Sarawak,19,3,16,2013
2013-04-23,Sarawak,34,5,29,2013
2013-04-24,Sarawak,43,28,15,2013
2013-04-25,Sarawak,29,4,25,2013
2013-04-26,Sarawak,13,1,12,2013
2013-04-27,Sarawak,147,76,71,2013
2013-04-28,Sarawak,21,4,17,2013
2013-04-29,Sarawak,14,0,14,2013
2013-04-30,Sarawak,63,8,55,2013
2013-05-01,Sarawak,95,47,48,2013
2013-05-02,Sarawak,112,64,48,2013
2013-05-03,Sarawak,22,3,19,2013
2013-05-04,Sarawak,22,8,14,2013
2013-05-05,Sarawak,0,0,0,2013
2013-05-06,Sarawak,12,2,10,2013
2013-05-07,Sarawak,31,5,26,2013
2013-05-08,Sarawak,70,23,47,2013
2013-05-09,Sarawak,122,53,69,2013
2013-05-10,Sarawak,55,16,39,2013
2013-05-11,Sarawak,68,32,36,2013
2013-05-12,Sarawak,181,34,147,2013
2013-05-13,Sarawak,19,5,14,2013
2013-05-14,Sarawak,89,54,35,2013
2013-05-15,Sarawak,86,41,45,2013
2013-05-16,Sarawak,56,12,44,2013
2013-05-17,Sarawak,15,1,14,2013
2013-05-18,Sarawak,89,44,45,2013
2013-05-19,Sarawak,158,48,110,2013
2013-05-20,Sarawak,21,3,18,2013
2013-05-21,Sarawak,57,21,36,2013
2013-05-22,Sarawak,13,1,12,2013
2013-05-23,Sarawak,42,8,34,2013
2013-05-24,Sarawak,147,43,104,2013
2013-05-25,Sarawak,67,23,44,2013
2013-05-26,Sarawak,44,8,36,2013
2013-05-27,Sarawak,25,5,20,2013
2013-05-28,Sarawak,27,5,22,2013
2013-05-29,Sarawak,12,1,11,2013
2013-05-30,Sarawak,14,1,13,2013
2013-05-31,Sarawak,18,0,18,2013
2013-06-01,Sarawak,1,1,0,2013
2013-06-02,Sarawak,0,0,0,2013
2013-06-03,Sarawak,13,1,12,2013
2013-06-04,Sarawak,34,12,22,2013
2013-06-05,Sarawak,23,1,22,2013
2013-06-06,Sarawak,18,0,18,2013
2013-06-07,Sarawak,22,1,21,2013
2013-06-08,Sarawak,27,10,17,2013
2013-06-09,Sarawak,283,38,245,2013
2013-06-10,Sarawak,21,4,17,2013
2013-06-11,Sarawak,42,6,36,2013
2013-06-12,Sarawak,10,0,10,2013
2013-06-13,Sarawak,22,0,22,2013
2013-06-14,Sarawak,33,2,31,2013
2013-06-15,Sarawak,0,0,0,2013
2013-06-16,Sarawak,193,15,178,2013
2013-06-17,Sarawak,12,0,12,2013
2013-06-18,Sarawak,47,31,16,2013
2013-06-19,Sarawak,33,13,20,2013
2013-06-20,Sarawak,67,18,49,2013
2013-06-21,Sarawak,23,0,23,2013
2013-06-22,Sarawak,193,49,144,2013
2013-06-23,Sarawak,248,53,195,2013
2013-06-24,Sarawak,11,2,9,2013
2013-06-25,Sarawak,6,1,5,2013
2013-06-26,Sarawak,55,3,52,2013
2013-06-27,Sarawak,83,26,57,2013
2013-06-28,Sarawak,24,5,19,2013
2013-06-29,Sarawak,23,6,17,2013
2013-06-30,Sarawak,41,11,30,2013
2013-07-01,Sarawak,27,1,26,2013
2013-07-02,Sarawak,46,17,29,2013
2013-07-03,Sarawak,48,12,36,2013
2013-07-04,Sarawak,35,6,29,2013
2013-07-05,Sarawak,27,2,25,2013
2013-07-06,Sarawak,75,20,55,2013
2013-07-07,Sarawak,351,45,306,2013
2013-07-08,Sarawak,26,2,24,2013
2013-07-09,Sarawak,67,3,64,2013
2013-07-10,Sarawak,10,1,9,2013
2013-07-11,Sarawak,13,2,11,2013
2013-07-12,Sarawak,17,0,17,2013
2013-07-13,Sarawak,26,8,18,2013
2013-07-14,Sarawak,177,26,151,2013
2013-07-15,Sarawak,21,2,19,2013
2013-07-16,Sarawak,60,12,48,2013
2013-07-17,Sarawak,9,0,9,2013
2013-07-18,Sarawak,9,0,9,2013
2013-07-19,Sarawak,14,1,13,2013
2013-07-20,Sarawak,32,10,22,2013
2013-07-21,Sarawak,139,19,120,2013
2013-07-22,Sarawak,21,2,19,2013
2013-07-23,Sarawak,9,1,8,2013
2013-07-24,Sarawak,51,25,26,2013
2013-07-25,Sarawak,28,5,23,2013
2013-07-26,Sarawak,12,1,11,2013
2013-07-27,Sarawak,48,30,18,2013
2013-07-28,Sarawak,112,34,78,2013
2013-07-29,Sarawak,11,1,10,2013
2013-07-30,Sarawak,39,12,27,2013
2013-07-31,Sarawak,42,3,39,2013
2013-08-01,Sarawak,8,1,7,2013
2013-08-02,Sarawak,12,3,9,2013
2013-08-03,Sarawak,28,16,12,2013
2013-08-04,Sarawak,104,32,72,2013
2013-08-05,Sarawak,12,2,10,2013
2013-08-06,Sarawak,13,0,13,2013
2013-08-07,Sarawak,10,2,8,2013
2013-08-08,Sarawak,0,0,0,2013
2013-08-09,Sarawak,0,0,0,2013
2013-08-10,Sarawak,15,5,10,2013
2013-08-11,Sarawak,20,6,14,2013
2013-08-12,Sarawak,27,3,24,2013
2013-08-13,Sarawak,21,1,20,2013
2013-08-14,Sarawak,54,32,22,2013
2013-08-15,Sarawak,30,2,28,2013
2013-08-16,Sarawak,27,3,24,2013
2013-08-17,Sarawak,21,7,14,2013
2013-08-18,Sarawak,218,31,187,2013
2013-08-19,Sarawak,34,4,30,2013
2013-08-20,Sarawak,25,1,24,2013
2013-08-21,Sarawak,18,2,16,2013
2013-08-22,Sarawak,63,14,49,2013
2013-08-23,Sarawak,30,2,28,2013
2013-08-24,Sarawak,37,22,15,2013
2013-08-25,Sarawak,97,10,87,2013
2013-08-26,Sarawak,19,1,18,2013
2013-08-27,Sarawak,14,1,13,2013
2013-08-28,Sarawak,17,3,14,2013
2013-08-29,Sarawak,27,11,16,2013
2013-08-30,Sarawak,21,1,20,2013
2013-08-31,Sarawak,75,31,44,2013
2013-09-01,Sarawak,128,21,107,2013
2013-09-02,Sarawak,22,3,19,2013
2013-09-03,Sarawak,55,15,40,2013
2013-09-04,Sarawak,19,2,17,2013
2013-09-05,Sarawak,36,9,27,2013
2013-09-06,Sarawak,27,4,23,2013
2013-09-07,Sarawak,67,16,51,2013
2013-09-08,Sarawak,107,36,71,2013
2013-09-09,Sarawak,17,1,16,2013
2013-09-10,Sarawak,17,2,15,2013
2013-09-11,Sarawak,40,16,24,2013
2013-09-12,Sarawak,59,13,46,2013
2013-09-13,Sarawak,24,4,20,2013
2013-09-14,Sarawak,33,9,24,2013
2013-09-15,Sarawak,167,14,153,2013
2013-09-16,Sarawak,4,1,3,2013
2013-09-17,Sarawak,45,7,38,2013
2013-09-18,Sarawak,38,10,28,2013
2013-09-19,Sarawak,55,9,46,2013
2013-09-20,Sarawak,30,4,26,2013
2013-09-21,Sarawak,99,42,57,2013
2013-09-22,Sarawak,54,20,34,2013
2013-09-23,Sarawak,14,2,12,2013
2013-09-24,Sarawak,30,6,24,2013
2013-09-25,Sarawak,28,5,23,2013
2013-09-26,Sarawak,54,3,51,2013
2013-09-27,Sarawak,85,37,48,2013
2013-09-28,Sarawak,64,26,38,2013
2013-09-29,Sarawak,208,24,184,2013
2013-09-30,Sarawak,25,2,23,2013
2013-10-01,Sarawak,17,2,15,2013
2013-10-02,Sarawak,24,0,24,2013
2013-10-03,Sarawak,34,2,32,2013
2013-10-04,Sarawak,27,2,25,2013
2013-10-05,Sarawak,112,71,41,2013
2013-10-06,Sarawak,497,108,389,2013
2013-10-07,Sarawak,45,9,36,2013
2013-10-08,Sarawak,59,4,55,2013
2013-10-09,Sarawak,32,14,18,2013
2013-10-10,Sarawak,36,2,34,2013
2013-10-11,Sarawak,16,2,14,2013
2013-10-12,Sarawak,28,7,21,2013
2013-10-13,Sarawak,170,23,147,2013
2013-10-14,Sarawak,28,2,26,2013
2013-10-15,Sarawak,0,0,0,2013
2013-10-16,Sarawak,14,0,14,2013
2013-10-17,Sarawak,71,12,59,2013
2013-10-18,Sarawak,26,2,24,2013
2013-10-19,Sarawak,43,10,33,2013
2013-10-20,Sarawak,194,20,174,2013
2013-10-21,Sarawak,16,0,16,2013
2013-10-22,Sarawak,65,38,27,2013
2013-10-23,Sarawak,20,2,18,2013
2013-10-24,Sarawak,33,9,24,2013
2013-10-25,Sarawak,10,0,10,2013
2013-10-26,Sarawak,16,6,10,2013
2013-10-27,Sarawak,173,19,154,2013
2013-10-28,Sarawak,16,0,16,2013
2013-10-29,Sarawak,37,7,30,2013
2013-10-30,Sarawak,127,53,74,2013
2013-10-31,Sarawak,56,11,45,2013
2013-11-01,Sarawak,16,2,14,2013
2013-11-02,Sarawak,45,18,27,2013
2013-11-03,Sarawak,137,18,119,2013
2013-11-04,Sarawak,23,4,19,2013
2013-11-05,Sarawak,60,13,47,2013
2013-11-06,Sarawak,9,2,7,2013
2013-11-07,Sarawak,54,7,47,2013
2013-11-08,Sarawak,12,0,12,2013
2013-11-09,Sarawak,26,15,11,2013
2013-11-10,Sarawak,50,7,43,2013
2013-11-11,Sarawak,11,4,7,2013
2013-11-12,Sarawak,15,0,15,2013
2013-11-13,Sarawak,36,12,24,2013
2013-11-14,Sarawak,21,9,12,2013
2013-11-15,Sarawak,24,5,19,2013
2013-11-16,Sarawak,15,10,5,2013
2013-11-17,Sarawak,67,21,46,2013
2013-11-18,Sarawak,21,2,19,2013
2013-11-19,Sarawak,24,3,21,2013
2013-11-20,Sarawak,38,3,35,2013
2013-11-21,Sarawak,61,16,45,2013
2013-11-22,Sarawak,21,0,21,2013
2013-11-23,Sarawak,92,47,45,2013
2013-11-24,Sarawak,154,23,131,2013
2013-11-25,Sarawak,23,3,20,2013
2013-11-26,Sarawak,44,2,42,2013
2013-11-27,Sarawak,52,14,38,2013
2013-11-28,Sarawak,14,1,13,2013
2013-11-29,Sarawak,19,1,18,2013
2013-11-30,Sarawak,50,25,25,2013
2013-12-01,Sarawak,141,44,97,2013
2013-12-02,Sarawak,32,12,20,2013
2013-12-03,Sarawak,60,25,35,2013
2013-12-04,Sarawak,145,92,53,2013
2013-12-05,Sarawak,18,2,16,2013
2013-12-06,Sarawak,28,6,22,2013
2013-12-07,Sarawak,106,89,17,2013
2013-12-08,Sarawak,93,9,84,2013
2013-12-09,Sarawak,28,8,20,2013
2013-12-10,Sarawak,38,13,25,2013
2013-12-11,Sarawak,72,41,31,2013
2013-12-12,Sarawak,14,7,7,2013
2013-12-13,Sarawak,27,6,21,2013
2013-12-14,Sarawak,23,6,17,2013
2013-12-15,Sarawak,395,197,198,2013
2013-12-16,Sarawak,23,7,16,2013
2013-12-17,Sarawak,132,45,87,2013
2013-12-18,Sarawak,49,32,17,2013
2013-12-19,Sarawak,114,44,70,2013
2013-12-20,Sarawak,30,11,19,2013
2013-12-21,Sarawak,82,39,43,2013
2013-12-22,Sarawak,77,31,46,2013
2013-12-23,Sarawak,22,8,14,2013
2013-12-24,Sarawak,27,9,18,2013
2013-12-25,Sarawak,0,0,0,2013
2013-12-26,Sarawak,31,4,27,2013
2013-12-27,Sarawak,23,11,12,2013
2013-12-28,Sarawak,29,8,21,2013
2013-12-29,Sarawak,96,61,35,2013
2013-12-30,Sarawak,24,10,14,2013
2013-12-31,Sarawak,37,8,29,2013
2014-01-01,Sarawak,167,19,148,2014
2014-01-02,Sarawak,27,14,13,2014
2014-01-03,Sarawak,24,8,16,2014
2014-01-04,Sarawak,12,1,11,2014
2014-01-05,Sarawak,103,46,57,2014
2014-01-06,Sarawak,37,14,23,2014
2014-01-07,Sarawak,92,24,68,2014
2014-01-08,Sarawak,76,26,50,2014
2014-01-09,Sarawak,144,50,94,2014
2014-01-10,Sarawak,28,7,21,2014
2014-01-11,Sarawak,50,42,8,2014
2014-01-12,Sarawak,186,35,151,2014
2014-01-13,Sarawak,47,18,29,2014
2014-01-14,Sarawak,225,21,204,2014
2014-01-15,Sarawak,43,16,27,2014
2014-01-16,Sarawak,86,17,69,2014
2014-01-17,Sarawak,33,11,22,2014
2014-01-18,Sarawak,181,118,63,2014
2014-01-19,Sarawak,148,83,65,2014
2014-01-20,Sarawak,82,37,45,2014
2014-01-21,Sarawak,97,28,69,2014
2014-01-22,Sarawak,80,56,24,2014
2014-01-23,Sarawak,47,16,31,2014
2014-01-24,Sarawak,34,9,25,2014
2014-01-25,Sarawak,47,31,16,2014
2014-01-26,Sarawak,61,27,34,2014
2014-01-27,Sarawak,32,9,23,2014
2014-01-28,Sarawak,94,56,38,2014
2014-01-29,Sarawak,70,29,41,2014
2014-01-30,Sarawak,39,13,26,2014
2014-01-31,Sarawak,0,0,0,2014
2014-02-01,Sarawak,0,0,0,2014
2014-02-02,Sarawak,33,14,19,2014
2014-02-03,Sarawak,47,19,28,2014
2014-02-04,Sarawak,82,22,60,2014
2014-02-05,Sarawak,116,38,78,2014
2014-02-06,Sarawak,67,37,30,2014
2014-02-07,Sarawak,23,7,16,2014
2014-02-08,Sarawak,38,36,2,2014
2014-02-09,Sarawak,146,114,32,2014
2014-02-10,Sarawak,80,38,42,2014
2014-02-11,Sarawak,67,13,54,2014
2014-02-12,Sarawak,67,43,24,2014
2014-02-13,Sarawak,36,11,25,2014
2014-02-14,Sarawak,44,14,30,2014
2014-02-15,Sarawak,23,12,11,2014
2014-02-16,Sarawak,82,48,34,2014
2014-02-17,Sarawak,23,14,9,2014
2014-02-18,Sarawak,30,3,27,2014
2014-02-19,Sarawak,98,55,43,2014
2014-02-20,Sarawak,51,11,40,2014
2014-02-21,Sarawak,33,18,15,2014
2014-02-22,Sarawak,102,47,55,2014
2014-02-23,Sarawak,248,152,96,2014
2014-02-24,Sarawak,41,15,26,2014
2014-02-25,Sarawak,92,40,52,2014
2014-02-26,Sarawak,81,40,41,2014
2014-02-27,Sarawak,53,24,29,2014
2014-02-28,Sarawak,40,12,28,2014
2014-03-01,Sarawak,61,27,34,2014
2014-03-02,Sarawak,280,51,229,2014
2014-03-03,Sarawak,34,5,29,2014
2014-03-04,Sarawak,37,15,22,2014
2014-03-05,Sarawak,25,5,20,2014
2014-03-06,Sarawak,43,7,36,2014
2014-03-07,Sarawak,29,8,21,2014
2014-03-08,Sarawak,80,45,35,2014
2014-03-09,Sarawak,241,42,199,2014
2014-03-10,Sarawak,32,7,25,2014
2014-03-11,Sarawak,25,7,18,2014
2014-03-12,Sarawak,111,40,71,2014
2014-03-13,Sarawak,72,27,45,2014
2014-03-14,Sarawak,22,2,20,2014
2014-03-15,Sarawak,77,37,40,2014
2014-03-16,Sarawak,129,73,56,2014
2014-03-17,Sarawak,27,7,20,2014
2014-03-18,Sarawak,167,95,72,2014
2014-03-19,Sarawak,68,17,51,2014
2014-03-20,Sarawak,83,53,30,2014
2014-03-21,Sarawak,28,8,20,2014
2014-03-22,Sarawak,72,45,27,2014
2014-03-23,Sarawak,268,57,211,2014
2014-03-24,Sarawak,23,6,17,2014
2014-03-25,Sarawak,56,23,33,2014
2014-03-26,Sarawak,139,67,72,2014
2014-03-27,Sarawak,84,33,51,2014
2014-03-28,Sarawak,31,8,23,2014
2014-03-29,Sarawak,57,24,33,2014
2014-03-30,Sarawak,93,45,48,2014
2014-03-31,Sarawak,30,4,26,2014
2014-04-01,Sarawak,27,3,24,2014
2014-04-02,Sarawak,89,33,56,2014
2014-04-03,Sarawak,48,12,36,2014
2014-04-04,Sarawak,30,3,27,2014
2014-04-05,Sarawak,47,34,13,2014
2014-04-06,Sarawak,157,33,124,2014
2014-04-07,Sarawak,36,7,29,2014
2014-04-08,Sarawak,49,15,34,2014
2014-04-09,Sarawak,94,37,57,2014
2014-04-10,Sarawak,61,4,57,2014
2014-04-11,Sarawak,22,5,17,2014
2014-04-12,Sarawak,103,58,45,2014
2014-04-13,Sarawak,445,94,351,2014
2014-04-14,Sarawak,34,6,28,2014
2014-04-15,Sarawak,47,13,34,2014
2014-04-16,Sarawak,104,25,79,2014
2014-04-17,Sarawak,49,8,41,2014
2014-04-18,Sarawak,22,6,16,2014
2014-04-19,Sarawak,83,53,30,2014
2014-04-20,Sarawak,231,48,183,2014
2014-04-21,Sarawak,26,4,22,2014
2014-04-22,Sarawak,61,25,36,2014
2014-04-23,Sarawak,116,57,59,2014
2014-04-24,Sarawak,51,17,34,2014
2014-04-25,Sarawak,23,1,22,2014
2014-04-26,Sarawak,121,56,65,2014
2014-04-27,Sarawak,101,50,51,2014
2014-04-28,Sarawak,33,4,29,2014
2014-04-29,Sarawak,219,90,129,2014
2014-04-30,Sarawak,72,34,38,2014
2014-05-01,Sarawak,103,44,59,2014
2014-05-02,Sarawak,31,1,30,2014
2014-05-03,Sarawak,90,35,55,2014
2014-05-04,Sarawak,99,31,68,2014
2014-05-05,Sarawak,29,4,25,2014
2014-05-06,Sarawak,92,25,67,2014
2014-05-07,Sarawak,147,90,57,2014
2014-05-08,Sarawak,85,29,56,2014
2014-05-09,Sarawak,27,3,24,2014
2014-05-10,Sarawak,95,41,54,2014
2014-05-11,Sarawak,171,52,119,2014
2014-05-12,Sarawak,45,5,40,2014
2014-05-13,Sarawak,70,27,43,2014
2014-05-14,Sarawak,50,8,42,2014
2014-05-15,Sarawak,47,9,38,2014
2014-05-16,Sarawak,28,5,23,2014
2014-05-17,Sarawak,68,40,28,2014
2014-05-18,Sarawak,257,118,139,2014
2014-05-19,Sarawak,29,2,27,2014
2014-05-20,Sarawak,46,5,41,2014
2014-05-21,Sarawak,70,28,42,2014
2014-05-22,Sarawak,42,7,35,2014
2014-05-23,Sarawak,20,2,18,2014
2014-05-24,Sarawak,154,63,91,2014
2014-05-25,Sarawak,263,95,168,2014
2014-05-26,Sarawak,42,6,36,2014
2014-05-27,Sarawak,90,41,49,2014
2014-05-28,Sarawak,120,60,60,2014
2014-05-29,Sarawak,95,22,73,2014
2014-05-30,Sarawak,24,4,20,2014
2014-05-31,Sarawak,16,4,12,2014
2014-06-01,Sarawak,0,0,0,2014
2014-06-02,Sarawak,0,0,0,2014
2014-06-03,Sarawak,9,2,7,2014
2014-06-04,Sarawak,26,3,23,2014
2014-06-05,Sarawak,28,3,25,2014
2014-06-06,Sarawak,39,7,32,2014
2014-06-07,Sarawak,65,38,27,2014
2014-06-08,Sarawak,253,35,218,2014
2014-06-09,Sarawak,33,6,27,2014
2014-06-10,Sarawak,24,4,20,2014
2014-06-11,Sarawak,130,78,52,2014
2014-06-12,Sarawak,48,10,38,2014
2014-06-13,Sarawak,34,9,25,2014
2014-06-14,Sarawak,78,26,52,2014
2014-06-15,Sarawak,326,86,240,2014
2014-06-16,Sarawak,40,7,33,2014
2014-06-17,Sarawak,76,11,65,2014
2014-06-18,Sarawak,46,22,24,2014
2014-06-19,Sarawak,38,2,36,2014
2014-06-20,Sarawak,29,7,22,2014
2014-06-21,Sarawak,86,52,34,2014
2014-06-22,Sarawak,161,27,134,2014
2014-06-23,Sarawak,30,5,25,2014
2014-06-24,Sarawak,59,13,46,2014
2014-06-25,Sarawak,86,39,47,2014
2014-06-26,Sarawak,57,8,49,2014
2014-06-27,Sarawak,45,10,35,2014
2014-06-28,Sarawak,85,44,41,2014
2014-06-29,Sarawak,92,29,63,2014
2014-06-30,Sarawak,24,4,20,2014
2014-07-01,Sarawak,13,2,11,2014
2014-07-02,Sarawak,19,0,19,2014
2014-07-03,Sarawak,15,5,10,2014
2014-07-04,Sarawak,29,0,29,2014
2014-07-05,Sarawak,23,3,20,2014
2014-07-06,Sarawak,225,68,157,2014
2014-07-07,Sarawak,14,1,13,2014
2014-07-08,Sarawak,60,45,15,2014
2014-07-09,Sarawak,8,2,6,2014
2014-07-10,Sarawak,18,3,15,2014
2014-07-11,Sarawak,23,2,21,2014
2014-07-12,Sarawak,66,33,33,2014
2014-07-13,Sarawak,240,41,199,2014
2014-07-14,Sarawak,18,2,16,2014
2014-07-15,Sarawak,25,10,15,2014
2014-07-16,Sarawak,41,18,23,2014
2014-07-17,Sarawak,19,8,11,2014
2014-07-18,Sarawak,28,6,22,2014
2014-07-19,Sarawak,143,57,86,2014
2014-07-20,Sarawak,211,43,168,2014
2014-07-21,Sarawak,22,6,16,2014
2014-07-22,Sarawak,44,20,24,2014
2014-07-23,Sarawak,65,54,11,2014
2014-07-24,Sarawak,54,22,32,2014
2014-07-25,Sarawak,39,8,31,2014
2014-07-26,Sarawak,21,6,15,2014
2014-07-27,Sarawak,83,37,46,2014
2014-07-28,Sarawak,0,0,0,2014
2014-07-29,Sarawak,0,0,0,2014
2014-07-30,Sarawak,43,7,36,2014
2014-07-31,Sarawak,35,6,29,2014
2014-08-01,Sarawak,37,6,31,2014
2014-08-02,Sarawak,80,42,38,2014
2014-08-03,Sarawak,178,49,129,2014
2014-08-04,Sarawak,35,5,30,2014
2014-08-05,Sarawak,44,4,40,2014
2014-08-06,Sarawak,48,7,41,2014
2014-08-07,Sarawak,101,15,86,2014
2014-08-08,Sarawak,58,12,46,2014
2014-08-09,Sarawak,112,44,68,2014
2014-08-10,Sarawak,104,47,57,2014
2014-08-11,Sarawak,74,19,55,2014
2014-08-12,Sarawak,75,26,49,2014
2014-08-13,Sarawak,127,47,80,2014
2014-08-14,Sarawak,33,7,26,2014
2014-08-15,Sarawak,43,9,34,2014
2014-08-16,Sarawak,71,31,40,2014
2014-08-17,Sarawak,259,45,214,2014
2014-08-18,Sarawak,62,28,34,2014
2014-08-19,Sarawak,86,10,76,2014
2014-08-20,Sarawak,146,51,95,2014
2014-08-21,Sarawak,51,5,46,2014
2014-08-22,Sarawak,32,5,27,2014
2014-08-23,Sarawak,53,31,22,2014
2014-08-24,Sarawak,178,23,155,2014
2014-08-25,Sarawak,23,4,19,2014
2014-08-26,Sarawak,19,3,16,2014
2014-08-27,Sarawak,93,44,49,2014
2014-08-28,Sarawak,41,6,35,2014
2014-08-29,Sarawak,35,5,30,2014
2014-08-30,Sarawak,129,43,86,2014
2014-08-31,Sarawak,46,11,35,2014
2014-09-01,Sarawak,23,7,16,2014
2014-09-02,Sarawak,78,23,55,2014
2014-09-03,Sarawak,89,48,41,2014
2014-09-04,Sarawak,47,11,36,2014
2014-09-05,Sarawak,27,4,23,2014
2014-09-06,Sarawak,76,9,67,2014
2014-09-07,Sarawak,165,56,109,2014
2014-09-08,Sarawak,50,10,40,2014
2014-09-09,Sarawak,67,13,54,2014
2014-09-10,Sarawak,146,48,98,2014
2014-09-11,Sarawak,28,5,23,2014
2014-09-12,Sarawak,44,6,38,2014
2014-09-13,Sarawak,57,17,40,2014
2014-09-14,Sarawak,185,41,144,2014
2014-09-15,Sarawak,38,6,32,2014
2014-09-16,Sarawak,191,63,128,2014
2014-09-17,Sarawak,47,11,36,2014
2014-09-18,Sarawak,98,23,75,2014
2014-09-19,Sarawak,20,2,18,2014
2014-09-20,Sarawak,95,35,60,2014
2014-09-21,Sarawak,94,45,49,2014
2014-09-22,Sarawak,46,10,36,2014
2014-09-23,Sarawak,97,41,56,2014
2014-09-24,Sarawak,317,121,196,2014
2014-09-25,Sarawak,89,13,76,2014
2014-09-26,Sarawak,31,4,27,2014
2014-09-27,Sarawak,174,79,95,2014
2014-09-28,Sarawak,275,37,238,2014
2014-09-29,Sarawak,34,8,26,2014
2014-09-30,Sarawak,56,20,36,2014
2014-10-01,Sarawak,57,13,44,2014
2014-10-02,Sarawak,82,37,45,2014
2014-10-03,Sarawak,29,3,26,2014
2014-10-04,Sarawak,54,23,31,2014
2014-10-05,Sarawak,130,43,87,2014
2014-10-06,Sarawak,182,99,83,2014
2014-10-07,Sarawak,40,15,25,2014
2014-10-08,Sarawak,113,66,47,2014
2014-10-09,Sarawak,59,9,50,2014
2014-10-10,Sarawak,33,6,27,2014
2014-10-11,Sarawak,75,27,48,2014
2014-10-12,Sarawak,392,64,328,2014
2014-10-13,Sarawak,31,7,24,2014
2014-10-14,Sarawak,72,28,44,2014
2014-10-15,Sarawak,80,33,47,2014
2014-10-16,Sarawak,98,44,54,2014
2014-10-17,Sarawak,40,7,33,2014
2014-10-18,Sarawak,113,68,45,2014
2014-10-19,Sarawak,85,29,56,2014
2014-10-20,Sarawak,33,6,27,2014
2014-10-21,Sarawak,50,28,22,2014
2014-10-22,Sarawak,45,18,27,2014
2014-10-23,Sarawak,61,11,50,2014
2014-10-24,Sarawak,39,17,22,2014
2014-10-25,Sarawak,112,58,54,2014
2014-10-26,Sarawak,271,48,223,2014
2014-10-27,Sarawak,26,5,21,2014
2014-10-28,Sarawak,47,12,35,2014
2014-10-29,Sarawak,102,77,25,2014
2014-10-30,Sarawak,51,20,31,2014
2014-10-31,Sarawak,28,6,22,2014
2014-11-01,Sarawak,56,34,22,2014
2014-11-02,Sarawak,178,29,149,2014
2014-11-03,Sarawak,25,2,23,2014
2014-11-04,Sarawak,26,1,25,2014
2014-11-05,Sarawak,66,24,42,2014
2014-11-06,Sarawak,70,35,35,2014
2014-11-07,Sarawak,19,0,19,2014
2014-11-08,Sarawak,48,23,25,2014
2014-11-09,Sarawak,139,44,95,2014
2014-11-10,Sarawak,23,1,22,2014
2014-11-11,Sarawak,79,12,67,2014
2014-11-12,Sarawak,154,83,71,2014
2014-11-13,Sarawak,89,21,68,2014
2014-11-14,Sarawak,22,2,20,2014
2014-11-15,Sarawak,73,30,43,2014
2014-11-16,Sarawak,202,44,158,2014
2014-11-17,Sarawak,33,5,28,2014
2014-11-18,Sarawak,40,6,34,2014
2014-11-19,Sarawak,109,25,84,2014
2014-11-20,Sarawak,105,20,85,2014
2014-11-21,Sarawak,33,9,24,2014
2014-11-22,Sarawak,48,19,29,2014
2014-11-23,Sarawak,90,25,65,2014
2014-11-24,Sarawak,47,23,24,2014
2014-11-25,Sarawak,45,15,30,2014
2014-11-26,Sarawak,89,43,46,2014
2014-11-27,Sarawak,104,39,65,2014
2014-11-28,Sarawak,58,13,45,2014
2014-11-29,Sarawak,80,31,49,2014
2014-11-30,Sarawak,383,141,242,2014
2014-12-01,Sarawak,32,6,26,2014
2014-12-02,Sarawak,27,9,18,2014
2014-12-03,Sarawak,44,14,30,2014
2014-12-04,Sarawak,183,148,35,2014
2014-12-05,Sarawak,28,10,18,2014
2014-12-06,Sarawak,139,78,61,2014
2014-12-07,Sarawak,223,92,131,2014
2014-12-08,Sarawak,58,21,37,2014
2014-12-09,Sarawak,127,88,39,2014
2014-12-10,Sarawak,54,24,30,2014
2014-12-11,Sarawak,98,46,52,2014
2014-12-12,Sarawak,58,28,30,2014
2014-12-13,Sarawak,148,120,28,2014
2014-12-14,Sarawak,195,50,145,2014
2014-12-15,Sarawak,49,14,35,2014
2014-12-16,Sarawak,183,108,75,2014
2014-12-17,Sarawak,54,24,30,2014
2014-12-18,Sarawak,96,73,23,2014
2014-12-19,Sarawak,29,7,22,2014
2014-12-20,Sarawak,76,49,27,2014
2014-12-21,Sarawak,205,106,99,2014
2014-12-22,Sarawak,49,6,43,2014
2014-12-23,Sarawak,40,21,19,2014
2014-12-24,Sarawak,36,13,23,2014
2014-12-25,Sarawak,0,0,0,2014
2014-12-26,Sarawak,36,13,23,2014
2014-12-27,Sarawak,55,30,25,2014
2014-12-28,Sarawak,216,125,91,2014
2014-12-29,Sarawak,58,12,46,2014
2014-12-30,Sarawak,58,23,35,2014
2014-12-31,Sarawak,61,21,40,2014
2015-01-01,Sarawak,180,24,156,2015
2015-01-02,Sarawak,52,7,45,2015
2015-01-03,Sarawak,43,16,27,2015
2015-01-04,Sarawak,243,161,82,2015
2015-01-05,Sarawak,53,18,35,2015
2015-01-06,Sarawak,51,19,32,2015
2015-01-07,Sarawak,81,26,55,2015
2015-01-08,Sarawak,67,17,50,2015
2015-01-09,Sarawak,61,22,39,2015
2015-01-10,Sarawak,140,74,66,2015
2015-01-11,Sarawak,218,40,178,2015
2015-01-12,Sarawak,64,17,47,2015
2015-01-13,Sarawak,57,17,40,2015
2015-01-14,Sarawak,107,43,64,2015
2015-01-15,Sarawak,52,20,32,2015
2015-01-16,Sarawak,31,14,17,2015
2015-01-17,Sarawak,84,47,37,2015
2015-01-18,Sarawak,332,108,224,2015
2015-01-19,Sarawak,23,11,12,2015
2015-01-20,Sarawak,102,53,49,2015
2015-01-21,Sarawak,116,43,73,2015
2015-01-22,Sarawak,92,27,65,2015
2015-01-23,Sarawak,45,13,32,2015
2015-01-24,Sarawak,98,73,25,2015
2015-01-25,Sarawak,261,92,169,2015
2015-01-26,Sarawak,38,12,26,2015
2015-01-27,Sarawak,47,31,16,2015
2015-01-28,Sarawak,47,12,35,2015
2015-01-29,Sarawak,92,22,70,2015
2015-01-30,Sarawak,25,7,18,2015
2015-01-31,Sarawak,81,58,23,2015
2015-02-01,Sarawak,142,67,75,2015
2015-02-02,Sarawak,36,12,24,2015
2015-02-03,Sarawak,83,32,51,2015
2015-02-04,Sarawak,116,62,54,2015
2015-02-05,Sarawak,31,16,15,2015
2015-02-06,Sarawak,41,14,27,2015
2015-02-07,Sarawak,127,55,72,2015
2015-02-08,Sarawak,219,143,76,2015
2015-02-09,Sarawak,28,10,18,2015
2015-02-10,Sarawak,40,8,32,2015
2015-02-11,Sarawak,92,21,71,2015
2015-02-12,Sarawak,67,47,20,2015
2015-02-13,Sarawak,34,11,23,2015
2015-02-14,Sarawak,156,68,88,2015
2015-02-15,Sarawak,189,100,89,2015
2015-02-16,Sarawak,99,42,57,2015
2015-02-17,Sarawak,60,16,44,2015
2015-02-18,Sarawak,218,147,71,2015
2015-02-19,Sarawak,39,13,26,2015
2015-02-20,Sarawak,2,1,1,2015
2015-02-21,Sarawak,79,27,52,2015
2015-02-22,Sarawak,62,22,40,2015
2015-02-23,Sarawak,47,17,30,2015
2015-02-24,Sarawak,112,37,75,2015
2015-02-25,Sarawak,116,71,45,2015
2015-02-26,Sarawak,125,45,80,2015
2015-02-27,Sarawak,51,15,36,2015
2015-02-28,Sarawak,93,59,34,2015
2015-03-01,Sarawak,230,89,141,2015
2015-03-02,Sarawak,85,34,51,2015
2015-03-03,Sarawak,61,18,43,2015
2015-03-04,Sarawak,76,10,66,2015
2015-03-05,Sarawak,160,79,81,2015
2015-03-06,Sarawak,38,7,31,2015
2015-03-07,Sarawak,105,63,42,2015
2015-03-08,Sarawak,114,62,52,2015
2015-03-09,Sarawak,44,13,31,2015
2015-03-10,Sarawak,36,6,30,2015
2015-03-11,Sarawak,111,42,69,2015
2015-03-12,Sarawak,277,116,161,2015
2015-03-13,Sarawak,49,9,40,2015
2015-03-14,Sarawak,239,102,137,2015
2015-03-15,Sarawak,386,91,295,2015
2015-03-16,Sarawak,40,10,30,2015
2015-03-17,Sarawak,144,100,44,2015
2015-03-18,Sarawak,86,31,55,2015
2015-03-19,Sarawak,72,35,37,2015
2015-03-20,Sarawak,40,13,27,2015
2015-03-21,Sarawak,99,47,52,2015
2015-03-22,Sarawak,347,126,221,2015
2015-03-23,Sarawak,49,8,41,2015
2015-03-24,Sarawak,42,10,32,2015
2015-03-25,Sarawak,178,103,75,2015
2015-03-26,Sarawak,74,11,63,2015
2015-03-27,Sarawak,37,8,29,2015
2015-03-28,Sarawak,82,32,50,2015
2015-03-29,Sarawak,253,82,171,2015
2015-03-30,Sarawak,39,10,29,2015
2015-03-31,Sarawak,65,17,48,2015
2015-04-01,Sarawak,138,81,57,2015
2015-04-02,Sarawak,40,7,33,2015
2015-04-03,Sarawak,0,0,0,2015
2015-04-04,Sarawak,56,22,34,2015
2015-04-05,Sarawak,343,110,233,2015
2015-04-06,Sarawak,67,15,52,2015
2015-04-07,Sarawak,96,24,72,2015
2015-04-08,Sarawak,90,32,58,2015
2015-04-09,Sarawak,83,40,43,2015
2015-04-10,Sarawak,39,3,36,2015
2015-04-11,Sarawak,199,98,101,2015
2015-04-12,Sarawak,303,100,203,2015
2015-04-13,Sarawak,88,15,73,2015
2015-04-14,Sarawak,61,14,47,2015
2015-04-15,Sarawak,54,18,36,2015
2015-04-16,Sarawak,64,31,33,2015
2015-04-17,Sarawak,33,1,32,2015
2015-04-18,Sarawak,143,54,89,2015
2015-04-19,Sarawak,202,78,124,2015
2015-04-20,Sarawak,70,30,40,2015
2015-04-21,Sarawak,147,73,74,2015
2015-04-22,Sarawak,60,17,43,2015
2015-04-23,Sarawak,73,40,33,2015
2015-04-24,Sarawak,35,9,26,2015
2015-04-25,Sarawak,88,41,47,2015
2015-04-26,Sarawak,268,85,183,2015
2015-04-27,Sarawak,40,4,36,2015
2015-04-28,Sarawak,67,11,56,2015
2015-04-29,Sarawak,147,61,86,2015
2015-04-30,Sarawak,49,9,40,2015
2015-05-01,Sarawak,169,60,109,2015
2015-05-02,Sarawak,120,51,69,2015
2015-05-03,Sarawak,111,36,75,2015
2015-05-04,Sarawak,123,75,48,2015
2015-05-05,Sarawak,86,28,58,2015
2015-05-06,Sarawak,56,16,40,2015
2015-05-07,Sarawak,87,20,67,2015
2015-05-08,Sarawak,24,5,19,2015
2015-05-09,Sarawak,161,47,114,2015
2015-05-10,Sarawak,434,111,323,2015
2015-05-11,Sarawak,53,8,45,2015
2015-05-12,Sarawak,72,12,60,2015
2015-05-13,Sarawak,86,15,71,2015
2015-05-14,Sarawak,82,19,63,2015
2015-05-15,Sarawak,27,4,23,2015
2015-05-16,Sarawak,114,76,38,2015
2015-05-17,Sarawak,168,46,122,2015
2015-05-18,Sarawak,63,16,47,2015
2015-05-19,Sarawak,24,1,23,2015
2015-05-20,Sarawak,25,5,20,2015
2015-05-21,Sarawak,167,59,108,2015
2015-05-22,Sarawak,28,4,24,2015
2015-05-23,Sarawak,125,73,52,2015
2015-05-24,Sarawak,376,76,300,2015
2015-05-25,Sarawak,30,5,25,2015
2015-05-26,Sarawak,109,27,82,2015
2015-05-27,Sarawak,158,84,74,2015
2015-05-28,Sarawak,45,11,34,2015
2015-05-29,Sarawak,39,3,36,2015
2015-05-30,Sarawak,81,37,44,2015
2015-05-31,Sarawak,75,27,48,2015
2015-06-01,Sarawak,0,0,0,2015
2015-06-02,Sarawak,0,0,0,2015
2015-06-03,Sarawak,26,4,22,2015
2015-06-04,Sarawak,45,10,35,2015
2015-06-05,Sarawak,39,3,36,2015
2015-06-06,Sarawak,90,54,36,2015
2015-06-07,Sarawak,168,64,104,2015
2015-06-08,Sarawak,61,20,41,2015
2015-06-09,Sarawak,40,5,35,2015
2015-06-10,Sarawak,122,36,86,2015
2015-06-11,Sarawak,71,11,60,2015
2015-06-12,Sarawak,31,5,26,2015
2015-06-13,Sarawak,183,72,111,2015
2015-06-14,Sarawak,427,69,358,2015
2015-06-15,Sarawak,41,2,39,2015
2015-06-16,Sarawak,150,46,104,2015
2015-06-17,Sarawak,101,20,81,2015
2015-06-18,Sarawak,72,42,30,2015
2015-06-19,Sarawak,21,3,18,2015
2015-06-20,Sarawak,74,20,54,2015
2015-06-21,Sarawak,143,38,105,2015
2015-06-22,Sarawak,34,4,30,2015
2015-06-23,Sarawak,23,3,20,2015
2015-06-24,Sarawak,98,57,41,2015
2015-06-25,Sarawak,30,2,28,2015
2015-06-26,Sarawak,28,8,20,2015
2015-06-27,Sarawak,95,47,48,2015
2015-06-28,Sarawak,305,69,236,2015
2015-06-29,Sarawak,34,5,29,2015
2015-06-30,Sarawak,140,109,31,2015
2015-07-01,Sarawak,45,16,29,2015
2015-07-02,Sarawak,30,4,26,2015
2015-07-03,Sarawak,18,6,12,2015
2015-07-04,Sarawak,56,12,44,2015
2015-07-05,Sarawak,420,84,336,2015
2015-07-06,Sarawak,68,37,31,2015
2015-07-07,Sarawak,27,9,18,2015
2015-07-08,Sarawak,69,13,56,2015
2015-07-09,Sarawak,88,55,33,2015
2015-07-10,Sarawak,28,6,22,2015
2015-07-11,Sarawak,125,48,77,2015
2015-07-12,Sarawak,287,82,205,2015
2015-07-13,Sarawak,94,42,52,2015
2015-07-14,Sarawak,61,6,55,2015
2015-07-15,Sarawak,70,18,52,2015
2015-07-16,Sarawak,36,6,30,2015
2015-07-17,Sarawak,1,0,1,2015
2015-07-18,Sarawak,30,6,24,2015
2015-07-19,Sarawak,130,38,92,2015
2015-07-20,Sarawak,50,4,46,2015
2015-07-21,Sarawak,56,15,41,2015
2015-07-22,Sarawak,80,29,51,2015
2015-07-23,Sarawak,84,35,49,2015
2015-07-24,Sarawak,159,44,115,2015
2015-07-25,Sarawak,128,37,91,2015
2015-07-26,Sarawak,316,69,247,2015
2015-07-27,Sarawak,40,6,34,2015
2015-07-28,Sarawak,126,57,69,2015
2015-07-29,Sarawak,122,31,91,2015
2015-07-30,Sarawak,53,6,47,2015
2015-07-31,Sarawak,43,2,41,2015
2015-08-01,Sarawak,264,120,144,2015
2015-08-02,Sarawak,166,35,131,2015
2015-08-03,Sarawak,48,7,41,2015
2015-08-04,Sarawak,55,11,44,2015
2015-08-05,Sarawak,98,43,55,2015
2015-08-06,Sarawak,36,3,33,2015
2015-08-07,Sarawak,38,7,31,2015
2015-08-08,Sarawak,149,72,77,2015
2015-08-09,Sarawak,309,80,229,2015
2015-08-10,Sarawak,44,12,32,2015
2015-08-11,Sarawak,73,15,58,2015
2015-08-12,Sarawak,133,32,101,2015
2015-08-13,Sarawak,144,34,110,2015
2015-08-14,Sarawak,80,22,58,2015
2015-08-15,Sarawak,57,22,35,2015
2015-08-16,Sarawak,278,81,197,2015
2015-08-17,Sarawak,70,19,51,2015
2015-08-18,Sarawak,68,11,57,2015
2015-08-19,Sarawak,138,31,107,2015
2015-08-20,Sarawak,224,75,149,2015
2015-08-21,Sarawak,51,8,43,2015
2015-08-22,Sarawak,214,124,90,2015
2015-08-23,Sarawak,228,86,142,2015
2015-08-24,Sarawak,36,7,29,2015
2015-08-25,Sarawak,95,11,84,2015
2015-08-26,Sarawak,157,29,128,2015
2015-08-27,Sarawak,160,91,69,2015
2015-08-28,Sarawak,24,1,23,2015
2015-08-29,Sarawak,68,15,53,2015
2015-08-30,Sarawak,308,57,251,2015
2015-08-31,Sarawak,150,41,109,2015
2015-09-01,Sarawak,54,3,51,2015
2015-09-02,Sarawak,181,65,116,2015
2015-09-03,Sarawak,88,25,63,2015
2015-09-04,Sarawak,64,19,45,2015
2015-09-05,Sarawak,84,38,46,2015
2015-09-06,Sarawak,312,86,226,2015
2015-09-07,Sarawak,25,1,24,2015
2015-09-08,Sarawak,90,35,55,2015
2015-09-09,Sarawak,63,21,42,2015
2015-09-10,Sarawak,56,9,47,2015
2015-09-11,Sarawak,33,4,29,2015
2015-09-12,Sarawak,68,16,52,2015
2015-09-13,Sarawak,240,52,188,2015
2015-09-14,Sarawak,36,5,31,2015
2015-09-15,Sarawak,132,78,54,2015
2015-09-16,Sarawak,382,161,221,2015
2015-09-17,Sarawak,87,16,71,2015
2015-09-18,Sarawak,43,6,37,2015
2015-09-19,Sarawak,163,82,81,2015
2015-09-20,Sarawak,271,43,228,2015
2015-09-21,Sarawak,39,8,31,2015
2015-09-22,Sarawak,50,9,41,2015
2015-09-23,Sarawak,40,6,34,2015
2015-09-24,Sarawak,53,27,26,2015
2015-09-25,Sarawak,43,1,42,2015
2015-09-26,Sarawak,113,44,69,2015
2015-09-27,Sarawak,209,41,168,2015
2015-09-28,Sarawak,36,6,30,2015
2015-09-29,Sarawak,66,26,40,2015
2015-09-30,Sarawak,39,5,34,2015
2015-10-01,Sarawak,65,34,31,2015
2015-10-02,Sarawak,73,13,60,2015
2015-10-03,Sarawak,88,39,49,2015
2015-10-04,Sarawak,427,54,373,2015
2015-10-05,Sarawak,41,8,33,2015
2015-10-06,Sarawak,37,4,33,2015
2015-10-07,Sarawak,73,34,39,2015
2015-10-08,Sarawak,29,3,26,2015
2015-10-09,Sarawak,44,13,31,2015
2015-10-10,Sarawak,62,13,49,2015
2015-10-11,Sarawak,293,46,247,2015
2015-10-12,Sarawak,72,19,53,2015
2015-10-13,Sarawak,29,1,28,2015
2015-10-14,Sarawak,71,14,57,2015
2015-10-15,Sarawak,72,21,51,2015
2015-10-16,Sarawak,37,8,29,2015
2015-10-17,Sarawak,108,48,60,2015
2015-10-18,Sarawak,221,72,149,2015
2015-10-19,Sarawak,53,9,44,2015
2015-10-20,Sarawak,77,35,42,2015
2015-10-21,Sarawak,111,51,60,2015
2015-10-22,Sarawak,91,32,59,2015
2015-10-23,Sarawak,37,5,32,2015
2015-10-24,Sarawak,74,22,52,2015
2015-10-25,Sarawak,215,40,175,2015
2015-10-26,Sarawak,39,2,37,2015
2015-10-27,Sarawak,53,17,36,2015
2015-10-28,Sarawak,133,41,92,2015
2015-10-29,Sarawak,53,11,42,2015
2015-10-30,Sarawak,35,4,31,2015
2015-10-31,Sarawak,143,59,84,2015
2015-11-01,Sarawak,217,48,169,2015
2015-11-02,Sarawak,43,6,37,2015
2015-11-03,Sarawak,101,28,73,2015
2015-11-04,Sarawak,73,22,51,2015
2015-11-05,Sarawak,58,7,51,2015
2015-11-06,Sarawak,21,2,19,2015
2015-11-07,Sarawak,92,41,51,2015
2015-11-08,Sarawak,301,82,219,2015
2015-11-09,Sarawak,37,7,30,2015
2015-11-10,Sarawak,35,8,27,2015
2015-11-11,Sarawak,113,42,71,2015
2015-11-12,Sarawak,70,12,58,2015
2015-11-13,Sarawak,43,2,41,2015
2015-11-14,Sarawak,137,37,100,2015
2015-11-15,Sarawak,308,50,258,2015
2015-11-16,Sarawak,48,6,42,2015
2015-11-17,Sarawak,97,14,83,2015
2015-11-18,Sarawak,66,9,57,2015
2015-11-19,Sarawak,80,5,75,2015
2015-11-20,Sarawak,37,6,31,2015
2015-11-21,Sarawak,87,27,60,2015
2015-11-22,Sarawak,145,30,115,2015
2015-11-23,Sarawak,204,97,107,2015
2015-11-24,Sarawak,46,10,36,2015
2015-11-25,Sarawak,110,26,84,2015
2015-11-26,Sarawak,107,23,84,2015
2015-11-27,Sarawak,64,22,42,2015
2015-11-28,Sarawak,136,54,82,2015
2015-11-29,Sarawak,315,52,263,2015
2015-11-30,Sarawak,33,5,28,2015
2015-12-01,Sarawak,58,17,41,2015
2015-12-02,Sarawak,82,16,66,2015
2015-12-03,Sarawak,107,42,65,2015
2015-12-04,Sarawak,147,59,88,2015
2015-12-05,Sarawak,127,41,86,2015
2015-12-06,Sarawak,122,33,89,2015
2015-12-07,Sarawak,70,6,64,2015
2015-12-08,Sarawak,40,4,36,2015
2015-12-09,Sarawak,123,58,65,2015
2015-12-10,Sarawak,74,27,47,2015
2015-12-11,Sarawak,30,2,28,2015
2015-12-12,Sarawak,157,47,110,2015
2015-12-13,Sarawak,279,27,252,2015
2015-12-14,Sarawak,140,48,92,2015
2015-12-15,Sarawak,77,16,61,2015
2015-12-16,Sarawak,98,40,58,2015
2015-12-17,Sarawak,174,67,107,2015
2015-12-18,Sarawak,31,4,27,2015
2015-12-19,Sarawak,118,31,87,2015
2015-12-20,Sarawak,271,56,215,2015
2015-12-21,Sarawak,46,10,36,2015
2015-12-22,Sarawak,93,21,72,2015
2015-12-23,Sarawak,49,10,39,2015
2015-12-24,Sarawak,1,0,1,2015
2015-12-25,Sarawak,0,0,0,2015
2015-12-26,Sarawak,30,10,20,2015
2015-12-27,Sarawak,175,37,138,2015
2015-12-28,Sarawak,32,6,26,2015
2015-12-29,Sarawak,63,14,49,2015
2015-12-30,Sarawak,89,17,72,2015
2015-12-31,Sarawak,34,4,30,2015
2016-01-01,Sarawak,172,24,148,2016
2016-01-02,Sarawak,32,6,26,2016
2016-01-03,Sarawak,255,19,236,2016
2016-01-04,Sarawak,40,7,33,2016
2016-01-05,Sarawak,43,4,39,2016
2016-01-06,Sarawak,93,26,67,2016
2016-01-07,Sarawak,71,13,58,2016
2016-01-08,Sarawak,48,7,41,2016
2016-01-09,Sarawak,161,35,126,2016
2016-01-10,Sarawak,288,46,242,2016
2016-01-11,Sarawak,47,7,40,2016
2016-01-12,Sarawak,27,2,25,2016
2016-01-13,Sarawak,141,52,89,2016
2016-01-14,Sarawak,128,36,92,2016
2016-01-15,Sarawak,24,5,19,2016
2016-01-16,Sarawak,47,9,38,2016
2016-01-17,Sarawak,246,38,208,2016
2016-01-18,Sarawak,44,3,41,2016
2016-01-19,Sarawak,42,10,32,2016
2016-01-20,Sarawak,59,9,50,2016
2016-01-21,Sarawak,25,3,22,2016
2016-01-22,Sarawak,65,16,49,2016
2016-01-23,Sarawak,103,19,84,2016
2016-01-24,Sarawak,133,31,102,2016
2016-01-25,Sarawak,56,8,48,2016
2016-01-26,Sarawak,135,39,96,2016
2016-01-27,Sarawak,82,13,69,2016
2016-01-28,Sarawak,68,11,57,2016
2016-01-29,Sarawak,76,23,53,2016
2016-01-30,Sarawak,180,63,117,2016
2016-01-31,Sarawak,200,34,166,2016
2016-02-01,Sarawak,75,13,62,2016
2016-02-02,Sarawak,87,24,63,2016
2016-02-03,Sarawak,167,56,111,2016
2016-02-04,Sarawak,132,52,80,2016
2016-02-05,Sarawak,95,44,51,2016
2016-02-06,Sarawak,55,15,40,2016
2016-02-07,Sarawak,55,22,33,2016
2016-02-08,Sarawak,1,0,1,2016
2016-02-09,Sarawak,0,0,0,2016
2016-02-10,Sarawak,35,7,28,2016
2016-02-11,Sarawak,133,49,84,2016
2016-02-12,Sarawak,50,8,42,2016
2016-02-13,Sarawak,86,27,59,2016
2016-02-14,Sarawak,191,49,142,2016
2016-02-15,Sarawak,48,7,41,2016
2016-02-16,Sarawak,75,28,47,2016
2016-02-17,Sarawak,121,29,92,2016
2016-02-18,Sarawak,98,14,84,2016
2016-02-19,Sarawak,52,9,43,2016
2016-02-20,Sarawak,139,56,83,2016
2016-02-21,Sarawak,180,59,121,2016
2016-02-22,Sarawak,56,11,45,2016
2016-02-23,Sarawak,107,47,60,2016
2016-02-24,Sarawak,94,12,82,2016
2016-02-25,Sarawak,138,31,107,2016
2016-02-26,Sarawak,143,70,73,2016
2016-02-27,Sarawak,65,31,34,2016
2016-02-28,Sarawak,317,69,248,2016
2016-02-29,Sarawak,79,31,48,2016
2016-03-01,Sarawak,31,6,25,2016
2016-03-02,Sarawak,99,35,64,2016
2016-03-03,Sarawak,110,30,80,2016
2016-03-04,Sarawak,37,4,33,2016
2016-03-05,Sarawak,194,99,95,2016
2016-03-06,Sarawak,141,31,110,2016
2016-03-07,Sarawak,77,36,41,2016
2016-03-08,Sarawak,333,148,185,2016
2016-03-09,Sarawak,158,61,97,2016
2016-03-10,Sarawak,80,11,69,2016
2016-03-11,Sarawak,85,20,65,2016
2016-03-12,Sarawak,192,70,122,2016
2016-03-13,Sarawak,227,50,177,2016
2016-03-14,Sarawak,56,11,45,2016
2016-03-15,Sarawak,126,42,84,2016
2016-03-16,Sarawak,116,46,70,2016
2016-03-17,Sarawak,37,6,31,2016
2016-03-18,Sarawak,33,2,31,2016
2016-03-19,Sarawak,200,46,154,2016
2016-03-20,Sarawak,271,50,221,2016
2016-03-21,Sarawak,32,6,26,2016
2016-03-22,Sarawak,77,16,61,2016
2016-03-23,Sarawak,36,1,35,2016
2016-03-24,Sarawak,39,3,36,2016
2016-03-25,Sarawak,0,0,0,2016
2016-03-26,Sarawak,132,50,82,2016
2016-03-27,Sarawak,376,49,327,2016
2016-03-28,Sarawak,57,14,43,2016
2016-03-29,Sarawak,203,83,120,2016
2016-03-30,Sarawak,90,23,67,2016
2016-03-31,Sarawak,77,36,41,2016
2016-04-01,Sarawak,40,2,38,2016
2016-04-02,Sarawak,117,39,78,2016
2016-04-03,Sarawak,362,72,290,2016
2016-04-04,Sarawak,45,3,42,2016
2016-04-05,Sarawak,64,20,44,2016
2016-04-06,Sarawak,95,36,59,2016
2016-04-07,Sarawak,68,17,51,2016
2016-04-08,Sarawak,113,39,74,2016
2016-04-09,Sarawak,136,49,87,2016
2016-04-10,Sarawak,194,32,162,2016
2016-04-11,Sarawak,38,11,27,2016
2016-04-12,Sarawak,62,16,46,2016
2016-04-13,Sarawak,138,38,100,2016
2016-04-14,Sarawak,70,4,66,2016
2016-04-15,Sarawak,63,18,45,2016
2016-04-16,Sarawak,88,30,58,2016
2016-04-17,Sarawak,349,59,290,2016
2016-04-18,Sarawak,71,32,39,2016
2016-04-19,Sarawak,48,6,42,2016
2016-04-20,Sarawak,72,17,55,2016
2016-04-21,Sarawak,62,15,47,2016
2016-04-22,Sarawak,42,6,36,2016
2016-04-23,Sarawak,47,19,28,2016
2016-04-24,Sarawak,167,36,131,2016
2016-04-25,Sarawak,127,70,57,2016
2016-04-26,Sarawak,37,9,28,2016
2016-04-27,Sarawak,64,12,52,2016
2016-04-28,Sarawak,75,18,57,2016
2016-04-29,Sarawak,29,5,24,2016
2016-04-30,Sarawak,41,9,32,2016
2016-05-01,Sarawak,291,57,234,2016
2016-05-02,Sarawak,43,16,27,2016
2016-05-03,Sarawak,29,7,22,2016
2016-05-04,Sarawak,44,5,39,2016
2016-05-05,Sarawak,72,18,54,2016
2016-05-06,Sarawak,111,41,70,2016
2016-05-07,Sarawak,0,0,0,2016
2016-05-08,Sarawak,112,30,82,2016
2016-05-09,Sarawak,34,0,34,2016
2016-05-10,Sarawak,58,14,44,2016
2016-05-11,Sarawak,174,49,125,2016
2016-05-12,Sarawak,55,6,49,2016
2016-05-13,Sarawak,35,6,29,2016
2016-05-14,Sarawak,90,30,60,2016
2016-05-15,Sarawak,403,59,344,2016
2016-05-16,Sarawak,37,7,30,2016
2016-05-17,Sarawak,65,12,53,2016
2016-05-18,Sarawak,245,96,149,2016
2016-05-19,Sarawak,61,16,45,2016
2016-05-20,Sarawak,39,4,35,2016
2016-05-21,Sarawak,115,26,89,2016
2016-05-22,Sarawak,154,37,117,2016
2016-05-23,Sarawak,32,7,25,2016
2016-05-24,Sarawak,92,14,78,2016
2016-05-25,Sarawak,143,44,99,2016
2016-05-26,Sarawak,97,17,80,2016
2016-05-27,Sarawak,26,3,23,2016
2016-05-28,Sarawak,56,18,38,2016
2016-05-29,Sarawak,252,48,204,2016
2016-05-30,Sarawak,39,6,33,2016
2016-05-31,Sarawak,64,8,56,2016
2016-06-01,Sarawak,0,0,0,2016
2016-06-02,Sarawak,0,0,0,2016
2016-06-03,Sarawak,66,3,63,2016
2016-06-04,Sarawak,62,15,47,2016
2016-06-05,Sarawak,230,50,180,2016
2016-06-06,Sarawak,28,2,26,2016
2016-06-07,Sarawak,22,1,21,2016
2016-06-08,Sarawak,42,10,32,2016
2016-06-09,Sarawak,28,1,27,2016
2016-06-10,Sarawak,28,6,22,2016
2016-06-11,Sarawak,61,27,34,2016
2016-06-12,Sarawak,233,42,191,2016
2016-06-13,Sarawak,26,4,22,2016
2016-06-14,Sarawak,56,18,38,2016
2016-06-15,Sarawak,77,20,57,2016
2016-06-16,Sarawak,79,14,65,2016
2016-06-17,Sarawak,36,2,34,2016
2016-06-18,Sarawak,70,25,45,2016
2016-06-19,Sarawak,148,17,131,2016
2016-06-20,Sarawak,22,1,21,2016
2016-06-21,Sarawak,127,43,84,2016
2016-06-22,Sarawak,58,24,34,2016
2016-06-23,Sarawak,57,21,36,2016
2016-06-24,Sarawak,29,4,25,2016
2016-06-25,Sarawak,103,51,52,2016
2016-06-26,Sarawak,298,33,265,2016
2016-06-27,Sarawak,20,2,18,2016
2016-06-28,Sarawak,59,26,33,2016
2016-06-29,Sarawak,44,6,38,2016
2016-06-30,Sarawak,29,5,24,2016
2016-07-01,Sarawak,46,11,35,2016
2016-07-02,Sarawak,84,25,59,2016
2016-07-03,Sarawak,345,59,286,2016
2016-07-04,Sarawak,40,4,36,2016
2016-07-05,Sarawak,31,1,30,2016
2016-07-06,Sarawak,0,0,0,2016
2016-07-07,Sarawak,0,0,0,2016
2016-07-08,Sarawak,15,4,11,2016
2016-07-09,Sarawak,61,19,42,2016
2016-07-10,Sarawak,194,20,174,2016
2016-07-11,Sarawak,80,11,69,2016
2016-07-12,Sarawak,66,12,54,2016
2016-07-13,Sarawak,129,31,98,2016
2016-07-14,Sarawak,69,11,58,2016
2016-07-15,Sarawak,80,12,68,2016
2016-07-16,Sarawak,90,29,61,2016
2016-07-17,Sarawak,325,51,274,2016
2016-07-18,Sarawak,76,13,63,2016
2016-07-19,Sarawak,93,27,66,2016
2016-07-20,Sarawak,134,44,90,2016
2016-07-21,Sarawak,117,22,95,2016
2016-07-22,Sarawak,100,28,72,2016
2016-07-23,Sarawak,51,13,38,2016
2016-07-24,Sarawak,207,44,163,2016
2016-07-25,Sarawak,34,5,29,2016
2016-07-26,Sarawak,54,26,28,2016
2016-07-27,Sarawak,63,22,41,2016
2016-07-28,Sarawak,38,0,38,2016
2016-07-29,Sarawak,59,16,43,2016
2016-07-30,Sarawak,100,43,57,2016
2016-07-31,Sarawak,324,50,274,2016
2016-08-01,Sarawak,80,14,66,2016
2016-08-02,Sarawak,43,6,37,2016
2016-08-03,Sarawak,38,5,33,2016
2016-08-04,Sarawak,36,6,30,2016
2016-08-05,Sarawak,59,12,47,2016
2016-08-06,Sarawak,146,57,89,2016
2016-08-07,Sarawak,214,65,149,2016
2016-08-08,Sarawak,41,1,40,2016
2016-08-09,Sarawak,370,182,188,2016
2016-08-10,Sarawak,105,58,47,2016
2016-08-11,Sarawak,58,12,46,2016
2016-08-12,Sarawak,84,28,56,2016
2016-08-13,Sarawak,60,22,38,2016
2016-08-14,Sarawak,140,36,104,2016
2016-08-15,Sarawak,67,11,56,2016
2016-08-16,Sarawak,89,39,50,2016
2016-08-17,Sarawak,166,50,116,2016
2016-08-18,Sarawak,33,5,28,2016
2016-08-19,Sarawak,120,17,103,2016
2016-08-20,Sarawak,66,15,51,2016
2016-08-21,Sarawak,317,50,267,2016
2016-08-22,Sarawak,110,26,84,2016
2016-08-23,Sarawak,37,7,30,2016
2016-08-24,Sarawak,151,45,106,2016
2016-08-25,Sarawak,108,20,88,2016
2016-08-26,Sarawak,57,7,50,2016
2016-08-27,Sarawak,102,21,81,2016
2016-08-28,Sarawak,406,65,341,2016
2016-08-29,Sarawak,94,24,70,2016
2016-08-30,Sarawak,45,11,34,2016
2016-08-31,Sarawak,40,11,29,2016
2016-09-01,Sarawak,60,10,50,2016
2016-09-02,Sarawak,45,10,35,2016
2016-09-03,Sarawak,94,41,53,2016
2016-09-04,Sarawak,220,44,176,2016
2016-09-05,Sarawak,60,10,50,2016
2016-09-06,Sarawak,80,22,58,2016
2016-09-07,Sarawak,161,56,105,2016
2016-09-08,Sarawak,44,12,32,2016
2016-09-09,Sarawak,64,8,56,2016
2016-09-10,Sarawak,152,44,108,2016
2016-09-11,Sarawak,163,36,127,2016
2016-09-12,Sarawak,0,0,0,2016
2016-09-13,Sarawak,31,6,25,2016
2016-09-14,Sarawak,44,4,40,2016
2016-09-15,Sarawak,38,5,33,2016
2016-09-16,Sarawak,182,61,121,2016
2016-09-17,Sarawak,108,32,76,2016
2016-09-18,Sarawak,224,52,172,2016
2016-09-19,Sarawak,56,9,47,2016
2016-09-20,Sarawak,64,11,53,2016
2016-09-21,Sarawak,110,34,76,2016
2016-09-22,Sarawak,175,46,129,2016
2016-09-23,Sarawak,35,5,30,2016
2016-09-24,Sarawak,110,62,48,2016
2016-09-25,Sarawak,186,34,152,2016
2016-09-26,Sarawak,33,2,31,2016
2016-09-27,Sarawak,77,27,50,2016
2016-09-28,Sarawak,216,113,103,2016
2016-09-29,Sarawak,24,3,21,2016
2016-09-30,Sarawak,57,14,43,2016
2016-10-01,Sarawak,124,35,89,2016
2016-10-02,Sarawak,370,65,305,2016
2016-10-03,Sarawak,82,37,45,2016
2016-10-04,Sarawak,46,4,42,2016
2016-10-05,Sarawak,91,37,54,2016
2016-10-06,Sarawak,103,15,88,2016
2016-10-07,Sarawak,43,4,39,2016
2016-10-08,Sarawak,128,31,97,2016
2016-10-09,Sarawak,236,36,200,2016
2016-10-10,Sarawak,75,14,61,2016
2016-10-11,Sarawak,35,2,33,2016
2016-10-12,Sarawak,124,22,102,2016
2016-10-13,Sarawak,75,12,63,2016
2016-10-14,Sarawak,133,46,87,2016
2016-10-15,Sarawak,154,70,84,2016
2016-10-16,Sarawak,139,33,106,2016
2016-10-17,Sarawak,33,4,29,2016
2016-10-18,Sarawak,120,76,44,2016
2016-10-19,Sarawak,77,20,57,2016
2016-10-20,Sarawak,44,6,38,2016
2016-10-21,Sarawak,57,7,50,2016
2016-10-22,Sarawak,104,40,64,2016
2016-10-23,Sarawak,299,41,258,2016
2016-10-24,Sarawak,44,4,40,2016
2016-10-25,Sarawak,57,8,49,2016
2016-10-26,Sarawak,122,28,94,2016
2016-10-27,Sarawak,36,4,32,2016
2016-10-28,Sarawak,31,3,28,2016
2016-10-29,Sarawak,52,19,33,2016
2016-10-30,Sarawak,184,33,151,2016
2016-10-31,Sarawak,23,3,20,2016
2016-11-01,Sarawak,51,6,45,2016
2016-11-02,Sarawak,78,23,55,2016
2016-11-03,Sarawak,19,2,17,2016
2016-11-04,Sarawak,34,5,29,2016
2016-11-05,Sarawak,110,38,72,2016
2016-11-06,Sarawak,298,46,252,2016
2016-11-07,Sarawak,55,4,51,2016
2016-11-08,Sarawak,74,18,56,2016
2016-11-09,Sarawak,103,31,72,2016
2016-11-10,Sarawak,145,45,100,2016
2016-11-11,Sarawak,71,19,52,2016
2016-11-12,Sarawak,57,25,32,2016
2016-11-13,Sarawak,132,29,103,2016
2016-11-14,Sarawak,49,6,43,2016
2016-11-15,Sarawak,77,13,64,2016
2016-11-16,Sarawak,60,5,55,2016
2016-11-17,Sarawak,120,6,114,2016
2016-11-18,Sarawak,108,38,70,2016
2016-11-19,Sarawak,86,38,48,2016
2016-11-20,Sarawak,216,40,176,2016
2016-11-21,Sarawak,47,7,40,2016
2016-11-22,Sarawak,57,15,42,2016
2016-11-23,Sarawak,133,19,114,2016
2016-11-24,Sarawak,85,14,71,2016
2016-11-25,Sarawak,37,5,32,2016
2016-11-26,Sarawak,126,37,89,2016
2016-11-27,Sarawak,255,66,189,2016
2016-11-28,Sarawak,47,6,41,2016
2016-11-29,Sarawak,34,6,28,2016
2016-11-30,Sarawak,49,16,33,2016
2016-12-01,Sarawak,179,58,121,2016
2016-12-02,Sarawak,35,3,32,2016
2016-12-03,Sarawak,61,15,46,2016
2016-12-04,Sarawak,272,38,234,2016
2016-12-05,Sarawak,36,6,30,2016
2016-12-06,Sarawak,71,11,60,2016
2016-12-07,Sarawak,25,2,23,2016
2016-12-08,Sarawak,81,26,55,2016
2016-12-09,Sarawak,27,1,26,2016
2016-12-10,Sarawak,155,41,114,2016
2016-12-11,Sarawak,207,24,183,2016
2016-12-12,Sarawak,42,21,21,2016
2016-12-13,Sarawak,148,92,56,2016
2016-12-14,Sarawak,111,29,82,2016
2016-12-15,Sarawak,64,8,56,2016
2016-12-16,Sarawak,34,1,33,2016
2016-12-17,Sarawak,98,32,66,2016
2016-12-18,Sarawak,173,18,155,2016
2016-12-19,Sarawak,42,3,39,2016
2016-12-20,Sarawak,106,35,71,2016
2016-12-21,Sarawak,134,93,41,2016
2016-12-22,Sarawak,59,12,47,2016
2016-12-23,Sarawak,32,1,31,2016
2016-12-24,Sarawak,43,12,31,2016
2016-12-25,Sarawak,98,22,76,2016
2016-12-26,Sarawak,0,0,0,2016
2016-12-27,Sarawak,27,1,26,2016
2016-12-28,Sarawak,74,20,54,2016
2016-12-29,Sarawak,55,15,40,2016
2016-12-30,Sarawak,41,2,39,2016
2016-12-31,Sarawak,24,5,19,2016
2017-01-01,Sarawak,238,28,210,2017
2017-01-02,Sarawak,2,0,2,2017
2017-01-03,Sarawak,38,2,36,2017
2017-01-04,Sarawak,51,5,46,2017
2017-01-05,Sarawak,46,5,41,2017
2017-01-06,Sarawak,39,5,34,2017
2017-01-07,Sarawak,116,26,90,2017
2017-01-08,Sarawak,242,37,205,2017
2017-01-09,Sarawak,106,22,84,2017
2017-01-10,Sarawak,71,7,64,2017
2017-01-11,Sarawak,151,26,125,2017
2017-01-12,Sarawak,0,0,0,2017
2017-01-13,Sarawak,45,5,40,2017
2017-01-14,Sarawak,84,25,59,2017
2017-01-15,Sarawak,282,40,242,2017
2017-01-16,Sarawak,49,1,48,2017
2017-01-17,Sarawak,154,46,108,2017
2017-01-18,Sarawak,77,23,54,2017
2017-01-19,Sarawak,90,23,67,2017
2017-01-20,Sarawak,59,11,48,2017
2017-01-21,Sarawak,127,24,103,2017
2017-01-22,Sarawak,173,29,144,2017
2017-01-23,Sarawak,44,6,38,2017
2017-01-24,Sarawak,118,36,82,2017
2017-01-25,Sarawak,195,103,92,2017
2017-01-26,Sarawak,119,43,76,2017
2017-01-27,Sarawak,39,3,36,2017
2017-01-28,Sarawak,6,2,4,2017
2017-01-29,Sarawak,0,0,0,2017
2017-01-30,Sarawak,6,0,6,2017
2017-01-31,Sarawak,52,7,45,2017
2017-02-01,Sarawak,93,27,66,2017
2017-02-02,Sarawak,109,30,79,2017
2017-02-03,Sarawak,62,7,55,2017
2017-02-04,Sarawak,177,61,116,2017
2017-02-05,Sarawak,157,51,106,2017
2017-02-06,Sarawak,52,6,46,2017
2017-02-07,Sarawak,86,15,71,2017
2017-02-08,Sarawak,102,34,68,2017
2017-02-09,Sarawak,286,198,88,2017
2017-02-10,Sarawak,48,5,43,2017
2017-02-11,Sarawak,89,32,57,2017
2017-02-12,Sarawak,181,34,147,2017
2017-02-13,Sarawak,94,27,67,2017
2017-02-14,Sarawak,92,24,68,2017
2017-02-15,Sarawak,81,20,61,2017
2017-02-16,Sarawak,39,6,33,2017
2017-02-17,Sarawak,44,6,38,2017
2017-02-18,Sarawak,139,45,94,2017
2017-02-19,Sarawak,321,29,292,2017
2017-02-20,Sarawak,52,10,42,2017
2017-02-21,Sarawak,52,10,42,2017
2017-02-22,Sarawak,141,20,121,2017
2017-02-23,Sarawak,176,38,138,2017
2017-02-24,Sarawak,37,10,27,2017
2017-02-25,Sarawak,167,50,117,2017
2017-02-26,Sarawak,246,35,211,2017
2017-02-27,Sarawak,60,9,51,2017
2017-02-28,Sarawak,62,16,46,2017
2017-03-01,Sarawak,76,8,68,2017
2017-03-02,Sarawak,134,59,75,2017
2017-03-03,Sarawak,64,22,42,2017
2017-03-04,Sarawak,103,23,80,2017
2017-03-05,Sarawak,321,67,254,2017
2017-03-06,Sarawak,47,0,47,2017
2017-03-07,Sarawak,83,8,75,2017
2017-03-08,Sarawak,244,105,139,2017
2017-03-09,Sarawak,45,8,37,2017
2017-03-10,Sarawak,29,3,26,2017
2017-03-11,Sarawak,160,53,107,2017
2017-03-12,Sarawak,276,61,215,2017
2017-03-13,Sarawak,148,48,100,2017
2017-03-14,Sarawak,69,20,49,2017
2017-03-15,Sarawak,61,17,44,2017
2017-03-16,Sarawak,144,57,87,2017
2017-03-17,Sarawak,71,24,47,2017
2017-03-18,Sarawak,107,49,58,2017
2017-03-19,Sarawak,320,39,281,2017
2017-03-20,Sarawak,56,6,50,2017
2017-03-21,Sarawak,100,19,81,2017
2017-03-22,Sarawak,169,56,113,2017
2017-03-23,Sarawak,80,18,62,2017
2017-03-24,Sarawak,115,44,71,2017
2017-03-25,Sarawak,81,28,53,2017
2017-03-26,Sarawak,265,56,209,2017
2017-03-27,Sarawak,103,57,46,2017
2017-03-28,Sarawak,119,37,82,2017
2017-03-29,Sarawak,148,53,95,2017
2017-03-30,Sarawak,106,37,69,2017
2017-03-31,Sarawak,47,8,39,2017
2017-04-01,Sarawak,93,24,69,2017
2017-04-02,Sarawak,338,59,279,2017
2017-04-03,Sarawak,33,4,29,2017
2017-04-04,Sarawak,130,24,106,2017
2017-04-05,Sarawak,135,51,84,2017
2017-04-06,Sarawak,92,51,41,2017
2017-04-07,Sarawak,38,7,31,2017
2017-04-08,Sarawak,171,52,119,2017
2017-04-09,Sarawak,213,19,194,2017
2017-04-10,Sarawak,47,4,43,2017
2017-04-11,Sarawak,46,3,43,2017
2017-04-12,Sarawak,86,46,40,2017
2017-04-13,Sarawak,53,8,45,2017
2017-04-14,Sarawak,0,0,0,2017
2017-04-15,Sarawak,156,62,94,2017
2017-04-16,Sarawak,126,32,94,2017
2017-04-17,Sarawak,70,9,61,2017
2017-04-18,Sarawak,65,16,49,2017
2017-04-19,Sarawak,90,35,55,2017
2017-04-20,Sarawak,81,23,58,2017
2017-04-21,Sarawak,36,7,29,2017
2017-04-22,Sarawak,96,39,57,2017
2017-04-23,Sarawak,286,49,237,2017
2017-04-24,Sarawak,0,0,0,2017
2017-04-25,Sarawak,77,12,65,2017
2017-04-26,Sarawak,174,51,123,2017
2017-04-27,Sarawak,79,12,67,2017
2017-04-28,Sarawak,40,4,36,2017
2017-04-29,Sarawak,84,29,55,2017
2017-04-30,Sarawak,176,41,135,2017
2017-05-01,Sarawak,183,47,136,2017
2017-05-02,Sarawak,47,1,46,2017
2017-05-03,Sarawak,90,20,70,2017
2017-05-04,Sarawak,66,9,57,2017
2017-05-05,Sarawak,28,2,26,2017
2017-05-06,Sarawak,73,26,47,2017
2017-05-07,Sarawak,130,22,108,2017
2017-05-08,Sarawak,87,28,59,2017
2017-05-09,Sarawak,117,34,83,2017
2017-05-10,Sarawak,85,29,56,2017
2017-05-11,Sarawak,139,55,84,2017
2017-05-12,Sarawak,72,10,62,2017
2017-05-13,Sarawak,102,26,76,2017
2017-05-14,Sarawak,292,62,230,2017
2017-05-15,Sarawak,67,8,59,2017
2017-05-16,Sarawak,68,5,63,2017
2017-05-17,Sarawak,116,15,101,2017
2017-05-18,Sarawak,111,31,80,2017
2017-05-19,Sarawak,42,1,41,2017
2017-05-20,Sarawak,94,34,60,2017
2017-05-21,Sarawak,379,64,315,2017
2017-05-22,Sarawak,52,2,50,2017
2017-05-23,Sarawak,122,8,114,2017
2017-05-24,Sarawak,162,14,148,2017
2017-05-25,Sarawak,64,5,59,2017
2017-05-26,Sarawak,69,14,55,2017
2017-05-27,Sarawak,137,37,100,2017
2017-05-28,Sarawak,298,61,237,2017
2017-05-29,Sarawak,32,4,28,2017
2017-05-30,Sarawak,32,7,25,2017
2017-05-31,Sarawak,17,0,17,2017
2017-06-01,Sarawak,0,0,0,2017
2017-06-02,Sarawak,1,0,1,2017
2017-06-03,Sarawak,22,4,18,2017
2017-06-04,Sarawak,89,36,53,2017
2017-06-05,Sarawak,23,2,21,2017
2017-06-06,Sarawak,31,0,31,2017
2017-06-07,Sarawak,36,2,34,2017
2017-06-08,Sarawak,27,2,25,2017
2017-06-09,Sarawak,36,1,35,2017
2017-06-10,Sarawak,76,23,53,2017
2017-06-11,Sarawak,243,28,215,2017
2017-06-12,Sarawak,20,0,20,2017
2017-06-13,Sarawak,70,24,46,2017
2017-06-14,Sarawak,115,47,68,2017
2017-06-15,Sarawak,76,8,68,2017
2017-06-16,Sarawak,21,0,21,2017
2017-06-17,Sarawak,118,33,85,2017
2017-06-18,Sarawak,192,24,168,2017
2017-06-19,Sarawak,26,2,24,2017
2017-06-20,Sarawak,43,6,37,2017
2017-06-21,Sarawak,105,69,36,2017
2017-06-22,Sarawak,85,11,74,2017
2017-06-23,Sarawak,45,6,39,2017
2017-06-24,Sarawak,41,11,30,2017
2017-06-25,Sarawak,0,0,0,2017
2017-06-26,Sarawak,0,0,0,2017
2017-06-27,Sarawak,23,6,17,2017
2017-06-28,Sarawak,36,2,34,2017
2017-06-29,Sarawak,51,7,44,2017
2017-06-30,Sarawak,50,4,46,2017
2017-07-01,Sarawak,32,10,22,2017
2017-07-02,Sarawak,328,33,295,2017
2017-07-03,Sarawak,62,5,57,2017
2017-07-04,Sarawak,55,2,53,2017
2017-07-05,Sarawak,91,40,51,2017
2017-07-06,Sarawak,47,2,45,2017
2017-07-07,Sarawak,43,3,40,2017
2017-07-08,Sarawak,119,40,79,2017
2017-07-09,Sarawak,360,48,312,2017
2017-07-10,Sarawak,60,4,56,2017
2017-07-11,Sarawak,65,5,60,2017
2017-07-12,Sarawak,195,112,83,2017
2017-07-13,Sarawak,88,6,82,2017
2017-07-14,Sarawak,99,37,62,2017
2017-07-15,Sarawak,67,26,41,2017
2017-07-16,Sarawak,211,39,172,2017
2017-07-17,Sarawak,60,6,54,2017
2017-07-18,Sarawak,115,42,73,2017
2017-07-19,Sarawak,73,16,57,2017
2017-07-20,Sarawak,116,48,68,2017
2017-07-21,Sarawak,64,18,46,2017
2017-07-22,Sarawak,285,65,220,2017
2017-07-23,Sarawak,262,47,215,2017
2017-07-24,Sarawak,33,3,30,2017
2017-07-25,Sarawak,98,17,81,2017
2017-07-26,Sarawak,60,18,42,2017
2017-07-27,Sarawak,144,18,126,2017
2017-07-28,Sarawak,39,3,36,2017
2017-07-29,Sarawak,139,33,106,2017
2017-07-30,Sarawak,267,58,209,2017
2017-07-31,Sarawak,36,3,33,2017
2017-08-01,Sarawak,44,3,41,2017
2017-08-02,Sarawak,125,46,79,2017
2017-08-03,Sarawak,105,24,81,2017
2017-08-04,Sarawak,37,3,34,2017
2017-08-05,Sarawak,179,50,129,2017
2017-08-06,Sarawak,289,69,220,2017
2017-08-07,Sarawak,43,3,40,2017
2017-08-08,Sarawak,101,15,86,2017
2017-08-09,Sarawak,89,32,57,2017
2017-08-10,Sarawak,37,6,31,2017
2017-08-11,Sarawak,30,5,25,2017
2017-08-12,Sarawak,166,73,93,2017
2017-08-13,Sarawak,247,62,185,2017
2017-08-14,Sarawak,33,1,32,2017
2017-08-15,Sarawak,91,9,82,2017
2017-08-16,Sarawak,46,13,33,2017
2017-08-17,Sarawak,85,9,76,2017
2017-08-18,Sarawak,31,3,28,2017
2017-08-19,Sarawak,110,39,71,2017
2017-08-20,Sarawak,495,82,413,2017
2017-08-21,Sarawak,66,13,53,2017
2017-08-22,Sarawak,52,7,45,2017
2017-08-23,Sarawak,69,13,56,2017
2017-08-24,Sarawak,94,8,86,2017
2017-08-25,Sarawak,35,1,34,2017
2017-08-26,Sarawak,188,57,131,2017
2017-08-27,Sarawak,326,74,252,2017
2017-08-28,Sarawak,62,11,51,2017
2017-08-29,Sarawak,58,6,52,2017
2017-08-30,Sarawak,47,2,45,2017
2017-08-31,Sarawak,59,12,47,2017
2017-09-01,Sarawak,0,0,0,2017
2017-09-02,Sarawak,74,21,53,2017
2017-09-03,Sarawak,146,38,108,2017
2017-09-04,Sarawak,3,0,3,2017
2017-09-05,Sarawak,33,2,31,2017
2017-09-06,Sarawak,164,37,127,2017
2017-09-07,Sarawak,68,7,61,2017
2017-09-08,Sarawak,43,5,38,2017
2017-09-09,Sarawak,36,15,21,2017
2017-09-10,Sarawak,270,32,238,2017
2017-09-11,Sarawak,84,17,67,2017
2017-09-12,Sarawak,97,21,76,2017
2017-09-13,Sarawak,118,51,67,2017
2017-09-14,Sarawak,24,1,23,2017
2017-09-15,Sarawak,38,1,37,2017
2017-09-16,Sarawak,265,76,189,2017
2017-09-17,Sarawak,186,51,135,2017
2017-09-18,Sarawak,39,1,38,2017
2017-09-19,Sarawak,40,6,34,2017
2017-09-20,Sarawak,81,25,56,2017
2017-09-21,Sarawak,47,6,41,2017
2017-09-22,Sarawak,0,0,0,2017
2017-09-23,Sarawak,160,79,81,2017
2017-09-24,Sarawak,233,39,194,2017
2017-09-25,Sarawak,43,11,32,2017
2017-09-26,Sarawak,135,45,90,2017
2017-09-27,Sarawak,85,21,64,2017
2017-09-28,Sarawak,59,6,53,2017
2017-09-29,Sarawak,70,16,54,2017
2017-09-30,Sarawak,93,27,66,2017
2017-10-01,Sarawak,379,65,314,2017
2017-10-02,Sarawak,43,3,40,2017
2017-10-03,Sarawak,85,36,49,2017
2017-10-04,Sarawak,112,42,70,2017
2017-10-05,Sarawak,66,9,57,2017
2017-10-06,Sarawak,50,4,46,2017
2017-10-07,Sarawak,164,68,96,2017
2017-10-08,Sarawak,293,51,242,2017
2017-10-09,Sarawak,45,6,39,2017
2017-10-10,Sarawak,42,4,38,2017
2017-10-11,Sarawak,121,31,90,2017
2017-10-12,Sarawak,124,30,94,2017
2017-10-13,Sarawak,49,5,44,2017
2017-10-14,Sarawak,116,39,77,2017
2017-10-15,Sarawak,203,52,151,2017
2017-10-16,Sarawak,60,12,48,2017
2017-10-17,Sarawak,67,12,55,2017
2017-10-18,Sarawak,59,7,52,2017
2017-10-19,Sarawak,70,5,65,2017
2017-10-20,Sarawak,38,5,33,2017
2017-10-21,Sarawak,152,24,128,2017
2017-10-22,Sarawak,247,29,218,2017
2017-10-23,Sarawak,18,1,17,2017
2017-10-24,Sarawak,41,9,32,2017
2017-10-25,Sarawak,120,28,92,2017
2017-10-26,Sarawak,87,14,73,2017
2017-10-27,Sarawak,41,8,33,2017
2017-10-28,Sarawak,132,48,84,2017
2017-10-29,Sarawak,212,25,187,2017
2017-10-30,Sarawak,30,2,28,2017
2017-10-31,Sarawak,62,6,56,2017
2017-11-01,Sarawak,98,19,79,2017
2017-11-02,Sarawak,53,21,32,2017
2017-11-03,Sarawak,39,2,37,2017
2017-11-04,Sarawak,124,46,78,2017
2017-11-05,Sarawak,263,53,210,2017
2017-11-06,Sarawak,73,14,59,2017
2017-11-07,Sarawak,45,2,43,2017
2017-11-08,Sarawak,54,7,47,2017
2017-11-09,Sarawak,61,10,51,2017
2017-11-10,Sarawak,37,9,28,2017
2017-11-11,Sarawak,189,39,150,2017
2017-11-12,Sarawak,127,21,106,2017
2017-11-13,Sarawak,36,3,33,2017
2017-11-14,Sarawak,89,9,80,2017
2017-11-15,Sarawak,38,2,36,2017
2017-11-16,Sarawak,41,7,34,2017
2017-11-17,Sarawak,45,1,44,2017
2017-11-18,Sarawak,92,26,66,2017
2017-11-19,Sarawak,249,31,218,2017
2017-11-20,Sarawak,44,2,42,2017
2017-11-21,Sarawak,62,11,51,2017
2017-11-22,Sarawak,65,13,52,2017
2017-11-23,Sarawak,114,31,83,2017
2017-11-24,Sarawak,22,2,20,2017
2017-11-25,Sarawak,36,12,24,2017
2017-11-26,Sarawak,261,49,212,2017
2017-11-27,Sarawak,36,3,33,2017
2017-11-28,Sarawak,100,13,87,2017
2017-11-29,Sarawak,79,14,65,2017
2017-11-30,Sarawak,47,9,38,2017
2017-12-01,Sarawak,0,0,0,2017
2017-12-02,Sarawak,46,21,25,2017
2017-12-03,Sarawak,155,26,129,2017
2017-12-04,Sarawak,37,1,36,2017
2017-12-05,Sarawak,108,22,86,2017
2017-12-06,Sarawak,44,13,31,2017
2017-12-07,Sarawak,101,45,56,2017
2017-12-08,Sarawak,34,3,31,2017
2017-12-09,Sarawak,115,21,94,2017
2017-12-10,Sarawak,207,41,166,2017
2017-12-11,Sarawak,36,4,32,2017
2017-12-12,Sarawak,99,18,81,2017
2017-12-13,Sarawak,122,13,109,2017
2017-12-14,Sarawak,84,29,55,2017
2017-12-15,Sarawak,50,5,45,2017
2017-12-16,Sarawak,52,23,29,2017
2017-12-17,Sarawak,286,53,233,2017
2017-12-18,Sarawak,61,13,48,2017
2017-12-19,Sarawak,46,4,42,2017
2017-12-20,Sarawak,70,6,64,2017
2017-12-21,Sarawak,214,84,130,2017
2017-12-22,Sarawak,61,9,52,2017
2017-12-23,Sarawak,51,10,41,2017
2017-12-24,Sarawak,105,17,88,2017
2017-12-25,Sarawak,0,0,0,2017
2017-12-26,Sarawak,53,4,49,2017
2017-12-27,Sarawak,80,13,67,2017
2017-12-28,Sarawak,106,29,77,2017
2017-12-29,Sarawak,77,12,65,2017
2017-12-30,Sarawak,26,4,22,2017
2017-12-31,Sarawak,118,20,98,2017
2018-01-01,Sarawak,235,21,214,2018
2018-01-02,Sarawak,29,2,27,2018
2018-01-03,Sarawak,62,20,42,2018
2018-01-04,Sarawak,134,82,52,2018
2018-01-05,Sarawak,37,2,35,2018
2018-01-06,Sarawak,58,18,40,2018
2018-01-07,Sarawak,406,31,375,2018
2018-01-08,Sarawak,56,8,48,2018
2018-01-09,Sarawak,32,1,31,2018
2018-01-10,Sarawak,47,9,38,2018
2018-01-11,Sarawak,42,3,39,2018
2018-01-12,Sarawak,90,24,66,2018
2018-01-13,Sarawak,102,19,83,2018
2018-01-14,Sarawak,278,42,236,2018
2018-01-15,Sarawak,47,5,42,2018
2018-01-16,Sarawak,52,9,43,2018
2018-01-17,Sarawak,92,49,43,2018
2018-01-18,Sarawak,102,11,91,2018
2018-01-19,Sarawak,200,73,127,2018
2018-01-20,Sarawak,91,32,59,2018
2018-01-21,Sarawak,211,44,167,2018
2018-01-22,Sarawak,54,13,41,2018
2018-01-23,Sarawak,89,10,79,2018
2018-01-24,Sarawak,203,101,102,2018
2018-01-25,Sarawak,89,18,71,2018
2018-01-26,Sarawak,74,14,60,2018
2018-01-27,Sarawak,105,29,76,2018
2018-01-28,Sarawak,279,36,243,2018
2018-01-29,Sarawak,42,5,37,2018
2018-01-30,Sarawak,67,6,61,2018
2018-01-31,Sarawak,118,35,83,2018
2018-02-01,Sarawak,86,17,69,2018
2018-02-02,Sarawak,53,14,39,2018
2018-02-03,Sarawak,196,114,82,2018
2018-02-04,Sarawak,202,54,148,2018
2018-02-05,Sarawak,42,6,36,2018
2018-02-06,Sarawak,53,13,40,2018
2018-02-07,Sarawak,115,52,63,2018
2018-02-08,Sarawak,118,61,57,2018
2018-02-09,Sarawak,42,3,39,2018
2018-02-10,Sarawak,93,32,61,2018
2018-02-11,Sarawak,211,45,166,2018
2018-02-12,Sarawak,37,4,33,2018
2018-02-13,Sarawak,144,63,81,2018
2018-02-14,Sarawak,135,48,87,2018
2018-02-15,Sarawak,71,25,46,2018
2018-02-16,Sarawak,0,0,0,2018
2018-02-17,Sarawak,32,11,21,2018
2018-02-18,Sarawak,31,6,25,2018
2018-02-19,Sarawak,38,2,36,2018
2018-02-20,Sarawak,39,2,37,2018
2018-02-21,Sarawak,91,26,65,2018
2018-02-22,Sarawak,111,26,85,2018
2018-02-23,Sarawak,64,9,55,2018
2018-02-24,Sarawak,142,51,91,2018
2018-02-25,Sarawak,221,53,168,2018
2018-02-26,Sarawak,86,17,69,2018
2018-02-27,Sarawak,79,29,50,2018
2018-02-28,Sarawak,62,17,45,2018
2018-03-01,Sarawak,108,32,76,2018
2018-03-02,Sarawak,68,20,48,2018
2018-03-03,Sarawak,146,37,109,2018
2018-03-04,Sarawak,371,58,313,2018
2018-03-05,Sarawak,48,3,45,2018
2018-03-06,Sarawak,101,13,88,2018
2018-03-07,Sarawak,124,36,88,2018
2018-03-08,Sarawak,106,28,78,2018
2018-03-09,Sarawak,39,2,37,2018
2018-03-10,Sarawak,49,8,41,2018
2018-03-11,Sarawak,192,39,153,2018
2018-03-12,Sarawak,37,1,36,2018
2018-03-13,Sarawak,86,22,64,2018
2018-03-14,Sarawak,191,82,109,2018
2018-03-15,Sarawak,57,7,50,2018
2018-03-16,Sarawak,30,3,27,2018
2018-03-17,Sarawak,125,40,85,2018
2018-03-18,Sarawak,316,53,263,2018
2018-03-19,Sarawak,39,2,37,2018
2018-03-20,Sarawak,101,14,87,2018
2018-03-21,Sarawak,115,24,91,2018
2018-03-22,Sarawak,94,34,60,2018
2018-03-23,Sarawak,35,4,31,2018
2018-03-24,Sarawak,142,39,103,2018
2018-03-25,Sarawak,253,53,200,2018
2018-03-26,Sarawak,42,3,39,2018
2018-03-27,Sarawak,60,11,49,2018
2018-03-28,Sarawak,68,15,53,2018
2018-03-29,Sarawak,57,21,36,2018
2018-03-30,Sarawak,164,50,114,2018
2018-03-31,Sarawak,149,106,43,2018
2018-04-01,Sarawak,318,51,267,2018
2018-04-02,Sarawak,40,4,36,2018
2018-04-03,Sarawak,93,38,55,2018
2018-04-04,Sarawak,51,14,37,2018
2018-04-05,Sarawak,354,132,222,2018
2018-04-06,Sarawak,38,4,34,2018
2018-04-07,Sarawak,190,54,136,2018
2018-04-08,Sarawak,267,26,241,2018
2018-04-09,Sarawak,45,4,41,2018
2018-04-10,Sarawak,77,12,65,2018
2018-04-11,Sarawak,59,16,43,2018
2018-04-12,Sarawak,47,9,38,2018
2018-04-13,Sarawak,47,5,42,2018
2018-04-14,Sarawak,188,72,116,2018
2018-04-15,Sarawak,238,54,184,2018
2018-04-16,Sarawak,51,9,42,2018
2018-04-17,Sarawak,125,64,61,2018
2018-04-18,Sarawak,128,45,83,2018
2018-04-19,Sarawak,48,6,42,2018
2018-04-20,Sarawak,41,4,37,2018
2018-04-21,Sarawak,102,16,86,2018
2018-04-22,Sarawak,284,39,245,2018
2018-04-23,Sarawak,43,5,38,2018
2018-04-24,Sarawak,42,3,39,2018
2018-04-25,Sarawak,101,14,87,2018
2018-04-26,Sarawak,118,19,99,2018
2018-04-27,Sarawak,31,1,30,2018
2018-04-28,Sarawak,76,21,55,2018
2018-04-29,Sarawak,252,45,207,2018
2018-04-30,Sarawak,27,2,25,2018
2018-05-01,Sarawak,207,40,167,2018
2018-05-02,Sarawak,52,8,44,2018
2018-05-03,Sarawak,53,22,31,2018
2018-05-04,Sarawak,33,3,30,2018
2018-05-05,Sarawak,151,49,102,2018
2018-05-06,Sarawak,141,39,102,2018
2018-05-07,Sarawak,62,16,46,2018
2018-05-08,Sarawak,49,3,46,2018
2018-05-09,Sarawak,0,0,0,2018
2018-05-10,Sarawak,12,0,12,2018
2018-05-11,Sarawak,76,12,64,2018
2018-05-12,Sarawak,97,30,67,2018
2018-05-13,Sarawak,188,38,150,2018
2018-05-14,Sarawak,76,12,64,2018
2018-05-15,Sarawak,89,18,71,2018
2018-05-16,Sarawak,138,29,109,2018
2018-05-17,Sarawak,19,6,13,2018
2018-05-18,Sarawak,0,0,0,2018
2018-05-19,Sarawak,64,23,41,2018
2018-05-20,Sarawak,279,46,233,2018
2018-05-21,Sarawak,29,3,26,2018
2018-05-22,Sarawak,56,21,35,2018
2018-05-23,Sarawak,90,33,57,2018
2018-05-24,Sarawak,47,18,29,2018
2018-05-25,Sarawak,63,8,55,2018
2018-05-26,Sarawak,51,17,34,2018
2018-05-27,Sarawak,218,38,180,2018
2018-05-28,Sarawak,34,5,29,2018
2018-05-29,Sarawak,102,27,75,2018
2018-05-30,Sarawak,50,5,45,2018
2018-05-31,Sarawak,29,2,27,2018
2018-06-01,Sarawak,26,4,22,2018
2018-06-02,Sarawak,0,0,0,2018
2018-06-03,Sarawak,133,24,109,2018
2018-06-04,Sarawak,49,14,35,2018
2018-06-05,Sarawak,51,7,44,2018
2018-06-06,Sarawak,69,17,52,2018
2018-06-07,Sarawak,26,1,25,2018
2018-06-08,Sarawak,35,3,32,2018
2018-06-09,Sarawak,127,27,100,2018
2018-06-10,Sarawak,354,59,295,2018
2018-06-11,Sarawak,91,12,79,2018
2018-06-12,Sarawak,61,13,48,2018
2018-06-13,Sarawak,48,8,40,2018
2018-06-14,Sarawak,37,3,34,2018
2018-06-15,Sarawak,0,0,0,2018
2018-06-16,Sarawak,0,0,0,2018
2018-06-17,Sarawak,101,14,87,2018
2018-06-18,Sarawak,42,7,35,2018
2018-06-19,Sarawak,74,13,61,2018
2018-06-20,Sarawak,100,16,84,2018
2018-06-21,Sarawak,64,7,57,2018
2018-06-22,Sarawak,69,6,63,2018
2018-06-23,Sarawak,184,51,133,2018
2018-06-24,Sarawak,336,56,280,2018
2018-06-25,Sarawak,63,7,56,2018
2018-06-26,Sarawak,99,18,81,2018
2018-06-27,Sarawak,91,21,70,2018
2018-06-28,Sarawak,142,30,112,2018
2018-06-29,Sarawak,45,6,39,2018
2018-06-30,Sarawak,73,22,51,2018
2018-07-01,Sarawak,342,55,287,2018
2018-07-02,Sarawak,56,4,52,2018
2018-07-03,Sarawak,113,19,94,2018
2018-07-04,Sarawak,129,31,98,2018
2018-07-05,Sarawak,69,8,61,2018
2018-07-06,Sarawak,35,4,31,2018
2018-07-07,Sarawak,195,44,151,2018
2018-07-08,Sarawak,266,45,221,2018
2018-07-09,Sarawak,49,2,47,2018
2018-07-10,Sarawak,69,11,58,2018
2018-07-11,Sarawak,164,49,115,2018
2018-07-12,Sarawak,86,31,55,2018
2018-07-13,Sarawak,32,5,27,2018
2018-07-14,Sarawak,116,18,98,2018
2018-07-15,Sarawak,255,33,222,2018
2018-07-16,Sarawak,26,2,24,2018
2018-07-17,Sarawak,67,6,61,2018
2018-07-18,Sarawak,66,15,51,2018
2018-07-19,Sarawak,102,28,74,2018
2018-07-20,Sarawak,88,18,70,2018
2018-07-21,Sarawak,123,53,70,2018
2018-07-22,Sarawak,225,45,180,2018
2018-07-23,Sarawak,27,6,21,2018
2018-07-24,Sarawak,165,48,117,2018
2018-07-25,Sarawak,106,14,92,2018
2018-07-26,Sarawak,142,73,69,2018
2018-07-27,Sarawak,37,6,31,2018
2018-07-28,Sarawak,175,76,99,2018
2018-07-29,Sarawak,232,32,200,2018
2018-07-30,Sarawak,48,2,46,2018
2018-07-31,Sarawak,59,20,39,2018
2018-08-01,Sarawak,88,19,69,2018
2018-08-02,Sarawak,53,2,51,2018
2018-08-03,Sarawak,33,4,29,2018
2018-08-04,Sarawak,152,49,103,2018
2018-08-05,Sarawak,248,59,189,2018
2018-08-06,Sarawak,177,66,111,2018
2018-08-07,Sarawak,115,9,106,2018
2018-08-08,Sarawak,109,49,60,2018
2018-08-09,Sarawak,77,25,52,2018
2018-08-10,Sarawak,35,4,31,2018
2018-08-11,Sarawak,184,64,120,2018
2018-08-12,Sarawak,311,72,239,2018
2018-08-13,Sarawak,32,2,30,2018
2018-08-14,Sarawak,57,12,45,2018
2018-08-15,Sarawak,52,8,44,2018
2018-08-16,Sarawak,35,4,31,2018
2018-08-17,Sarawak,92,29,63,2018
2018-08-18,Sarawak,236,67,169,2018
2018-08-19,Sarawak,222,51,171,2018
2018-08-20,Sarawak,47,6,41,2018
2018-08-21,Sarawak,28,4,24,2018
2018-08-22,Sarawak,0,0,0,2018
2018-08-23,Sarawak,70,10,60,2018
2018-08-24,Sarawak,36,5,31,2018
2018-08-25,Sarawak,125,19,106,2018
2018-08-26,Sarawak,316,34,282,2018
2018-08-27,Sarawak,28,3,25,2018
2018-08-28,Sarawak,72,19,53,2018
2018-08-29,Sarawak,101,33,68,2018
2018-08-30,Sarawak,45,15,30,2018
2018-08-31,Sarawak,126,29,97,2018
2018-09-01,Sarawak,60,16,44,2018
2018-09-02,Sarawak,268,54,214,2018
2018-09-03,Sarawak,36,2,34,2018
2018-09-04,Sarawak,91,32,59,2018
2018-09-05,Sarawak,70,26,44,2018
2018-09-06,Sarawak,136,42,94,2018
2018-09-07,Sarawak,52,7,45,2018
2018-09-08,Sarawak,134,44,90,2018
2018-09-09,Sarawak,183,70,113,2018
2018-09-10,Sarawak,0,0,0,2018
2018-09-11,Sarawak,0,0,0,2018
2018-09-12,Sarawak,81,12,69,2018
2018-09-13,Sarawak,85,18,67,2018
2018-09-14,Sarawak,48,8,40,2018
2018-09-15,Sarawak,73,33,40,2018
2018-09-16,Sarawak,292,62,230,2018
2018-09-17,Sarawak,83,25,58,2018
2018-09-18,Sarawak,68,7,61,2018
2018-09-19,Sarawak,75,14,61,2018
2018-09-20,Sarawak,55,14,41,2018
2018-09-21,Sarawak,52,8,44,2018
2018-09-22,Sarawak,77,30,47,2018
2018-09-23,Sarawak,174,29,145,2018
2018-09-24,Sarawak,44,5,39,2018
2018-09-25,Sarawak,68,16,52,2018
2018-09-26,Sarawak,151,40,111,2018
2018-09-27,Sarawak,91,25,66,2018
2018-09-28,Sarawak,25,1,24,2018
2018-09-29,Sarawak,90,28,62,2018
2018-09-30,Sarawak,314,46,268,2018
2018-10-01,Sarawak,56,2,54,2018
2018-10-02,Sarawak,24,1,23,2018
2018-10-03,Sarawak,135,76,59,2018
2018-10-04,Sarawak,56,7,49,2018
2018-10-05,Sarawak,44,9,35,2018
2018-10-06,Sarawak,214,51,163,2018
2018-10-07,Sarawak,418,51,367,2018
2018-10-08,Sarawak,69,9,60,2018
2018-10-09,Sarawak,91,18,73,2018
2018-10-10,Sarawak,98,27,71,2018
2018-10-11,Sarawak,96,16,80,2018
2018-10-12,Sarawak,49,4,45,2018
2018-10-13,Sarawak,189,71,118,2018
2018-10-14,Sarawak,182,30,152,2018
2018-10-15,Sarawak,41,2,39,2018
2018-10-16,Sarawak,73,11,62,2018
2018-10-17,Sarawak,159,67,92,2018
2018-10-18,Sarawak,121,42,79,2018
2018-10-19,Sarawak,30,2,28,2018
2018-10-20,Sarawak,109,33,76,2018
2018-10-21,Sarawak,264,34,230,2018
2018-10-22,Sarawak,33,3,30,2018
2018-10-23,Sarawak,60,14,46,2018
2018-10-24,Sarawak,170,75,95,2018
2018-10-25,Sarawak,127,26,101,2018
2018-10-26,Sarawak,40,5,35,2018
2018-10-27,Sarawak,115,33,82,2018
2018-10-28,Sarawak,342,50,292,2018
2018-10-29,Sarawak,73,7,66,2018
2018-10-30,Sarawak,131,58,73,2018
2018-10-31,Sarawak,154,61,93,2018
2018-11-01,Sarawak,88,32,56,2018
2018-11-02,Sarawak,53,5,48,2018
2018-11-03,Sarawak,61,6,55,2018
2018-11-04,Sarawak,195,33,162,2018
2018-11-05,Sarawak,43,5,38,2018
2018-11-06,Sarawak,50,8,42,2018
2018-11-07,Sarawak,123,20,103,2018
2018-11-08,Sarawak,58,6,52,2018
2018-11-09,Sarawak,38,4,34,2018
2018-11-10,Sarawak,92,32,60,2018
2018-11-11,Sarawak,127,15,112,2018
2018-11-12,Sarawak,34,4,30,2018
2018-11-13,Sarawak,69,20,49,2018
2018-11-14,Sarawak,35,5,30,2018
2018-11-15,Sarawak,87,22,65,2018
2018-11-16,Sarawak,37,8,29,2018
2018-11-17,Sarawak,79,21,58,2018
2018-11-18,Sarawak,338,64,274,2018
2018-11-19,Sarawak,30,1,29,2018
2018-11-20,Sarawak,41,12,29,2018
2018-11-21,Sarawak,57,5,52,2018
2018-11-22,Sarawak,55,18,37,2018
2018-11-23,Sarawak,30,4,26,2018
2018-11-24,Sarawak,152,34,118,2018
2018-11-25,Sarawak,174,30,144,2018
2018-11-26,Sarawak,34,1,33,2018
2018-11-27,Sarawak,56,9,47,2018
2018-11-28,Sarawak,81,18,63,2018
2018-11-29,Sarawak,17,2,15,2018
2018-11-30,Sarawak,37,2,35,2018
2018-12-01,Sarawak,60,16,44,2018
2018-12-02,Sarawak,249,41,208,2018
2018-12-03,Sarawak,34,2,32,2018
2018-12-04,Sarawak,78,6,72,2018
2018-12-05,Sarawak,124,44,80,2018
2018-12-06,Sarawak,44,6,38,2018
2018-12-07,Sarawak,29,1,28,2018
2018-12-08,Sarawak,136,49,87,2018
2018-12-09,Sarawak,139,30,109,2018
2018-12-10,Sarawak,33,2,31,2018
2018-12-11,Sarawak,52,13,39,2018
2018-12-12,Sarawak,72,16,56,2018
2018-12-13,Sarawak,83,13,70,2018
2018-12-14,Sarawak,55,6,49,2018
2018-12-15,Sarawak,158,61,97,2018
2018-12-16,Sarawak,267,50,217,2018
2018-12-17,Sarawak,41,1,40,2018
2018-12-18,Sarawak,113,33,80,2018
2018-12-19,Sarawak,55,2,53,2018
2018-12-20,Sarawak,71,10,61,2018
2018-12-21,Sarawak,46,10,36,2018
2018-12-22,Sarawak,102,32,70,2018
2018-12-23,Sarawak,242,35,207,2018
2018-12-24,Sarawak,39,1,38,2018
2018-12-25,Sarawak,0,0,0,2018
2018-12-26,Sarawak,29,6,23,2018
2018-12-27,Sarawak,130,33,97,2018
2018-12-28,Sarawak,61,4,57,2018
2018-12-29,Sarawak,51,13,38,2018
2018-12-30,Sarawak,259,31,228,2018
2018-12-31,Sarawak,66,6,60,2018
2019-01-01,Sarawak,191,26,165,2019
2019-01-02,Sarawak,31,1,30,2019
2019-01-03,Sarawak,52,16,36,2019
2019-01-04,Sarawak,43,2,41,2019
2019-01-05,Sarawak,129,58,71,2019
2019-01-06,Sarawak,429,56,373,2019
2019-01-07,Sarawak,34,3,31,2019
2019-01-08,Sarawak,46,0,46,2019
2019-01-09,Sarawak,41,5,36,2019
2019-01-10,Sarawak,72,11,61,2019
2019-01-11,Sarawak,31,0,31,2019
2019-01-12,Sarawak,149,37,112,2019
2019-01-13,Sarawak,239,28,211,2019
2019-01-14,Sarawak,29,3,26,2019
2019-01-15,Sarawak,133,24,109,2019
2019-01-16,Sarawak,58,18,40,2019
2019-01-17,Sarawak,122,36,86,2019
2019-01-18,Sarawak,62,10,52,2019
2019-01-19,Sarawak,245,81,164,2019
2019-01-20,Sarawak,253,56,197,2019
2019-01-21,Sarawak,57,5,52,2019
2019-01-22,Sarawak,31,2,29,2019
2019-01-23,Sarawak,117,24,93,2019
2019-01-24,Sarawak,54,10,44,2019
2019-01-25,Sarawak,108,11,97,2019
2019-01-26,Sarawak,90,18,72,2019
2019-01-27,Sarawak,269,42,227,2019
2019-01-28,Sarawak,55,9,46,2019
2019-01-29,Sarawak,99,21,78,2019
2019-01-30,Sarawak,77,11,66,2019
2019-01-31,Sarawak,52,10,42,2019
2019-02-01,Sarawak,105,26,79,2019
2019-02-02,Sarawak,127,41,86,2019
2019-02-03,Sarawak,134,43,91,2019
2019-02-04,Sarawak,43,4,39,2019
2019-02-05,Sarawak,0,0,0,2019
2019-02-06,Sarawak,0,0,0,2019
2019-02-07,Sarawak,58,13,45,2019
2019-02-08,Sarawak,70,14,56,2019
2019-02-09,Sarawak,31,10,21,2019
2019-02-10,Sarawak,102,36,66,2019
2019-02-11,Sarawak,42,9,33,2019
2019-02-12,Sarawak,78,35,43,2019
2019-02-13,Sarawak,101,45,56,2019
2019-02-14,Sarawak,68,19,49,2019
2019-02-15,Sarawak,42,3,39,2019
2019-02-16,Sarawak,151,56,95,2019
2019-02-17,Sarawak,300,53,247,2019
2019-02-18,Sarawak,66,10,56,2019
2019-02-19,Sarawak,82,23,59,2019
2019-02-20,Sarawak,77,19,58,2019
2019-02-21,Sarawak,138,41,97,2019
2019-02-22,Sarawak,59,26,33,2019
2019-02-23,Sarawak,116,43,73,2019
2019-02-24,Sarawak,384,80,304,2019
2019-02-25,Sarawak,43,6,37,2019
2019-02-26,Sarawak,85,36,49,2019
2019-02-27,Sarawak,105,30,75,2019
2019-02-28,Sarawak,82,33,49,2019
2019-03-01,Sarawak,57,20,37,2019
2019-03-02,Sarawak,222,100,122,2019
2019-03-03,Sarawak,333,50,283,2019
2019-03-04,Sarawak,61,8,53,2019
2019-03-05,Sarawak,135,71,64,2019
2019-03-06,Sarawak,108,44,64,2019
2019-03-07,Sarawak,85,12,73,2019
2019-03-08,Sarawak,51,17,34,2019
2019-03-09,Sarawak,189,51,138,2019
2019-03-10,Sarawak,246,43,203,2019
2019-03-11,Sarawak,46,1,45,2019
2019-03-12,Sarawak,54,20,34,2019
2019-03-13,Sarawak,105,36,69,2019
2019-03-14,Sarawak,76,40,36,2019
2019-03-15,Sarawak,27,4,23,2019
2019-03-16,Sarawak,105,33,72,2019
2019-03-17,Sarawak,314,58,256,2019
2019-03-18,Sarawak,62,4,58,2019
2019-03-19,Sarawak,158,44,114,2019
2019-03-20,Sarawak,152,43,109,2019
2019-03-21,Sarawak,98,13,85,2019
2019-03-22,Sarawak,45,6,39,2019
2019-03-23,Sarawak,90,25,65,2019
2019-03-24,Sarawak,284,45,239,2019
2019-03-25,Sarawak,40,4,36,2019
2019-03-26,Sarawak,75,18,57,2019
2019-03-27,Sarawak,89,25,64,2019
2019-03-28,Sarawak,87,27,60,2019
2019-03-29,Sarawak,43,6,37,2019
2019-03-30,Sarawak,63,19,44,2019
2019-03-31,Sarawak,278,52,226,2019
2019-04-01,Sarawak,27,1,26,2019
2019-04-02,Sarawak,114,46,68,2019
2019-04-03,Sarawak,98,16,82,2019
2019-04-04,Sarawak,97,50,47,2019
2019-04-05,Sarawak,67,18,49,2019
2019-04-06,Sarawak,208,81,127,2019
2019-04-07,Sarawak,431,33,398,2019
2019-04-08,Sarawak,41,2,39,2019
2019-04-09,Sarawak,42,6,36,2019
2019-04-10,Sarawak,148,59,89,2019
2019-04-11,Sarawak,47,7,40,2019
2019-04-12,Sarawak,86,11,75,2019
2019-04-13,Sarawak,177,57,120,2019
2019-04-14,Sarawak,280,37,243,2019
2019-04-15,Sarawak,114,33,81,2019
2019-04-16,Sarawak,69,9,60,2019
2019-04-17,Sarawak,311,116,195,2019
2019-04-18,Sarawak,129,30,99,2019
2019-04-19,Sarawak,24,8,16,2019
2019-04-20,Sarawak,42,6,36,2019
2019-04-21,Sarawak,257,48,209,2019
2019-04-22,Sarawak,71,13,58,2019
2019-04-23,Sarawak,97,20,77,2019
2019-04-24,Sarawak,87,22,65,2019
2019-04-25,Sarawak,72,10,62,2019
2019-04-26,Sarawak,62,13,49,2019
2019-04-27,Sarawak,177,39,138,2019
2019-04-28,Sarawak,173,34,139,2019
2019-04-29,Sarawak,87,32,55,2019
2019-04-30,Sarawak,109,44,65,2019
2019-05-01,Sarawak,305,88,217,2019
2019-05-02,Sarawak,57,8,49,2019
2019-05-03,Sarawak,84,25,59,2019
2019-05-04,Sarawak,123,39,84,2019
2019-05-05,Sarawak,126,25,101,2019
2019-05-06,Sarawak,19,1,18,2019
2019-05-07,Sarawak,19,2,17,2019
2019-05-08,Sarawak,33,3,30,2019
2019-05-09,Sarawak,36,8,28,2019
2019-05-10,Sarawak,34,3,31,2019
2019-05-11,Sarawak,135,44,91,2019
2019-05-12,Sarawak,202,35,167,2019
2019-05-13,Sarawak,31,3,28,2019
2019-05-14,Sarawak,31,3,28,2019
2019-05-15,Sarawak,40,6,34,2019
2019-05-16,Sarawak,41,7,34,2019
2019-05-17,Sarawak,21,2,19,2019
2019-05-18,Sarawak,99,19,80,2019
2019-05-19,Sarawak,216,28,188,2019
2019-05-20,Sarawak,62,15,47,2019
2019-05-21,Sarawak,16,1,15,2019
2019-05-22,Sarawak,62,17,45,2019
2019-05-23,Sarawak,42,15,27,2019
2019-05-24,Sarawak,13,0,13,2019
2019-05-25,Sarawak,113,30,83,2019
2019-05-26,Sarawak,140,33,107,2019
2019-05-27,Sarawak,55,13,42,2019
2019-05-28,Sarawak,34,5,29,2019
2019-05-29,Sarawak,30,2,28,2019
2019-05-30,Sarawak,50,12,38,2019
2019-05-31,Sarawak,28,4,24,2019
2019-06-01,Sarawak,0,0,0,2019
2019-06-02,Sarawak,73,21,52,2019
2019-06-03,Sarawak,12,3,9,2019
2019-06-04,Sarawak,30,0,30,2019
2019-06-05,Sarawak,0,0,0,2019
2019-06-06,Sarawak,10,2,8,2019
2019-06-07,Sarawak,41,7,34,2019
2019-06-08,Sarawak,60,19,41,2019
2019-06-09,Sarawak,90,18,72,2019
2019-06-10,Sarawak,44,11,33,2019
2019-06-11,Sarawak,68,11,57,2019
2019-06-12,Sarawak,103,18,85,2019
2019-06-13,Sarawak,76,15,61,2019
2019-06-14,Sarawak,101,25,76,2019
2019-06-15,Sarawak,224,47,177,2019
2019-06-16,Sarawak,407,51,356,2019
2019-06-17,Sarawak,93,18,75,2019
2019-06-18,Sarawak,44,4,40,2019
2019-06-19,Sarawak,127,37,90,2019
2019-06-20,Sarawak,73,10,63,2019
2019-06-21,Sarawak,85,14,71,2019
2019-06-22,Sarawak,75,18,57,2019
2019-06-23,Sarawak,371,49,322,2019
2019-06-24,Sarawak,109,18,91,2019
2019-06-25,Sarawak,68,14,54,2019
2019-06-26,Sarawak,53,7,46,2019
2019-06-27,Sarawak,221,75,146,2019
2019-06-28,Sarawak,46,2,44,2019
2019-06-29,Sarawak,112,31,81,2019
2019-06-30,Sarawak,236,27,209,2019
2019-07-01,Sarawak,50,0,50,2019
2019-07-02,Sarawak,89,13,76,2019
2019-07-03,Sarawak,94,15,79,2019
2019-07-04,Sarawak,36,5,31,2019
2019-07-05,Sarawak,28,0,28,2019
2019-07-06,Sarawak,100,25,75,2019
2019-07-07,Sarawak,524,80,444,2019
2019-07-08,Sarawak,46,7,39,2019
2019-07-09,Sarawak,34,3,31,2019
2019-07-10,Sarawak,201,77,124,2019
2019-07-11,Sarawak,67,8,59,2019
2019-07-12,Sarawak,42,5,37,2019
2019-07-13,Sarawak,108,26,82,2019
2019-07-14,Sarawak,216,27,189,2019
2019-07-15,Sarawak,54,4,50,2019
2019-07-16,Sarawak,68,11,57,2019
2019-07-17,Sarawak,184,50,134,2019
2019-07-18,Sarawak,50,5,45,2019
2019-07-19,Sarawak,46,2,44,2019
2019-07-20,Sarawak,220,122,98,2019
2019-07-21,Sarawak,321,41,280,2019
2019-07-22,Sarawak,101,31,70,2019
2019-07-23,Sarawak,51,8,43,2019
2019-07-24,Sarawak,140,44,96,2019
2019-07-25,Sarawak,73,4,69,2019
2019-07-26,Sarawak,32,0,32,2019
2019-07-27,Sarawak,39,11,28,2019
2019-07-28,Sarawak,185,32,153,2019
2019-07-29,Sarawak,50,3,47,2019
2019-07-30,Sarawak,0,0,0,2019
2019-07-31,Sarawak,119,37,82,2019
2019-08-01,Sarawak,84,9,75,2019
2019-08-02,Sarawak,64,7,57,2019
2019-08-03,Sarawak,127,35,92,2019
2019-08-04,Sarawak,238,39,199,2019
2019-08-05,Sarawak,33,2,31,2019
2019-08-06,Sarawak,77,9,68,2019
2019-08-07,Sarawak,136,34,102,2019
2019-08-08,Sarawak,65,36,29,2019
2019-08-09,Sarawak,39,2,37,2019
2019-08-10,Sarawak,67,9,58,2019
2019-08-11,Sarawak,19,3,16,2019
2019-08-12,Sarawak,87,21,66,2019
2019-08-13,Sarawak,57,7,50,2019
2019-08-14,Sarawak,73,22,51,2019
2019-08-15,Sarawak,30,3,27,2019
2019-08-16,Sarawak,32,2,30,2019
2019-08-17,Sarawak,86,24,62,2019
2019-08-18,Sarawak,280,48,232,2019
2019-08-19,Sarawak,52,17,35,2019
2019-08-20,Sarawak,35,2,33,2019
2019-08-21,Sarawak,97,40,57,2019
2019-08-22,Sarawak,96,16,80,2019
2019-08-23,Sarawak,151,30,121,2019
2019-08-24,Sarawak,269,86,183,2019
2019-08-25,Sarawak,288,63,225,2019
2019-08-26,Sarawak,29,2,27,2019
2019-08-27,Sarawak,41,7,34,2019
2019-08-28,Sarawak,113,44,69,2019
2019-08-29,Sarawak,83,30,53,2019
2019-08-30,Sarawak,42,6,36,2019
2019-08-31,Sarawak,167,45,122,2019
2019-09-01,Sarawak,152,21,131,2019
2019-09-02,Sarawak,61,11,50,2019
2019-09-03,Sarawak,68,28,40,2019
2019-09-04,Sarawak,121,37,84,2019
2019-09-05,Sarawak,105,18,87,2019
2019-09-06,Sarawak,41,9,32,2019
2019-09-07,Sarawak,112,25,87,2019
2019-09-08,Sarawak,227,56,171,2019
2019-09-09,Sarawak,19,3,16,2019
2019-09-10,Sarawak,53,13,40,2019
2019-09-11,Sarawak,114,34,80,2019
2019-09-12,Sarawak,68,27,41,2019
2019-09-13,Sarawak,38,1,37,2019
2019-09-14,Sarawak,132,25,107,2019
2019-09-15,Sarawak,230,46,184,2019
2019-09-16,Sarawak,134,32,102,2019
2019-09-17,Sarawak,44,1,43,2019
2019-09-18,Sarawak,120,44,76,2019
2019-09-19,Sarawak,83,15,68,2019
2019-09-20,Sarawak,61,10,51,2019
2019-09-21,Sarawak,189,52,137,2019
2019-09-22,Sarawak,379,53,326,2019
2019-09-23,Sarawak,70,12,58,2019
2019-09-24,Sarawak,50,9,41,2019
2019-09-25,Sarawak,74,12,62,2019
2019-09-26,Sarawak,133,56,77,2019
2019-09-27,Sarawak,39,3,36,2019
2019-09-28,Sarawak,92,31,61,2019
2019-09-29,Sarawak,190,29,161,2019
2019-09-30,Sarawak,37,1,36,2019
2019-10-01,Sarawak,47,3,44,2019
2019-10-02,Sarawak,89,31,58,2019
2019-10-03,Sarawak,110,20,90,2019
2019-10-04,Sarawak,26,3,23,2019
2019-10-05,Sarawak,192,78,114,2019
2019-10-06,Sarawak,446,65,381,2019
2019-10-07,Sarawak,30,1,29,2019
2019-10-08,Sarawak,56,5,51,2019
2019-10-09,Sarawak,131,46,85,2019
2019-10-10,Sarawak,121,43,78,2019
2019-10-11,Sarawak,44,3,41,2019
2019-10-12,Sarawak,241,45,196,2019
2019-10-13,Sarawak,207,21,186,2019
2019-10-14,Sarawak,37,9,28,2019
2019-10-15,Sarawak,115,71,44,2019
2019-10-16,Sarawak,173,89,84,2019
2019-10-17,Sarawak,35,4,31,2019
2019-10-18,Sarawak,34,1,33,2019
2019-10-19,Sarawak,122,23,99,2019
2019-10-20,Sarawak,337,32,305,2019
2019-10-21,Sarawak,37,4,33,2019
2019-10-22,Sarawak,49,4,45,2019
2019-10-23,Sarawak,43,3,40,2019
2019-10-24,Sarawak,58,8,50,2019
2019-10-25,Sarawak,61,9,52,2019
2019-10-26,Sarawak,100,27,73,2019
2019-10-27,Sarawak,102,20,82,2019
2019-10-28,Sarawak,22,0,22,2019
2019-10-29,Sarawak,25,3,22,2019
2019-10-30,Sarawak,130,28,102,2019
2019-10-31,Sarawak,63,18,45,2019
2019-11-01,Sarawak,28,0,28,2019
2019-11-02,Sarawak,110,23,87,2019
2019-11-03,Sarawak,294,46,248,2019
2019-11-04,Sarawak,42,5,37,2019
2019-11-05,Sarawak,32,2,30,2019
2019-11-06,Sarawak,99,27,72,2019
2019-11-07,Sarawak,122,23,99,2019
2019-11-08,Sarawak,59,15,44,2019
2019-11-09,Sarawak,17,0,17,2019
2019-11-10,Sarawak,268,38,230,2019
2019-11-11,Sarawak,27,5,22,2019
2019-11-12,Sarawak,48,17,31,2019
2019-11-13,Sarawak,66,15,51,2019
2019-11-14,Sarawak,69,7,62,2019
2019-11-15,Sarawak,27,4,23,2019
2019-11-16,Sarawak,122,31,91,2019
2019-11-17,Sarawak,266,52,214,2019
2019-11-18,Sarawak,29,2,27,2019
2019-11-19,Sarawak,68,7,61,2019
2019-11-20,Sarawak,122,13,109,2019
2019-11-21,Sarawak,63,11,52,2019
2019-11-22,Sarawak,53,9,44,2019
2019-11-23,Sarawak,152,30,122,2019
2019-11-24,Sarawak,151,23,128,2019
2019-11-25,Sarawak,42,3,39,2019
2019-11-26,Sarawak,93,51,42,2019
2019-11-27,Sarawak,63,11,52,2019
2019-11-28,Sarawak,80,5,75,2019
2019-11-29,Sarawak,94,18,76,2019
2019-11-30,Sarawak,115,34,81,2019
2019-12-01,Sarawak,227,35,192,2019
2019-12-02,Sarawak,48,2,46,2019
2019-12-03,Sarawak,37,7,30,2019
2019-12-04,Sarawak,112,41,71,2019
2019-12-05,Sarawak,54,8,46,2019
2019-12-06,Sarawak,33,3,30,2019
2019-12-07,Sarawak,139,36,103,2019
2019-12-08,Sarawak,193,44,149,2019
2019-12-09,Sarawak,24,3,21,2019
2019-12-10,Sarawak,67,17,50,2019
2019-12-11,Sarawak,90,17,73,2019
2019-12-12,Sarawak,78,35,43,2019
2019-12-13,Sarawak,37,1,36,2019
2019-12-14,Sarawak,162,26,136,2019
2019-12-15,Sarawak,295,52,243,2019
2019-12-16,Sarawak,36,3,33,2019
2019-12-17,Sarawak,111,14,97,2019
2019-12-18,Sarawak,62,13,49,2019
2019-12-19,Sarawak,35,1,34,2019
2019-12-20,Sarawak,52,3,49,2019
2019-12-21,Sarawak,56,9,47,2019
2019-12-22,Sarawak,240,34,206,2019
2019-12-23,Sarawak,50,7,43,2019
2019-12-24,Sarawak,57,4,53,2019
2019-12-25,Sarawak,0,0,0,2019
2019-12-26,Sarawak,69,13,56,2019
2019-12-27,Sarawak,43,5,38,2019
2019-12-28,Sarawak,153,58,95,2019
2019-12-29,Sarawak,202,38,164,2019
2019-12-30,Sarawak,41,3,38,2019
2019-12-31,Sarawak,41,4,37,2019
2020-01-01,Sarawak,173,10,163,2020
2020-01-02,Sarawak,36,5,31,2020
2020-01-03,Sarawak,34,5,29,2020
2020-01-04,Sarawak,68,15,53,2020
2020-01-05,Sarawak,377,42,335,2020
2020-01-06,Sarawak,32,1,31,2020
2020-01-07,Sarawak,65,8,57,2020
2020-01-08,Sarawak,87,14,73,2020
2020-01-09,Sarawak,51,5,46,2020
2020-01-10,Sarawak,29,0,29,2020
2020-01-11,Sarawak,172,34,138,2020
2020-01-12,Sarawak,224,34,190,2020
2020-01-13,Sarawak,35,5,30,2020
2020-01-14,Sarawak,58,15,43,2020
2020-01-15,Sarawak,68,10,58,2020
2020-01-16,Sarawak,99,13,86,2020
2020-01-17,Sarawak,95,20,75,2020
2020-01-18,Sarawak,154,36,118,2020
2020-01-19,Sarawak,252,43,209,2020
2020-01-20,Sarawak,68,8,60,2020
2020-01-21,Sarawak,105,39,66,2020
2020-01-22,Sarawak,72,12,60,2020
2020-01-23,Sarawak,70,9,61,2020
2020-01-24,Sarawak,67,15,52,2020
2020-01-25,Sarawak,19,12,7,2020
2020-01-26,Sarawak,0,0,0,2020
2020-01-27,Sarawak,70,27,43,2020
2020-01-28,Sarawak,76,12,64,2020
2020-01-29,Sarawak,28,6,22,2020
2020-01-30,Sarawak,69,7,62,2020
2020-01-31,Sarawak,55,19,36,2020
2020-02-01,Sarawak,86,23,63,2020
2020-02-02,Sarawak,173,26,147,2020
2020-02-03,Sarawak,36,10,26,2020
2020-02-04,Sarawak,62,13,49,2020
2020-02-05,Sarawak,79,15,64,2020
2020-02-06,Sarawak,70,10,60,2020
2020-02-07,Sarawak,44,5,39,2020
2020-02-08,Sarawak,115,20,95,2020
2020-02-09,Sarawak,159,39,120,2020
2020-02-10,Sarawak,26,3,23,2020
2020-02-11,Sarawak,76,37,39,2020
2020-02-12,Sarawak,121,40,81,2020
2020-02-13,Sarawak,56,5,51,2020
2020-02-14,Sarawak,57,12,45,2020
2020-02-15,Sarawak,140,38,102,2020
2020-02-16,Sarawak,296,37,259,2020
2020-02-17,Sarawak,29,1,28,2020
2020-02-18,Sarawak,90,29,61,2020
2020-02-19,Sarawak,55,5,50,2020
2020-02-20,Sarawak,126,48,78,2020
2020-02-21,Sarawak,31,0,31,2020
2020-02-22,Sarawak,102,25,77,2020
2020-02-23,Sarawak,238,48,190,2020
2020-02-24,Sarawak,44,5,39,2020
2020-02-25,Sarawak,97,3,94,2020
2020-02-26,Sarawak,57,14,43,2020
2020-02-27,Sarawak,47,4,43,2020
2020-02-28,Sarawak,74,11,63,2020
2020-02-29,Sarawak,235,126,109,2020
2020-03-01,Sarawak,266,61,205,2020
2020-03-02,Sarawak,36,1,35,2020
2020-03-03,Sarawak,37,9,28,2020
2020-03-04,Sarawak,123,39,84,2020
2020-03-05,Sarawak,91,28,63,2020
2020-03-06,Sarawak,50,20,30,2020
2020-03-07,Sarawak,76,17,59,2020
2020-03-08,Sarawak,328,57,271,2020
2020-03-09,Sarawak,26,2,24,2020
2020-03-10,Sarawak,165,59,106,2020
2020-03-11,Sarawak,70,11,59,2020
2020-03-12,Sarawak,59,17,42,2020
2020-03-13,Sarawak,33,3,30,2020
2020-03-14,Sarawak,94,23,71,2020
2020-03-15,Sarawak,64,13,51,2020
2020-03-16,Sarawak,21,3,18,2020
2020-03-17,Sarawak,41,16,25,2020
2020-03-18,Sarawak,36,8,28,2020
2020-03-19,Sarawak,47,9,38,2020
2020-03-20,Sarawak,49,7,42,2020
2020-03-21,Sarawak,71,16,55,2020
2020-03-22,Sarawak,57,17,40,2020
2020-03-23,Sarawak,53,11,42,2020
2020-03-24,Sarawak,142,21,121,2020
2020-03-25,Sarawak,146,18,128,2020
2020-03-26,Sarawak,87,15,72,2020
2020-03-27,Sarawak,103,19,84,2020
2020-03-28,Sarawak,162,50,112,2020
2020-03-29,Sarawak,222,65,157,2020
2020-03-30,Sarawak,64,6,58,2020
2020-03-31,Sarawak,75,18,57,2020
2020-04-01,Sarawak,91,25,66,2020
2020-04-02,Sarawak,89,14,75,2020
2020-04-03,Sarawak,43,6,37,2020
2020-04-04,Sarawak,72,13,59,2020
2020-04-05,Sarawak,57,3,54,2020
2020-04-06,Sarawak,33,3,30,2020
2020-04-07,Sarawak,22,3,19,2020
2020-04-08,Sarawak,64,8,56,2020
2020-04-09,Sarawak,24,2,22,2020
2020-04-10,Sarawak,33,2,31,2020
2020-04-11,Sarawak,102,13,89,2020
2020-04-12,Sarawak,63,5,58,2020
2020-04-13,Sarawak,26,2,24,2020
2020-04-14,Sarawak,23,4,19,2020
2020-04-15,Sarawak,40,4,36,2020
2020-04-16,Sarawak,27,4,23,2020
2020-04-17,Sarawak,33,3,30,2020
2020-04-18,Sarawak,106,34,72,2020
2020-04-19,Sarawak,60,22,38,2020
2020-04-20,Sarawak,49,2,47,2020
2020-04-21,Sarawak,146,47,99,2020
2020-04-22,Sarawak,111,19,92,2020
2020-04-23,Sarawak,98,25,73,2020
2020-04-24,Sarawak,16,4,12,2020
2020-04-25,Sarawak,58,10,48,2020
2020-04-26,Sarawak,72,4,68,2020
2020-04-27,Sarawak,23,1,22,2020
2020-04-28,Sarawak,50,4,46,2020
2020-04-29,Sarawak,95,11,84,2020
2020-04-30,Sarawak,53,6,47,2020
2020-05-01,Sarawak,171,38,133,2020
2020-05-02,Sarawak,59,5,54,2020
2020-05-03,Sarawak,50,3,47,2020
2020-05-04,Sarawak,34,5,29,2020
2020-05-05,Sarawak,47,7,40,2020
2020-05-06,Sarawak,82,12,70,2020
2020-05-07,Sarawak,105,65,40,2020
2020-05-08,Sarawak,115,42,73,2020
2020-05-09,Sarawak,111,30,81,2020
2020-05-10,Sarawak,93,10,83,2020
2020-05-11,Sarawak,62,15,47,2020
2020-05-12,Sarawak,40,6,34,2020
2020-05-13,Sarawak,51,11,40,2020
2020-05-14,Sarawak,77,16,61,2020
2020-05-15,Sarawak,75,9,66,2020
2020-05-16,Sarawak,192,106,86,2020
2020-05-17,Sarawak,166,45,121,2020
2020-05-18,Sarawak,51,7,44,2020
2020-05-19,Sarawak,77,8,69,2020
2020-05-20,Sarawak,137,20,117,2020
2020-05-21,Sarawak,202,74,128,2020
2020-05-22,Sarawak,99,9,90,2020
2020-05-23,Sarawak,126,51,75,2020
2020-05-24,Sarawak,0,0,0,2020
2020-05-25,Sarawak,0,0,0,2020
2020-05-26,Sarawak,0,0,0,2020
2020-05-27,Sarawak,122,15,107,2020
2020-05-28,Sarawak,103,13,90,2020
2020-05-29,Sarawak,64,5,59,2020
2020-05-30,Sarawak,180,37,143,2020
2020-05-31,Sarawak,262,31,231,2020
2020-06-01,Sarawak,0,0,0,2020
2020-06-02,Sarawak,0,0,0,2020
2020-06-03,Sarawak,41,6,35,2020
2020-06-04,Sarawak,62,13,49,2020
2020-06-05,Sarawak,95,19,76,2020
2020-06-06,Sarawak,164,32,132,2020
2020-06-07,Sarawak,137,16,121,2020
2020-06-08,Sarawak,50,16,34,2020
2020-06-09,Sarawak,146,60,86,2020
2020-06-10,Sarawak,98,14,84,2020
2020-06-11,Sarawak,111,10,101,2020
2020-06-12,Sarawak,32,2,30,2020
2020-06-13,Sarawak,192,32,160,2020
2020-06-14,Sarawak,205,31,174,2020
2020-06-15,Sarawak,52,5,47,2020
2020-06-16,Sarawak,108,23,85,2020
2020-06-17,Sarawak,70,11,59,2020
2020-06-18,Sarawak,35,6,29,2020
2020-06-19,Sarawak,77,35,42,2020
2020-06-20,Sarawak,203,36,167,2020
2020-06-21,Sarawak,251,47,204,2020
2020-06-22,Sarawak,42,6,36,2020
2020-06-23,Sarawak,75,12,63,2020
2020-06-24,Sarawak,85,11,74,2020
2020-06-25,Sarawak,49,5,44,2020
2020-06-26,Sarawak,33,3,30,2020
2020-06-27,Sarawak,227,55,172,2020
2020-06-28,Sarawak,239,38,201,2020
2020-06-29,Sarawak,52,7,45,2020
2020-06-30,Sarawak,59,6,53,2020
2020-07-01,Sarawak,30,7,23,2020
2020-07-02,Sarawak,38,1,37,2020
2020-07-03,Sarawak,42,4,38,2020
2020-07-04,Sarawak,168,57,111,2020
2020-07-05,Sarawak,221,31,190,2020
2020-07-06,Sarawak,43,5,38,2020
2020-07-07,Sarawak,59,16,43,2020
2020-07-08,Sarawak,33,4,29,2020
2020-07-09,Sarawak,61,4,57,2020
2020-07-10,Sarawak,22,1,21,2020
2020-07-11,Sarawak,163,28,135,2020
2020-07-12,Sarawak,224,41,183,2020
2020-07-13,Sarawak,38,3,35,2020
2020-07-14,Sarawak,43,4,39,2020
2020-07-15,Sarawak,108,14,94,2020
2020-07-16,Sarawak,48,5,43,2020
2020-07-17,Sarawak,66,4,62,2020
2020-07-18,Sarawak,227,51,176,2020
2020-07-19,Sarawak,170,49,121,2020
2020-07-20,Sarawak,27,3,24,2020
2020-07-21,Sarawak,24,2,22,2020
2020-07-22,Sarawak,171,35,136,2020
2020-07-23,Sarawak,35,7,28,2020
2020-07-24,Sarawak,20,0,20,2020
2020-07-25,Sarawak,125,31,94,2020
2020-07-26,Sarawak,210,28,182,2020
2020-07-27,Sarawak,20,2,18,2020
2020-07-28,Sarawak,40,8,32,2020
2020-07-29,Sarawak,59,5,54,2020
2020-07-30,Sarawak,41,10,31,2020
2020-07-31,Sarawak,0,0,0,2020
2020-08-01,Sarawak,85,23,62,2020
2020-08-02,Sarawak,102,21,81,2020
2020-08-03,Sarawak,73,35,38,2020
2020-08-04,Sarawak,127,31,96,2020
2020-08-05,Sarawak,54,7,47,2020
2020-08-06,Sarawak,94,27,67,2020
2020-08-07,Sarawak,61,14,47,2020
2020-08-08,Sarawak,166,60,106,2020
2020-08-09,Sarawak,225,51,174,2020
2020-08-10,Sarawak,50,6,44,2020
2020-08-11,Sarawak,54,8,46,2020
2020-08-12,Sarawak,69,17,52,2020
2020-08-13,Sarawak,45,11,34,2020
2020-08-14,Sarawak,36,4,32,2020
2020-08-15,Sarawak,219,75,144,2020
2020-08-16,Sarawak,253,31,222,2020
2020-08-17,Sarawak,37,2,35,2020
2020-08-18,Sarawak,60,13,47,2020
2020-08-19,Sarawak,112,38,74,2020
2020-08-20,Sarawak,0,0,0,2020
2020-08-21,Sarawak,44,2,42,2020
2020-08-22,Sarawak,123,18,105,2020
2020-08-23,Sarawak,180,47,133,2020
2020-08-24,Sarawak,42,7,35,2020
2020-08-25,Sarawak,49,7,42,2020
2020-08-26,Sarawak,95,25,70,2020
2020-08-27,Sarawak,153,49,104,2020
2020-08-28,Sarawak,39,5,34,2020
2020-08-29,Sarawak,88,21,67,2020
2020-08-30,Sarawak,159,26,133,2020
2020-08-31,Sarawak,198,44,154,2020
2020-09-01,Sarawak,47,5,42,2020
2020-09-02,Sarawak,77,14,63,2020
2020-09-03,Sarawak,66,15,51,2020
2020-09-04,Sarawak,35,5,30,2020
2020-09-05,Sarawak,184,44,140,2020
2020-09-06,Sarawak,289,43,246,2020
2020-09-07,Sarawak,46,3,43,2020
2020-09-08,Sarawak,73,13,60,2020
2020-09-09,Sarawak,49,1,48,2020
2020-09-10,Sarawak,37,2,35,2020
2020-09-11,Sarawak,52,6,46,2020
2020-09-12,Sarawak,176,42,134,2020
2020-09-13,Sarawak,277,58,219,2020
2020-09-14,Sarawak,53,26,27,2020
2020-09-15,Sarawak,66,3,63,2020
2020-09-16,Sarawak,52,17,35,2020
2020-09-17,Sarawak,73,17,56,2020
2020-09-18,Sarawak,54,3,51,2020
2020-09-19,Sarawak,245,33,212,2020
2020-09-20,Sarawak,264,31,233,2020
2020-09-21,Sarawak,32,2,30,2020
2020-09-22,Sarawak,91,33,58,2020
2020-09-23,Sarawak,60,5,55,2020
2020-09-24,Sarawak,82,18,64,2020
2020-09-25,Sarawak,36,0,36,2020
2020-09-26,Sarawak,19,4,15,2020
2020-09-27,Sarawak,238,23,215,2020
2020-09-28,Sarawak,29,1,28,2020
2020-09-29,Sarawak,58,5,53,2020
2020-09-30,Sarawak,84,25,59,2020
2020-10-01,Sarawak,85,31,54,2020
2020-10-02,Sarawak,43,5,38,2020
2020-10-03,Sarawak,165,33,132,2020
2020-10-04,Sarawak,281,50,231,2020
2020-10-05,Sarawak,34,3,31,2020
2020-10-06,Sarawak,54,10,44,2020
2020-10-07,Sarawak,21,0,21,2020
2020-10-08,Sarawak,23,4,19,2020
2020-10-09,Sarawak,42,4,38,2020
2020-10-10,Sarawak,188,36,152,2020
2020-10-11,Sarawak,141,12,129,2020
2020-10-12,Sarawak,42,3,39,2020
2020-10-13,Sarawak,50,8,42,2020
2020-10-14,Sarawak,91,26,65,2020
2020-10-15,Sarawak,91,29,62,2020
2020-10-16,Sarawak,26,5,21,2020
2020-10-17,Sarawak,225,67,158,2020
2020-10-18,Sarawak,272,40,232,2020
2020-10-19,Sarawak,30,2,28,2020
2020-10-20,Sarawak,68,14,54,2020
2020-10-21,Sarawak,96,12,84,2020
2020-10-22,Sarawak,55,16,39,2020
2020-10-23,Sarawak,37,4,33,2020
2020-10-24,Sarawak,159,48,111,2020
2020-10-25,Sarawak,190,27,163,2020
2020-10-26,Sarawak,20,1,19,2020
2020-10-27,Sarawak,75,15,60,2020
2020-10-28,Sarawak,22,2,20,2020
2020-10-29,Sarawak,4,1,3,2020
2020-10-30,Sarawak,47,8,39,2020
2020-10-31,Sarawak,126,31,95,2020
2020-11-01,Sarawak,172,30,142,2020
2020-11-02,Sarawak,33,1,32,2020
2020-11-03,Sarawak,61,8,53,2020
2020-11-04,Sarawak,71,6,65,2020
2020-11-05,Sarawak,119,16,103,2020
2020-11-06,Sarawak,70,4,66,2020
2020-11-07,Sarawak,218,54,164,2020
2020-11-08,Sarawak,212,29,183,2020
2020-11-09,Sarawak,36,3,33,2020
2020-11-10,Sarawak,189,79,110,2020
2020-11-11,Sarawak,39,4,35,2020
2020-11-12,Sarawak,43,6,37,2020
2020-11-13,Sarawak,34,2,32,2020
2020-11-14,Sarawak,147,31,116,2020
2020-11-15,Sarawak,180,22,158,2020
2020-11-16,Sarawak,50,5,45,2020
2020-11-17,Sarawak,41,2,39,2020
2020-11-18,Sarawak,80,13,67,2020
2020-11-19,Sarawak,96,24,72,2020
2020-11-20,Sarawak,32,1,31,2020
2020-11-21,Sarawak,201,49,152,2020
2020-11-22,Sarawak,240,41,199,2020
2020-11-23,Sarawak,47,5,42,2020
2020-11-24,Sarawak,29,2,27,2020
2020-11-25,Sarawak,112,45,67,2020
2020-11-26,Sarawak,129,42,87,2020
2020-11-27,Sarawak,52,12,40,2020
2020-11-28,Sarawak,136,30,106,2020
2020-11-29,Sarawak,268,35,233,2020
2020-11-30,Sarawak,48,2,46,2020
2020-12-01,Sarawak,48,7,41,2020
2020-12-02,Sarawak,42,5,37,2020
2020-12-03,Sarawak,120,46,74,2020
2020-12-04,Sarawak,26,1,25,2020
2020-12-05,Sarawak,167,51,116,2020
2020-12-06,Sarawak,287,29,258,2020
2020-12-07,Sarawak,29,2,27,2020
2020-12-08,Sarawak,88,16,72,2020
2020-12-09,Sarawak,72,19,53,2020
2020-12-10,Sarawak,38,5,33,2020
2020-12-11,Sarawak,67,12,55,2020
2020-12-12,Sarawak,185,33,152,2020
2020-12-13,Sarawak,329,42,287,2020
2020-12-14,Sarawak,52,8,44,2020
2020-12-15,Sarawak,63,12,51,2020
2020-12-16,Sarawak,27,2,25,2020
2020-12-17,Sarawak,67,10,57,2020
2020-12-18,Sarawak,107,34,73,2020
2020-12-19,Sarawak,234,23,211,2020
2020-12-20,Sarawak,266,29,237,2020
2020-12-21,Sarawak,46,6,40,2020
2020-12-22,Sarawak,73,6,67,2020
2020-12-23,Sarawak,83,12,71,2020
2020-12-24,Sarawak,85,11,74,2020
2020-12-25,Sarawak,47,13,34,2020
2020-12-26,Sarawak,82,19,63,2020
2020-12-27,Sarawak,224,28,196,2020
2020-12-28,Sarawak,40,2,38,2020
2020-12-29,Sarawak,37,8,29,2020
2020-12-30,Sarawak,44,4,40,2020
2020-12-31,Sarawak,40,2,38,2020
2021-01-01,Sarawak,164,16,148,2021
2021-01-02,Sarawak,50,2,48,2021
2021-01-03,Sarawak,270,44,226,2021
2021-01-04,Sarawak,36,5,31,2021
2021-01-05,Sarawak,42,4,38,2021
2021-01-06,Sarawak,45,6,39,2021
2021-01-07,Sarawak,84,11,73,2021
2021-01-08,Sarawak,42,2,40,2021
2021-01-09,Sarawak,169,30,139,2021
2021-01-10,Sarawak,225,34,191,2021
2021-01-11,Sarawak,28,3,25,2021
2021-01-12,Sarawak,36,4,32,2021
2021-01-13,Sarawak,46,14,32,2021
2021-01-14,Sarawak,38,2,36,2021
2021-01-15,Sarawak,26,3,23,2021
2021-01-16,Sarawak,86,8,78,2021
2021-01-17,Sarawak,111,9,102,2021
2021-01-18,Sarawak,36,3,33,2021
2021-01-19,Sarawak,42,5,37,2021
2021-01-20,Sarawak,28,2,26,2021
2021-01-21,Sarawak,85,22,63,2021
2021-01-22,Sarawak,89,7,82,2021
2021-01-23,Sarawak,248,101,147,2021
2021-01-24,Sarawak,155,23,132,2021
2021-01-25,Sarawak,50,3,47,2021
2021-01-26,Sarawak,162,61,101,2021
2021-01-27,Sarawak,51,6,45,2021
2021-01-28,Sarawak,85,31,54,2021
2021-01-29,Sarawak,41,1,40,2021
2021-01-30,Sarawak,197,47,150,2021
2021-01-31,Sarawak,216,37,179,2021
2021-02-01,Sarawak,36,4,32,2021
2021-02-02,Sarawak,71,10,61,2021
2021-02-03,Sarawak,67,19,48,2021
2021-02-04,Sarawak,48,3,45,2021
2021-02-05,Sarawak,51,7,44,2021
2021-02-06,Sarawak,186,60,126,2021
2021-02-07,Sarawak,187,50,137,2021
2021-02-08,Sarawak,42,5,37,2021
2021-02-09,Sarawak,96,14,82,2021
2021-02-10,Sarawak,102,16,86,2021
2021-02-11,Sarawak,49,6,43,2021
2021-02-12,Sarawak,1,0,1,2021
2021-02-13,Sarawak,218,83,135,2021
2021-02-14,Sarawak,188,29,159,2021
2021-02-15,Sarawak,38,3,35,2021
2021-02-16,Sarawak,37,5,32,2021
2021-02-17,Sarawak,93,9,84,2021
2021-02-18,Sarawak,46,1,45,2021
2021-02-19,Sarawak,29,1,28,2021
2021-02-20,Sarawak,205,43,162,2021
2021-02-21,Sarawak,145,27,118,2021
2021-02-22,Sarawak,27,3,24,2021
2021-02-23,Sarawak,70,5,65,2021
2021-02-24,Sarawak,81,21,60,2021
2021-02-25,Sarawak,94,23,71,2021
2021-02-26,Sarawak,41,1,40,2021
2021-02-27,Sarawak,261,43,218,2021
2021-02-28,Sarawak,281,32,249,2021
2021-03-01,Sarawak,52,3,49,2021
2021-03-02,Sarawak,41,6,35,2021
2021-03-03,Sarawak,46,2,44,2021
2021-03-04,Sarawak,271,113,158,2021
2021-03-05,Sarawak,50,5,45,2021
2021-03-06,Sarawak,104,12,92,2021
2021-03-07,Sarawak,255,55,200,2021
2021-03-08,Sarawak,33,1,32,2021
2021-03-09,Sarawak,110,40,70,2021
2021-03-10,Sarawak,53,7,46,2021
2021-03-11,Sarawak,71,24,47,2021
2021-03-12,Sarawak,40,4,36,2021
2021-03-13,Sarawak,183,31,152,2021
2021-03-14,Sarawak,183,19,164,2021
2021-03-15,Sarawak,42,4,38,2021
2021-03-16,Sarawak,76,5,71,2021
2021-03-17,Sarawak,54,3,51,2021
2021-03-18,Sarawak,48,3,45,2021
2021-03-19,Sarawak,56,6,50,2021
2021-03-20,Sarawak,227,18,209,2021
2021-03-21,Sarawak,222,31,191,2021
2021-03-22,Sarawak,48,1,47,2021
2021-03-23,Sarawak,86,3,83,2021
2021-03-24,Sarawak,102,20,82,2021
2021-03-25,Sarawak,95,24,71,2021
2021-03-26,Sarawak,42,3,39,2021
2021-03-27,Sarawak,145,30,115,2021
2021-03-28,Sarawak,174,13,161,2021
2021-03-29,Sarawak,52,3,49,2021
2021-03-30,Sarawak,120,33,87,2021
2021-03-31,Sarawak,96,29,67,2021
2021-04-01,Sarawak,52,11,41,2021
2021-04-02,Sarawak,51,6,45,2021
2021-04-03,Sarawak,200,35,165,2021
2021-04-04,Sarawak,298,29,269,2021
2021-04-05,Sarawak,38,0,38,2021
2021-04-06,Sarawak,84,26,58,2021
2021-04-07,Sarawak,80,10,70,2021
2021-04-08,Sarawak,104,25,79,2021
2021-04-09,Sarawak,60,12,48,2021
2021-04-10,Sarawak,221,51,170,2021
2021-04-11,Sarawak,241,41,200,2021
2021-04-12,Sarawak,58,3,55,2021
2021-04-13,Sarawak,23,0,23,2021
2021-04-14,Sarawak,37,3,34,2021
2021-04-15,Sarawak,52,17,35,2021
2021-04-16,Sarawak,22,4,18,2021
2021-04-17,Sarawak,118,23,95,2021
2021-04-18,Sarawak,98,9,89,2021
2021-04-19,Sarawak,17,2,15,2021
2021-04-20,Sarawak,31,2,29,2021
2021-04-21,Sarawak,57,6,51,2021
2021-04-22,Sarawak,88,25,63,2021
2021-04-23,Sarawak,40,4,36,2021
2021-04-24,Sarawak,154,47,107,2021
2021-04-25,Sarawak,151,17,134,2021
2021-04-26,Sarawak,24,1,23,2021
2021-04-27,Sarawak,23,3,20,2021
2021-04-28,Sarawak,20,0,20,2021
2021-04-29,Sarawak,38,3,35,2021
2021-04-30,Sarawak,29,1,28,2021
2021-05-01,Sarawak,261,41,220,2021
2021-05-02,Sarawak,179,28,151,2021
2021-05-03,Sarawak,27,2,25,2021
2021-05-04,Sarawak,57,10,47,2021
2021-05-05,Sarawak,27,0,27,2021
2021-05-06,Sarawak,59,23,36,2021
2021-05-07,Sarawak,26,2,24,2021
2021-05-08,Sarawak,158,44,114,2021
2021-05-09,Sarawak,144,47,97,2021
2021-05-10,Sarawak,84,27,57,2021
2021-05-11,Sarawak,28,3,25,2021
2021-05-12,Sarawak,51,3,48,2021
2021-05-13,Sarawak,0,0,0,2021
2021-05-14,Sarawak,0,0,0,2021
2021-05-15,Sarawak,75,11,64,2021
2021-05-16,Sarawak,142,14,128,2021
2021-05-17,Sarawak,54,3,51,2021
2021-05-18,Sarawak,111,30,81,2021
2021-05-19,Sarawak,96,21,75,2021
2021-05-20,Sarawak,64,4,60,2021
2021-05-21,Sarawak,97,24,73,2021
2021-05-22,Sarawak,176,31,145,2021
2021-05-23,Sarawak,216,47,169,2021
2021-05-24,Sarawak,111,26,85,2021
2021-05-25,Sarawak,72,6,66,2021
2021-05-26,Sarawak,0,0,0,2021
2021-05-27,Sarawak,95,8,87,2021
2021-05-28,Sarawak,67,11,56,2021
2021-05-29,Sarawak,166,21,145,2021
2021-05-30,Sarawak,197,21,176,2021
2021-05-31,Sarawak,33,3,30,2021
2021-06-01,Sarawak,0,0,0,2021
2021-06-02,Sarawak,0,0,0,2021
2021-06-03,Sarawak,73,10,63,2021
2021-06-04,Sarawak,71,19,52,2021
2021-06-05,Sarawak,175,27,148,2021
2021-06-06,Sarawak,255,48,207,2021
2021-06-07,Sarawak,91,10,81,2021
2021-06-08,Sarawak,81,8,73,2021
2021-06-09,Sarawak,117,23,94,2021
2021-06-10,Sarawak,33,2,31,2021
2021-06-11,Sarawak,49,2,47,2021
2021-06-12,Sarawak,208,30,178,2021
2021-06-13,Sarawak,130,17,113,2021
2021-06-14,Sarawak,95,13,82,2021
2021-06-15,Sarawak,83,12,71,2021
2021-06-16,Sarawak,145,52,93,2021
2021-06-17,Sarawak,101,27,74,2021
2021-06-18,Sarawak,72,9,63,2021
2021-06-19,Sarawak,200,21,179,2021
2021-06-20,Sarawak,174,26,148,2021
2021-06-21,Sarawak,63,6,57,2021
2021-06-22,Sarawak,49,3,46,2021
2021-06-23,Sarawak,75,8,67,2021
2021-06-24,Sarawak,52,6,46,2021
2021-06-25,Sarawak,75,7,68,2021
2021-06-26,Sarawak,181,28,153,2021
2021-06-27,Sarawak,195,31,164,2021
2021-06-28,Sarawak,48,4,44,2021
2021-06-29,Sarawak,34,4,30,2021
2021-06-30,Sarawak,49,4,45,2021
2021-07-01,Sarawak,37,4,33,2021
2021-07-02,Sarawak,41,4,37,2021
2021-07-03,Sarawak,132,13,119,2021
2021-07-04,Sarawak,219,37,182,2021
2021-07-05,Sarawak,47,6,41,2021
2021-07-06,Sarawak,38,1,37,2021
2021-07-07,Sarawak,58,9,49,2021
2021-07-08,Sarawak,36,4,32,2021
2021-07-09,Sarawak,52,10,42,2021
2021-07-10,Sarawak,157,12,145,2021
2021-07-11,Sarawak,136,21,115,2021
2021-07-12,Sarawak,43,8,35,2021
2021-07-13,Sarawak,62,14,48,2021
2021-07-14,Sarawak,76,15,61,2021
2021-07-15,Sarawak,45,3,42,2021
2021-07-16,Sarawak,43,4,39,2021
2021-07-17,Sarawak,109,22,87,2021
2021-07-18,Sarawak,142,20,122,2021
2021-07-19,Sarawak,45,6,39,2021
2021-07-20,Sarawak,0,0,0,2021
2021-07-21,Sarawak,46,11,35,2021
2021-07-22,Sarawak,288,41,247,2021
2021-07-23,Sarawak,36,7,29,2021
2021-07-24,Sarawak,176,45,131,2021
2021-07-25,Sarawak,166,29,137,2021
2021-07-26,Sarawak,41,5,36,2021
2021-07-27,Sarawak,47,8,39,2021
2021-07-28,Sarawak,133,28,105,2021
2021-07-29,Sarawak,180,52,128,2021
2021-07-30,Sarawak,93,27,66,2021
2021-07-31,Sarawak,129,23,106,2021
2021-08-01,Sarawak,173,20,153,2021
2021-08-02,Sarawak,56,4,52,2021
2021-08-03,Sarawak,53,8,45,2021
2021-08-04,Sarawak,81,17,64,2021
2021-08-05,Sarawak,138,38,100,2021
2021-08-06,Sarawak,55,11,44,2021
2021-08-07,Sarawak,157,25,132,2021
2021-08-08,Sarawak,278,64,214,2021
2021-08-09,Sarawak,57,8,49,2021
2021-08-10,Sarawak,130,30,100,2021
2021-08-11,Sarawak,64,10,54,2021
2021-08-12,Sarawak,61,10,51,2021
2021-08-13,Sarawak,112,53,59,2021
2021-08-14,Sarawak,130,23,107,2021
2021-08-15,Sarawak,193,28,165,2021
2021-08-16,Sarawak,46,8,38,2021
2021-08-17,Sarawak,47,8,39,2021
2021-08-18,Sarawak,31,5,26,2021
2021-08-19,Sarawak,140,31,109,2021
2021-08-20,Sarawak,57,13,44,2021
2021-08-21,Sarawak,219,89,130,2021
2021-08-22,Sarawak,231,40,191,2021
2021-08-23,Sarawak,35,3,32,2021
2021-08-24,Sarawak,52,12,40,2021
2021-08-25,Sarawak,48,5,43,2021
2021-08-26,Sarawak,62,6,56,2021
2021-08-27,Sarawak,30,3,27,2021
2021-08-28,Sarawak,144,31,113,2021
2021-08-29,Sarawak,192,28,164,2021
2021-08-30,Sarawak,37,4,33,2021
2021-08-31,Sarawak,278,48,230,2021
2021-09-01,Sarawak,37,5,32,2021
2021-09-02,Sarawak,50,13,37,2021
2021-09-03,Sarawak,49,3,46,2021
2021-09-04,Sarawak,184,45,139,2021
2021-09-05,Sarawak,202,33,169,2021
2021-09-06,Sarawak,36,0,36,2021
2021-09-07,Sarawak,32,2,30,2021
2021-09-08,Sarawak,102,32,70,2021
2021-09-09,Sarawak,42,9,33,2021
2021-09-10,Sarawak,65,11,54,2021
2021-09-11,Sarawak,111,26,85,2021
2021-09-12,Sarawak,261,43,218,2021
2021-09-13,Sarawak,32,3,29,2021
2021-09-14,Sarawak,71,25,46,2021
2021-09-15,Sarawak,122,39,83,2021
2021-09-16,Sarawak,259,54,205,2021
2021-09-17,Sarawak,48,2,46,2021
2021-09-18,Sarawak,172,16,156,2021
2021-09-19,Sarawak,273,54,219,2021
2021-09-20,Sarawak,48,4,44,2021
2021-09-21,Sarawak,46,7,39,2021
2021-09-22,Sarawak,56,4,52,2021
2021-09-23,Sarawak,71,5,66,2021
2021-09-24,Sarawak,45,7,38,2021
2021-09-25,Sarawak,122,27,95,2021
2021-09-26,Sarawak,257,25,232,2021
2021-09-27,Sarawak,43,2,41,2021
2021-09-28,Sarawak,57,6,51,2021
2021-09-29,Sarawak,32,2,30,2021
2021-09-30,Sarawak,46,3,43,2021
2021-10-01,Sarawak,48,4,44,2021
2021-10-02,Sarawak,113,12,101,2021
2021-10-03,Sarawak,242,25,217,2021
2021-10-04,Sarawak,33,2,31,2021
2021-10-05,Sarawak,41,5,36,2021
2021-10-06,Sarawak,72,17,55,2021
2021-10-07,Sarawak,51,14,37,2021
2021-10-08,Sarawak,49,10,39,2021
2021-10-09,Sarawak,263,34,229,2021
2021-10-10,Sarawak,119,10,109,2021
2021-10-11,Sarawak,42,5,37,2021
2021-10-12,Sarawak,77,13,64,2021
2021-10-13,Sarawak,43,5,38,2021
2021-10-14,Sarawak,32,3,29,2021
2021-10-15,Sarawak,41,5,36,2021
2021-10-16,Sarawak,197,40,157,2021
2021-10-17,Sarawak,175,24,151,2021
2021-10-18,Sarawak,34,4,30,2021
2021-10-19,Sarawak,122,14,108,2021
2021-10-20,Sarawak,42,7,35,2021
2021-10-21,Sarawak,37,5,32,2021
2021-10-22,Sarawak,38,8,30,2021
2021-10-23,Sarawak,194,34,160,2021
2021-10-24,Sarawak,223,41,182,2021
2021-10-25,Sarawak,34,5,29,2021
2021-10-26,Sarawak,51,8,43,2021
2021-10-27,Sarawak,95,23,72,2021
2021-10-28,Sarawak,131,27,104,2021
2021-10-29,Sarawak,54,9,45,2021
2021-10-30,Sarawak,153,37,116,2021
2021-10-31,Sarawak,204,38,166,2021
2021-11-01,Sarawak,37,3,34,2021
2021-11-02,Sarawak,82,13,69,2021
2021-11-03,Sarawak,45,3,42,2021
2021-11-04,Sarawak,45,7,38,2021
2021-11-05,Sarawak,95,17,78,2021
2021-11-06,Sarawak,203,49,154,2021
2021-11-07,Sarawak,147,14,133,2021
2021-11-08,Sarawak,44,5,39,2021
2021-11-09,Sarawak,78,11,67,2021
2021-11-10,Sarawak,62,7,55,2021
2021-11-11,Sarawak,110,22,88,2021
2021-11-12,Sarawak,60,4,56,2021
2021-11-13,Sarawak,177,38,139,2021
2021-11-14,Sarawak,268,56,212,2021
2021-11-15,Sarawak,85,13,72,2021
2021-11-16,Sarawak,62,10,52,2021
2021-11-17,Sarawak,37,1,36,2021
2021-11-18,Sarawak,198,87,111,2021
2021-11-19,Sarawak,53,7,46,2021
2021-11-20,Sarawak,213,43,170,2021
2021-11-21,Sarawak,149,18,131,2021
2021-11-22,Sarawak,35,4,31,2021
2021-11-23,Sarawak,71,12,59,2021
2021-11-24,Sarawak,100,17,83,2021
2021-11-25,Sarawak,72,14,58,2021
2021-11-26,Sarawak,38,1,37,2021
2021-11-27,Sarawak,145,47,98,2021
2021-11-28,Sarawak,297,39,258,2021
2021-11-29,Sarawak,36,5,31,2021
2021-11-30,Sarawak,30,3,27,2021
2021-12-01,Sarawak,37,3,34,2021
2021-12-02,Sarawak,101,25,76,2021
2021-12-03,Sarawak,40,2,38,2021
2021-12-04,Sarawak,206,52,154,2021
2021-12-05,Sarawak,185,27,158,2021
2021-12-06,Sarawak,40,2,38,2021
2021-12-07,Sarawak,40,5,35,2021
2021-12-08,Sarawak,44,7,37,2021
2021-12-09,Sarawak,121,21,100,2021
2021-12-10,Sarawak,37,3,34,2021
2021-12-11,Sarawak,160,29,131,2021
2021-12-12,Sarawak,268,34,234,2021
2021-12-13,Sarawak,34,3,31,2021
2021-12-14,Sarawak,36,5,31,2021
2021-12-15,Sarawak,74,36,38,2021
2021-12-16,Sarawak,63,17,46,2021
2021-12-17,Sarawak,50,1,49,2021
2021-12-18,Sarawak,159,14,145,2021
2021-12-19,Sarawak,233,30,203,2021
2021-12-20,Sarawak,51,3,48,2021
2021-12-21,Sarawak,96,13,83,2021
2021-12-22,Sarawak,74,11,63,2021
2021-12-23,Sarawak,197,53,144,2021
2021-12-24,Sarawak,61,6,55,2021
2021-12-25,Sarawak,58,16,42,2021
2021-12-26,Sarawak,242,31,211,2021
2021-12-27,Sarawak,58,6,52,2021
2021-12-28,Sarawak,136,33,103,2021
2021-12-29,Sarawak,48,8,40,2021
2021-12-30,Sarawak,116,33,83,2021
2021-12-31,Sarawak,77,12,65,2021
2022-01-01,Sarawak,257,29,228,2022
2022-01-02,Sarawak,315,52,263,2022
2022-01-03,Sarawak,50,5,45,2022
2022-01-04,Sarawak,53,4,49,2022
2022-01-05,Sarawak,54,5,49,2022
2022-01-06,Sarawak,74,30,44,2022
2022-01-07,Sarawak,64,10,54,2022
2022-01-08,Sarawak,219,28,191,2022
2022-01-09,Sarawak,279,39,240,2022
2022-01-10,Sarawak,45,8,37,2022
2022-01-11,Sarawak,37,5,32,2022
2022-01-12,Sarawak,51,9,42,2022
2022-01-13,Sarawak,78,13,65,2022
2022-01-14,Sarawak,72,13,59,2022
2022-01-15,Sarawak,238,40,198,2022
2022-01-16,Sarawak,206,37,169,2022
2022-01-17,Sarawak,70,7,63,2022
2022-01-18,Sarawak,73,2,71,2022
2022-01-19,Sarawak,120,31,89,2022
2022-01-20,Sarawak,69,22,47,2022
2022-01-21,Sarawak,64,7,57,2022
2022-01-22,Sarawak,250,53,197,2022
2022-01-23,Sarawak,165,40,125,2022
2022-01-24,Sarawak,54,5,49,2022
2022-01-25,Sarawak,75,18,57,2022
2022-01-26,Sarawak,67,16,51,2022
2022-01-27,Sarawak,174,59,115,2022
2022-01-28,Sarawak,65,6,59,2022
2022-01-29,Sarawak,185,68,117,2022
2022-01-30,Sarawak,255,37,218,2022
2022-01-31,Sarawak,66,2,64,2022
2022-02-01,Sarawak,0,0,0,2022
2022-02-02,Sarawak,0,0,0,2022
2022-02-03,Sarawak,116,31,85,2022
2022-02-04,Sarawak,50,4,46,2022
2022-02-05,Sarawak,137,25,112,2022
2022-02-06,Sarawak,168,27,141,2022
2022-02-07,Sarawak,62,7,55,2022
2022-02-08,Sarawak,39,6,33,2022
2022-02-09,Sarawak,108,15,93,2022
2022-02-10,Sarawak,92,14,78,2022
2022-02-11,Sarawak,54,7,47,2022
2022-02-12,Sarawak,237,33,204,2022
2022-02-13,Sarawak,203,26,177,2022
2022-02-14,Sarawak,58,5,53,2022
2022-02-15,Sarawak,75,13,62,2022
2022-02-16,Sarawak,68,13,55,2022
2022-02-17,Sarawak,208,42,166,2022
2022-02-18,Sarawak,42,5,37,2022
2022-02-19,Sarawak,183,25,158,2022
2022-02-20,Sarawak,316,49,267,2022
2022-02-21,Sarawak,55,7,48,2022
2022-02-22,Sarawak,122,21,101,2022
2022-02-23,Sarawak,79,12,67,2022
2022-02-24,Sarawak,77,31,46,2022
2022-02-25,Sarawak,45,6,39,2022
2022-02-26,Sarawak,174,38,136,2022
2022-02-27,Sarawak,398,71,327,2022
2022-02-28,Sarawak,55,9,46,2022
2022-03-01,Sarawak,50,10,40,2022
2022-03-02,Sarawak,53,14,39,2022
2022-03-03,Sarawak,73,17,56,2022
2022-03-04,Sarawak,49,5,44,2022
2022-03-05,Sarawak,38,8,30,2022
2022-03-06,Sarawak,175,26,149,2022
2022-03-07,Sarawak,53,2,51,2022
2022-03-08,Sarawak,66,3,63,2022
2022-03-09,Sarawak,126,32,94,2022
2022-03-10,Sarawak,70,10,60,2022
2022-03-11,Sarawak,51,5,46,2022
2022-03-12,Sarawak,157,22,135,2022
2022-03-13,Sarawak,224,21,203,2022
2022-03-14,Sarawak,42,2,40,2022
2022-03-15,Sarawak,54,7,47,2022
2022-03-16,Sarawak,139,40,99,2022
2022-03-17,Sarawak,34,4,30,2022
2022-03-18,Sarawak,106,31,75,2022
2022-03-19,Sarawak,186,15,171,2022
2022-03-20,Sarawak,221,22,199,2022
2022-03-21,Sarawak,75,16,59,2022
2022-03-22,Sarawak,53,9,44,2022
2022-03-23,Sarawak,99,17,82,2022
2022-03-24,Sarawak,92,16,76,2022
2022-03-25,Sarawak,62,8,54,2022
2022-03-26,Sarawak,323,62,261,2022
2022-03-27,Sarawak,232,22,210,2022
2022-03-28,Sarawak,133,30,103,2022
2022-03-29,Sarawak,171,61,110,2022
2022-03-30,Sarawak,97,20,77,2022
2022-03-31,Sarawak,37,4,33,2022
2022-04-01,Sarawak,67,5,62,2022
2022-04-02,Sarawak,171,25,146,2022
2022-04-03,Sarawak,292,37,255,2022
2022-04-04,Sarawak,38,6,32,2022
2022-04-05,Sarawak,73,20,53,2022
2022-04-06,Sarawak,33,4,29,2022
2022-04-07,Sarawak,68,13,55,2022
2022-04-08,Sarawak,27,6,21,2022
2022-04-09,Sarawak,219,23,196,2022
2022-04-10,Sarawak,163,23,140,2022
2022-04-11,Sarawak,38,3,35,2022
2022-04-12,Sarawak,60,17,43,2022
2022-04-13,Sarawak,160,49,111,2022
2022-04-14,Sarawak,92,16,76,2022
2022-04-15,Sarawak,26,3,23,2022
2022-04-16,Sarawak,196,35,161,2022
2022-04-17,Sarawak,235,39,196,2022
2022-04-18,Sarawak,34,3,31,2022
2022-04-19,Sarawak,61,9,52,2022
2022-04-20,Sarawak,44,6,38,2022
2022-04-21,Sarawak,61,13,48,2022
2022-04-22,Sarawak,33,8,25,2022
2022-04-23,Sarawak,177,24,153,2022
2022-04-24,Sarawak,259,31,228,2022
2022-04-25,Sarawak,30,3,27,2022
2022-04-26,Sarawak,37,2,35,2022
2022-04-27,Sarawak,47,3,44,2022
2022-04-28,Sarawak,60,9,51,2022
2022-04-29,Sarawak,68,7,61,2022
2022-04-30,Sarawak,71,12,59,2022
2022-05-01,Sarawak,219,36,183,2022
2022-05-02,Sarawak,0,0,0,2022
2022-05-03,Sarawak,1,0,1,2022
2022-05-04,Sarawak,2,0,2,2022
2022-05-05,Sarawak,67,2,65,2022
2022-05-06,Sarawak,51,3,48,2022
2022-05-07,Sarawak,73,9,64,2022
2022-05-08,Sarawak,148,22,126,2022
2022-05-09,Sarawak,82,15,67,2022
2022-05-10,Sarawak,108,15,93,2022
2022-05-11,Sarawak,71,13,58,2022
2022-05-12,Sarawak,72,7,65,2022
2022-05-13,Sarawak,58,8,50,2022
2022-05-14,Sarawak,202,52,150,2022
2022-05-15,Sarawak,238,57,181,2022
2022-05-16,Sarawak,312,68,244,2022
2022-05-17,Sarawak,52,3,49,2022
2022-05-18,Sarawak,59,6,53,2022
2022-05-19,Sarawak,76,3,73,2022
2022-05-20,Sarawak,58,5,53,2022
2022-05-21,Sarawak,199,62,137,2022
2022-05-22,Sarawak,254,29,225,2022
2022-05-23,Sarawak,60,1,59,2022
2022-05-24,Sarawak,126,51,75,2022
2022-05-25,Sarawak,120,42,78,2022
2022-05-26,Sarawak,161,54,107,2022
2022-05-27,Sarawak,69,7,62,2022
2022-05-28,Sarawak,175,36,139,2022
2022-05-29,Sarawak,283,30,253,2022
2022-05-30,Sarawak,50,4,46,2022
2022-05-31,Sarawak,142,95,47,2022
2022-06-01,Sarawak,87,26,61,2022
2022-06-02,Sarawak,0,0,0,2022
2022-06-03,Sarawak,58,3,55,2022
2022-06-04,Sarawak,181,96,85,2022
2022-06-05,Sarawak,226,44,182,2022
2022-06-06,Sarawak,55,5,50,2022
2022-06-07,Sarawak,99,5,94,2022
2022-06-08,Sarawak,115,19,96,2022
2022-06-09,Sarawak,68,4,64,2022
2022-06-10,Sarawak,49,3,46,2022
2022-06-11,Sarawak,189,40,149,2022
2022-06-12,Sarawak,311,35,276,2022
2022-06-13,Sarawak,58,3,55,2022
2022-06-14,Sarawak,169,21,148,2022
2022-06-15,Sarawak,169,26,143,2022
2022-06-16,Sarawak,104,20,84,2022
2022-06-17,Sarawak,77,11,66,2022
2022-06-18,Sarawak,203,20,183,2022
2022-06-19,Sarawak,256,26,230,2022
2022-06-20,Sarawak,46,2,44,2022
2022-06-21,Sarawak,121,44,77,2022
2022-06-22,Sarawak,64,4,60,2022
2022-06-23,Sarawak,92,5,87,2022
2022-06-24,Sarawak,55,0,55,2022
2022-06-25,Sarawak,154,31,123,2022
2022-06-26,Sarawak,284,56,228,2022
2022-06-27,Sarawak,58,3,55,2022
2022-06-28,Sarawak,77,17,60,2022
2022-06-29,Sarawak,149,53,96,2022
2022-06-30,Sarawak,53,4,49,2022
2022-07-01,Sarawak,41,3,38,2022
2022-07-02,Sarawak,118,24,94,2022
2022-07-03,Sarawak,291,42,249,2022
2022-07-04,Sarawak,60,9,51,2022
2022-07-05,Sarawak,56,2,54,2022
2022-07-06,Sarawak,61,6,55,2022
2022-07-07,Sarawak,69,14,55,2022
2022-07-08,Sarawak,52,2,50,2022
2022-07-09,Sarawak,72,17,55,2022
2022-07-10,Sarawak,72,11,61,2022
2022-07-11,Sarawak,58,10,48,2022
2022-07-12,Sarawak,49,2,47,2022
2022-07-13,Sarawak,45,6,39,2022
2022-07-14,Sarawak,93,18,75,2022
2022-07-15,Sarawak,54,9,45,2022
2022-07-16,Sarawak,293,30,263,2022
2022-07-17,Sarawak,197,24,173,2022
2022-07-18,Sarawak,60,4,56,2022
2022-07-19,Sarawak,57,8,49,2022
2022-07-20,Sarawak,118,33,85,2022
2022-07-21,Sarawak,81,10,71,2022
2022-07-22,Sarawak,261,49,212,2022
2022-07-23,Sarawak,90,19,71,2022
2022-07-24,Sarawak,322,29,293,2022
2022-07-25,Sarawak,47,4,43,2022
2022-07-26,Sarawak,43,6,37,2022
2022-07-27,Sarawak,50,4,46,2022
2022-07-28,Sarawak,41,7,34,2022
2022-07-29,Sarawak,67,4,63,2022
2022-07-30,Sarawak,192,52,140,2022
2022-07-31,Sarawak,209,34,175,2022
2022-08-01,Sarawak,32,7,25,2022
2022-08-02,Sarawak,47,3,44,2022
2022-08-03,Sarawak,101,18,83,2022
2022-08-04,Sarawak,43,2,41,2022
2022-08-05,Sarawak,31,3,28,2022
2022-08-06,Sarawak,232,75,157,2022
2022-08-07,Sarawak,208,24,184,2022
2022-08-08,Sarawak,47,4,43,2022
2022-08-09,Sarawak,34,6,28,2022
2022-08-10,Sarawak,106,28,78,2022
2022-08-11,Sarawak,95,28,67,2022
2022-08-12,Sarawak,52,5,47,2022
2022-08-13,Sarawak,122,32,90,2022
2022-08-14,Sarawak,244,28,216,2022
2022-08-15,Sarawak,42,0,42,2022
2022-08-16,Sarawak,56,6,50,2022
2022-08-17,Sarawak,54,11,43,2022
2022-08-18,Sarawak,92,27,65,2022
2022-08-19,Sarawak,49,3,46,2022
2022-08-20,Sarawak,182,37,145,2022
2022-08-21,Sarawak,230,23,207,2022
2022-08-22,Sarawak,51,20,31,2022
2022-08-23,Sarawak,62,5,57,2022
2022-08-24,Sarawak,41,7,34,2022
2022-08-25,Sarawak,44,5,39,2022
2022-08-26,Sarawak,67,9,58,2022
2022-08-27,Sarawak,187,44,143,2022
2022-08-28,Sarawak,264,48,216,2022
2022-08-29,Sarawak,46,3,43,2022
2022-08-30,Sarawak,46,7,39,2022
2022-08-31,Sarawak,248,40,208,2022
2022-09-01,Sarawak,65,9,56,2022
2022-09-02,Sarawak,56,2,54,2022
2022-09-03,Sarawak,122,17,105,2022
2022-09-04,Sarawak,209,30,179,2022
2022-09-05,Sarawak,46,2,44,2022
2022-09-06,Sarawak,34,3,31,2022
2022-09-07,Sarawak,132,23,109,2022
2022-09-08,Sarawak,108,15,93,2022
2022-09-09,Sarawak,40,3,37,2022
2022-09-10,Sarawak,175,39,136,2022
2022-09-11,Sarawak,216,34,182,2022
2022-09-12,Sarawak,39,6,33,2022
2022-09-13,Sarawak,50,8,42,2022
2022-09-14,Sarawak,77,21,56,2022
2022-09-15,Sarawak,47,8,39,2022
2022-09-16,Sarawak,270,36,234,2022
2022-09-17,Sarawak,229,14,215,2022
2022-09-18,Sarawak,279,32,247,2022
2022-09-19,Sarawak,53,1,52,2022
2022-09-20,Sarawak,44,6,38,2022
2022-09-21,Sarawak,47,7,40,2022
2022-09-22,Sarawak,134,52,82,2022
2022-09-23,Sarawak,93,22,71,2022
2022-09-24,Sarawak,210,42,168,2022
2022-09-25,Sarawak,274,31,243,2022
2022-09-26,Sarawak,44,6,38,2022
2022-09-27,Sarawak,89,11,78,2022
2022-09-28,Sarawak,107,11,96,2022
2022-09-29,Sarawak,77,6,71,2022
2022-09-30,Sarawak,53,5,48,2022
2022-10-01,Sarawak,179,42,137,2022
2022-10-02,Sarawak,273,33,240,2022
2022-10-03,Sarawak,54,1,53,2022
2022-10-04,Sarawak,105,12,93,2022
2022-10-05,Sarawak,41,4,37,2022
2022-10-06,Sarawak,65,10,55,2022
2022-10-07,Sarawak,72,11,61,2022
2022-10-08,Sarawak,202,24,178,2022
2022-10-09,Sarawak,153,26,127,2022
2022-10-10,Sarawak,0,0,0,2022
2022-10-11,Sarawak,64,17,47,2022
2022-10-12,Sarawak,53,10,43,2022
2022-10-13,Sarawak,44,6,38,2022
2022-10-14,Sarawak,65,7,58,2022
2022-10-15,Sarawak,185,28,157,2022
2022-10-16,Sarawak,280,50,230,2022
2022-10-17,Sarawak,86,14,72,2022
2022-10-18,Sarawak,95,20,75,2022
2022-10-19,Sarawak,184,55,129,2022
2022-10-20,Sarawak,102,17,85,2022
2022-10-21,Sarawak,41,1,40,2022
2022-10-22,Sarawak,217,48,169,2022
2022-10-23,Sarawak,286,63,223,2022
2022-10-24,Sarawak,44,8,36,2022
2022-10-25,Sarawak,56,6,50,2022
2022-10-26,Sarawak,135,50,85,2022
2022-10-27,Sarawak,102,19,83,2022
2022-10-28,Sarawak,45,4,41,2022
2022-10-29,Sarawak,225,68,157,2022
2022-10-30,Sarawak,251,42,209,2022
2022-10-31,Sarawak,45,3,42,2022
2022-11-01,Sarawak,69,25,44,2022
2022-11-02,Sarawak,66,12,54,2022
2022-11-03,Sarawak,98,14,84,2022
2022-11-04,Sarawak,52,12,40,2022
2022-11-05,Sarawak,125,31,94,2022
2022-11-06,Sarawak,138,29,109,2022
2022-11-07,Sarawak,42,2,40,2022
2022-11-08,Sarawak,102,39,63,2022
2022-11-09,Sarawak,40,3,37,2022
2022-11-10,Sarawak,78,15,63,2022
2022-11-11,Sarawak,46,5,41,2022
2022-11-12,Sarawak,105,24,81,2022
2022-11-13,Sarawak,257,30,227,2022
2022-11-14,Sarawak,47,1,46,2022
2022-11-15,Sarawak,47,2,45,2022
2022-11-16,Sarawak,93,29,64,2022
2022-11-17,Sarawak,49,0,49,2022
2022-11-18,Sarawak,0,0,0,2022
2022-11-19,Sarawak,152,26,126,2022
2022-11-20,Sarawak,93,8,85,2022
2022-11-21,Sarawak,58,3,55,2022
2022-11-22,Sarawak,29,1,28,2022
2022-11-23,Sarawak,57,8,49,2022
2022-11-24,Sarawak,95,14,81,2022
2022-11-25,Sarawak,60,11,49,2022
2022-11-26,Sarawak,203,28,175,2022
2022-11-27,Sarawak,252,27,225,2022
2022-11-28,Sarawak,0,0,0,2022
2022-11-29,Sarawak,74,9,65,2022
2022-11-30,Sarawak,58,18,40,2022
2022-12-01,Sarawak,92,25,67,2022
2022-12-02,Sarawak,57,2,55,2022
2022-12-03,Sarawak,182,34,148,2022
2022-12-04,Sarawak,282,36,246,2022
2022-12-05,Sarawak,73,4,69,2022
2022-12-06,Sarawak,115,18,97,2022
2022-12-07,Sarawak,126,35,91,2022
2022-12-08,Sarawak,127,26,101,2022
2022-12-09,Sarawak,42,3,39,2022
2022-12-10,Sarawak,186,39,147,2022
2022-12-11,Sarawak,250,18,232,2022
2022-12-12,Sarawak,49,1,48,2022
2022-12-13,Sarawak,105,5,100,2022
2022-12-14,Sarawak,60,5,55,2022
2022-12-15,Sarawak,49,3,46,2022
2022-12-16,Sarawak,54,3,51,2022
2022-12-17,Sarawak,190,14,176,2022
2022-12-18,Sarawak,194,19,175,2022
2022-12-19,Sarawak,45,2,43,2022
2022-12-20,Sarawak,137,31,106,2022
2022-12-21,Sarawak,93,41,52,2022
2022-12-22,Sarawak,81,28,53,2022
2022-12-23,Sarawak,47,4,43,2022
2022-12-24,Sarawak,130,22,108,2022
2022-12-25,Sarawak,119,15,104,2022
2022-12-26,Sarawak,48,11,37,2022
2022-12-27,Sarawak,67,3,64,2022
2022-12-28,Sarawak,62,5,57,2022
2022-12-29,Sarawak,66,3,63,2022
2022-12-30,Sarawak,95,8,87,2022
2022-12-31,Sarawak,118,9,109,2022
2023-01-01,Sarawak,212,21,191,2023
2023-01-02,Sarawak,85,7,78,2023
2023-01-03,Sarawak,53,6,47,2023
2023-01-04,Sarawak,46,1,45,2023
2023-01-05,Sarawak,50,5,45,2023
2023-01-06,Sarawak,46,3,43,2023
2023-01-07,Sarawak,174,24,150,2023
2023-01-08,Sarawak,391,40,351,2023
2023-01-09,Sarawak,53,5,48,2023
2023-01-10,Sarawak,44,1,43,2023
2023-01-11,Sarawak,41,5,36,2023
2023-01-12,Sarawak,72,12,60,2023
2023-01-13,Sarawak,50,6,44,2023
2023-01-14,Sarawak,141,25,116,2023
2023-01-15,Sarawak,248,38,210,2023
2023-01-16,Sarawak,45,4,41,2023
2023-01-17,Sarawak,64,10,54,2023
2023-01-18,Sarawak,142,23,119,2023
2023-01-19,Sarawak,96,12,84,2023
2023-01-20,Sarawak,73,5,68,2023
2023-01-21,Sarawak,161,37,124,2023
2023-01-22,Sarawak,0,0,0,2023
2023-01-23,Sarawak,0,0,0,2023
2023-01-24,Sarawak,0,0,0,2023
2023-01-25,Sarawak,122,22,100,2023
2023-01-26,Sarawak,116,13,103,2023
2023-01-27,Sarawak,66,5,61,2023
2023-01-28,Sarawak,165,26,139,2023
2023-01-29,Sarawak,241,33,208,2023
2023-01-30,Sarawak,54,3,51,2023
2023-01-31,Sarawak,89,16,73,2023
2023-02-01,Sarawak,74,8,66,2023
2023-02-02,Sarawak,86,8,78,2023
2023-02-03,Sarawak,42,6,36,2023
2023-02-04,Sarawak,223,65,158,2023
2023-02-05,Sarawak,251,38,213,2023
2023-02-06,Sarawak,39,6,33,2023
2023-02-07,Sarawak,64,10,54,2023
2023-02-08,Sarawak,82,5,77,2023
2023-02-09,Sarawak,72,10,62,2023
2023-02-10,Sarawak,41,1,40,2023
2023-02-11,Sarawak,274,44,230,2023
2023-02-12,Sarawak,368,40,328,2023
2023-02-13,Sarawak,60,9,51,2023
2023-02-14,Sarawak,121,19,102,2023
2023-02-15,Sarawak,90,17,73,2023
2023-02-16,Sarawak,96,15,81,2023
2023-02-17,Sarawak,40,4,36,2023
2023-02-18,Sarawak,168,90,78,2023
2023-02-19,Sarawak,315,47,268,2023
2023-02-20,Sarawak,49,3,46,2023
2023-02-21,Sarawak,91,19,72,2023
2023-02-22,Sarawak,134,28,106,2023
2023-02-23,Sarawak,89,20,69,2023
2023-02-24,Sarawak,51,7,44,2023
2023-02-25,Sarawak,210,55,155,2023
2023-02-26,Sarawak,317,48,269,2023
2023-02-27,Sarawak,78,10,68,2023
2023-02-28,Sarawak,117,32,85,2023
2023-03-01,Sarawak,63,11,52,2023
2023-03-02,Sarawak,88,15,73,2023
2023-03-03,Sarawak,56,4,52,2023
2023-03-04,Sarawak,165,29,136,2023
2023-03-05,Sarawak,301,43,258,2023
2023-03-06,Sarawak,67,4,63,2023
2023-03-07,Sarawak,117,12,105,2023
2023-03-08,Sarawak,122,29,93,2023
2023-03-09,Sarawak,127,38,89,2023
2023-03-10,Sarawak,38,3,35,2023
2023-03-11,Sarawak,126,14,112,2023
2023-03-12,Sarawak,341,35,306,2023
2023-03-13,Sarawak,53,5,48,2023
2023-03-14,Sarawak,94,13,81,2023
2023-03-15,Sarawak,136,29,107,2023
2023-03-16,Sarawak,108,19,89,2023
2023-03-17,Sarawak,45,3,42,2023
2023-03-18,Sarawak,254,33,221,2023
2023-03-19,Sarawak,301,26,275,2023
2023-03-20,Sarawak,76,7,69,2023
2023-03-21,Sarawak,67,11,56,2023
2023-03-22,Sarawak,148,35,113,2023
2023-03-23,Sarawak,39,6,33,2023
2023-03-24,Sarawak,17,0,17,2023
2023-03-25,Sarawak,169,35,134,2023
2023-03-26,Sarawak,202,31,171,2023
2023-03-27,Sarawak,33,1,32,2023
2023-03-28,Sarawak,101,10,91,2023
2023-03-29,Sarawak,37,3,34,2023
2023-03-30,Sarawak,78,23,55,2023
2023-03-31,Sarawak,42,3,39,2023
2023-04-01,Sarawak,145,23,122,2023
2023-04-02,Sarawak,284,29,255,2023
2023-04-03,Sarawak,35,6,29,2023
2023-04-04,Sarawak,52,7,45,2023
2023-04-05,Sarawak,53,18,35,2023
2023-04-06,Sarawak,52,9,43,2023
2023-04-07,Sarawak,90,18,72,2023
2023-04-08,Sarawak,152,33,119,2023
2023-04-09,Sarawak,264,27,237,2023
2023-04-10,Sarawak,34,0,34,2023
2023-04-11,Sarawak,46,7,39,2023
2023-04-12,Sarawak,28,0,28,2023
2023-04-13,Sarawak,28,2,26,2023
2023-04-14,Sarawak,29,1,28,2023
2023-04-15,Sarawak,103,17,86,2023
2023-04-16,Sarawak,222,40,182,2023
2023-04-17,Sarawak,81,21,60,2023
2023-04-18,Sarawak,65,10,55,2023
2023-04-19,Sarawak,77,13,64,2023
2023-04-20,Sarawak,77,12,65,2023
2023-04-21,Sarawak,0,0,0,2023
2023-04-22,Sarawak,0,0,0,2023
2023-04-23,Sarawak,86,12,74,2023
2023-04-24,Sarawak,45,6,39,2023
2023-04-25,Sarawak,68,16,52,2023
2023-04-26,Sarawak,44,7,37,2023
2023-04-27,Sarawak,87,10,77,2023
2023-04-28,Sarawak,88,15,73,2023
2023-04-29,Sarawak,172,33,139,2023
2023-04-30,Sarawak,309,34,275,2023
2023-05-01,Sarawak,259,34,225,2023
2023-05-02,Sarawak,64,8,56,2023
2023-05-03,Sarawak,171,66,105,2023
2023-05-04,Sarawak,107,14,93,2023
2023-05-05,Sarawak,44,3,41,2023
2023-05-06,Sarawak,190,52,138,2023
2023-05-07,Sarawak,251,38,213,2023
2023-05-08,Sarawak,73,2,71,2023
2023-05-09,Sarawak,110,64,46,2023
2023-05-10,Sarawak,133,37,96,2023
2023-05-11,Sarawak,127,37,90,2023
2023-05-12,Sarawak,56,0,56,2023
2023-05-13,Sarawak,251,62,189,2023
2023-05-14,Sarawak,265,23,242,2023
2023-05-15,Sarawak,65,7,58,2023
2023-05-16,Sarawak,45,4,41,2023
2023-05-17,Sarawak,136,31,105,2023
2023-05-18,Sarawak,138,41,97,2023
2023-05-19,Sarawak,45,2,43,2023
2023-05-20,Sarawak,225,53,172,2023
2023-05-21,Sarawak,312,32,280,2023
2023-05-22,Sarawak,48,6,42,2023
2023-05-23,Sarawak,129,40,89,2023
2023-05-24,Sarawak,85,38,47,2023
2023-05-25,Sarawak,83,8,75,2023
2023-05-26,Sarawak,37,5,32,2023
2023-05-27,Sarawak,200,43,157,2023
2023-05-28,Sarawak,277,38,239,2023
2023-05-29,Sarawak,43,2,41,2023
2023-05-30,Sarawak,65,8,57,2023
2023-05-31,Sarawak,65,3,62,2023
2023-06-01,Sarawak,0,0,0,2023
2023-06-02,Sarawak,0,0,0,2023
2023-06-03,Sarawak,93,15,78,2023
2023-06-04,Sarawak,244,39,205,2023
2023-06-05,Sarawak,77,17,60,2023
2023-06-06,Sarawak,92,22,70,2023
2023-06-07,Sarawak,159,36,123,2023
2023-06-08,Sarawak,104,20,84,2023
2023-06-09,Sarawak,68,6,62,2023
2023-06-10,Sarawak,121,16,105,2023
2023-06-11,Sarawak,311,30,281,2023
2023-06-12,Sarawak,61,3,58,2023
2023-06-13,Sarawak,110,14,96,2023
2023-06-14,Sarawak,160,59,101,2023
2023-06-15,Sarawak,113,15,98,2023
2023-06-16,Sarawak,58,3,55,2023
2023-06-17,Sarawak,290,33,257,2023
2023-06-18,Sarawak,318,47,271,2023
2023-06-19,Sarawak,76,6,70,2023
2023-06-20,Sarawak,60,3,57,2023
2023-06-21,Sarawak,98,22,76,2023
2023-06-22,Sarawak,77,20,57,2023
2023-06-23,Sarawak,66,4,62,2023
2023-06-24,Sarawak,167,29,138,2023
2023-06-25,Sarawak,290,32,258,2023
2023-06-26,Sarawak,64,3,61,2023
2023-06-27,Sarawak,126,17,109,2023
2023-06-28,Sarawak,91,7,84,2023
2023-06-29,Sarawak,63,13,50,2023
2023-06-30,Sarawak,52,2,50,2023
2023-07-01,Sarawak,105,22,83,2023
2023-07-02,Sarawak,269,32,237,2023
2023-07-03,Sarawak,52,4,48,2023
2023-07-04,Sarawak,58,5,53,2023
2023-07-05,Sarawak,76,22,54,2023
2023-07-06,Sarawak,36,2,34,2023
2023-07-07,Sarawak,40,2,38,2023
2023-07-08,Sarawak,218,40,178,2023
2023-07-09,Sarawak,301,41,260,2023
2023-07-10,Sarawak,56,6,50,2023
2023-07-11,Sarawak,47,6,41,2023
2023-07-12,Sarawak,31,4,27,2023
2023-07-13,Sarawak,70,8,62,2023
2023-07-14,Sarawak,37,0,37,2023
2023-07-15,Sarawak,194,54,140,2023
2023-07-16,Sarawak,208,29,179,2023
2023-07-17,Sarawak,42,2,40,2023
2023-07-18,Sarawak,95,18,77,2023
2023-07-19,Sarawak,89,23,66,2023
2023-07-20,Sarawak,91,21,70,2023
2023-07-21,Sarawak,54,8,46,2023
2023-07-22,Sarawak,322,25,297,2023
2023-07-23,Sarawak,268,24,244,2023
2023-07-24,Sarawak,41,10,31,2023
2023-07-25,Sarawak,46,8,38,2023
2023-07-26,Sarawak,67,24,43,2023
2023-07-27,Sarawak,31,4,27,2023
2023-07-28,Sarawak,31,1,30,2023
2023-07-29,Sarawak,233,58,175,2023
2023-07-30,Sarawak,233,41,192,2023
2023-07-31,Sarawak,44,2,42,2023
2023-08-01,Sarawak,58,9,49,2023
2023-08-02,Sarawak,68,9,59,2023
2023-08-03,Sarawak,39,5,34,2023
2023-08-04,Sarawak,30,5,25,2023
2023-08-05,Sarawak,188,43,145,2023
2023-08-06,Sarawak,205,37,168,2023
2023-08-07,Sarawak,32,3,29,2023
2023-08-08,Sarawak,88,3,85,2023
2023-08-09,Sarawak,140,25,115,2023
2023-08-10,Sarawak,40,6,34,2023
2023-08-11,Sarawak,58,4,54,2023
2023-08-12,Sarawak,214,23,191,2023
2023-08-13,Sarawak,339,34,305,2023
2023-08-14,Sarawak,56,6,50,2023
2023-08-15,Sarawak,92,14,78,2023
2023-08-16,Sarawak,115,33,82,2023
2023-08-17,Sarawak,83,27,56,2023
2023-08-18,Sarawak,41,5,36,2023
2023-08-19,Sarawak,256,70,186,2023
2023-08-20,Sarawak,231,41,190,2023
2023-08-21,Sarawak,32,1,31,2023
2023-08-22,Sarawak,69,13,56,2023
2023-08-23,Sarawak,86,13,73,2023
2023-08-24,Sarawak,83,32,51,2023
2023-08-25,Sarawak,35,5,30,2023
2023-08-26,Sarawak,219,36,183,2023
2023-08-27,Sarawak,278,34,244,2023
2023-08-28,Sarawak,41,2,39,2023
2023-08-29,Sarawak,71,35,36,2023
2023-08-30,Sarawak,35,3,32,2023
2023-08-31,Sarawak,206,52,154,2023
2023-09-01,Sarawak,48,3,45,2023
2023-09-02,Sarawak,137,65,72,2023
2023-09-03,Sarawak,210,30,180,2023
2023-09-04,Sarawak,50,1,49,2023
2023-09-05,Sarawak,45,1,44,2023
2023-09-06,Sarawak,65,10,55,2023
2023-09-07,Sarawak,87,11,76,2023
2023-09-08,Sarawak,34,4,30,2023
2023-09-09,Sarawak,166,29,137,2023
2023-09-10,Sarawak,285,41,244,2023
2023-09-11,Sarawak,46,5,41,2023
2023-09-12,Sarawak,53,6,47,2023
2023-09-13,Sarawak,94,25,69,2023
2023-09-14,Sarawak,136,20,116,2023
2023-09-15,Sarawak,47,0,47,2023
2023-09-16,Sarawak,251,29,222,2023
2023-09-17,Sarawak,341,16,325,2023
2023-09-18,Sarawak,48,2,46,2023
2023-09-19,Sarawak,52,11,41,2023
2023-09-20,Sarawak,139,43,96,2023
2023-09-21,Sarawak,132,51,81,2023
2023-09-22,Sarawak,33,2,31,2023
2023-09-23,Sarawak,164,21,143,2023
2023-09-24,Sarawak,250,27,223,2023
2023-09-25,Sarawak,46,5,41,2023
2023-09-26,Sarawak,106,11,95,2023
2023-09-27,Sarawak,74,9,65,2023
2023-09-28,Sarawak,78,17,61,2023
2023-09-29,Sarawak,58,4,54,2023
2023-09-30,Sarawak,141,40,101,2023
2023-10-01,Sarawak,202,21,181,2023
2023-10-02,Sarawak,56,3,53,2023
2023-10-03,Sarawak,85,11,74,2023
2023-10-04,Sarawak,74,12,62,2023
2023-10-05,Sarawak,75,21,54,2023
2023-10-06,Sarawak,59,6,53,2023
2023-10-07,Sarawak,195,24,171,2023
2023-10-08,Sarawak,224,22,202,2023
2023-10-09,Sarawak,41,1,40,2023
2023-10-10,Sarawak,65,18,47,2023
2023-10-11,Sarawak,107,43,64,2023
2023-10-12,Sarawak,47,8,39,2023
2023-10-13,Sarawak,60,6,54,2023
2023-10-14,Sarawak,182,16,166,2023
2023-10-15,Sarawak,171,11,160,2023
2023-10-16,Sarawak,49,3,46,2023
2023-10-17,Sarawak,110,20,90,2023
2023-10-18,Sarawak,90,18,72,2023
2023-10-19,Sarawak,74,14,60,2023
2023-10-20,Sarawak,37,5,32,2023
2023-10-21,Sarawak,224,54,170,2023
2023-10-22,Sarawak,222,15,207,2023
2023-10-23,Sarawak,85,18,67,2023
2023-10-24,Sarawak,90,11,79,2023
2023-10-25,Sarawak,102,23,79,2023
2023-10-26,Sarawak,85,10,75,2023
2023-10-27,Sarawak,58,3,55,2023
2023-10-28,Sarawak,174,26,148,2023
2023-10-29,Sarawak,236,24,212,2023
2023-10-30,Sarawak,34,3,31,2023
2023-10-31,Sarawak,84,30,54,2023
2023-11-01,Sarawak,121,53,68,2023
2023-11-02,Sarawak,92,21,71,2023
2023-11-03,Sarawak,37,5,32,2023
2023-11-04,Sarawak,198,33,165,2023
2023-11-05,Sarawak,302,43,259,2023
2023-11-06,Sarawak,53,9,44,2023
2023-11-07,Sarawak,81,26,55,2023
2023-11-08,Sarawak,117,13,104,2023
2023-11-09,Sarawak,76,13,63,2023
2023-11-10,Sarawak,52,7,45,2023
2023-11-11,Sarawak,239,51,188,2023
2023-11-12,Sarawak,179,26,153,2023
2023-11-13,Sarawak,34,3,31,2023
2023-11-14,Sarawak,87,27,60,2023
2023-11-15,Sarawak,122,31,91,2023
2023-11-16,Sarawak,82,13,69,2023
2023-11-17,Sarawak,52,4,48,2023
2023-11-18,Sarawak,240,41,199,2023
2023-11-19,Sarawak,296,25,271,2023
2023-11-20,Sarawak,35,4,31,2023
2023-11-21,Sarawak,70,12,58,2023
2023-11-22,Sarawak,60,9,51,2023
2023-11-23,Sarawak,123,26,97,2023
2023-11-24,Sarawak,50,4,46,2023
2023-11-25,Sarawak,113,32,81,2023
2023-11-26,Sarawak,332,26,306,2023
2023-11-27,Sarawak,40,4,36,2023
2023-11-28,Sarawak,80,12,68,2023
2023-11-29,Sarawak,75,14,61,2023
2023-11-30,Sarawak,55,14,41,2023
2023-12-01,Sarawak,62,7,55,2023
2023-12-02,Sarawak,158,30,128,2023
2023-12-03,Sarawak,270,20,250,2023
2023-12-04,Sarawak,34,3,31,2023
2023-12-05,Sarawak,92,13,79,2023
2023-12-06,Sarawak,123,13,110,2023
2023-12-07,Sarawak,54,6,48,2023
2023-12-08,Sarawak,38,0,38,2023
2023-12-09,Sarawak,154,54,100,2023
2023-12-10,Sarawak,321,24,297,2023
2023-12-11,Sarawak,71,16,55,2023
2023-12-12,Sarawak,65,2,63,2023
2023-12-13,Sarawak,119,35,84,2023
2023-12-14,Sarawak,86,10,76,2023
2023-12-15,Sarawak,43,1,42,2023
2023-12-16,Sarawak,180,17,163,2023
2023-12-17,Sarawak,192,18,174,2023
2023-12-18,Sarawak,49,0,49,2023
2023-12-19,Sarawak,50,2,48,2023
2023-12-20,Sarawak,77,10,67,2023
2023-12-21,Sarawak,52,1,51,2023
2023-12-22,Sarawak,50,2,48,2023
2023-12-23,Sarawak,142,57,85,2023
2023-12-24,Sarawak,22,2,20,2023
2023-12-25,Sarawak,60,6,54,2023
2023-12-26,Sarawak,58,2,56,2023
2023-12-27,Sarawak,85,10,75,2023
2023-12-28,Sarawak,69,6,63,2023
2023-12-29,Sarawak,102,8,94,2023
2023-12-30,Sarawak,173,25,148,2023
2023-12-31,Sarawak,306,42,264,2023
2024-01-01,Sarawak,236,19,217,2024
2024-01-02,Sarawak,45,5,40,2024
2024-01-03,Sarawak,34,4,30,2024
2024-01-04,Sarawak,36,3,33,2024
2024-01-05,Sarawak,51,5,46,2024
2024-01-06,Sarawak,189,26,163,2024
2024-01-07,Sarawak,282,55,227,2024
2024-01-08,Sarawak,47,1,46,2024
2024-01-09,Sarawak,60,4,56,2024
2024-01-10,Sarawak,94,14,80,2024
2024-01-11,Sarawak,124,30,94,2024
2024-01-12,Sarawak,58,4,54,2024
2024-01-13,Sarawak,176,28,148,2024
2024-01-14,Sarawak,269,31,238,2024
2024-01-15,Sarawak,59,4,55,2024
2024-01-16,Sarawak,128,20,108,2024
2024-01-17,Sarawak,112,17,95,2024
2024-01-18,Sarawak,56,6,50,2024
2024-01-19,Sarawak,60,3,57,2024
2024-01-20,Sarawak,257,54,203,2024
2024-01-21,Sarawak,223,33,190,2024
2024-01-22,Sarawak,50,2,48,2024
2024-01-23,Sarawak,59,3,56,2024
2024-01-24,Sarawak,132,52,80,2024
2024-01-25,Sarawak,106,31,75,2024
2024-01-26,Sarawak,50,5,45,2024
2024-01-27,Sarawak,232,50,182,2024
2024-01-28,Sarawak,264,23,241,2024
2024-01-29,Sarawak,73,15,58,2024
2024-01-30,Sarawak,91,16,75,2024
2024-01-31,Sarawak,93,11,82,2024
2024-02-01,Sarawak,66,13,53,2024
2024-02-02,Sarawak,57,9,48,2024
2006-01-01,Selangor,1,1,0,2006
2006-01-02,Selangor,1,0,1,2006
2006-01-03,Selangor,4,0,4,2006
2006-01-04,Selangor,6,0,6,2006
2006-01-05,Selangor,5,1,4,2006
2006-01-06,Selangor,9,1,8,2006
2006-01-07,Selangor,0,0,0,2006
2006-01-08,Selangor,3,3,0,2006
2006-01-09,Selangor,7,2,5,2006
2006-01-10,Selangor,0,0,0,2006
2006-01-11,Selangor,3,0,3,2006
2006-01-12,Selangor,8,0,8,2006
2006-01-13,Selangor,5,0,5,2006
2006-01-14,Selangor,1,0,1,2006
2006-01-15,Selangor,3,0,3,2006
2006-01-16,Selangor,9,2,7,2006
2006-01-17,Selangor,6,1,5,2006
2006-01-18,Selangor,6,2,4,2006
2006-01-19,Selangor,5,1,4,2006
2006-01-20,Selangor,4,1,3,2006
2006-01-21,Selangor,7,4,3,2006
2006-01-22,Selangor,7,1,6,2006
2006-01-23,Selangor,7,2,5,2006
2006-01-24,Selangor,7,1,6,2006
2006-01-25,Selangor,11,4,7,2006
2006-01-26,Selangor,43,30,13,2006
2006-01-27,Selangor,9,3,6,2006
2006-01-28,Selangor,5,0,5,2006
2006-01-29,Selangor,0,0,0,2006
2006-01-30,Selangor,0,0,0,2006
2006-01-31,Selangor,8,1,7,2006
2006-02-01,Selangor,4,2,2,2006
2006-02-02,Selangor,8,0,8,2006
2006-02-03,Selangor,7,1,6,2006
2006-02-04,Selangor,7,2,5,2006
2006-02-05,Selangor,10,7,3,2006
2006-02-06,Selangor,7,0,7,2006
2006-02-07,Selangor,12,1,11,2006
2006-02-08,Selangor,18,4,14,2006
2006-02-09,Selangor,10,3,7,2006
2006-02-10,Selangor,4,0,4,2006
2006-02-11,Selangor,1,1,0,2006
2006-02-12,Selangor,8,7,1,2006
2006-02-13,Selangor,12,1,11,2006
2006-02-14,Selangor,9,0,9,2006
2006-02-15,Selangor,3,0,3,2006
2006-02-16,Selangor,8,0,8,2006
2006-02-17,Selangor,11,6,5,2006
2006-02-18,Selangor,5,4,1,2006
2006-02-19,Selangor,8,2,6,2006
2006-02-20,Selangor,13,1,12,2006
2006-02-21,Selangor,12,2,10,2006
2006-02-22,Selangor,1,0,1,2006
2006-02-23,Selangor,6,0,6,2006
2006-02-24,Selangor,7,1,6,2006
2006-02-25,Selangor,1,0,1,2006
2006-02-26,Selangor,9,4,5,2006
2006-02-27,Selangor,8,2,6,2006
2006-02-28,Selangor,5,0,5,2006
2006-03-01,Selangor,7,1,6,2006
2006-03-02,Selangor,5,0,5,2006
2006-03-03,Selangor,8,0,8,2006
2006-03-04,Selangor,5,3,2,2006
2006-03-05,Selangor,1,0,1,2006
2006-03-06,Selangor,6,1,5,2006
2006-03-07,Selangor,12,4,8,2006
2006-03-08,Selangor,10,0,10,2006
2006-03-09,Selangor,6,1,5,2006
2006-03-10,Selangor,2,0,2,2006
2006-03-11,Selangor,6,4,2,2006
2006-03-12,Selangor,19,8,11,2006
2006-03-13,Selangor,21,2,19,2006
2006-03-14,Selangor,9,0,9,2006
2006-03-15,Selangor,10,1,9,2006
2006-03-16,Selangor,3,1,2,2006
2006-03-17,Selangor,5,1,4,2006
2006-03-18,Selangor,1,1,0,2006
2006-03-19,Selangor,9,3,6,2006
2006-03-20,Selangor,8,0,8,2006
2006-03-21,Selangor,7,0,7,2006
2006-03-22,Selangor,4,1,3,2006
2006-03-23,Selangor,5,0,5,2006
2006-03-24,Selangor,13,3,10,2006
2006-03-25,Selangor,1,0,1,2006
2006-03-26,Selangor,0,0,0,2006
2006-03-27,Selangor,8,1,7,2006
2006-03-28,Selangor,6,0,6,2006
2006-03-29,Selangor,13,7,6,2006
2006-03-30,Selangor,4,1,3,2006
2006-03-31,Selangor,6,0,6,2006
2006-04-01,Selangor,0,0,0,2006
2006-04-02,Selangor,2,1,1,2006
2006-04-03,Selangor,22,4,18,2006
2006-04-04,Selangor,26,10,16,2006
2006-04-05,Selangor,12,1,11,2006
2006-04-06,Selangor,3,1,2,2006
2006-04-07,Selangor,4,0,4,2006
2006-04-08,Selangor,8,7,1,2006
2006-04-09,Selangor,10,3,7,2006
2006-04-10,Selangor,5,0,5,2006
2006-04-11,Selangor,30,10,20,2006
2006-04-12,Selangor,15,0,15,2006
2006-04-13,Selangor,18,5,13,2006
2006-04-14,Selangor,11,0,11,2006
2006-04-15,Selangor,1,0,1,2006
2006-04-16,Selangor,1,1,0,2006
2006-04-17,Selangor,7,1,6,2006
2006-04-18,Selangor,9,2,7,2006
2006-04-19,Selangor,13,7,6,2006
2006-04-20,Selangor,7,1,6,2006
2006-04-21,Selangor,10,0,10,2006
2006-04-22,Selangor,20,7,13,2006
2006-04-23,Selangor,2,1,1,2006
2006-04-24,Selangor,4,0,4,2006
2006-04-25,Selangor,2,0,2,2006
2006-04-26,Selangor,7,3,4,2006
2006-04-27,Selangor,7,0,7,2006
2006-04-28,Selangor,10,0,10,2006
2006-04-29,Selangor,4,0,4,2006
2006-04-30,Selangor,21,1,20,2006
2006-05-01,Selangor,6,1,5,2006
2006-05-02,Selangor,6,0,6,2006
2006-05-03,Selangor,6,2,4,2006
2006-05-04,Selangor,7,0,7,2006
2006-05-05,Selangor,7,0,7,2006
2006-05-06,Selangor,2,1,1,2006
2006-05-07,Selangor,10,1,9,2006
2006-05-08,Selangor,8,1,7,2006
2006-05-09,Selangor,8,0,8,2006
2006-05-10,Selangor,12,0,12,2006
2006-05-11,Selangor,20,5,15,2006
2006-05-12,Selangor,1,1,0,2006
2006-05-13,Selangor,0,0,0,2006
2006-05-14,Selangor,10,5,5,2006
2006-05-15,Selangor,7,2,5,2006
2006-05-16,Selangor,10,1,9,2006
2006-05-17,Selangor,12,0,12,2006
2006-05-18,Selangor,5,0,5,2006
2006-05-19,Selangor,9,1,8,2006
2006-05-20,Selangor,3,1,2,2006
2006-05-21,Selangor,28,3,25,2006
2006-05-22,Selangor,6,0,6,2006
2006-05-23,Selangor,4,0,4,2006
2006-05-24,Selangor,13,4,9,2006
2006-05-25,Selangor,9,1,8,2006
2006-05-26,Selangor,7,1,6,2006
2006-05-27,Selangor,0,0,0,2006
2006-05-28,Selangor,9,0,9,2006
2006-05-29,Selangor,9,0,9,2006
2006-05-30,Selangor,8,1,7,2006
2006-05-31,Selangor,5,1,4,2006
2006-06-01,Selangor,27,1,26,2006
2006-06-02,Selangor,8,0,8,2006
2006-06-03,Selangor,2,0,2,2006
2006-06-04,Selangor,14,5,9,2006
2006-06-05,Selangor,7,1,6,2006
2006-06-06,Selangor,9,0,9,2006
2006-06-07,Selangor,7,0,7,2006
2006-06-08,Selangor,12,0,12,2006
2006-06-09,Selangor,4,0,4,2006
2006-06-10,Selangor,0,0,0,2006
2006-06-11,Selangor,41,4,37,2006
2006-06-12,Selangor,4,1,3,2006
2006-06-13,Selangor,2,0,2,2006
2006-06-14,Selangor,16,2,14,2006
2006-06-15,Selangor,9,2,7,2006
2006-06-16,Selangor,6,0,6,2006
2006-06-17,Selangor,5,1,4,2006
2006-06-18,Selangor,21,6,15,2006
2006-06-19,Selangor,10,1,9,2006
2006-06-20,Selangor,12,1,11,2006
2006-06-21,Selangor,7,1,6,2006
2006-06-22,Selangor,12,1,11,2006
2006-06-23,Selangor,3,0,3,2006
2006-06-24,Selangor,2,1,1,2006
2006-06-25,Selangor,3,0,3,2006
2006-06-26,Selangor,8,0,8,2006
2006-06-27,Selangor,7,0,7,2006
2006-06-28,Selangor,5,1,4,2006
2006-06-29,Selangor,2,0,2,2006
2006-06-30,Selangor,7,0,7,2006
2006-07-01,Selangor,0,0,0,2006
2006-07-02,Selangor,24,5,19,2006
2006-07-03,Selangor,9,2,7,2006
2006-07-04,Selangor,7,3,4,2006
2006-07-05,Selangor,4,0,4,2006
2006-07-06,Selangor,5,1,4,2006
2006-07-07,Selangor,7,0,7,2006
2006-07-08,Selangor,7,2,5,2006
2006-07-09,Selangor,4,0,4,2006
2006-07-10,Selangor,10,2,8,2006
2006-07-11,Selangor,9,2,7,2006
2006-07-12,Selangor,8,2,6,2006
2006-07-13,Selangor,7,2,5,2006
2006-07-14,Selangor,10,0,10,2006
2006-07-15,Selangor,11,3,8,2006
2006-07-16,Selangor,0,0,0,2006
2006-07-17,Selangor,6,1,5,2006
2006-07-18,Selangor,9,0,9,2006
2006-07-19,Selangor,7,0,7,2006
2006-07-20,Selangor,6,0,6,2006
2006-07-21,Selangor,4,1,3,2006
2006-07-22,Selangor,5,2,3,2006
2006-07-23,Selangor,1,0,1,2006
2006-07-24,Selangor,14,1,13,2006
2006-07-25,Selangor,4,0,4,2006
2006-07-26,Selangor,12,1,11,2006
2006-07-27,Selangor,5,1,4,2006
2006-07-28,Selangor,3,0,3,2006
2006-07-29,Selangor,2,0,2,2006
2006-07-30,Selangor,3,1,2,2006
2006-07-31,Selangor,13,2,11,2006
2006-08-01,Selangor,5,0,5,2006
2006-08-02,Selangor,4,1,3,2006
2006-08-03,Selangor,19,3,16,2006
2006-08-04,Selangor,6,0,6,2006
2006-08-05,Selangor,1,0,1,2006
2006-08-06,Selangor,38,7,31,2006
2006-08-07,Selangor,9,0,9,2006
2006-08-08,Selangor,2,1,1,2006
2006-08-09,Selangor,10,1,9,2006
2006-08-10,Selangor,10,2,8,2006
2006-08-11,Selangor,9,1,8,2006
2006-08-12,Selangor,0,0,0,2006
2006-08-13,Selangor,22,4,18,2006
2006-08-14,Selangor,8,0,8,2006
2006-08-15,Selangor,4,1,3,2006
2006-08-16,Selangor,16,2,14,2006
2006-08-17,Selangor,8,0,8,2006
2006-08-18,Selangor,6,0,6,2006
2006-08-19,Selangor,2,0,2,2006
2006-08-20,Selangor,4,1,3,2006
2006-08-21,Selangor,54,30,24,2006
2006-08-22,Selangor,9,0,9,2006
2006-08-23,Selangor,11,3,8,2006
2006-08-24,Selangor,7,1,6,2006
2006-08-25,Selangor,9,1,8,2006
2006-08-26,Selangor,0,0,0,2006
2006-08-27,Selangor,18,5,13,2006
2006-08-28,Selangor,11,0,11,2006
2006-08-29,Selangor,7,0,7,2006
2006-08-30,Selangor,5,1,4,2006
2006-08-31,Selangor,1,0,1,2006
2006-09-01,Selangor,12,0,12,2006
2006-09-02,Selangor,4,3,1,2006
2006-09-03,Selangor,34,17,17,2006
2006-09-04,Selangor,11,1,10,2006
2006-09-05,Selangor,7,1,6,2006
2006-09-06,Selangor,17,4,13,2006
2006-09-07,Selangor,4,0,4,2006
2006-09-08,Selangor,6,1,5,2006
2006-09-09,Selangor,13,3,10,2006
2006-09-10,Selangor,2,0,2,2006
2006-09-11,Selangor,9,1,8,2006
2006-09-12,Selangor,19,8,11,2006
2006-09-13,Selangor,19,4,15,2006
2006-09-14,Selangor,2,0,2,2006
2006-09-15,Selangor,4,1,3,2006
2006-09-16,Selangor,3,1,2,2006
2006-09-17,Selangor,17,4,13,2006
2006-09-18,Selangor,12,0,12,2006
2006-09-19,Selangor,12,0,12,2006
2006-09-20,Selangor,11,1,10,2006
2006-09-21,Selangor,12,1,11,2006
2006-09-22,Selangor,14,3,11,2006
2006-09-23,Selangor,14,2,12,2006
2006-09-24,Selangor,0,0,0,2006
2006-09-25,Selangor,1,0,1,2006
2006-09-26,Selangor,4,0,4,2006
2006-09-27,Selangor,1,0,1,2006
2006-09-28,Selangor,3,1,2,2006
2006-09-29,Selangor,6,1,5,2006
2006-09-30,Selangor,0,0,0,2006
2006-10-01,Selangor,6,1,5,2006
2006-10-02,Selangor,1,0,1,2006
2006-10-03,Selangor,4,0,4,2006
2006-10-04,Selangor,9,4,5,2006
2006-10-05,Selangor,3,0,3,2006
2006-10-06,Selangor,7,0,7,2006
2006-10-07,Selangor,0,0,0,2006
2006-10-08,Selangor,4,2,2,2006
2006-10-09,Selangor,3,0,3,2006
2006-10-10,Selangor,4,1,3,2006
2006-10-11,Selangor,3,0,3,2006
2006-10-12,Selangor,4,0,4,2006
2006-10-13,Selangor,2,0,2,2006
2006-10-14,Selangor,3,1,2,2006
2006-10-15,Selangor,15,3,12,2006
2006-10-16,Selangor,6,0,6,2006
2006-10-17,Selangor,2,0,2,2006
2006-10-18,Selangor,4,2,2,2006
2006-10-19,Selangor,6,1,5,2006
2006-10-20,Selangor,5,0,5,2006
2006-10-21,Selangor,1,0,1,2006
2006-10-22,Selangor,8,2,6,2006
2006-10-23,Selangor,2,0,2,2006
2006-10-24,Selangor,1,0,1,2006
2006-10-25,Selangor,2,0,2,2006
2006-10-26,Selangor,7,2,5,2006
2006-10-27,Selangor,8,2,6,2006
2006-10-28,Selangor,0,0,0,2006
2006-10-29,Selangor,1,1,0,2006
2006-10-30,Selangor,10,1,9,2006
2006-10-31,Selangor,13,1,12,2006
2006-11-01,Selangor,6,1,5,2006
2006-11-02,Selangor,5,0,5,2006
2006-11-03,Selangor,12,3,9,2006
2006-11-04,Selangor,2,1,1,2006
2006-11-05,Selangor,14,0,14,2006
2006-11-06,Selangor,7,0,7,2006
2006-11-07,Selangor,9,2,7,2006
2006-11-08,Selangor,10,1,9,2006
2006-11-09,Selangor,10,0,10,2006
2006-11-10,Selangor,18,5,13,2006
2006-11-11,Selangor,5,1,4,2006
2006-11-12,Selangor,13,3,10,2006
2006-11-13,Selangor,6,1,5,2006
2006-11-14,Selangor,8,0,8,2006
2006-11-15,Selangor,4,1,3,2006
2006-11-16,Selangor,16,5,11,2006
2006-11-17,Selangor,16,3,13,2006
2006-11-18,Selangor,1,1,0,2006
2006-11-19,Selangor,0,0,0,2006
2006-11-20,Selangor,9,0,9,2006
2006-11-21,Selangor,5,1,4,2006
2006-11-22,Selangor,8,1,7,2006
2006-11-23,Selangor,16,7,9,2006
2006-11-24,Selangor,7,2,5,2006
2006-11-25,Selangor,0,0,0,2006
2006-11-26,Selangor,3,2,1,2006
2006-11-27,Selangor,25,13,12,2006
2006-11-28,Selangor,17,4,13,2006
2006-11-29,Selangor,13,6,7,2006
2006-11-30,Selangor,21,14,7,2006
2006-12-01,Selangor,7,2,5,2006
2006-12-02,Selangor,0,0,0,2006
2006-12-03,Selangor,179,99,80,2006
2006-12-04,Selangor,12,7,5,2006
2006-12-05,Selangor,22,12,10,2006
2006-12-06,Selangor,53,36,17,2006
2006-12-07,Selangor,11,0,11,2006
2006-12-08,Selangor,40,27,13,2006
2006-12-09,Selangor,53,37,16,2006
2006-12-10,Selangor,153,94,59,2006
2006-12-11,Selangor,1,1,0,2006
2006-12-12,Selangor,3,0,3,2006
2006-12-13,Selangor,67,47,20,2006
2006-12-14,Selangor,63,15,48,2006
2006-12-15,Selangor,12,1,11,2006
2006-12-16,Selangor,46,38,8,2006
2006-12-17,Selangor,65,48,17,2006
2006-12-18,Selangor,15,1,14,2006
2006-12-19,Selangor,59,37,22,2006
2006-12-20,Selangor,73,64,9,2006
2006-12-21,Selangor,130,107,23,2006
2006-12-22,Selangor,70,58,12,2006
2006-12-23,Selangor,19,17,2,2006
2006-12-24,Selangor,39,36,3,2006
2006-12-25,Selangor,0,0,0,2006
2006-12-26,Selangor,10,5,5,2006
2006-12-27,Selangor,22,8,14,2006
2006-12-28,Selangor,25,10,15,2006
2006-12-29,Selangor,39,22,17,2006
2006-12-30,Selangor,19,13,6,2006
2006-12-31,Selangor,0,0,0,2006
2007-01-01,Selangor,26,16,10,2007
2007-01-02,Selangor,34,28,6,2007
2007-01-03,Selangor,22,10,12,2007
2007-01-04,Selangor,56,39,17,2007
2007-01-05,Selangor,36,24,12,2007
2007-01-06,Selangor,27,17,10,2007
2007-01-07,Selangor,73,46,27,2007
2007-01-08,Selangor,54,28,26,2007
2007-01-09,Selangor,15,4,11,2007
2007-01-10,Selangor,19,6,13,2007
2007-01-11,Selangor,49,42,7,2007
2007-01-12,Selangor,30,16,14,2007
2007-01-13,Selangor,56,40,16,2007
2007-01-14,Selangor,89,62,27,2007
2007-01-15,Selangor,13,3,10,2007
2007-01-16,Selangor,39,31,8,2007
2007-01-17,Selangor,12,3,9,2007
2007-01-18,Selangor,83,59,24,2007
2007-01-19,Selangor,12,6,6,2007
2007-01-20,Selangor,58,31,27,2007
2007-01-21,Selangor,149,64,85,2007
2007-01-22,Selangor,33,23,10,2007
2007-01-23,Selangor,10,5,5,2007
2007-01-24,Selangor,58,30,28,2007
2007-01-25,Selangor,48,25,23,2007
2007-01-26,Selangor,118,88,30,2007
2007-01-27,Selangor,11,5,6,2007
2007-01-28,Selangor,20,13,7,2007
2007-01-29,Selangor,15,8,7,2007
2007-01-30,Selangor,11,2,9,2007
2007-01-31,Selangor,162,94,68,2007
2007-02-01,Selangor,94,82,12,2007
2007-02-02,Selangor,36,24,12,2007
2007-02-03,Selangor,50,35,15,2007
2007-02-04,Selangor,110,70,40,2007
2007-02-05,Selangor,9,1,8,2007
2007-02-06,Selangor,66,33,33,2007
2007-02-07,Selangor,108,48,60,2007
2007-02-08,Selangor,46,33,13,2007
2007-02-09,Selangor,78,49,29,2007
2007-02-10,Selangor,146,115,31,2007
2007-02-11,Selangor,92,54,38,2007
2007-02-12,Selangor,38,23,15,2007
2007-02-13,Selangor,28,8,20,2007
2007-02-14,Selangor,12,2,10,2007
2007-02-15,Selangor,23,14,9,2007
2007-02-16,Selangor,21,11,10,2007
2007-02-17,Selangor,14,12,2,2007
2007-02-18,Selangor,16,14,2,2007
2007-02-19,Selangor,17,15,2,2007
2007-02-20,Selangor,3,2,1,2007
2007-02-21,Selangor,28,9,19,2007
2007-02-22,Selangor,64,43,21,2007
2007-02-23,Selangor,78,50,28,2007
2007-02-24,Selangor,50,41,9,2007
2007-02-25,Selangor,121,106,15,2007
2007-02-26,Selangor,81,53,28,2007
2007-02-27,Selangor,37,20,17,2007
2007-02-28,Selangor,196,147,49,2007
2007-03-01,Selangor,18,6,12,2007
2007-03-02,Selangor,14,4,10,2007
2007-03-03,Selangor,81,66,15,2007
2007-03-04,Selangor,68,57,11,2007
2007-03-05,Selangor,107,61,46,2007
2007-03-06,Selangor,118,85,33,2007
2007-03-07,Selangor,62,22,40,2007
2007-03-08,Selangor,70,54,16,2007
2007-03-09,Selangor,74,43,31,2007
2007-03-10,Selangor,60,52,8,2007
2007-03-11,Selangor,135,105,30,2007
2007-03-12,Selangor,130,75,55,2007
2007-03-13,Selangor,11,0,11,2007
2007-03-14,Selangor,194,144,50,2007
2007-03-15,Selangor,10,3,7,2007
2007-03-16,Selangor,10,1,9,2007
2007-03-17,Selangor,29,13,16,2007
2007-03-18,Selangor,227,123,104,2007
2007-03-19,Selangor,12,3,9,2007
2007-03-20,Selangor,19,8,11,2007
2007-03-21,Selangor,15,4,11,2007
2007-03-22,Selangor,41,23,18,2007
2007-03-23,Selangor,25,15,10,2007
2007-03-24,Selangor,42,34,8,2007
2007-03-25,Selangor,149,79,70,2007
2007-03-26,Selangor,20,6,14,2007
2007-03-27,Selangor,12,2,10,2007
2007-03-28,Selangor,26,20,6,2007
2007-03-29,Selangor,13,1,12,2007
2007-03-30,Selangor,16,0,16,2007
2007-03-31,Selangor,52,41,11,2007
2007-04-01,Selangor,103,64,39,2007
2007-04-02,Selangor,20,3,17,2007
2007-04-03,Selangor,12,4,8,2007
2007-04-04,Selangor,16,8,8,2007
2007-04-05,Selangor,88,43,45,2007
2007-04-06,Selangor,13,3,10,2007
2007-04-07,Selangor,55,44,11,2007
2007-04-08,Selangor,55,39,16,2007
2007-04-09,Selangor,63,49,14,2007
2007-04-10,Selangor,12,3,9,2007
2007-04-11,Selangor,63,44,19,2007
2007-04-12,Selangor,56,33,23,2007
2007-04-13,Selangor,34,23,11,2007
2007-04-14,Selangor,8,6,2,2007
2007-04-15,Selangor,64,39,25,2007
2007-04-16,Selangor,8,3,5,2007
2007-04-17,Selangor,20,6,14,2007
2007-04-18,Selangor,58,44,14,2007
2007-04-19,Selangor,49,31,18,2007
2007-04-20,Selangor,6,1,5,2007
2007-04-21,Selangor,3,1,2,2007
2007-04-22,Selangor,65,30,35,2007
2007-04-23,Selangor,41,24,17,2007
2007-04-24,Selangor,56,31,25,2007
2007-04-25,Selangor,32,18,14,2007
2007-04-26,Selangor,5,5,0,2007
2007-04-27,Selangor,16,2,14,2007
2007-04-28,Selangor,79,71,8,2007
2007-04-29,Selangor,50,31,19,2007
2007-04-30,Selangor,12,1,11,2007
2007-05-01,Selangor,93,62,31,2007
2007-05-02,Selangor,16,11,5,2007
2007-05-03,Selangor,61,33,28,2007
2007-05-04,Selangor,14,1,13,2007
2007-05-05,Selangor,115,74,41,2007
2007-05-06,Selangor,70,62,8,2007
2007-05-07,Selangor,21,2,19,2007
2007-05-08,Selangor,7,2,5,2007
2007-05-09,Selangor,30,17,13,2007
2007-05-10,Selangor,31,18,13,2007
2007-05-11,Selangor,41,20,21,2007
2007-05-12,Selangor,37,21,16,2007
2007-05-13,Selangor,141,72,69,2007
2007-05-14,Selangor,15,2,13,2007
2007-05-15,Selangor,7,1,6,2007
2007-05-16,Selangor,31,15,16,2007
2007-05-17,Selangor,36,17,19,2007
2007-05-18,Selangor,17,3,14,2007
2007-05-19,Selangor,12,7,5,2007
2007-05-20,Selangor,281,152,129,2007
2007-05-21,Selangor,11,4,7,2007
2007-05-22,Selangor,19,3,16,2007
2007-05-23,Selangor,27,20,7,2007
2007-05-24,Selangor,38,23,15,2007
2007-05-25,Selangor,89,68,21,2007
2007-05-26,Selangor,60,36,24,2007
2007-05-27,Selangor,54,44,10,2007
2007-05-28,Selangor,10,4,6,2007
2007-05-29,Selangor,7,0,7,2007
2007-05-30,Selangor,67,17,50,2007
2007-05-31,Selangor,61,31,30,2007
2007-06-01,Selangor,29,12,17,2007
2007-06-02,Selangor,9,6,3,2007
2007-06-03,Selangor,100,70,30,2007
2007-06-04,Selangor,12,1,11,2007
2007-06-05,Selangor,11,2,9,2007
2007-06-06,Selangor,38,23,15,2007
2007-06-07,Selangor,39,17,22,2007
2007-06-08,Selangor,70,40,30,2007
2007-06-09,Selangor,0,0,0,2007
2007-06-10,Selangor,110,97,13,2007
2007-06-11,Selangor,12,1,11,2007
2007-06-12,Selangor,35,19,16,2007
2007-06-13,Selangor,43,19,24,2007
2007-06-14,Selangor,6,0,6,2007
2007-06-15,Selangor,15,2,13,2007
2007-06-16,Selangor,57,50,7,2007
2007-06-17,Selangor,188,74,114,2007
2007-06-18,Selangor,8,1,7,2007
2007-06-19,Selangor,8,1,7,2007
2007-06-20,Selangor,25,12,13,2007
2007-06-21,Selangor,18,7,11,2007
2007-06-22,Selangor,9,0,9,2007
2007-06-23,Selangor,58,47,11,2007
2007-06-24,Selangor,110,72,38,2007
2007-06-25,Selangor,10,1,9,2007
2007-06-26,Selangor,50,24,26,2007
2007-06-27,Selangor,46,26,20,2007
2007-06-28,Selangor,136,117,19,2007
2007-06-29,Selangor,16,3,13,2007
2007-06-30,Selangor,21,15,6,2007
2007-07-01,Selangor,103,70,33,2007
2007-07-02,Selangor,27,15,12,2007
2007-07-03,Selangor,12,1,11,2007
2007-07-04,Selangor,27,13,14,2007
2007-07-05,Selangor,49,36,13,2007
2007-07-06,Selangor,90,61,29,2007
2007-07-07,Selangor,106,68,38,2007
2007-07-08,Selangor,158,110,48,2007
2007-07-09,Selangor,13,2,11,2007
2007-07-10,Selangor,16,8,8,2007
2007-07-11,Selangor,94,51,43,2007
2007-07-12,Selangor,47,32,15,2007
2007-07-13,Selangor,12,4,8,2007
2007-07-14,Selangor,20,15,5,2007
2007-07-15,Selangor,85,66,19,2007
2007-07-16,Selangor,17,1,16,2007
2007-07-17,Selangor,58,22,36,2007
2007-07-18,Selangor,144,101,43,2007
2007-07-19,Selangor,112,87,25,2007
2007-07-20,Selangor,9,0,9,2007
2007-07-21,Selangor,46,34,12,2007
2007-07-22,Selangor,91,83,8,2007
2007-07-23,Selangor,13,2,11,2007
2007-07-24,Selangor,159,99,60,2007
2007-07-25,Selangor,10,4,6,2007
2007-07-26,Selangor,128,100,28,2007
2007-07-27,Selangor,14,2,12,2007
2007-07-28,Selangor,41,31,10,2007
2007-07-29,Selangor,71,58,13,2007
2007-07-30,Selangor,59,44,15,2007
2007-07-31,Selangor,9,4,5,2007
2007-08-01,Selangor,14,3,11,2007
2007-08-02,Selangor,56,29,27,2007
2007-08-03,Selangor,6,0,6,2007
2007-08-04,Selangor,47,41,6,2007
2007-08-05,Selangor,26,23,3,2007
2007-08-06,Selangor,65,44,21,2007
2007-08-07,Selangor,12,5,7,2007
2007-08-08,Selangor,48,25,23,2007
2007-08-09,Selangor,56,38,18,2007
2007-08-10,Selangor,19,2,17,2007
2007-08-11,Selangor,140,101,39,2007
2007-08-12,Selangor,167,91,76,2007
2007-08-13,Selangor,18,2,16,2007
2007-08-14,Selangor,28,21,7,2007
2007-08-15,Selangor,56,46,10,2007
2007-08-16,Selangor,60,52,8,2007
2007-08-17,Selangor,6,0,6,2007
2007-08-18,Selangor,89,70,19,2007
2007-08-19,Selangor,142,86,56,2007
2007-08-20,Selangor,27,14,13,2007
2007-08-21,Selangor,28,15,13,2007
2007-08-22,Selangor,32,23,9,2007
2007-08-23,Selangor,84,51,33,2007
2007-08-24,Selangor,12,2,10,2007
2007-08-25,Selangor,24,11,13,2007
2007-08-26,Selangor,290,215,75,2007
2007-08-27,Selangor,43,36,7,2007
2007-08-28,Selangor,124,70,54,2007
2007-08-29,Selangor,197,112,85,2007
2007-08-30,Selangor,38,23,15,2007
2007-08-31,Selangor,26,10,16,2007
2007-09-01,Selangor,31,24,7,2007
2007-09-02,Selangor,69,43,26,2007
2007-09-03,Selangor,69,46,23,2007
2007-09-04,Selangor,12,2,10,2007
2007-09-05,Selangor,58,25,33,2007
2007-09-06,Selangor,77,62,15,2007
2007-09-07,Selangor,49,39,10,2007
2007-09-08,Selangor,97,63,34,2007
2007-09-09,Selangor,75,52,23,2007
2007-09-10,Selangor,96,77,19,2007
2007-09-11,Selangor,19,4,15,2007
2007-09-12,Selangor,26,4,22,2007
2007-09-13,Selangor,7,1,6,2007
2007-09-14,Selangor,4,1,3,2007
2007-09-15,Selangor,0,0,0,2007
2007-09-16,Selangor,152,121,31,2007
2007-09-17,Selangor,15,6,9,2007
2007-09-18,Selangor,22,12,10,2007
2007-09-19,Selangor,18,4,14,2007
2007-09-20,Selangor,22,13,9,2007
2007-09-21,Selangor,9,1,8,2007
2007-09-22,Selangor,17,13,4,2007
2007-09-23,Selangor,106,81,25,2007
2007-09-24,Selangor,12,2,10,2007
2007-09-25,Selangor,7,2,5,2007
2007-09-26,Selangor,68,48,20,2007
2007-09-27,Selangor,9,2,7,2007
2007-09-28,Selangor,25,13,12,2007
2007-09-29,Selangor,3,1,2,2007
2007-09-30,Selangor,204,127,77,2007
2007-10-01,Selangor,13,7,6,2007
2007-10-02,Selangor,29,16,13,2007
2007-10-03,Selangor,34,21,13,2007
2007-10-04,Selangor,57,23,34,2007
2007-10-05,Selangor,7,0,7,2007
2007-10-06,Selangor,92,58,34,2007
2007-10-07,Selangor,140,80,60,2007
2007-10-08,Selangor,12,3,9,2007
2007-10-09,Selangor,67,57,10,2007
2007-10-10,Selangor,43,17,26,2007
2007-10-11,Selangor,88,61,27,2007
2007-10-12,Selangor,16,0,16,2007
2007-10-13,Selangor,1,0,1,2007
2007-10-14,Selangor,0,0,0,2007
2007-10-15,Selangor,0,0,0,2007
2007-10-16,Selangor,12,5,7,2007
2007-10-17,Selangor,17,5,12,2007
2007-10-18,Selangor,40,14,26,2007
2007-10-19,Selangor,48,28,20,2007
2007-10-20,Selangor,42,33,9,2007
2007-10-21,Selangor,135,87,48,2007
2007-10-22,Selangor,12,0,12,2007
2007-10-23,Selangor,24,13,11,2007
2007-10-24,Selangor,72,50,22,2007
2007-10-25,Selangor,58,17,41,2007
2007-10-26,Selangor,26,10,16,2007
2007-10-27,Selangor,20,17,3,2007
2007-10-28,Selangor,156,91,65,2007
2007-10-29,Selangor,52,33,19,2007
2007-10-30,Selangor,72,51,21,2007
2007-10-31,Selangor,64,34,30,2007
2007-11-01,Selangor,5,1,4,2007
2007-11-02,Selangor,9,1,8,2007
2007-11-03,Selangor,6,5,1,2007
2007-11-04,Selangor,138,102,36,2007
2007-11-05,Selangor,12,5,7,2007
2007-11-06,Selangor,29,17,12,2007
2007-11-07,Selangor,52,22,30,2007
2007-11-08,Selangor,57,46,11,2007
2007-11-09,Selangor,51,25,26,2007
2007-11-10,Selangor,1,0,1,2007
2007-11-11,Selangor,106,74,32,2007
2007-11-12,Selangor,21,8,13,2007
2007-11-13,Selangor,8,1,7,2007
2007-11-14,Selangor,27,9,18,2007
2007-11-15,Selangor,88,73,15,2007
2007-11-16,Selangor,86,65,21,2007
2007-11-17,Selangor,16,14,2,2007
2007-11-18,Selangor,66,42,24,2007
2007-11-19,Selangor,113,89,24,2007
2007-11-20,Selangor,15,4,11,2007
2007-11-21,Selangor,12,2,10,2007
2007-11-22,Selangor,81,67,14,2007
2007-11-23,Selangor,30,10,20,2007
2007-11-24,Selangor,64,49,15,2007
2007-11-25,Selangor,34,26,8,2007
2007-11-26,Selangor,26,16,10,2007
2007-11-27,Selangor,64,31,33,2007
2007-11-28,Selangor,78,35,43,2007
2007-11-29,Selangor,13,6,7,2007
2007-11-30,Selangor,9,1,8,2007
2007-12-01,Selangor,0,0,0,2007
2007-12-02,Selangor,194,105,89,2007
2007-12-03,Selangor,78,63,15,2007
2007-12-04,Selangor,39,30,9,2007
2007-12-05,Selangor,49,28,21,2007
2007-12-06,Selangor,36,22,14,2007
2007-12-07,Selangor,22,8,14,2007
2007-12-08,Selangor,1,0,1,2007
2007-12-09,Selangor,189,84,105,2007
2007-12-10,Selangor,22,11,11,2007
2007-12-11,Selangor,21,13,8,2007
2007-12-12,Selangor,58,37,21,2007
2007-12-13,Selangor,8,2,6,2007
2007-12-14,Selangor,35,17,18,2007
2007-12-15,Selangor,22,19,3,2007
2007-12-16,Selangor,68,57,11,2007
2007-12-17,Selangor,38,16,22,2007
2007-12-18,Selangor,42,19,23,2007
2007-12-19,Selangor,44,31,13,2007
2007-12-20,Selangor,1,0,1,2007
2007-12-21,Selangor,13,2,11,2007
2007-12-22,Selangor,17,11,6,2007
2007-12-23,Selangor,24,13,11,2007
2007-12-24,Selangor,50,24,26,2007
2007-12-25,Selangor,24,13,11,2007
2007-12-26,Selangor,23,7,16,2007
2007-12-27,Selangor,39,17,22,2007
2007-12-28,Selangor,85,71,14,2007
2007-12-29,Selangor,2,2,0,2007
2007-12-30,Selangor,30,22,8,2007
2007-12-31,Selangor,16,2,14,2007
2008-01-01,Selangor,2,2,0,2008
2008-01-02,Selangor,37,19,18,2008
2008-01-03,Selangor,97,63,34,2008
2008-01-04,Selangor,35,18,17,2008
2008-01-05,Selangor,27,14,13,2008
2008-01-06,Selangor,37,24,13,2008
2008-01-07,Selangor,24,4,20,2008
2008-01-08,Selangor,15,2,13,2008
2008-01-09,Selangor,39,22,17,2008
2008-01-10,Selangor,45,34,11,2008
2008-01-11,Selangor,52,38,14,2008
2008-01-12,Selangor,94,61,33,2008
2008-01-13,Selangor,18,13,5,2008
2008-01-14,Selangor,11,4,7,2008
2008-01-15,Selangor,17,3,14,2008
2008-01-16,Selangor,33,18,15,2008
2008-01-17,Selangor,43,26,17,2008
2008-01-18,Selangor,59,34,25,2008
2008-01-19,Selangor,33,26,7,2008
2008-01-20,Selangor,94,50,44,2008
2008-01-21,Selangor,14,8,6,2008
2008-01-22,Selangor,67,38,29,2008
2008-01-23,Selangor,59,37,22,2008
2008-01-24,Selangor,40,20,20,2008
2008-01-25,Selangor,32,19,13,2008
2008-01-26,Selangor,57,49,8,2008
2008-01-27,Selangor,26,17,9,2008
2008-01-28,Selangor,34,22,12,2008
2008-01-29,Selangor,54,26,28,2008
2008-01-30,Selangor,66,41,25,2008
2008-01-31,Selangor,38,29,9,2008
2008-02-01,Selangor,23,4,19,2008
2008-02-02,Selangor,0,0,0,2008
2008-02-03,Selangor,30,22,8,2008
2008-02-04,Selangor,41,19,22,2008
2008-02-05,Selangor,93,49,44,2008
2008-02-06,Selangor,45,23,22,2008
2008-02-07,Selangor,23,12,11,2008
2008-02-08,Selangor,9,6,3,2008
2008-02-09,Selangor,16,11,5,2008
2008-02-10,Selangor,31,22,9,2008
2008-02-11,Selangor,15,2,13,2008
2008-02-12,Selangor,15,4,11,2008
2008-02-13,Selangor,140,88,52,2008
2008-02-14,Selangor,34,15,19,2008
2008-02-15,Selangor,36,17,19,2008
2008-02-16,Selangor,4,3,1,2008
2008-02-17,Selangor,52,26,26,2008
2008-02-18,Selangor,13,1,12,2008
2008-02-19,Selangor,42,28,14,2008
2008-02-20,Selangor,10,2,8,2008
2008-02-21,Selangor,67,55,12,2008
2008-02-22,Selangor,85,69,16,2008
2008-02-23,Selangor,73,61,12,2008
2008-02-24,Selangor,86,59,27,2008
2008-02-25,Selangor,8,1,7,2008
2008-02-26,Selangor,12,8,4,2008
2008-02-27,Selangor,103,67,36,2008
2008-02-28,Selangor,41,15,26,2008
2008-02-29,Selangor,72,36,36,2008
2008-03-01,Selangor,40,28,12,2008
2008-03-02,Selangor,44,33,11,2008
2008-03-03,Selangor,19,7,12,2008
2008-03-04,Selangor,55,29,26,2008
2008-03-05,Selangor,52,24,28,2008
2008-03-06,Selangor,39,24,15,2008
2008-03-07,Selangor,20,6,14,2008
2008-03-08,Selangor,0,0,0,2008
2008-03-09,Selangor,0,0,0,2008
2008-03-10,Selangor,38,20,18,2008
2008-03-11,Selangor,72,41,31,2008
2008-03-12,Selangor,55,12,43,2008
2008-03-13,Selangor,45,35,10,2008
2008-03-14,Selangor,41,14,27,2008
2008-03-15,Selangor,60,50,10,2008
2008-03-16,Selangor,19,13,6,2008
2008-03-17,Selangor,29,13,16,2008
2008-03-18,Selangor,91,38,53,2008
2008-03-19,Selangor,41,27,14,2008
2008-03-20,Selangor,50,28,22,2008
2008-03-21,Selangor,44,23,21,2008
2008-03-22,Selangor,77,64,13,2008
2008-03-23,Selangor,278,169,109,2008
2008-03-24,Selangor,16,0,16,2008
2008-03-25,Selangor,64,39,25,2008
2008-03-26,Selangor,16,2,14,2008
2008-03-27,Selangor,64,39,25,2008
2008-03-28,Selangor,13,4,9,2008
2008-03-29,Selangor,36,19,17,2008
2008-03-30,Selangor,150,47,103,2008
2008-03-31,Selangor,27,8,19,2008
2008-04-01,Selangor,11,3,8,2008
2008-04-02,Selangor,145,96,49,2008
2008-04-03,Selangor,20,3,17,2008
2008-04-04,Selangor,10,3,7,2008
2008-04-05,Selangor,12,4,8,2008
2008-04-06,Selangor,0,0,0,2008
2008-04-07,Selangor,58,19,39,2008
2008-04-08,Selangor,48,21,27,2008
2008-04-09,Selangor,38,14,24,2008
2008-04-10,Selangor,72,22,50,2008
2008-04-11,Selangor,16,5,11,2008
2008-04-12,Selangor,95,79,16,2008
2008-04-13,Selangor,175,98,77,2008
2008-04-14,Selangor,58,32,26,2008
2008-04-15,Selangor,21,10,11,2008
2008-04-16,Selangor,61,28,33,2008
2008-04-17,Selangor,69,39,30,2008
2008-04-18,Selangor,67,44,23,2008
2008-04-19,Selangor,30,19,11,2008
2008-04-20,Selangor,16,9,7,2008
2008-04-21,Selangor,55,24,31,2008
2008-04-22,Selangor,50,29,21,2008
2008-04-23,Selangor,14,2,12,2008
2008-04-24,Selangor,46,29,17,2008
2008-04-25,Selangor,33,25,8,2008
2008-04-26,Selangor,162,87,75,2008
2008-04-27,Selangor,68,34,34,2008
2008-04-28,Selangor,15,2,13,2008
2008-04-29,Selangor,33,15,18,2008
2008-04-30,Selangor,42,27,15,2008
2008-05-01,Selangor,19,14,5,2008
2008-05-02,Selangor,15,4,11,2008
2008-05-03,Selangor,30,16,14,2008
2008-05-04,Selangor,126,50,76,2008
2008-05-05,Selangor,11,2,9,2008
2008-05-06,Selangor,50,29,21,2008
2008-05-07,Selangor,17,0,17,2008
2008-05-08,Selangor,71,38,33,2008
2008-05-09,Selangor,16,6,10,2008
2008-05-10,Selangor,3,2,1,2008
2008-05-11,Selangor,74,31,43,2008
2008-05-12,Selangor,9,1,8,2008
2008-05-13,Selangor,56,30,26,2008
2008-05-14,Selangor,51,19,32,2008
2008-05-15,Selangor,48,18,30,2008
2008-05-16,Selangor,6,0,6,2008
2008-05-17,Selangor,112,97,15,2008
2008-05-18,Selangor,0,0,0,2008
2008-05-19,Selangor,245,126,119,2008
2008-05-20,Selangor,19,4,15,2008
2008-05-21,Selangor,12,1,11,2008
2008-05-22,Selangor,68,48,20,2008
2008-05-23,Selangor,46,26,20,2008
2008-05-24,Selangor,39,37,2,2008
2008-05-25,Selangor,150,56,94,2008
2008-05-26,Selangor,32,11,21,2008
2008-05-27,Selangor,13,3,10,2008
2008-05-28,Selangor,81,49,32,2008
2008-05-29,Selangor,125,84,41,2008
2008-05-30,Selangor,39,30,9,2008
2008-05-31,Selangor,0,0,0,2008
2008-06-01,Selangor,65,28,37,2008
2008-06-02,Selangor,9,1,8,2008
2008-06-03,Selangor,28,13,15,2008
2008-06-04,Selangor,89,33,56,2008
2008-06-05,Selangor,59,22,37,2008
2008-06-06,Selangor,35,16,19,2008
2008-06-07,Selangor,17,17,0,2008
2008-06-08,Selangor,18,17,1,2008
2008-06-09,Selangor,15,3,12,2008
2008-06-10,Selangor,83,47,36,2008
2008-06-11,Selangor,81,46,35,2008
2008-06-12,Selangor,24,11,13,2008
2008-06-13,Selangor,24,9,15,2008
2008-06-14,Selangor,3,2,1,2008
2008-06-15,Selangor,118,56,62,2008
2008-06-16,Selangor,18,2,16,2008
2008-06-17,Selangor,34,12,22,2008
2008-06-18,Selangor,63,56,7,2008
2008-06-19,Selangor,82,72,10,2008
2008-06-20,Selangor,11,0,11,2008
2008-06-21,Selangor,66,43,23,2008
2008-06-22,Selangor,90,42,48,2008
2008-06-23,Selangor,29,14,15,2008
2008-06-24,Selangor,23,17,6,2008
2008-06-25,Selangor,16,10,6,2008
2008-06-26,Selangor,48,8,40,2008
2008-06-27,Selangor,17,6,11,2008
2008-06-28,Selangor,24,17,7,2008
2008-06-29,Selangor,0,0,0,2008
2008-06-30,Selangor,72,33,39,2008
2008-07-01,Selangor,41,21,20,2008
2008-07-02,Selangor,69,51,18,2008
2008-07-03,Selangor,13,1,12,2008
2008-07-04,Selangor,29,12,17,2008
2008-07-05,Selangor,29,15,14,2008
2008-07-06,Selangor,177,126,51,2008
2008-07-07,Selangor,33,30,3,2008
2008-07-08,Selangor,61,36,25,2008
2008-07-09,Selangor,87,63,24,2008
2008-07-10,Selangor,9,2,7,2008
2008-07-11,Selangor,39,23,16,2008
2008-07-12,Selangor,21,15,6,2008
2008-07-13,Selangor,173,61,112,2008
2008-07-14,Selangor,37,13,24,2008
2008-07-15,Selangor,46,29,17,2008
2008-07-16,Selangor,31,12,19,2008
2008-07-17,Selangor,34,19,15,2008
2008-07-18,Selangor,33,17,16,2008
2008-07-19,Selangor,1,1,0,2008
2008-07-20,Selangor,91,52,39,2008
2008-07-21,Selangor,41,23,18,2008
2008-07-22,Selangor,27,14,13,2008
2008-07-23,Selangor,46,18,28,2008
2008-07-24,Selangor,28,16,12,2008
2008-07-25,Selangor,10,1,9,2008
2008-07-26,Selangor,66,50,16,2008
2008-07-27,Selangor,126,84,42,2008
2008-07-28,Selangor,35,24,11,2008
2008-07-29,Selangor,6,1,5,2008
2008-07-30,Selangor,214,139,75,2008
2008-07-31,Selangor,92,70,22,2008
2008-08-01,Selangor,16,3,13,2008
2008-08-02,Selangor,10,7,3,2008
2008-08-03,Selangor,82,39,43,2008
2008-08-04,Selangor,31,14,17,2008
2008-08-05,Selangor,3,0,3,2008
2008-08-06,Selangor,46,13,33,2008
2008-08-07,Selangor,25,18,7,2008
2008-08-08,Selangor,27,4,23,2008
2008-08-09,Selangor,42,28,14,2008
2008-08-10,Selangor,389,165,224,2008
2008-08-11,Selangor,36,13,23,2008
2008-08-12,Selangor,35,11,24,2008
2008-08-13,Selangor,49,27,22,2008
2008-08-14,Selangor,10,2,8,2008
2008-08-15,Selangor,11,2,9,2008
2008-08-16,Selangor,68,53,15,2008
2008-08-17,Selangor,107,73,34,2008
2008-08-18,Selangor,25,11,14,2008
2008-08-19,Selangor,2,1,1,2008
2008-08-20,Selangor,123,53,70,2008
2008-08-21,Selangor,85,50,35,2008
2008-08-22,Selangor,15,2,13,2008
2008-08-23,Selangor,26,16,10,2008
2008-08-24,Selangor,36,18,18,2008
2008-08-25,Selangor,154,129,25,2008
2008-08-26,Selangor,69,40,29,2008
2008-08-27,Selangor,177,80,97,2008
2008-08-28,Selangor,79,53,26,2008
2008-08-29,Selangor,83,46,37,2008
2008-08-30,Selangor,150,82,68,2008
2008-08-31,Selangor,223,143,80,2008
2008-09-01,Selangor,1,1,0,2008
2008-09-02,Selangor,7,2,5,2008
2008-09-03,Selangor,16,11,5,2008
2008-09-04,Selangor,8,1,7,2008
2008-09-05,Selangor,15,8,7,2008
2008-09-06,Selangor,1,0,1,2008
2008-09-07,Selangor,29,12,17,2008
2008-09-08,Selangor,22,7,15,2008
2008-09-09,Selangor,17,4,13,2008
2008-09-10,Selangor,24,7,17,2008
2008-09-11,Selangor,19,8,11,2008
2008-09-12,Selangor,22,10,12,2008
2008-09-13,Selangor,53,38,15,2008
2008-09-14,Selangor,177,75,102,2008
2008-09-15,Selangor,98,46,52,2008
2008-09-16,Selangor,2,0,2,2008
2008-09-17,Selangor,0,0,0,2008
2008-09-18,Selangor,79,29,50,2008
2008-09-19,Selangor,51,33,18,2008
2008-09-20,Selangor,65,29,36,2008
2008-09-21,Selangor,227,91,136,2008
2008-09-22,Selangor,42,8,34,2008
2008-09-23,Selangor,15,7,8,2008
2008-09-24,Selangor,10,1,9,2008
2008-09-25,Selangor,14,4,10,2008
2008-09-26,Selangor,14,5,9,2008
2008-09-27,Selangor,21,7,14,2008
2008-09-28,Selangor,35,7,28,2008
2008-09-29,Selangor,14,2,12,2008
2008-09-30,Selangor,12,2,10,2008
2008-10-01,Selangor,0,0,0,2008
2008-10-02,Selangor,0,0,0,2008
2008-10-03,Selangor,15,3,12,2008
2008-10-04,Selangor,15,9,6,2008
2008-10-05,Selangor,17,14,3,2008
2008-10-06,Selangor,10,2,8,2008
2008-10-07,Selangor,13,2,11,2008
2008-10-08,Selangor,155,80,75,2008
2008-10-09,Selangor,42,33,9,2008
2008-10-10,Selangor,18,1,17,2008
2008-10-11,Selangor,14,8,6,2008
2008-10-12,Selangor,85,39,46,2008
2008-10-13,Selangor,31,4,27,2008
2008-10-14,Selangor,43,16,27,2008
2008-10-15,Selangor,13,3,10,2008
2008-10-16,Selangor,33,13,20,2008
2008-10-17,Selangor,41,20,21,2008
2008-10-18,Selangor,19,16,3,2008
2008-10-19,Selangor,78,35,43,2008
2008-10-20,Selangor,38,22,16,2008
2008-10-21,Selangor,32,17,15,2008
2008-10-22,Selangor,42,17,25,2008
2008-10-23,Selangor,65,43,22,2008
2008-10-24,Selangor,66,49,17,2008
2008-10-25,Selangor,32,24,8,2008
2008-10-26,Selangor,43,17,26,2008
2008-10-27,Selangor,11,5,6,2008
2008-10-28,Selangor,32,10,22,2008
2008-10-29,Selangor,51,23,28,2008
2008-10-30,Selangor,10,2,8,2008
2008-10-31,Selangor,13,1,12,2008
2008-11-01,Selangor,27,14,13,2008
2008-11-02,Selangor,54,45,9,2008
2008-11-03,Selangor,30,12,18,2008
2008-11-04,Selangor,33,9,24,2008
2008-11-05,Selangor,79,45,34,2008
2008-11-06,Selangor,87,38,49,2008
2008-11-07,Selangor,16,7,9,2008
2008-11-08,Selangor,66,40,26,2008
2008-11-09,Selangor,69,44,25,2008
2008-11-10,Selangor,41,17,24,2008
2008-11-11,Selangor,42,19,23,2008
2008-11-12,Selangor,67,55,12,2008
2008-11-13,Selangor,53,28,25,2008
2008-11-14,Selangor,26,13,13,2008
2008-11-15,Selangor,36,16,20,2008
2008-11-16,Selangor,16,7,9,2008
2008-11-17,Selangor,16,3,13,2008
2008-11-18,Selangor,46,18,28,2008
2008-11-19,Selangor,36,24,12,2008
2008-11-20,Selangor,51,27,24,2008
2008-11-21,Selangor,47,26,21,2008
2008-11-22,Selangor,52,26,26,2008
2008-11-23,Selangor,159,92,67,2008
2008-11-24,Selangor,32,13,19,2008
2008-11-25,Selangor,58,34,24,2008
2008-11-26,Selangor,140,105,35,2008
2008-11-27,Selangor,31,22,9,2008
2008-11-28,Selangor,53,39,14,2008
2008-11-29,Selangor,63,35,28,2008
2008-11-30,Selangor,38,24,14,2008
2008-12-01,Selangor,39,20,19,2008
2008-12-02,Selangor,61,21,40,2008
2008-12-03,Selangor,74,26,48,2008
2008-12-04,Selangor,25,15,10,2008
2008-12-05,Selangor,73,43,30,2008
2008-12-06,Selangor,59,40,19,2008
2008-12-07,Selangor,102,41,61,2008
2008-12-08,Selangor,0,0,0,2008
2008-12-09,Selangor,8,1,7,2008
2008-12-10,Selangor,30,16,14,2008
2008-12-11,Selangor,5,0,5,2008
2008-12-12,Selangor,24,9,15,2008
2008-12-13,Selangor,139,86,53,2008
2008-12-14,Selangor,139,80,59,2008
2008-12-15,Selangor,16,3,13,2008
2008-12-16,Selangor,50,27,23,2008
2008-12-17,Selangor,76,55,21,2008
2008-12-18,Selangor,45,13,32,2008
2008-12-19,Selangor,43,25,18,2008
2008-12-20,Selangor,96,58,38,2008
2008-12-21,Selangor,16,8,8,2008
2008-12-22,Selangor,41,16,25,2008
2008-12-23,Selangor,40,15,25,2008
2008-12-24,Selangor,59,9,50,2008
2008-12-25,Selangor,33,19,14,2008
2008-12-26,Selangor,32,13,19,2008
2008-12-27,Selangor,0,0,0,2008
2008-12-28,Selangor,42,31,11,2008
2008-12-29,Selangor,32,24,8,2008
2008-12-30,Selangor,57,24,33,2008
2008-12-31,Selangor,86,45,41,2008
2009-01-01,Selangor,41,28,13,2009
2009-01-02,Selangor,71,29,42,2009
2009-01-03,Selangor,40,34,6,2009
2009-01-04,Selangor,57,43,14,2009
2009-01-05,Selangor,45,17,28,2009
2009-01-06,Selangor,33,14,19,2009
2009-01-07,Selangor,60,25,35,2009
2009-01-08,Selangor,60,31,29,2009
2009-01-09,Selangor,45,36,9,2009
2009-01-10,Selangor,52,33,19,2009
2009-01-11,Selangor,141,43,98,2009
2009-01-12,Selangor,36,18,18,2009
2009-01-13,Selangor,51,22,29,2009
2009-01-14,Selangor,23,8,15,2009
2009-01-15,Selangor,51,27,24,2009
2009-01-16,Selangor,29,20,9,2009
2009-01-17,Selangor,22,12,10,2009
2009-01-18,Selangor,29,18,11,2009
2009-01-19,Selangor,37,25,12,2009
2009-01-20,Selangor,87,40,47,2009
2009-01-21,Selangor,46,23,23,2009
2009-01-22,Selangor,86,44,42,2009
2009-01-23,Selangor,41,15,26,2009
2009-01-24,Selangor,29,15,14,2009
2009-01-25,Selangor,79,44,35,2009
2009-01-26,Selangor,57,28,29,2009
2009-01-27,Selangor,57,34,23,2009
2009-01-28,Selangor,47,22,25,2009
2009-01-29,Selangor,58,28,30,2009
2009-01-30,Selangor,32,18,14,2009
2009-01-31,Selangor,67,44,23,2009
2009-02-01,Selangor,49,32,17,2009
2009-02-02,Selangor,65,34,31,2009
2009-02-03,Selangor,71,44,27,2009
2009-02-04,Selangor,169,91,78,2009
2009-02-05,Selangor,79,27,52,2009
2009-02-06,Selangor,63,24,39,2009
2009-02-07,Selangor,8,2,6,2009
2009-02-08,Selangor,59,41,18,2009
2009-02-09,Selangor,24,17,7,2009
2009-02-10,Selangor,36,16,20,2009
2009-02-11,Selangor,152,53,99,2009
2009-02-12,Selangor,91,36,55,2009
2009-02-13,Selangor,49,19,30,2009
2009-02-14,Selangor,71,52,19,2009
2009-02-15,Selangor,82,59,23,2009
2009-02-16,Selangor,133,91,42,2009
2009-02-17,Selangor,43,19,24,2009
2009-02-18,Selangor,43,21,22,2009
2009-02-19,Selangor,110,50,60,2009
2009-02-20,Selangor,116,54,62,2009
2009-02-21,Selangor,107,98,9,2009
2009-02-22,Selangor,119,66,53,2009
2009-02-23,Selangor,10,0,10,2009
2009-02-24,Selangor,94,38,56,2009
2009-02-25,Selangor,123,28,95,2009
2009-02-26,Selangor,45,22,23,2009
2009-02-27,Selangor,38,15,23,2009
2009-02-28,Selangor,24,17,7,2009
2009-03-01,Selangor,17,11,6,2009
2009-03-02,Selangor,12,0,12,2009
2009-03-03,Selangor,19,9,10,2009
2009-03-04,Selangor,34,21,13,2009
2009-03-05,Selangor,23,6,17,2009
2009-03-06,Selangor,31,13,18,2009
2009-03-07,Selangor,59,34,25,2009
2009-03-08,Selangor,273,100,173,2009
2009-03-09,Selangor,34,20,14,2009
2009-03-10,Selangor,48,24,24,2009
2009-03-11,Selangor,45,18,27,2009
2009-03-12,Selangor,42,16,26,2009
2009-03-13,Selangor,98,80,18,2009
2009-03-14,Selangor,51,39,12,2009
2009-03-15,Selangor,168,95,73,2009
2009-03-16,Selangor,46,19,27,2009
2009-03-17,Selangor,29,10,19,2009
2009-03-18,Selangor,45,12,33,2009
2009-03-19,Selangor,49,41,8,2009
2009-03-20,Selangor,25,10,15,2009
2009-03-21,Selangor,34,23,11,2009
2009-03-22,Selangor,156,59,97,2009
2009-03-23,Selangor,96,65,31,2009
2009-03-24,Selangor,38,12,26,2009
2009-03-25,Selangor,38,19,19,2009
2009-03-26,Selangor,191,59,132,2009
2009-03-27,Selangor,7,0,7,2009
2009-03-28,Selangor,64,34,30,2009
2009-03-29,Selangor,70,47,23,2009
2009-03-30,Selangor,24,8,16,2009
2009-03-31,Selangor,52,25,27,2009
2009-04-01,Selangor,163,91,72,2009
2009-04-02,Selangor,181,111,70,2009
2009-04-03,Selangor,40,15,25,2009
2009-04-04,Selangor,0,0,0,2009
2009-04-05,Selangor,65,48,17,2009
2009-04-06,Selangor,14,6,8,2009
2009-04-07,Selangor,24,7,17,2009
2009-04-08,Selangor,33,11,22,2009
2009-04-09,Selangor,120,74,46,2009
2009-04-10,Selangor,16,4,12,2009
2009-04-11,Selangor,114,66,48,2009
2009-04-12,Selangor,100,41,59,2009
2009-04-13,Selangor,42,19,23,2009
2009-04-14,Selangor,41,18,23,2009
2009-04-15,Selangor,59,6,53,2009
2009-04-16,Selangor,19,2,17,2009
2009-04-17,Selangor,89,50,39,2009
2009-04-18,Selangor,59,41,18,2009
2009-04-19,Selangor,60,46,14,2009
2009-04-20,Selangor,35,17,18,2009
2009-04-21,Selangor,31,14,17,2009
2009-04-22,Selangor,98,81,17,2009
2009-04-23,Selangor,16,5,11,2009
2009-04-24,Selangor,15,3,12,2009
2009-04-25,Selangor,117,79,38,2009
2009-04-26,Selangor,26,20,6,2009
2009-04-27,Selangor,25,13,12,2009
2009-04-28,Selangor,72,61,11,2009
2009-04-29,Selangor,23,8,15,2009
2009-04-30,Selangor,14,4,10,2009
2009-05-01,Selangor,112,66,46,2009
2009-05-02,Selangor,19,15,4,2009
2009-05-03,Selangor,11,8,3,2009
2009-05-04,Selangor,64,21,43,2009
2009-05-05,Selangor,39,15,24,2009
2009-05-06,Selangor,56,27,29,2009
2009-05-07,Selangor,58,30,28,2009
2009-05-08,Selangor,41,32,9,2009
2009-05-09,Selangor,230,132,98,2009
2009-05-10,Selangor,80,47,33,2009
2009-05-11,Selangor,38,14,24,2009
2009-05-12,Selangor,40,20,20,2009
2009-05-13,Selangor,23,3,20,2009
2009-05-14,Selangor,75,34,41,2009
2009-05-15,Selangor,13,2,11,2009
2009-05-16,Selangor,41,25,16,2009
2009-05-17,Selangor,120,58,62,2009
2009-05-18,Selangor,7,3,4,2009
2009-05-19,Selangor,11,0,11,2009
2009-05-20,Selangor,103,91,12,2009
2009-05-21,Selangor,46,24,22,2009
2009-05-22,Selangor,9,3,6,2009
2009-05-23,Selangor,17,14,3,2009
2009-05-24,Selangor,27,21,6,2009
2009-05-25,Selangor,24,8,16,2009
2009-05-26,Selangor,20,4,16,2009
2009-05-27,Selangor,73,21,52,2009
2009-05-28,Selangor,24,8,16,2009
2009-05-29,Selangor,72,15,57,2009
2009-05-30,Selangor,24,9,15,2009
2009-05-31,Selangor,191,57,134,2009
2009-06-01,Selangor,33,9,24,2009
2009-06-02,Selangor,11,4,7,2009
2009-06-03,Selangor,44,13,31,2009
2009-06-04,Selangor,60,25,35,2009
2009-06-05,Selangor,15,6,9,2009
2009-06-06,Selangor,12,9,3,2009
2009-06-07,Selangor,82,25,57,2009
2009-06-08,Selangor,79,43,36,2009
2009-06-09,Selangor,88,38,50,2009
2009-06-10,Selangor,52,11,41,2009
2009-06-11,Selangor,37,9,28,2009
2009-06-12,Selangor,15,1,14,2009
2009-06-13,Selangor,68,54,14,2009
2009-06-14,Selangor,51,36,15,2009
2009-06-15,Selangor,29,13,16,2009
2009-06-16,Selangor,36,15,21,2009
2009-06-17,Selangor,39,21,18,2009
2009-06-18,Selangor,44,31,13,2009
2009-06-19,Selangor,50,33,17,2009
2009-06-20,Selangor,68,47,21,2009
2009-06-21,Selangor,85,43,42,2009
2009-06-22,Selangor,73,52,21,2009
2009-06-23,Selangor,51,19,32,2009
2009-06-24,Selangor,42,16,26,2009
2009-06-25,Selangor,30,19,11,2009
2009-06-26,Selangor,32,14,18,2009
2009-06-27,Selangor,46,37,9,2009
2009-06-28,Selangor,80,27,53,2009
2009-06-29,Selangor,45,19,26,2009
2009-06-30,Selangor,58,24,34,2009
2009-07-01,Selangor,17,3,14,2009
2009-07-02,Selangor,17,5,12,2009
2009-07-03,Selangor,26,4,22,2009
2009-07-04,Selangor,15,8,7,2009
2009-07-05,Selangor,117,69,48,2009
2009-07-06,Selangor,55,23,32,2009
2009-07-07,Selangor,69,48,21,2009
2009-07-08,Selangor,156,104,52,2009
2009-07-09,Selangor,92,56,36,2009
2009-07-10,Selangor,85,65,20,2009
2009-07-11,Selangor,43,27,16,2009
2009-07-12,Selangor,20,10,10,2009
2009-07-13,Selangor,112,77,35,2009
2009-07-14,Selangor,37,18,19,2009
2009-07-15,Selangor,67,27,40,2009
2009-07-16,Selangor,48,24,24,2009
2009-07-17,Selangor,43,21,22,2009
2009-07-18,Selangor,146,79,67,2009
2009-07-19,Selangor,19,9,10,2009
2009-07-20,Selangor,54,14,40,2009
2009-07-21,Selangor,35,16,19,2009
2009-07-22,Selangor,9,3,6,2009
2009-07-23,Selangor,56,30,26,2009
2009-07-24,Selangor,12,1,11,2009
2009-07-25,Selangor,18,9,9,2009
2009-07-26,Selangor,223,72,151,2009
2009-07-27,Selangor,39,14,25,2009
2009-07-28,Selangor,183,89,94,2009
2009-07-29,Selangor,11,2,9,2009
2009-07-30,Selangor,36,22,14,2009
2009-07-31,Selangor,15,8,7,2009
2009-08-01,Selangor,105,67,38,2009
2009-08-02,Selangor,50,29,21,2009
2009-08-03,Selangor,76,43,33,2009
2009-08-04,Selangor,59,32,27,2009
2009-08-05,Selangor,66,30,36,2009
2009-08-06,Selangor,45,12,33,2009
2009-08-07,Selangor,43,16,27,2009
2009-08-08,Selangor,36,17,19,2009
2009-08-09,Selangor,162,67,95,2009
2009-08-10,Selangor,43,26,17,2009
2009-08-11,Selangor,65,25,40,2009
2009-08-12,Selangor,62,8,54,2009
2009-08-13,Selangor,74,30,44,2009
2009-08-14,Selangor,45,18,27,2009
2009-08-15,Selangor,148,87,61,2009
2009-08-16,Selangor,234,110,124,2009
2009-08-17,Selangor,26,8,18,2009
2009-08-18,Selangor,45,16,29,2009
2009-08-19,Selangor,30,10,20,2009
2009-08-20,Selangor,122,39,83,2009
2009-08-21,Selangor,8,0,8,2009
2009-08-22,Selangor,4,1,3,2009
2009-08-23,Selangor,62,17,45,2009
2009-08-24,Selangor,23,7,16,2009
2009-08-25,Selangor,10,1,9,2009
2009-08-26,Selangor,6,1,5,2009
2009-08-27,Selangor,21,6,15,2009
2009-08-28,Selangor,17,7,10,2009
2009-08-29,Selangor,13,8,5,2009
2009-08-30,Selangor,362,83,279,2009
2009-08-31,Selangor,55,28,27,2009
2009-09-01,Selangor,14,3,11,2009
2009-09-02,Selangor,20,6,14,2009
2009-09-03,Selangor,11,6,5,2009
2009-09-04,Selangor,18,5,13,2009
2009-09-05,Selangor,17,7,10,2009
2009-09-06,Selangor,32,12,20,2009
2009-09-07,Selangor,18,9,9,2009
2009-09-08,Selangor,59,39,20,2009
2009-09-09,Selangor,73,50,23,2009
2009-09-10,Selangor,88,25,63,2009
2009-09-11,Selangor,23,8,15,2009
2009-09-12,Selangor,71,45,26,2009
2009-09-13,Selangor,225,56,169,2009
2009-09-14,Selangor,22,5,17,2009
2009-09-15,Selangor,22,8,14,2009
2009-09-16,Selangor,39,12,27,2009
2009-09-17,Selangor,59,23,36,2009
2009-09-18,Selangor,28,9,19,2009
2009-09-19,Selangor,16,9,7,2009
2009-09-20,Selangor,1,0,1,2009
2009-09-21,Selangor,2,0,2,2009
2009-09-22,Selangor,1,0,1,2009
2009-09-23,Selangor,32,11,21,2009
2009-09-24,Selangor,31,14,17,2009
2009-09-25,Selangor,33,14,19,2009
2009-09-26,Selangor,17,10,7,2009
2009-09-27,Selangor,135,69,66,2009
2009-09-28,Selangor,51,17,34,2009
2009-09-29,Selangor,158,69,89,2009
2009-09-30,Selangor,141,67,74,2009
2009-10-01,Selangor,16,0,16,2009
2009-10-02,Selangor,45,20,25,2009
2009-10-03,Selangor,0,0,0,2009
2009-10-04,Selangor,200,87,113,2009
2009-10-05,Selangor,34,11,23,2009
2009-10-06,Selangor,44,17,27,2009
2009-10-07,Selangor,48,33,15,2009
2009-10-08,Selangor,39,13,26,2009
2009-10-09,Selangor,72,44,28,2009
2009-10-10,Selangor,5,1,4,2009
2009-10-11,Selangor,159,70,89,2009
2009-10-12,Selangor,39,17,22,2009
2009-10-13,Selangor,61,31,30,2009
2009-10-14,Selangor,45,27,18,2009
2009-10-15,Selangor,34,20,14,2009
2009-10-16,Selangor,89,30,59,2009
2009-10-17,Selangor,24,13,11,2009
2009-10-18,Selangor,477,349,128,2009
2009-10-19,Selangor,22,8,14,2009
2009-10-20,Selangor,33,21,12,2009
2009-10-21,Selangor,18,9,9,2009
2009-10-22,Selangor,27,9,18,2009
2009-10-23,Selangor,35,15,20,2009
2009-10-24,Selangor,28,15,13,2009
2009-10-25,Selangor,59,37,22,2009
2009-10-26,Selangor,41,20,21,2009
2009-10-27,Selangor,238,124,114,2009
2009-10-28,Selangor,45,23,22,2009
2009-10-29,Selangor,32,15,17,2009
2009-10-30,Selangor,41,21,20,2009
2009-10-31,Selangor,77,48,29,2009
2009-11-01,Selangor,95,42,53,2009
2009-11-02,Selangor,9,2,7,2009
2009-11-03,Selangor,88,47,41,2009
2009-11-04,Selangor,68,29,39,2009
2009-11-05,Selangor,59,29,30,2009
2009-11-06,Selangor,29,10,19,2009
2009-11-07,Selangor,22,8,14,2009
2009-11-08,Selangor,30,26,4,2009
2009-11-09,Selangor,47,25,22,2009
2009-11-10,Selangor,45,17,28,2009
2009-11-11,Selangor,38,12,26,2009
2009-11-12,Selangor,41,12,29,2009
2009-11-13,Selangor,90,51,39,2009
2009-11-14,Selangor,28,16,12,2009
2009-11-15,Selangor,208,95,113,2009
2009-11-16,Selangor,71,29,42,2009
2009-11-17,Selangor,48,12,36,2009
2009-11-18,Selangor,73,26,47,2009
2009-11-19,Selangor,33,15,18,2009
2009-11-20,Selangor,91,44,47,2009
2009-11-21,Selangor,59,27,32,2009
2009-11-22,Selangor,114,48,66,2009
2009-11-23,Selangor,46,26,20,2009
2009-11-24,Selangor,42,14,28,2009
2009-11-25,Selangor,37,10,27,2009
2009-11-26,Selangor,73,46,27,2009
2009-11-27,Selangor,1,1,0,2009
2009-11-28,Selangor,49,27,22,2009
2009-11-29,Selangor,53,42,11,2009
2009-11-30,Selangor,53,16,37,2009
2009-12-01,Selangor,25,18,7,2009
2009-12-02,Selangor,69,31,38,2009
2009-12-03,Selangor,51,27,24,2009
2009-12-04,Selangor,48,16,32,2009
2009-12-05,Selangor,71,41,30,2009
2009-12-06,Selangor,58,39,19,2009
2009-12-07,Selangor,29,13,16,2009
2009-12-08,Selangor,57,38,19,2009
2009-12-09,Selangor,30,9,21,2009
2009-12-10,Selangor,40,15,25,2009
2009-12-11,Selangor,58,35,23,2009
2009-12-12,Selangor,47,25,22,2009
2009-12-13,Selangor,177,82,95,2009
2009-12-14,Selangor,49,19,30,2009
2009-12-15,Selangor,63,43,20,2009
2009-12-16,Selangor,62,11,51,2009
2009-12-17,Selangor,118,75,43,2009
2009-12-18,Selangor,70,37,33,2009
2009-12-19,Selangor,77,50,27,2009
2009-12-20,Selangor,151,73,78,2009
2009-12-21,Selangor,38,14,24,2009
2009-12-22,Selangor,62,50,12,2009
2009-12-23,Selangor,77,38,39,2009
2009-12-24,Selangor,72,51,21,2009
2009-12-25,Selangor,29,18,11,2009
2009-12-26,Selangor,30,18,12,2009
2009-12-27,Selangor,31,19,12,2009
2009-12-28,Selangor,46,11,35,2009
2009-12-29,Selangor,41,11,30,2009
2009-12-30,Selangor,55,17,38,2009
2009-12-31,Selangor,47,15,32,2009
2010-01-01,Selangor,103,55,48,2010
2010-01-02,Selangor,77,46,31,2010
2010-01-03,Selangor,118,58,60,2010
2010-01-04,Selangor,16,3,13,2010
2010-01-05,Selangor,15,3,12,2010
2010-01-06,Selangor,79,23,56,2010
2010-01-07,Selangor,31,14,17,2010
2010-01-08,Selangor,47,16,31,2010
2010-01-09,Selangor,57,39,18,2010
2010-01-10,Selangor,140,81,59,2010
2010-01-11,Selangor,25,9,16,2010
2010-01-12,Selangor,53,17,36,2010
2010-01-13,Selangor,68,39,29,2010
2010-01-14,Selangor,98,78,20,2010
2010-01-15,Selangor,86,60,26,2010
2010-01-16,Selangor,12,8,4,2010
2010-01-17,Selangor,92,33,59,2010
2010-01-18,Selangor,56,20,36,2010
2010-01-19,Selangor,72,28,44,2010
2010-01-20,Selangor,135,48,87,2010
2010-01-21,Selangor,60,21,39,2010
2010-01-22,Selangor,44,24,20,2010
2010-01-23,Selangor,74,31,43,2010
2010-01-24,Selangor,55,33,22,2010
2010-01-25,Selangor,72,14,58,2010
2010-01-26,Selangor,57,15,42,2010
2010-01-27,Selangor,162,94,68,2010
2010-01-28,Selangor,63,28,35,2010
2010-01-29,Selangor,52,26,26,2010
2010-01-30,Selangor,80,48,32,2010
2010-01-31,Selangor,96,49,47,2010
2010-02-01,Selangor,51,21,30,2010
2010-02-02,Selangor,48,20,28,2010
2010-02-03,Selangor,176,90,86,2010
2010-02-04,Selangor,141,76,65,2010
2010-02-05,Selangor,45,29,16,2010
2010-02-06,Selangor,99,50,49,2010
2010-02-07,Selangor,109,67,42,2010
2010-02-08,Selangor,38,16,22,2010
2010-02-09,Selangor,68,33,35,2010
2010-02-10,Selangor,130,87,43,2010
2010-02-11,Selangor,78,46,32,2010
2010-02-12,Selangor,61,24,37,2010
2010-02-13,Selangor,43,28,15,2010
2010-02-14,Selangor,36,17,19,2010
2010-02-15,Selangor,48,31,17,2010
2010-02-16,Selangor,76,45,31,2010
2010-02-17,Selangor,77,34,43,2010
2010-02-18,Selangor,75,38,37,2010
2010-02-19,Selangor,31,6,25,2010
2010-02-20,Selangor,37,20,17,2010
2010-02-21,Selangor,42,26,16,2010
2010-02-22,Selangor,41,16,25,2010
2010-02-23,Selangor,88,73,15,2010
2010-02-24,Selangor,99,32,67,2010
2010-02-25,Selangor,74,26,48,2010
2010-02-26,Selangor,122,67,55,2010
2010-02-27,Selangor,149,137,12,2010
2010-02-28,Selangor,103,63,40,2010
2010-03-01,Selangor,49,24,25,2010
2010-03-02,Selangor,46,19,27,2010
2010-03-03,Selangor,139,104,35,2010
2010-03-04,Selangor,52,28,24,2010
2010-03-05,Selangor,51,26,25,2010
2010-03-06,Selangor,54,35,19,2010
2010-03-07,Selangor,22,17,5,2010
2010-03-08,Selangor,30,11,19,2010
2010-03-09,Selangor,64,19,45,2010
2010-03-10,Selangor,14,4,10,2010
2010-03-11,Selangor,46,13,33,2010
2010-03-12,Selangor,116,53,63,2010
2010-03-13,Selangor,61,33,28,2010
2010-03-14,Selangor,160,36,124,2010
2010-03-15,Selangor,37,16,21,2010
2010-03-16,Selangor,56,20,36,2010
2010-03-17,Selangor,90,50,40,2010
2010-03-18,Selangor,120,64,56,2010
2010-03-19,Selangor,62,33,29,2010
2010-03-20,Selangor,26,15,11,2010
2010-03-21,Selangor,144,60,84,2010
2010-03-22,Selangor,51,29,22,2010
2010-03-23,Selangor,64,39,25,2010
2010-03-24,Selangor,111,83,28,2010
2010-03-25,Selangor,69,30,39,2010
2010-03-26,Selangor,38,11,27,2010
2010-03-27,Selangor,129,62,67,2010
2010-03-28,Selangor,15,9,6,2010
2010-03-29,Selangor,38,20,18,2010
2010-03-30,Selangor,38,22,16,2010
2010-03-31,Selangor,52,25,27,2010
2010-04-01,Selangor,131,99,32,2010
2010-04-02,Selangor,32,8,24,2010
2010-04-03,Selangor,13,7,6,2010
2010-04-04,Selangor,95,50,45,2010
2010-04-05,Selangor,11,2,9,2010
2010-04-06,Selangor,38,12,26,2010
2010-04-07,Selangor,37,12,25,2010
2010-04-08,Selangor,99,39,60,2010
2010-04-09,Selangor,36,21,15,2010
2010-04-10,Selangor,97,56,41,2010
2010-04-11,Selangor,40,17,23,2010
2010-04-12,Selangor,54,23,31,2010
2010-04-13,Selangor,32,13,19,2010
2010-04-14,Selangor,86,17,69,2010
2010-04-15,Selangor,26,14,12,2010
2010-04-16,Selangor,20,5,15,2010
2010-04-17,Selangor,34,20,14,2010
2010-04-18,Selangor,183,85,98,2010
2010-04-19,Selangor,67,39,28,2010
2010-04-20,Selangor,44,16,28,2010
2010-04-21,Selangor,53,19,34,2010
2010-04-22,Selangor,99,46,53,2010
2010-04-23,Selangor,20,9,11,2010
2010-04-24,Selangor,49,30,19,2010
2010-04-25,Selangor,63,31,32,2010
2010-04-26,Selangor,67,36,31,2010
2010-04-27,Selangor,41,10,31,2010
2010-04-28,Selangor,70,52,18,2010
2010-04-29,Selangor,71,39,32,2010
2010-04-30,Selangor,51,22,29,2010
2010-05-01,Selangor,83,53,30,2010
2010-05-02,Selangor,101,31,70,2010
2010-05-03,Selangor,45,10,35,2010
2010-05-04,Selangor,45,15,30,2010
2010-05-05,Selangor,49,25,24,2010
2010-05-06,Selangor,200,173,27,2010
2010-05-07,Selangor,43,27,16,2010
2010-05-08,Selangor,38,33,5,2010
2010-05-09,Selangor,29,17,12,2010
2010-05-10,Selangor,53,18,35,2010
2010-05-11,Selangor,61,46,15,2010
2010-05-12,Selangor,36,7,29,2010
2010-05-13,Selangor,52,29,23,2010
2010-05-14,Selangor,56,26,30,2010
2010-05-15,Selangor,74,34,40,2010
2010-05-16,Selangor,22,16,6,2010
2010-05-17,Selangor,31,7,24,2010
2010-05-18,Selangor,97,76,21,2010
2010-05-19,Selangor,59,22,37,2010
2010-05-20,Selangor,90,75,15,2010
2010-05-21,Selangor,65,35,30,2010
2010-05-22,Selangor,28,15,13,2010
2010-05-23,Selangor,84,56,28,2010
2010-05-24,Selangor,100,59,41,2010
2010-05-25,Selangor,41,32,9,2010
2010-05-26,Selangor,55,30,25,2010
2010-05-27,Selangor,46,24,22,2010
2010-05-28,Selangor,460,191,269,2010
2010-05-29,Selangor,0,0,0,2010
2010-05-30,Selangor,141,40,101,2010
2010-05-31,Selangor,43,10,33,2010
2010-06-01,Selangor,72,14,58,2010
2010-06-02,Selangor,44,22,22,2010
2010-06-03,Selangor,60,21,39,2010
2010-06-04,Selangor,51,22,29,2010
2010-06-05,Selangor,23,20,3,2010
2010-06-06,Selangor,7,1,6,2010
2010-06-07,Selangor,35,21,14,2010
2010-06-08,Selangor,38,22,16,2010
2010-06-09,Selangor,75,50,25,2010
2010-06-10,Selangor,50,22,28,2010
2010-06-11,Selangor,28,7,21,2010
2010-06-12,Selangor,68,36,32,2010
2010-06-13,Selangor,114,43,71,2010
2010-06-14,Selangor,106,52,54,2010
2010-06-15,Selangor,24,11,13,2010
2010-06-16,Selangor,34,11,23,2010
2010-06-17,Selangor,90,29,61,2010
2010-06-18,Selangor,46,25,21,2010
2010-06-19,Selangor,60,22,38,2010
2010-06-20,Selangor,75,41,34,2010
2010-06-21,Selangor,40,9,31,2010
2010-06-22,Selangor,46,30,16,2010
2010-06-23,Selangor,99,15,84,2010
2010-06-24,Selangor,48,17,31,2010
2010-06-25,Selangor,16,5,11,2010
2010-06-26,Selangor,72,55,17,2010
2010-06-27,Selangor,120,56,64,2010
2010-06-28,Selangor,59,30,29,2010
2010-06-29,Selangor,45,14,31,2010
2010-06-30,Selangor,43,33,10,2010
2010-07-01,Selangor,26,15,11,2010
2010-07-02,Selangor,47,16,31,2010
2010-07-03,Selangor,63,32,31,2010
2010-07-04,Selangor,185,64,121,2010
2010-07-05,Selangor,43,18,25,2010
2010-07-06,Selangor,41,16,25,2010
2010-07-07,Selangor,81,20,61,2010
2010-07-08,Selangor,51,34,17,2010
2010-07-09,Selangor,25,7,18,2010
2010-07-10,Selangor,65,29,36,2010
2010-07-11,Selangor,53,35,18,2010
2010-07-12,Selangor,60,43,17,2010
2010-07-13,Selangor,44,16,28,2010
2010-07-14,Selangor,60,32,28,2010
2010-07-15,Selangor,68,36,32,2010
2010-07-16,Selangor,80,28,52,2010
2010-07-17,Selangor,92,51,41,2010
2010-07-18,Selangor,301,139,162,2010
2010-07-19,Selangor,69,28,41,2010
2010-07-20,Selangor,51,25,26,2010
2010-07-21,Selangor,145,71,74,2010
2010-07-22,Selangor,52,21,31,2010
2010-07-23,Selangor,45,31,14,2010
2010-07-24,Selangor,62,43,19,2010
2010-07-25,Selangor,56,39,17,2010
2010-07-26,Selangor,98,27,71,2010
2010-07-27,Selangor,62,13,49,2010
2010-07-28,Selangor,47,17,30,2010
2010-07-29,Selangor,209,138,71,2010
2010-07-30,Selangor,43,19,24,2010
2010-07-31,Selangor,90,60,30,2010
2010-08-01,Selangor,49,17,32,2010
2010-08-02,Selangor,52,19,33,2010
2010-08-03,Selangor,47,18,29,2010
2010-08-04,Selangor,146,106,40,2010
2010-08-05,Selangor,37,11,26,2010
2010-08-06,Selangor,145,78,67,2010
2010-08-07,Selangor,223,109,114,2010
2010-08-08,Selangor,313,164,149,2010
2010-08-09,Selangor,25,3,22,2010
2010-08-10,Selangor,105,32,73,2010
2010-08-11,Selangor,81,38,43,2010
2010-08-12,Selangor,60,42,18,2010
2010-08-13,Selangor,6,1,5,2010
2010-08-14,Selangor,9,6,3,2010
2010-08-15,Selangor,155,52,103,2010
2010-08-16,Selangor,83,48,35,2010
2010-08-17,Selangor,39,20,19,2010
2010-08-18,Selangor,36,21,15,2010
2010-08-19,Selangor,69,54,15,2010
2010-08-20,Selangor,32,13,19,2010
2010-08-21,Selangor,112,63,49,2010
2010-08-22,Selangor,363,67,296,2010
2010-08-23,Selangor,5,0,5,2010
2010-08-24,Selangor,88,19,69,2010
2010-08-25,Selangor,92,34,58,2010
2010-08-26,Selangor,73,29,44,2010
2010-08-27,Selangor,34,20,14,2010
2010-08-28,Selangor,1,1,0,2010
2010-08-29,Selangor,86,31,55,2010
2010-08-30,Selangor,37,17,20,2010
2010-08-31,Selangor,1,0,1,2010
2010-09-01,Selangor,31,15,16,2010
2010-09-02,Selangor,23,11,12,2010
2010-09-03,Selangor,57,27,30,2010
2010-09-04,Selangor,21,8,13,2010
2010-09-05,Selangor,81,37,44,2010
2010-09-06,Selangor,21,6,15,2010
2010-09-07,Selangor,25,11,14,2010
2010-09-08,Selangor,35,7,28,2010
2010-09-09,Selangor,25,6,19,2010
2010-09-10,Selangor,0,0,0,2010
2010-09-11,Selangor,0,0,0,2010
2010-09-12,Selangor,67,37,30,2010
2010-09-13,Selangor,26,4,22,2010
2010-09-14,Selangor,31,11,20,2010
2010-09-15,Selangor,40,12,28,2010
2010-09-16,Selangor,23,10,13,2010
2010-09-17,Selangor,34,10,24,2010
2010-09-18,Selangor,1,1,0,2010
2010-09-19,Selangor,182,63,119,2010
2010-09-20,Selangor,54,21,33,2010
2010-09-21,Selangor,47,20,27,2010
2010-09-22,Selangor,94,50,44,2010
2010-09-23,Selangor,67,41,26,2010
2010-09-24,Selangor,19,7,12,2010
2010-09-25,Selangor,104,58,46,2010
2010-09-26,Selangor,124,37,87,2010
2010-09-27,Selangor,92,42,50,2010
2010-09-28,Selangor,35,7,28,2010
2010-09-29,Selangor,69,54,15,2010
2010-09-30,Selangor,38,19,19,2010
2010-10-01,Selangor,22,8,14,2010
2010-10-02,Selangor,14,8,6,2010
2010-10-03,Selangor,42,18,24,2010
2010-10-04,Selangor,26,10,16,2010
2010-10-05,Selangor,47,13,34,2010
2010-10-06,Selangor,110,70,40,2010
2010-10-07,Selangor,125,48,77,2010
2010-10-08,Selangor,68,44,24,2010
2010-10-09,Selangor,58,34,24,2010
2010-10-10,Selangor,167,54,113,2010
2010-10-11,Selangor,47,12,35,2010
2010-10-12,Selangor,50,33,17,2010
2010-10-13,Selangor,34,23,11,2010
2010-10-14,Selangor,125,45,80,2010
2010-10-15,Selangor,23,6,17,2010
2010-10-16,Selangor,0,0,0,2010
2010-10-17,Selangor,39,16,23,2010
2010-10-18,Selangor,89,54,35,2010
2010-10-19,Selangor,62,26,36,2010
2010-10-20,Selangor,49,14,35,2010
2010-10-21,Selangor,38,5,33,2010
2010-10-22,Selangor,13,1,12,2010
2010-10-23,Selangor,2,2,0,2010
2010-10-24,Selangor,496,331,165,2010
2010-10-25,Selangor,51,23,28,2010
2010-10-26,Selangor,37,24,13,2010
2010-10-27,Selangor,69,38,31,2010
2010-10-28,Selangor,11,2,9,2010
2010-10-29,Selangor,67,29,38,2010
2010-10-30,Selangor,71,23,48,2010
2010-10-31,Selangor,99,41,58,2010
2010-11-01,Selangor,69,54,15,2010
2010-11-02,Selangor,53,25,28,2010
2010-11-03,Selangor,70,50,20,2010
2010-11-04,Selangor,43,21,22,2010
2010-11-05,Selangor,27,10,17,2010
2010-11-06,Selangor,36,14,22,2010
2010-11-07,Selangor,30,15,15,2010
2010-11-08,Selangor,32,9,23,2010
2010-11-09,Selangor,72,11,61,2010
2010-11-10,Selangor,86,32,54,2010
2010-11-11,Selangor,62,24,38,2010
2010-11-12,Selangor,85,56,29,2010
2010-11-13,Selangor,47,24,23,2010
2010-11-14,Selangor,159,67,92,2010
2010-11-15,Selangor,50,19,31,2010
2010-11-16,Selangor,68,31,37,2010
2010-11-17,Selangor,4,2,2,2010
2010-11-18,Selangor,51,14,37,2010
2010-11-19,Selangor,32,11,21,2010
2010-11-20,Selangor,73,38,35,2010
2010-11-21,Selangor,29,18,11,2010
2010-11-22,Selangor,15,4,11,2010
2010-11-23,Selangor,103,53,50,2010
2010-11-24,Selangor,70,23,47,2010
2010-11-25,Selangor,63,24,39,2010
2010-11-26,Selangor,58,37,21,2010
2010-11-27,Selangor,45,16,29,2010
2010-11-28,Selangor,255,136,119,2010
2010-11-29,Selangor,56,32,24,2010
2010-11-30,Selangor,65,25,40,2010
2010-12-01,Selangor,66,23,43,2010
2010-12-02,Selangor,61,27,34,2010
2010-12-03,Selangor,30,9,21,2010
2010-12-04,Selangor,27,22,5,2010
2010-12-05,Selangor,87,21,66,2010
2010-12-06,Selangor,37,17,20,2010
2010-12-07,Selangor,68,40,28,2010
2010-12-08,Selangor,29,15,14,2010
2010-12-09,Selangor,66,33,33,2010
2010-12-10,Selangor,18,7,11,2010
2010-12-11,Selangor,55,28,27,2010
2010-12-12,Selangor,132,47,85,2010
2010-12-13,Selangor,78,46,32,2010
2010-12-14,Selangor,71,42,29,2010
2010-12-15,Selangor,113,45,68,2010
2010-12-16,Selangor,129,54,75,2010
2010-12-17,Selangor,53,38,15,2010
2010-12-18,Selangor,73,35,38,2010
2010-12-19,Selangor,57,32,25,2010
2010-12-20,Selangor,72,24,48,2010
2010-12-21,Selangor,115,84,31,2010
2010-12-22,Selangor,113,59,54,2010
2010-12-23,Selangor,67,12,55,2010
2010-12-24,Selangor,64,21,43,2010
2010-12-25,Selangor,39,22,17,2010
2010-12-26,Selangor,66,36,30,2010
2010-12-27,Selangor,53,24,29,2010
2010-12-28,Selangor,89,37,52,2010
2010-12-29,Selangor,53,6,47,2010
2010-12-30,Selangor,47,14,33,2010
2010-12-31,Selangor,0,0,0,2010
2011-01-01,Selangor,53,35,18,2011
2011-01-02,Selangor,108,61,47,2011
2011-01-03,Selangor,62,28,34,2011
2011-01-04,Selangor,78,33,45,2011
2011-01-05,Selangor,60,25,35,2011
2011-01-06,Selangor,99,58,41,2011
2011-01-07,Selangor,78,59,19,2011
2011-01-08,Selangor,13,4,9,2011
2011-01-09,Selangor,54,24,30,2011
2011-01-10,Selangor,92,63,29,2011
2011-01-11,Selangor,64,39,25,2011
2011-01-12,Selangor,180,91,89,2011
2011-01-13,Selangor,50,12,38,2011
2011-01-14,Selangor,37,23,14,2011
2011-01-15,Selangor,55,29,26,2011
2011-01-16,Selangor,81,35,46,2011
2011-01-17,Selangor,49,16,33,2011
2011-01-18,Selangor,42,11,31,2011
2011-01-19,Selangor,90,17,73,2011
2011-01-20,Selangor,97,38,59,2011
2011-01-21,Selangor,128,82,46,2011
2011-01-22,Selangor,67,28,39,2011
2011-01-23,Selangor,50,25,25,2011
2011-01-24,Selangor,52,21,31,2011
2011-01-25,Selangor,84,43,41,2011
2011-01-26,Selangor,45,11,34,2011
2011-01-27,Selangor,88,25,63,2011
2011-01-28,Selangor,37,8,29,2011
2011-01-29,Selangor,54,25,29,2011
2011-01-30,Selangor,40,18,22,2011
2011-01-31,Selangor,62,17,45,2011
2011-02-01,Selangor,56,24,32,2011
2011-02-02,Selangor,66,21,45,2011
2011-02-03,Selangor,39,21,18,2011
2011-02-04,Selangor,51,27,24,2011
2011-02-05,Selangor,32,12,20,2011
2011-02-06,Selangor,26,14,12,2011
2011-02-07,Selangor,34,7,27,2011
2011-02-08,Selangor,46,13,33,2011
2011-02-09,Selangor,113,73,40,2011
2011-02-10,Selangor,54,24,30,2011
2011-02-11,Selangor,55,28,27,2011
2011-02-12,Selangor,255,234,21,2011
2011-02-13,Selangor,33,18,15,2011
2011-02-14,Selangor,66,20,46,2011
2011-02-15,Selangor,70,37,33,2011
2011-02-16,Selangor,47,6,41,2011
2011-02-17,Selangor,54,18,36,2011
2011-02-18,Selangor,84,53,31,2011
2011-02-19,Selangor,77,39,38,2011
2011-02-20,Selangor,203,103,100,2011
2011-02-21,Selangor,33,7,26,2011
2011-02-22,Selangor,137,59,78,2011
2011-02-23,Selangor,200,90,110,2011
2011-02-24,Selangor,42,9,33,2011
2011-02-25,Selangor,62,30,32,2011
2011-02-26,Selangor,29,19,10,2011
2011-02-27,Selangor,221,79,142,2011
2011-02-28,Selangor,36,12,24,2011
2011-03-01,Selangor,32,7,25,2011
2011-03-02,Selangor,42,15,27,2011
2011-03-03,Selangor,104,84,20,2011
2011-03-04,Selangor,49,12,37,2011
2011-03-05,Selangor,164,140,24,2011
2011-03-06,Selangor,70,55,15,2011
2011-03-07,Selangor,147,119,28,2011
2011-03-08,Selangor,49,19,30,2011
2011-03-09,Selangor,69,30,39,2011
2011-03-10,Selangor,109,38,71,2011
2011-03-11,Selangor,139,52,87,2011
2011-03-12,Selangor,63,33,30,2011
2011-03-13,Selangor,130,49,81,2011
2011-03-14,Selangor,30,10,20,2011
2011-03-15,Selangor,64,25,39,2011
2011-03-16,Selangor,156,81,75,2011
2011-03-17,Selangor,55,35,20,2011
2011-03-18,Selangor,64,41,23,2011
2011-03-19,Selangor,28,15,13,2011
2011-03-20,Selangor,61,34,27,2011
2011-03-21,Selangor,78,33,45,2011
2011-03-22,Selangor,34,12,22,2011
2011-03-23,Selangor,51,22,29,2011
2011-03-24,Selangor,103,68,35,2011
2011-03-25,Selangor,45,21,24,2011
2011-03-26,Selangor,120,51,69,2011
2011-03-27,Selangor,181,68,113,2011
2011-03-28,Selangor,30,6,24,2011
2011-03-29,Selangor,39,22,17,2011
2011-03-30,Selangor,127,80,47,2011
2011-03-31,Selangor,103,52,51,2011
2011-04-01,Selangor,49,19,30,2011
2011-04-02,Selangor,43,29,14,2011
2011-04-03,Selangor,135,71,64,2011
2011-04-04,Selangor,56,34,22,2011
2011-04-05,Selangor,42,16,26,2011
2011-04-06,Selangor,41,4,37,2011
2011-04-07,Selangor,77,54,23,2011
2011-04-08,Selangor,55,19,36,2011
2011-04-09,Selangor,82,39,43,2011
2011-04-10,Selangor,155,47,108,2011
2011-04-11,Selangor,63,30,33,2011
2011-04-12,Selangor,94,49,45,2011
2011-04-13,Selangor,112,54,58,2011
2011-04-14,Selangor,139,58,81,2011
2011-04-15,Selangor,81,45,36,2011
2011-04-16,Selangor,67,32,35,2011
2011-04-17,Selangor,188,68,120,2011
2011-04-18,Selangor,47,24,23,2011
2011-04-19,Selangor,71,24,47,2011
2011-04-20,Selangor,102,38,64,2011
2011-04-21,Selangor,19,3,16,2011
2011-04-22,Selangor,21,8,13,2011
2011-04-23,Selangor,71,29,42,2011
2011-04-24,Selangor,206,77,129,2011
2011-04-25,Selangor,39,22,17,2011
2011-04-26,Selangor,26,6,20,2011
2011-04-27,Selangor,78,14,64,2011
2011-04-28,Selangor,87,40,47,2011
2011-04-29,Selangor,64,24,40,2011
2011-04-30,Selangor,49,32,17,2011
2011-05-01,Selangor,70,29,41,2011
2011-05-02,Selangor,62,24,38,2011
2011-05-03,Selangor,64,23,41,2011
2011-05-04,Selangor,40,14,26,2011
2011-05-05,Selangor,58,25,33,2011
2011-05-06,Selangor,56,23,33,2011
2011-05-07,Selangor,0,0,0,2011
2011-05-08,Selangor,166,74,92,2011
2011-05-09,Selangor,32,12,20,2011
2011-05-10,Selangor,51,19,32,2011
2011-05-11,Selangor,62,32,30,2011
2011-05-12,Selangor,77,26,51,2011
2011-05-13,Selangor,47,32,15,2011
2011-05-14,Selangor,11,10,1,2011
2011-05-15,Selangor,37,28,9,2011
2011-05-16,Selangor,64,29,35,2011
2011-05-17,Selangor,504,178,326,2011
2011-05-18,Selangor,202,71,131,2011
2011-05-19,Selangor,51,20,31,2011
2011-05-20,Selangor,100,26,74,2011
2011-05-21,Selangor,64,38,26,2011
2011-05-22,Selangor,133,50,83,2011
2011-05-23,Selangor,82,44,38,2011
2011-05-24,Selangor,53,15,38,2011
2011-05-25,Selangor,53,34,19,2011
2011-05-26,Selangor,74,44,30,2011
2011-05-27,Selangor,9,0,9,2011
2011-05-28,Selangor,27,11,16,2011
2011-05-29,Selangor,123,67,56,2011
2011-05-30,Selangor,43,17,26,2011
2011-05-31,Selangor,49,10,39,2011
2011-06-01,Selangor,41,22,19,2011
2011-06-02,Selangor,6,0,6,2011
2011-06-03,Selangor,29,11,18,2011
2011-06-04,Selangor,22,10,12,2011
2011-06-05,Selangor,0,0,0,2011
2011-06-06,Selangor,69,21,48,2011
2011-06-07,Selangor,74,28,46,2011
2011-06-08,Selangor,58,18,40,2011
2011-06-09,Selangor,38,15,23,2011
2011-06-10,Selangor,77,38,39,2011
2011-06-11,Selangor,126,56,70,2011
2011-06-12,Selangor,152,67,85,2011
2011-06-13,Selangor,23,3,20,2011
2011-06-14,Selangor,130,70,60,2011
2011-06-15,Selangor,77,38,39,2011
2011-06-16,Selangor,67,50,17,2011
2011-06-17,Selangor,54,9,45,2011
2011-06-18,Selangor,83,41,42,2011
2011-06-19,Selangor,184,78,106,2011
2011-06-20,Selangor,51,15,36,2011
2011-06-21,Selangor,57,28,29,2011
2011-06-22,Selangor,86,32,54,2011
2011-06-23,Selangor,80,40,40,2011
2011-06-24,Selangor,52,25,27,2011
2011-06-25,Selangor,134,114,20,2011
2011-06-26,Selangor,287,109,178,2011
2011-06-27,Selangor,99,57,42,2011
2011-06-28,Selangor,113,28,85,2011
2011-06-29,Selangor,50,15,35,2011
2011-06-30,Selangor,114,41,73,2011
2011-07-01,Selangor,64,17,47,2011
2011-07-02,Selangor,90,39,51,2011
2011-07-03,Selangor,255,88,167,2011
2011-07-04,Selangor,16,1,15,2011
2011-07-05,Selangor,89,29,60,2011
2011-07-06,Selangor,147,86,61,2011
2011-07-07,Selangor,74,23,51,2011
2011-07-08,Selangor,18,6,12,2011
2011-07-09,Selangor,77,59,18,2011
2011-07-10,Selangor,286,74,212,2011
2011-07-11,Selangor,43,27,16,2011
2011-07-12,Selangor,85,61,24,2011
2011-07-13,Selangor,58,33,25,2011
2011-07-14,Selangor,79,36,43,2011
2011-07-15,Selangor,60,50,10,2011
2011-07-16,Selangor,97,48,49,2011
2011-07-17,Selangor,74,32,42,2011
2011-07-18,Selangor,69,20,49,2011
2011-07-19,Selangor,57,29,28,2011
2011-07-20,Selangor,47,32,15,2011
2011-07-21,Selangor,124,77,47,2011
2011-07-22,Selangor,64,24,40,2011
2011-07-23,Selangor,60,25,35,2011
2011-07-24,Selangor,50,39,11,2011
2011-07-25,Selangor,52,23,29,2011
2011-07-26,Selangor,122,35,87,2011
2011-07-27,Selangor,49,28,21,2011
2011-07-28,Selangor,15,0,15,2011
2011-07-29,Selangor,149,68,81,2011
2011-07-30,Selangor,219,109,110,2011
2011-07-31,Selangor,310,140,170,2011
2011-08-01,Selangor,11,3,8,2011
2011-08-02,Selangor,10,2,8,2011
2011-08-03,Selangor,140,100,40,2011
2011-08-04,Selangor,47,27,20,2011
2011-08-05,Selangor,37,13,24,2011
2011-08-06,Selangor,18,5,13,2011
2011-08-07,Selangor,320,69,251,2011
2011-08-08,Selangor,42,13,29,2011
2011-08-09,Selangor,41,19,22,2011
2011-08-10,Selangor,56,11,45,2011
2011-08-11,Selangor,99,84,15,2011
2011-08-12,Selangor,10,2,8,2011
2011-08-13,Selangor,24,6,18,2011
2011-08-14,Selangor,100,42,58,2011
2011-08-15,Selangor,48,33,15,2011
2011-08-16,Selangor,40,11,29,2011
2011-08-17,Selangor,144,138,6,2011
2011-08-18,Selangor,62,35,27,2011
2011-08-19,Selangor,8,1,7,2011
2011-08-20,Selangor,64,37,27,2011
2011-08-21,Selangor,208,80,128,2011
2011-08-22,Selangor,96,39,57,2011
2011-08-23,Selangor,79,37,42,2011
2011-08-24,Selangor,17,7,10,2011
2011-08-25,Selangor,21,6,15,2011
2011-08-26,Selangor,15,6,9,2011
2011-08-27,Selangor,8,3,5,2011
2011-08-28,Selangor,132,33,99,2011
2011-08-29,Selangor,11,2,9,2011
2011-08-30,Selangor,2,0,2,2011
2011-08-31,Selangor,1,0,1,2011
2011-09-01,Selangor,0,0,0,2011
2011-09-02,Selangor,15,1,14,2011
2011-09-03,Selangor,3,0,3,2011
2011-09-04,Selangor,65,20,45,2011
2011-09-05,Selangor,39,11,28,2011
2011-09-06,Selangor,12,2,10,2011
2011-09-07,Selangor,67,22,45,2011
2011-09-08,Selangor,61,25,36,2011
2011-09-09,Selangor,50,16,34,2011
2011-09-10,Selangor,30,12,18,2011
2011-09-11,Selangor,54,4,50,2011
2011-09-12,Selangor,25,4,21,2011
2011-09-13,Selangor,44,19,25,2011
2011-09-14,Selangor,47,7,40,2011
2011-09-15,Selangor,71,40,31,2011
2011-09-16,Selangor,29,11,18,2011
2011-09-17,Selangor,27,12,15,2011
2011-09-18,Selangor,44,29,15,2011
2011-09-19,Selangor,29,8,21,2011
2011-09-20,Selangor,66,31,35,2011
2011-09-21,Selangor,55,23,32,2011
2011-09-22,Selangor,68,43,25,2011
2011-09-23,Selangor,18,1,17,2011
2011-09-24,Selangor,65,28,37,2011
2011-09-25,Selangor,74,37,37,2011
2011-09-26,Selangor,38,5,33,2011
2011-09-27,Selangor,41,18,23,2011
2011-09-28,Selangor,32,13,19,2011
2011-09-29,Selangor,35,5,30,2011
2011-09-30,Selangor,48,27,21,2011
2011-10-01,Selangor,29,15,14,2011
2011-10-02,Selangor,23,7,16,2011
2011-10-03,Selangor,39,12,27,2011
2011-10-04,Selangor,58,32,26,2011
2011-10-05,Selangor,25,9,16,2011
2011-10-06,Selangor,39,16,23,2011
2011-10-07,Selangor,26,9,17,2011
2011-10-08,Selangor,17,7,10,2011
2011-10-09,Selangor,159,41,118,2011
2011-10-10,Selangor,66,30,36,2011
2011-10-11,Selangor,55,21,34,2011
2011-10-12,Selangor,47,24,23,2011
2011-10-13,Selangor,37,18,19,2011
2011-10-14,Selangor,103,31,72,2011
2011-10-15,Selangor,26,13,13,2011
2011-10-16,Selangor,2,1,1,2011
2011-10-17,Selangor,55,17,38,2011
2011-10-18,Selangor,72,12,60,2011
2011-10-19,Selangor,77,34,43,2011
2011-10-20,Selangor,14,1,13,2011
2011-10-21,Selangor,71,28,43,2011
2011-10-22,Selangor,0,0,0,2011
2011-10-23,Selangor,409,220,189,2011
2011-10-24,Selangor,66,23,43,2011
2011-10-25,Selangor,80,36,44,2011
2011-10-26,Selangor,1,1,0,2011
2011-10-27,Selangor,60,20,40,2011
2011-10-28,Selangor,35,19,16,2011
2011-10-29,Selangor,17,15,2,2011
2011-10-30,Selangor,77,42,35,2011
2011-10-31,Selangor,60,42,18,2011
2011-11-01,Selangor,68,20,48,2011
2011-11-02,Selangor,61,33,28,2011
2011-11-03,Selangor,49,18,31,2011
2011-11-04,Selangor,53,37,16,2011
2011-11-05,Selangor,22,12,10,2011
2011-11-06,Selangor,0,0,0,2011
2011-11-07,Selangor,20,12,8,2011
2011-11-08,Selangor,39,26,13,2011
2011-11-09,Selangor,77,11,66,2011
2011-11-10,Selangor,28,13,15,2011
2011-11-11,Selangor,43,27,16,2011
2011-11-12,Selangor,82,66,16,2011
2011-11-13,Selangor,157,92,65,2011
2011-11-14,Selangor,55,11,44,2011
2011-11-15,Selangor,72,25,47,2011
2011-11-16,Selangor,46,22,24,2011
2011-11-17,Selangor,95,37,58,2011
2011-11-18,Selangor,37,14,23,2011
2011-11-19,Selangor,83,51,32,2011
2011-11-20,Selangor,86,36,50,2011
2011-11-21,Selangor,46,7,39,2011
2011-11-22,Selangor,13,5,8,2011
2011-11-23,Selangor,150,77,73,2011
2011-11-24,Selangor,29,12,17,2011
2011-11-25,Selangor,35,12,23,2011
2011-11-26,Selangor,21,16,5,2011
2011-11-27,Selangor,84,43,41,2011
2011-11-28,Selangor,73,25,48,2011
2011-11-29,Selangor,65,31,34,2011
2011-11-30,Selangor,54,29,25,2011
2011-12-01,Selangor,22,11,11,2011
2011-12-02,Selangor,89,49,40,2011
2011-12-03,Selangor,24,13,11,2011
2011-12-04,Selangor,338,154,184,2011
2011-12-05,Selangor,40,15,25,2011
2011-12-06,Selangor,57,17,40,2011
2011-12-07,Selangor,38,15,23,2011
2011-12-08,Selangor,31,13,18,2011
2011-12-09,Selangor,35,12,23,2011
2011-12-10,Selangor,92,57,35,2011
2011-12-11,Selangor,88,31,57,2011
2011-12-12,Selangor,39,18,21,2011
2011-12-13,Selangor,12,2,10,2011
2011-12-14,Selangor,49,9,40,2011
2011-12-15,Selangor,132,43,89,2011
2011-12-16,Selangor,33,17,16,2011
2011-12-17,Selangor,46,26,20,2011
2011-12-18,Selangor,49,31,18,2011
2011-12-19,Selangor,116,59,57,2011
2011-12-20,Selangor,11,1,10,2011
2011-12-21,Selangor,67,38,29,2011
2011-12-22,Selangor,70,24,46,2011
2011-12-23,Selangor,18,4,14,2011
2011-12-24,Selangor,103,47,56,2011
2011-12-25,Selangor,16,8,8,2011
2011-12-26,Selangor,106,62,44,2011
2011-12-27,Selangor,76,15,61,2011
2011-12-28,Selangor,53,10,43,2011
2011-12-29,Selangor,143,64,79,2011
2011-12-30,Selangor,34,7,27,2011
2011-12-31,Selangor,8,3,5,2011
2012-01-01,Selangor,78,29,49,2012
2012-01-02,Selangor,94,41,53,2012
2012-01-03,Selangor,88,50,38,2012
2012-01-04,Selangor,59,25,34,2012
2012-01-05,Selangor,120,61,59,2012
2012-01-06,Selangor,32,8,24,2012
2012-01-07,Selangor,50,30,20,2012
2012-01-08,Selangor,25,9,16,2012
2012-01-09,Selangor,34,9,25,2012
2012-01-10,Selangor,85,46,39,2012
2012-01-11,Selangor,128,49,79,2012
2012-01-12,Selangor,41,13,28,2012
2012-01-13,Selangor,42,14,28,2012
2012-01-14,Selangor,70,52,18,2012
2012-01-15,Selangor,60,43,17,2012
2012-01-16,Selangor,62,20,42,2012
2012-01-17,Selangor,90,48,42,2012
2012-01-18,Selangor,44,18,26,2012
2012-01-19,Selangor,29,5,24,2012
2012-01-20,Selangor,55,38,17,2012
2012-01-21,Selangor,75,29,46,2012
2012-01-22,Selangor,81,37,44,2012
2012-01-23,Selangor,46,19,27,2012
2012-01-24,Selangor,44,20,24,2012
2012-01-25,Selangor,41,17,24,2012
2012-01-26,Selangor,38,16,22,2012
2012-01-27,Selangor,92,37,55,2012
2012-01-28,Selangor,71,38,33,2012
2012-01-29,Selangor,80,42,38,2012
2012-01-30,Selangor,70,42,28,2012
2012-01-31,Selangor,44,21,23,2012
2012-02-01,Selangor,104,49,55,2012
2012-02-02,Selangor,36,19,17,2012
2012-02-03,Selangor,50,22,28,2012
2012-02-04,Selangor,13,7,6,2012
2012-02-05,Selangor,67,36,31,2012
2012-02-06,Selangor,48,27,21,2012
2012-02-07,Selangor,164,77,87,2012
2012-02-08,Selangor,54,33,21,2012
2012-02-09,Selangor,61,11,50,2012
2012-02-10,Selangor,47,16,31,2012
2012-02-11,Selangor,45,17,28,2012
2012-02-12,Selangor,34,18,16,2012
2012-02-13,Selangor,40,14,26,2012
2012-02-14,Selangor,72,21,51,2012
2012-02-15,Selangor,46,8,38,2012
2012-02-16,Selangor,8,2,6,2012
2012-02-17,Selangor,34,10,24,2012
2012-02-18,Selangor,59,30,29,2012
2012-02-19,Selangor,268,97,171,2012
2012-02-20,Selangor,44,10,34,2012
2012-02-21,Selangor,44,9,35,2012
2012-02-22,Selangor,156,58,98,2012
2012-02-23,Selangor,110,41,69,2012
2012-02-24,Selangor,99,40,59,2012
2012-02-25,Selangor,89,42,47,2012
2012-02-26,Selangor,59,25,34,2012
2012-02-27,Selangor,60,20,40,2012
2012-02-28,Selangor,103,52,51,2012
2012-02-29,Selangor,154,91,63,2012
2012-03-01,Selangor,24,7,17,2012
2012-03-02,Selangor,90,43,47,2012
2012-03-03,Selangor,160,124,36,2012
2012-03-04,Selangor,48,30,18,2012
2012-03-05,Selangor,62,28,34,2012
2012-03-06,Selangor,70,22,48,2012
2012-03-07,Selangor,47,10,37,2012
2012-03-08,Selangor,59,22,37,2012
2012-03-09,Selangor,18,7,11,2012
2012-03-10,Selangor,14,5,9,2012
2012-03-11,Selangor,73,23,50,2012
2012-03-12,Selangor,40,20,20,2012
2012-03-13,Selangor,103,62,41,2012
2012-03-14,Selangor,48,9,39,2012
2012-03-15,Selangor,67,32,35,2012
2012-03-16,Selangor,9,1,8,2012
2012-03-17,Selangor,113,83,30,2012
2012-03-18,Selangor,210,45,165,2012
2012-03-19,Selangor,38,12,26,2012
2012-03-20,Selangor,51,25,26,2012
2012-03-21,Selangor,106,46,60,2012
2012-03-22,Selangor,107,33,74,2012
2012-03-23,Selangor,95,44,51,2012
2012-03-24,Selangor,57,35,22,2012
2012-03-25,Selangor,28,11,17,2012
2012-03-26,Selangor,44,21,23,2012
2012-03-27,Selangor,61,33,28,2012
2012-03-28,Selangor,52,17,35,2012
2012-03-29,Selangor,74,48,26,2012
2012-03-30,Selangor,22,10,12,2012
2012-03-31,Selangor,106,51,55,2012
2012-04-01,Selangor,209,80,129,2012
2012-04-02,Selangor,56,22,34,2012
2012-04-03,Selangor,51,4,47,2012
2012-04-04,Selangor,38,16,22,2012
2012-04-05,Selangor,28,5,23,2012
2012-04-06,Selangor,40,11,29,2012
2012-04-07,Selangor,2,1,1,2012
2012-04-08,Selangor,116,30,86,2012
2012-04-09,Selangor,70,33,37,2012
2012-04-10,Selangor,77,21,56,2012
2012-04-11,Selangor,1,0,1,2012
2012-04-12,Selangor,46,15,31,2012
2012-04-13,Selangor,42,19,23,2012
2012-04-14,Selangor,79,39,40,2012
2012-04-15,Selangor,159,49,110,2012
2012-04-16,Selangor,44,19,25,2012
2012-04-17,Selangor,40,12,28,2012
2012-04-18,Selangor,32,9,23,2012
2012-04-19,Selangor,79,32,47,2012
2012-04-20,Selangor,54,21,33,2012
2012-04-21,Selangor,58,33,25,2012
2012-04-22,Selangor,202,54,148,2012
2012-04-23,Selangor,9,1,8,2012
2012-04-24,Selangor,16,3,13,2012
2012-04-25,Selangor,85,52,33,2012
2012-04-26,Selangor,35,13,22,2012
2012-04-27,Selangor,25,11,14,2012
2012-04-28,Selangor,38,17,21,2012
2012-04-29,Selangor,235,99,136,2012
2012-04-30,Selangor,41,13,28,2012
2012-05-01,Selangor,46,24,22,2012
2012-05-02,Selangor,73,26,47,2012
2012-05-03,Selangor,16,7,9,2012
2012-05-04,Selangor,34,16,18,2012
2012-05-05,Selangor,529,158,371,2012
2012-05-06,Selangor,56,37,19,2012
2012-05-07,Selangor,86,38,48,2012
2012-05-08,Selangor,63,20,43,2012
2012-05-09,Selangor,24,8,16,2012
2012-05-10,Selangor,35,14,21,2012
2012-05-11,Selangor,74,27,47,2012
2012-05-12,Selangor,87,35,52,2012
2012-05-13,Selangor,225,67,158,2012
2012-05-14,Selangor,48,23,25,2012
2012-05-15,Selangor,123,54,69,2012
2012-05-16,Selangor,85,28,57,2012
2012-05-17,Selangor,106,51,55,2012
2012-05-18,Selangor,11,3,8,2012
2012-05-19,Selangor,31,20,11,2012
2012-05-20,Selangor,98,40,58,2012
2012-05-21,Selangor,28,6,22,2012
2012-05-22,Selangor,45,8,37,2012
2012-05-23,Selangor,45,13,32,2012
2012-05-24,Selangor,45,15,30,2012
2012-05-25,Selangor,67,30,37,2012
2012-05-26,Selangor,18,6,12,2012
2012-05-27,Selangor,38,17,21,2012
2012-05-28,Selangor,19,3,16,2012
2012-05-29,Selangor,63,21,42,2012
2012-05-30,Selangor,25,10,15,2012
2012-05-31,Selangor,69,39,30,2012
2012-06-01,Selangor,31,14,17,2012
2012-06-02,Selangor,45,16,29,2012
2012-06-03,Selangor,38,15,23,2012
2012-06-04,Selangor,40,15,25,2012
2012-06-05,Selangor,52,13,39,2012
2012-06-06,Selangor,43,14,29,2012
2012-06-07,Selangor,126,36,90,2012
2012-06-08,Selangor,14,3,11,2012
2012-06-09,Selangor,49,36,13,2012
2012-06-10,Selangor,77,44,33,2012
2012-06-11,Selangor,128,65,63,2012
2012-06-12,Selangor,82,20,62,2012
2012-06-13,Selangor,46,14,32,2012
2012-06-14,Selangor,185,86,99,2012
2012-06-15,Selangor,54,8,46,2012
2012-06-16,Selangor,5,2,3,2012
2012-06-17,Selangor,192,50,142,2012
2012-06-18,Selangor,44,25,19,2012
2012-06-19,Selangor,68,18,50,2012
2012-06-20,Selangor,51,25,26,2012
2012-06-21,Selangor,33,11,22,2012
2012-06-22,Selangor,42,13,29,2012
2012-06-23,Selangor,88,64,24,2012
2012-06-24,Selangor,289,101,188,2012
2012-06-25,Selangor,89,24,65,2012
2012-06-26,Selangor,88,15,73,2012
2012-06-27,Selangor,46,29,17,2012
2012-06-28,Selangor,90,18,72,2012
2012-06-29,Selangor,22,11,11,2012
2012-06-30,Selangor,81,34,47,2012
2012-07-01,Selangor,227,73,154,2012
2012-07-02,Selangor,57,14,43,2012
2012-07-03,Selangor,42,15,27,2012
2012-07-04,Selangor,57,10,47,2012
2012-07-05,Selangor,98,18,80,2012
2012-07-06,Selangor,46,21,25,2012
2012-07-07,Selangor,21,13,8,2012
2012-07-08,Selangor,296,67,229,2012
2012-07-09,Selangor,57,15,42,2012
2012-07-10,Selangor,69,41,28,2012
2012-07-11,Selangor,21,3,18,2012
2012-07-12,Selangor,99,45,54,2012
2012-07-13,Selangor,65,30,35,2012
2012-07-14,Selangor,247,111,136,2012
2012-07-15,Selangor,279,114,165,2012
2012-07-16,Selangor,98,43,55,2012
2012-07-17,Selangor,51,23,28,2012
2012-07-18,Selangor,147,102,45,2012
2012-07-19,Selangor,84,54,30,2012
2012-07-20,Selangor,43,17,26,2012
2012-07-21,Selangor,0,0,0,2012
2012-07-22,Selangor,129,62,67,2012
2012-07-23,Selangor,8,0,8,2012
2012-07-24,Selangor,41,10,31,2012
2012-07-25,Selangor,110,90,20,2012
2012-07-26,Selangor,173,155,18,2012
2012-07-27,Selangor,2,1,1,2012
2012-07-28,Selangor,0,0,0,2012
2012-07-29,Selangor,178,46,132,2012
2012-07-30,Selangor,9,4,5,2012
2012-07-31,Selangor,141,68,73,2012
2012-08-01,Selangor,52,14,38,2012
2012-08-02,Selangor,6,0,6,2012
2012-08-03,Selangor,18,4,14,2012
2012-08-04,Selangor,1,1,0,2012
2012-08-05,Selangor,36,9,27,2012
2012-08-06,Selangor,20,10,10,2012
2012-08-07,Selangor,51,29,22,2012
2012-08-08,Selangor,21,3,18,2012
2012-08-09,Selangor,17,5,12,2012
2012-08-10,Selangor,36,14,22,2012
2012-08-11,Selangor,136,68,68,2012
2012-08-12,Selangor,91,20,71,2012
2012-08-13,Selangor,6,3,3,2012
2012-08-14,Selangor,43,20,23,2012
2012-08-15,Selangor,62,24,38,2012
2012-08-16,Selangor,16,3,13,2012
2012-08-17,Selangor,22,1,21,2012
2012-08-18,Selangor,5,0,5,2012
2012-08-19,Selangor,1,0,1,2012
2012-08-20,Selangor,1,0,1,2012
2012-08-21,Selangor,0,0,0,2012
2012-08-22,Selangor,37,9,28,2012
2012-08-23,Selangor,67,33,34,2012
2012-08-24,Selangor,68,29,39,2012
2012-08-25,Selangor,0,0,0,2012
2012-08-26,Selangor,328,49,279,2012
2012-08-27,Selangor,65,21,44,2012
2012-08-28,Selangor,16,1,15,2012
2012-08-29,Selangor,21,1,20,2012
2012-08-30,Selangor,56,13,43,2012
2012-08-31,Selangor,0,0,0,2012
2012-09-01,Selangor,46,18,28,2012
2012-09-02,Selangor,143,46,97,2012
2012-09-03,Selangor,38,6,32,2012
2012-09-04,Selangor,19,3,16,2012
2012-09-05,Selangor,38,22,16,2012
2012-09-06,Selangor,21,2,19,2012
2012-09-07,Selangor,17,2,15,2012
2012-09-08,Selangor,31,15,16,2012
2012-09-09,Selangor,107,33,74,2012
2012-09-10,Selangor,18,2,16,2012
2012-09-11,Selangor,339,211,128,2012
2012-09-12,Selangor,15,2,13,2012
2012-09-13,Selangor,39,16,23,2012
2012-09-14,Selangor,51,30,21,2012
2012-09-15,Selangor,1,0,1,2012
2012-09-16,Selangor,176,75,101,2012
2012-09-17,Selangor,0,0,0,2012
2012-09-18,Selangor,19,4,15,2012
2012-09-19,Selangor,53,9,44,2012
2012-09-20,Selangor,28,11,17,2012
2012-09-21,Selangor,56,16,40,2012
2012-09-22,Selangor,64,27,37,2012
2012-09-23,Selangor,90,32,58,2012
2012-09-24,Selangor,24,7,17,2012
2012-09-25,Selangor,43,17,26,2012
2012-09-26,Selangor,144,115,29,2012
2012-09-27,Selangor,30,15,15,2012
2012-09-28,Selangor,18,4,14,2012
2012-09-29,Selangor,59,20,39,2012
2012-09-30,Selangor,144,76,68,2012
2012-10-01,Selangor,37,15,22,2012
2012-10-02,Selangor,44,8,36,2012
2012-10-03,Selangor,18,2,16,2012
2012-10-04,Selangor,60,18,42,2012
2012-10-05,Selangor,18,8,10,2012
2012-10-06,Selangor,19,10,9,2012
2012-10-07,Selangor,118,63,55,2012
2012-10-08,Selangor,16,3,13,2012
2012-10-09,Selangor,42,14,28,2012
2012-10-10,Selangor,20,3,17,2012
2012-10-11,Selangor,57,13,44,2012
2012-10-12,Selangor,62,41,21,2012
2012-10-13,Selangor,10,6,4,2012
2012-10-14,Selangor,149,32,117,2012
2012-10-15,Selangor,13,1,12,2012
2012-10-16,Selangor,54,22,32,2012
2012-10-17,Selangor,55,12,43,2012
2012-10-18,Selangor,71,38,33,2012
2012-10-19,Selangor,47,31,16,2012
2012-10-20,Selangor,73,38,35,2012
2012-10-21,Selangor,45,15,30,2012
2012-10-22,Selangor,82,19,63,2012
2012-10-23,Selangor,71,36,35,2012
2012-10-24,Selangor,44,20,24,2012
2012-10-25,Selangor,81,34,47,2012
2012-10-26,Selangor,1,0,1,2012
2012-10-27,Selangor,38,13,25,2012
2012-10-28,Selangor,106,47,59,2012
2012-10-29,Selangor,44,17,27,2012
2012-10-30,Selangor,79,24,55,2012
2012-10-31,Selangor,51,7,44,2012
2012-11-01,Selangor,40,7,33,2012
2012-11-02,Selangor,25,7,18,2012
2012-11-03,Selangor,36,23,13,2012
2012-11-04,Selangor,150,86,64,2012
2012-11-05,Selangor,12,2,10,2012
2012-11-06,Selangor,12,1,11,2012
2012-11-07,Selangor,31,15,16,2012
2012-11-08,Selangor,99,53,46,2012
2012-11-09,Selangor,31,20,11,2012
2012-11-10,Selangor,73,34,39,2012
2012-11-11,Selangor,137,33,104,2012
2012-11-12,Selangor,129,37,92,2012
2012-11-13,Selangor,0,0,0,2012
2012-11-14,Selangor,132,33,99,2012
2012-11-15,Selangor,108,43,65,2012
2012-11-16,Selangor,58,12,46,2012
2012-11-17,Selangor,0,0,0,2012
2012-11-18,Selangor,133,35,98,2012
2012-11-19,Selangor,53,23,30,2012
2012-11-20,Selangor,90,24,66,2012
2012-11-21,Selangor,35,8,27,2012
2012-11-22,Selangor,76,24,52,2012
2012-11-23,Selangor,9,4,5,2012
2012-11-24,Selangor,33,29,4,2012
2012-11-25,Selangor,92,39,53,2012
2012-11-26,Selangor,30,18,12,2012
2012-11-27,Selangor,42,14,28,2012
2012-11-28,Selangor,69,35,34,2012
2012-11-29,Selangor,70,30,40,2012
2012-11-30,Selangor,38,11,27,2012
2012-12-01,Selangor,124,49,75,2012
2012-12-02,Selangor,135,62,73,2012
2012-12-03,Selangor,11,2,9,2012
2012-12-04,Selangor,64,17,47,2012
2012-12-05,Selangor,92,29,63,2012
2012-12-06,Selangor,95,42,53,2012
2012-12-07,Selangor,38,19,19,2012
2012-12-08,Selangor,52,16,36,2012
2012-12-09,Selangor,167,60,107,2012
2012-12-10,Selangor,19,5,14,2012
2012-12-11,Selangor,36,14,22,2012
2012-12-12,Selangor,107,33,74,2012
2012-12-13,Selangor,154,40,114,2012
2012-12-14,Selangor,18,3,15,2012
2012-12-15,Selangor,98,57,41,2012
2012-12-16,Selangor,65,35,30,2012
2012-12-17,Selangor,32,11,21,2012
2012-12-18,Selangor,20,3,17,2012
2012-12-19,Selangor,64,19,45,2012
2012-12-20,Selangor,97,33,64,2012
2012-12-21,Selangor,57,41,16,2012
2012-12-22,Selangor,35,16,19,2012
2012-12-23,Selangor,134,33,101,2012
2012-12-24,Selangor,16,5,11,2012
2012-12-25,Selangor,25,19,6,2012
2012-12-26,Selangor,34,11,23,2012
2012-12-27,Selangor,41,6,35,2012
2012-12-28,Selangor,51,14,37,2012
2012-12-29,Selangor,49,25,24,2012
2012-12-30,Selangor,57,19,38,2012
2012-12-31,Selangor,74,31,43,2012
2013-01-01,Selangor,78,24,54,2013
2013-01-02,Selangor,60,36,24,2013
2013-01-03,Selangor,37,12,25,2013
2013-01-04,Selangor,50,15,35,2013
2013-01-05,Selangor,0,0,0,2013
2013-01-06,Selangor,164,59,105,2013
2013-01-07,Selangor,38,22,16,2013
2013-01-08,Selangor,56,16,40,2013
2013-01-09,Selangor,45,18,27,2013
2013-01-10,Selangor,87,41,46,2013
2013-01-11,Selangor,66,25,41,2013
2013-01-12,Selangor,41,17,24,2013
2013-01-13,Selangor,46,28,18,2013
2013-01-14,Selangor,71,22,49,2013
2013-01-15,Selangor,73,25,48,2013
2013-01-16,Selangor,90,57,33,2013
2013-01-17,Selangor,140,78,62,2013
2013-01-18,Selangor,52,16,36,2013
2013-01-19,Selangor,50,27,23,2013
2013-01-20,Selangor,25,14,11,2013
2013-01-21,Selangor,39,9,30,2013
2013-01-22,Selangor,45,32,13,2013
2013-01-23,Selangor,112,59,53,2013
2013-01-24,Selangor,54,24,30,2013
2013-01-25,Selangor,42,23,19,2013
2013-01-26,Selangor,120,42,78,2013
2013-01-27,Selangor,133,46,87,2013
2013-01-28,Selangor,12,2,10,2013
2013-01-29,Selangor,61,15,46,2013
2013-01-30,Selangor,38,7,31,2013
2013-01-31,Selangor,52,10,42,2013
2013-02-01,Selangor,51,15,36,2013
2013-02-02,Selangor,31,19,12,2013
2013-02-03,Selangor,93,15,78,2013
2013-02-04,Selangor,44,22,22,2013
2013-02-05,Selangor,65,12,53,2013
2013-02-06,Selangor,39,13,26,2013
2013-02-07,Selangor,112,52,60,2013
2013-02-08,Selangor,75,29,46,2013
2013-02-09,Selangor,28,22,6,2013
2013-02-10,Selangor,57,26,31,2013
2013-02-11,Selangor,34,17,17,2013
2013-02-12,Selangor,40,18,22,2013
2013-02-13,Selangor,50,20,30,2013
2013-02-14,Selangor,167,59,108,2013
2013-02-15,Selangor,59,19,40,2013
2013-02-16,Selangor,28,8,20,2013
2013-02-17,Selangor,64,28,36,2013
2013-02-18,Selangor,68,29,39,2013
2013-02-19,Selangor,37,7,30,2013
2013-02-20,Selangor,146,70,76,2013
2013-02-21,Selangor,35,12,23,2013
2013-02-22,Selangor,48,16,32,2013
2013-02-23,Selangor,31,16,15,2013
2013-02-24,Selangor,28,11,17,2013
2013-02-25,Selangor,37,13,24,2013
2013-02-26,Selangor,39,16,23,2013
2013-02-27,Selangor,151,79,72,2013
2013-02-28,Selangor,68,40,28,2013
2013-03-01,Selangor,11,2,9,2013
2013-03-02,Selangor,93,88,5,2013
2013-03-03,Selangor,50,21,29,2013
2013-03-04,Selangor,26,13,13,2013
2013-03-05,Selangor,34,4,30,2013
2013-03-06,Selangor,41,7,34,2013
2013-03-07,Selangor,51,24,27,2013
2013-03-08,Selangor,8,1,7,2013
2013-03-09,Selangor,144,71,73,2013
2013-03-10,Selangor,124,30,94,2013
2013-03-11,Selangor,12,1,11,2013
2013-03-12,Selangor,60,12,48,2013
2013-03-13,Selangor,104,57,47,2013
2013-03-14,Selangor,44,25,19,2013
2013-03-15,Selangor,164,83,81,2013
2013-03-16,Selangor,200,99,101,2013
2013-03-17,Selangor,206,46,160,2013
2013-03-18,Selangor,54,21,33,2013
2013-03-19,Selangor,119,35,84,2013
2013-03-20,Selangor,157,51,106,2013
2013-03-21,Selangor,47,22,25,2013
2013-03-22,Selangor,98,36,62,2013
2013-03-23,Selangor,2,1,1,2013
2013-03-24,Selangor,167,54,113,2013
2013-03-25,Selangor,86,29,57,2013
2013-03-26,Selangor,92,39,53,2013
2013-03-27,Selangor,123,55,68,2013
2013-03-28,Selangor,90,54,36,2013
2013-03-29,Selangor,52,17,35,2013
2013-03-30,Selangor,37,22,15,2013
2013-03-31,Selangor,40,10,30,2013
2013-04-01,Selangor,23,7,16,2013
2013-04-02,Selangor,15,2,13,2013
2013-04-03,Selangor,41,13,28,2013
2013-04-04,Selangor,9,3,6,2013
2013-04-05,Selangor,53,14,39,2013
2013-04-06,Selangor,55,26,29,2013
2013-04-07,Selangor,25,12,13,2013
2013-04-08,Selangor,60,20,40,2013
2013-04-09,Selangor,66,21,45,2013
2013-04-10,Selangor,61,8,53,2013
2013-04-11,Selangor,12,0,12,2013
2013-04-12,Selangor,40,18,22,2013
2013-04-13,Selangor,45,16,29,2013
2013-04-14,Selangor,265,77,188,2013
2013-04-15,Selangor,23,8,15,2013
2013-04-16,Selangor,39,10,29,2013
2013-04-17,Selangor,61,25,36,2013
2013-04-18,Selangor,51,17,34,2013
2013-04-19,Selangor,50,14,36,2013
2013-04-20,Selangor,1,1,0,2013
2013-04-21,Selangor,212,66,146,2013
2013-04-22,Selangor,10,1,9,2013
2013-04-23,Selangor,15,3,12,2013
2013-04-24,Selangor,88,42,46,2013
2013-04-25,Selangor,67,33,34,2013
2013-04-26,Selangor,57,30,27,2013
2013-04-27,Selangor,2,0,2,2013
2013-04-28,Selangor,159,43,116,2013
2013-04-29,Selangor,67,29,38,2013
2013-04-30,Selangor,53,19,34,2013
2013-05-01,Selangor,91,32,59,2013
2013-05-02,Selangor,57,21,36,2013
2013-05-03,Selangor,37,21,16,2013
2013-05-04,Selangor,1,1,0,2013
2013-05-05,Selangor,0,0,0,2013
2013-05-06,Selangor,0,0,0,2013
2013-05-07,Selangor,33,12,21,2013
2013-05-08,Selangor,103,22,81,2013
2013-05-09,Selangor,30,13,17,2013
2013-05-10,Selangor,32,6,26,2013
2013-05-11,Selangor,116,41,75,2013
2013-05-12,Selangor,13,4,9,2013
2013-05-13,Selangor,28,13,15,2013
2013-05-14,Selangor,61,14,47,2013
2013-05-15,Selangor,57,18,39,2013
2013-05-16,Selangor,47,17,30,2013
2013-05-17,Selangor,50,13,37,2013
2013-05-18,Selangor,131,52,79,2013
2013-05-19,Selangor,60,15,45,2013
2013-05-20,Selangor,15,3,12,2013
2013-05-21,Selangor,39,13,26,2013
2013-05-22,Selangor,53,26,27,2013
2013-05-23,Selangor,40,14,26,2013
2013-05-24,Selangor,251,66,185,2013
2013-05-25,Selangor,0,0,0,2013
2013-05-26,Selangor,344,81,263,2013
2013-05-27,Selangor,13,2,11,2013
2013-05-28,Selangor,32,9,23,2013
2013-05-29,Selangor,37,11,26,2013
2013-05-30,Selangor,15,4,11,2013
2013-05-31,Selangor,22,5,17,2013
2013-06-01,Selangor,141,48,93,2013
2013-06-02,Selangor,39,25,14,2013
2013-06-03,Selangor,101,83,18,2013
2013-06-04,Selangor,90,22,68,2013
2013-06-05,Selangor,86,32,54,2013
2013-06-06,Selangor,20,6,14,2013
2013-06-07,Selangor,42,15,27,2013
2013-06-08,Selangor,42,26,16,2013
2013-06-09,Selangor,32,13,19,2013
2013-06-10,Selangor,28,4,24,2013
2013-06-11,Selangor,38,6,32,2013
2013-06-12,Selangor,44,15,29,2013
2013-06-13,Selangor,192,102,90,2013
2013-06-14,Selangor,120,40,80,2013
2013-06-15,Selangor,40,18,22,2013
2013-06-16,Selangor,219,89,130,2013
2013-06-17,Selangor,12,1,11,2013
2013-06-18,Selangor,65,44,21,2013
2013-06-19,Selangor,85,42,43,2013
2013-06-20,Selangor,87,17,70,2013
2013-06-21,Selangor,74,30,44,2013
2013-06-22,Selangor,90,56,34,2013
2013-06-23,Selangor,59,24,35,2013
2013-06-24,Selangor,12,1,11,2013
2013-06-25,Selangor,36,22,14,2013
2013-06-26,Selangor,59,17,42,2013
2013-06-27,Selangor,42,8,34,2013
2013-06-28,Selangor,60,49,11,2013
2013-06-29,Selangor,0,0,0,2013
2013-06-30,Selangor,116,58,58,2013
2013-07-01,Selangor,43,11,32,2013
2013-07-02,Selangor,41,12,29,2013
2013-07-03,Selangor,14,1,13,2013
2013-07-04,Selangor,32,13,19,2013
2013-07-05,Selangor,106,47,59,2013
2013-07-06,Selangor,238,87,151,2013
2013-07-07,Selangor,282,107,175,2013
2013-07-08,Selangor,11,2,9,2013
2013-07-09,Selangor,55,24,31,2013
2013-07-10,Selangor,9,0,9,2013
2013-07-11,Selangor,4,0,4,2013
2013-07-12,Selangor,28,10,18,2013
2013-07-13,Selangor,2,1,1,2013
2013-07-14,Selangor,134,59,75,2013
2013-07-15,Selangor,7,1,6,2013
2013-07-16,Selangor,112,99,13,2013
2013-07-17,Selangor,98,39,59,2013
2013-07-18,Selangor,56,11,45,2013
2013-07-19,Selangor,42,12,30,2013
2013-07-20,Selangor,38,15,23,2013
2013-07-21,Selangor,120,47,73,2013
2013-07-22,Selangor,29,12,17,2013
2013-07-23,Selangor,104,85,19,2013
2013-07-24,Selangor,69,25,44,2013
2013-07-25,Selangor,6,0,6,2013
2013-07-26,Selangor,34,9,25,2013
2013-07-27,Selangor,3,2,1,2013
2013-07-28,Selangor,183,55,128,2013
2013-07-29,Selangor,8,0,8,2013
2013-07-30,Selangor,132,62,70,2013
2013-07-31,Selangor,28,12,16,2013
2013-08-01,Selangor,8,3,5,2013
2013-08-02,Selangor,30,10,20,2013
2013-08-03,Selangor,1,1,0,2013
2013-08-04,Selangor,179,38,141,2013
2013-08-05,Selangor,29,10,19,2013
2013-08-06,Selangor,13,2,11,2013
2013-08-07,Selangor,11,1,10,2013
2013-08-08,Selangor,7,0,7,2013
2013-08-09,Selangor,1,1,0,2013
2013-08-10,Selangor,1,0,1,2013
2013-08-11,Selangor,100,14,86,2013
2013-08-12,Selangor,51,15,36,2013
2013-08-13,Selangor,25,4,21,2013
2013-08-14,Selangor,24,6,18,2013
2013-08-15,Selangor,59,14,45,2013
2013-08-16,Selangor,14,3,11,2013
2013-08-17,Selangor,0,0,0,2013
2013-08-18,Selangor,323,73,250,2013
2013-08-19,Selangor,16,2,14,2013
2013-08-20,Selangor,31,8,23,2013
2013-08-21,Selangor,46,21,25,2013
2013-08-22,Selangor,40,15,25,2013
2013-08-23,Selangor,10,1,9,2013
2013-08-24,Selangor,45,22,23,2013
2013-08-25,Selangor,138,44,94,2013
2013-08-26,Selangor,45,9,36,2013
2013-08-27,Selangor,89,42,47,2013
2013-08-28,Selangor,38,4,34,2013
2013-08-29,Selangor,34,7,27,2013
2013-08-30,Selangor,39,15,24,2013
2013-08-31,Selangor,131,55,76,2013
2013-09-01,Selangor,16,5,11,2013
2013-09-02,Selangor,38,13,25,2013
2013-09-03,Selangor,25,7,18,2013
2013-09-04,Selangor,40,1,39,2013
2013-09-05,Selangor,35,11,24,2013
2013-09-06,Selangor,41,9,32,2013
2013-09-07,Selangor,41,20,21,2013
2013-09-08,Selangor,39,5,34,2013
2013-09-09,Selangor,81,26,55,2013
2013-09-10,Selangor,63,30,33,2013
2013-09-11,Selangor,52,7,45,2013
2013-09-12,Selangor,122,46,76,2013
2013-09-13,Selangor,21,4,17,2013
2013-09-14,Selangor,3,1,2,2013
2013-09-15,Selangor,30,13,17,2013
2013-09-16,Selangor,43,24,19,2013
2013-09-17,Selangor,69,16,53,2013
2013-09-18,Selangor,156,113,43,2013
2013-09-19,Selangor,59,16,43,2013
2013-09-20,Selangor,48,16,32,2013
2013-09-21,Selangor,71,38,33,2013
2013-09-22,Selangor,208,62,146,2013
2013-09-23,Selangor,25,5,20,2013
2013-09-24,Selangor,34,3,31,2013
2013-09-25,Selangor,23,11,12,2013
2013-09-26,Selangor,82,29,53,2013
2013-09-27,Selangor,30,6,24,2013
2013-09-28,Selangor,79,28,51,2013
2013-09-29,Selangor,240,48,192,2013
2013-09-30,Selangor,51,16,35,2013
2013-10-01,Selangor,91,20,71,2013
2013-10-02,Selangor,77,22,55,2013
2013-10-03,Selangor,67,28,39,2013
2013-10-04,Selangor,47,11,36,2013
2013-10-05,Selangor,67,28,39,2013
2013-10-06,Selangor,93,36,57,2013
2013-10-07,Selangor,74,20,54,2013
2013-10-08,Selangor,111,29,82,2013
2013-10-09,Selangor,158,109,49,2013
2013-10-10,Selangor,83,31,52,2013
2013-10-11,Selangor,45,16,29,2013
2013-10-12,Selangor,32,29,3,2013
2013-10-13,Selangor,83,24,59,2013
2013-10-14,Selangor,23,6,17,2013
2013-10-15,Selangor,50,18,32,2013
2013-10-16,Selangor,33,6,27,2013
2013-10-17,Selangor,60,19,41,2013
2013-10-18,Selangor,37,8,29,2013
2013-10-19,Selangor,111,51,60,2013
2013-10-20,Selangor,59,23,36,2013
2013-10-21,Selangor,48,17,31,2013
2013-10-22,Selangor,73,31,42,2013
2013-10-23,Selangor,32,14,18,2013
2013-10-24,Selangor,39,8,31,2013
2013-10-25,Selangor,51,15,36,2013
2013-10-26,Selangor,100,31,69,2013
2013-10-27,Selangor,47,21,26,2013
2013-10-28,Selangor,40,11,29,2013
2013-10-29,Selangor,59,13,46,2013
2013-10-30,Selangor,36,3,33,2013
2013-10-31,Selangor,82,20,62,2013
2013-11-01,Selangor,10,1,9,2013
2013-11-02,Selangor,1,0,1,2013
2013-11-03,Selangor,74,12,62,2013
2013-11-04,Selangor,15,2,13,2013
2013-11-05,Selangor,64,24,40,2013
2013-11-06,Selangor,52,24,28,2013
2013-11-07,Selangor,57,34,23,2013
2013-11-08,Selangor,36,11,25,2013
2013-11-09,Selangor,0,0,0,2013
2013-11-10,Selangor,157,53,104,2013
2013-11-11,Selangor,18,2,16,2013
2013-11-12,Selangor,14,1,13,2013
2013-11-13,Selangor,102,60,42,2013
2013-11-14,Selangor,11,3,8,2013
2013-11-15,Selangor,18,7,11,2013
2013-11-16,Selangor,49,31,18,2013
2013-11-17,Selangor,43,9,34,2013
2013-11-18,Selangor,44,15,29,2013
2013-11-19,Selangor,13,2,11,2013
2013-11-20,Selangor,36,15,21,2013
2013-11-21,Selangor,12,2,10,2013
2013-11-22,Selangor,39,9,30,2013
2013-11-23,Selangor,26,15,11,2013
2013-11-24,Selangor,163,55,108,2013
2013-11-25,Selangor,11,1,10,2013
2013-11-26,Selangor,43,18,25,2013
2013-11-27,Selangor,49,15,34,2013
2013-11-28,Selangor,61,14,47,2013
2013-11-29,Selangor,71,53,18,2013
2013-11-30,Selangor,40,20,20,2013
2013-12-01,Selangor,98,42,56,2013
2013-12-02,Selangor,39,19,20,2013
2013-12-03,Selangor,45,12,33,2013
2013-12-04,Selangor,23,12,11,2013
2013-12-05,Selangor,51,21,30,2013
2013-12-06,Selangor,34,13,21,2013
2013-12-07,Selangor,71,29,42,2013
2013-12-08,Selangor,24,12,12,2013
2013-12-09,Selangor,69,22,47,2013
2013-12-10,Selangor,31,12,19,2013
2013-12-11,Selangor,27,9,18,2013
2013-12-12,Selangor,43,23,20,2013
2013-12-13,Selangor,74,39,35,2013
2013-12-14,Selangor,89,41,48,2013
2013-12-15,Selangor,147,41,106,2013
2013-12-16,Selangor,38,11,27,2013
2013-12-17,Selangor,51,16,35,2013
2013-12-18,Selangor,81,28,53,2013
2013-12-19,Selangor,115,29,86,2013
2013-12-20,Selangor,86,23,63,2013
2013-12-21,Selangor,82,55,27,2013
2013-12-22,Selangor,48,14,34,2013
2013-12-23,Selangor,136,44,92,2013
2013-12-24,Selangor,122,32,90,2013
2013-12-25,Selangor,28,8,20,2013
2013-12-26,Selangor,31,6,25,2013
2013-12-27,Selangor,56,16,40,2013
2013-12-28,Selangor,0,0,0,2013
2013-12-29,Selangor,118,25,93,2013
2013-12-30,Selangor,14,2,12,2013
2013-12-31,Selangor,28,10,18,2013
2014-01-01,Selangor,62,18,44,2014
2014-01-02,Selangor,27,8,19,2014
2014-01-03,Selangor,11,3,8,2014
2014-01-04,Selangor,28,11,17,2014
2014-01-05,Selangor,32,14,18,2014
2014-01-06,Selangor,22,4,18,2014
2014-01-07,Selangor,24,7,17,2014
2014-01-08,Selangor,49,26,23,2014
2014-01-09,Selangor,32,13,19,2014
2014-01-10,Selangor,45,18,27,2014
2014-01-11,Selangor,45,22,23,2014
2014-01-12,Selangor,193,86,107,2014
2014-01-13,Selangor,68,39,29,2014
2014-01-14,Selangor,135,84,51,2014
2014-01-15,Selangor,111,50,61,2014
2014-01-16,Selangor,48,8,40,2014
2014-01-17,Selangor,100,51,49,2014
2014-01-18,Selangor,38,7,31,2014
2014-01-19,Selangor,131,55,76,2014
2014-01-20,Selangor,23,5,18,2014
2014-01-21,Selangor,74,20,54,2014
2014-01-22,Selangor,69,32,37,2014
2014-01-23,Selangor,30,21,9,2014
2014-01-24,Selangor,49,4,45,2014
2014-01-25,Selangor,100,71,29,2014
2014-01-26,Selangor,50,19,31,2014
2014-01-27,Selangor,14,2,12,2014
2014-01-28,Selangor,42,11,31,2014
2014-01-29,Selangor,50,10,40,2014
2014-01-30,Selangor,35,9,26,2014
2014-01-31,Selangor,70,29,41,2014
2014-02-01,Selangor,15,6,9,2014
2014-02-02,Selangor,14,6,8,2014
2014-02-03,Selangor,75,24,51,2014
2014-02-04,Selangor,123,41,82,2014
2014-02-05,Selangor,87,32,55,2014
2014-02-06,Selangor,92,31,61,2014
2014-02-07,Selangor,66,19,47,2014
2014-02-08,Selangor,3,1,2,2014
2014-02-09,Selangor,33,14,19,2014
2014-02-10,Selangor,36,9,27,2014
2014-02-11,Selangor,109,62,47,2014
2014-02-12,Selangor,136,84,52,2014
2014-02-13,Selangor,30,11,19,2014
2014-02-14,Selangor,56,7,49,2014
2014-02-15,Selangor,27,8,19,2014
2014-02-16,Selangor,51,25,26,2014
2014-02-17,Selangor,53,16,37,2014
2014-02-18,Selangor,59,22,37,2014
2014-02-19,Selangor,16,5,11,2014
2014-02-20,Selangor,62,13,49,2014
2014-02-21,Selangor,121,37,84,2014
2014-02-22,Selangor,104,71,33,2014
2014-02-23,Selangor,202,62,140,2014
2014-02-24,Selangor,135,70,65,2014
2014-02-25,Selangor,69,30,39,2014
2014-02-26,Selangor,90,27,63,2014
2014-02-27,Selangor,31,9,22,2014
2014-02-28,Selangor,61,15,46,2014
2014-03-01,Selangor,27,7,20,2014
2014-03-02,Selangor,31,10,21,2014
2014-03-03,Selangor,66,20,46,2014
2014-03-04,Selangor,22,5,17,2014
2014-03-05,Selangor,47,10,37,2014
2014-03-06,Selangor,98,32,66,2014
2014-03-07,Selangor,55,18,37,2014
2014-03-08,Selangor,175,106,69,2014
2014-03-09,Selangor,176,41,135,2014
2014-03-10,Selangor,111,40,71,2014
2014-03-11,Selangor,50,10,40,2014
2014-03-12,Selangor,219,132,87,2014
2014-03-13,Selangor,80,38,42,2014
2014-03-14,Selangor,33,10,23,2014
2014-03-15,Selangor,43,19,24,2014
2014-03-16,Selangor,120,12,108,2014
2014-03-17,Selangor,57,16,41,2014
2014-03-18,Selangor,71,18,53,2014
2014-03-19,Selangor,131,79,52,2014
2014-03-20,Selangor,93,27,66,2014
2014-03-21,Selangor,47,9,38,2014
2014-03-22,Selangor,60,31,29,2014
2014-03-23,Selangor,15,3,12,2014
2014-03-24,Selangor,31,8,23,2014
2014-03-25,Selangor,11,3,8,2014
2014-03-26,Selangor,55,21,34,2014
2014-03-27,Selangor,54,19,35,2014
2014-03-28,Selangor,101,42,59,2014
2014-03-29,Selangor,16,9,7,2014
2014-03-30,Selangor,37,19,18,2014
2014-03-31,Selangor,12,2,10,2014
2014-04-01,Selangor,65,33,32,2014
2014-04-02,Selangor,29,10,19,2014
2014-04-03,Selangor,46,8,38,2014
2014-04-04,Selangor,43,16,27,2014
2014-04-05,Selangor,60,23,37,2014
2014-04-06,Selangor,44,21,23,2014
2014-04-07,Selangor,17,0,17,2014
2014-04-08,Selangor,116,27,89,2014
2014-04-09,Selangor,44,28,16,2014
2014-04-10,Selangor,52,18,34,2014
2014-04-11,Selangor,43,17,26,2014
2014-04-12,Selangor,147,32,115,2014
2014-04-13,Selangor,72,21,51,2014
2014-04-14,Selangor,196,84,112,2014
2014-04-15,Selangor,156,71,85,2014
2014-04-16,Selangor,102,38,64,2014
2014-04-17,Selangor,151,36,115,2014
2014-04-18,Selangor,22,6,16,2014
2014-04-19,Selangor,22,9,13,2014
2014-04-20,Selangor,18,2,16,2014
2014-04-21,Selangor,19,4,15,2014
2014-04-22,Selangor,11,1,10,2014
2014-04-23,Selangor,39,14,25,2014
2014-04-24,Selangor,32,8,24,2014
2014-04-25,Selangor,14,4,10,2014
2014-04-26,Selangor,45,25,20,2014
2014-04-27,Selangor,120,48,72,2014
2014-04-28,Selangor,105,32,73,2014
2014-04-29,Selangor,73,55,18,2014
2014-04-30,Selangor,36,17,19,2014
2014-05-01,Selangor,131,45,86,2014
2014-05-02,Selangor,43,8,35,2014
2014-05-03,Selangor,200,70,130,2014
2014-05-04,Selangor,29,16,13,2014
2014-05-05,Selangor,47,18,29,2014
2014-05-06,Selangor,54,26,28,2014
2014-05-07,Selangor,85,34,51,2014
2014-05-08,Selangor,36,7,29,2014
2014-05-09,Selangor,35,17,18,2014
2014-05-10,Selangor,3,1,2,2014
2014-05-11,Selangor,55,23,32,2014
2014-05-12,Selangor,21,5,16,2014
2014-05-13,Selangor,505,114,391,2014
2014-05-14,Selangor,32,6,26,2014
2014-05-15,Selangor,16,3,13,2014
2014-05-16,Selangor,39,11,28,2014
2014-05-17,Selangor,17,12,5,2014
2014-05-18,Selangor,196,51,145,2014
2014-05-19,Selangor,20,4,16,2014
2014-05-20,Selangor,58,15,43,2014
2014-05-21,Selangor,124,19,105,2014
2014-05-22,Selangor,51,11,40,2014
2014-05-23,Selangor,6,1,5,2014
2014-05-24,Selangor,18,11,7,2014
2014-05-25,Selangor,167,36,131,2014
2014-05-26,Selangor,57,43,14,2014
2014-05-27,Selangor,64,19,45,2014
2014-05-28,Selangor,53,21,32,2014
2014-05-29,Selangor,13,3,10,2014
2014-05-30,Selangor,7,1,6,2014
2014-05-31,Selangor,150,57,93,2014
2014-06-01,Selangor,130,28,102,2014
2014-06-02,Selangor,15,3,12,2014
2014-06-03,Selangor,37,15,22,2014
2014-06-04,Selangor,90,59,31,2014
2014-06-05,Selangor,8,2,6,2014
2014-06-06,Selangor,25,6,19,2014
2014-06-07,Selangor,116,76,40,2014
2014-06-08,Selangor,73,35,38,2014
2014-06-09,Selangor,46,13,33,2014
2014-06-10,Selangor,34,9,25,2014
2014-06-11,Selangor,49,10,39,2014
2014-06-12,Selangor,41,15,26,2014
2014-06-13,Selangor,52,13,39,2014
2014-06-14,Selangor,28,12,16,2014
2014-06-15,Selangor,152,40,112,2014
2014-06-16,Selangor,57,22,35,2014
2014-06-17,Selangor,66,13,53,2014
2014-06-18,Selangor,14,1,13,2014
2014-06-19,Selangor,93,69,24,2014
2014-06-20,Selangor,31,8,23,2014
2014-06-21,Selangor,175,75,100,2014
2014-06-22,Selangor,268,105,163,2014
2014-06-23,Selangor,30,6,24,2014
2014-06-24,Selangor,82,22,60,2014
2014-06-25,Selangor,81,65,16,2014
2014-06-26,Selangor,50,19,31,2014
2014-06-27,Selangor,16,2,14,2014
2014-06-28,Selangor,75,36,39,2014
2014-06-29,Selangor,53,17,36,2014
2014-06-30,Selangor,16,4,12,2014
2014-07-01,Selangor,10,2,8,2014
2014-07-02,Selangor,91,46,45,2014
2014-07-03,Selangor,5,0,5,2014
2014-07-04,Selangor,45,19,26,2014
2014-07-05,Selangor,3,1,2,2014
2014-07-06,Selangor,192,44,148,2014
2014-07-07,Selangor,105,34,71,2014
2014-07-08,Selangor,55,42,13,2014
2014-07-09,Selangor,85,44,41,2014
2014-07-10,Selangor,64,28,36,2014
2014-07-11,Selangor,27,7,20,2014
2014-07-12,Selangor,105,37,68,2014
2014-07-13,Selangor,70,19,51,2014
2014-07-14,Selangor,103,54,49,2014
2014-07-15,Selangor,20,9,11,2014
2014-07-16,Selangor,31,9,22,2014
2014-07-17,Selangor,7,2,5,2014
2014-07-18,Selangor,52,12,40,2014
2014-07-19,Selangor,40,19,21,2014
2014-07-20,Selangor,210,53,157,2014
2014-07-21,Selangor,42,32,10,2014
2014-07-22,Selangor,136,110,26,2014
2014-07-23,Selangor,96,59,37,2014
2014-07-24,Selangor,34,9,25,2014
2014-07-25,Selangor,38,14,24,2014
2014-07-26,Selangor,10,1,9,2014
2014-07-27,Selangor,7,0,7,2014
2014-07-28,Selangor,3,1,2,2014
2014-07-29,Selangor,2,0,2,2014
2014-07-30,Selangor,23,2,21,2014
2014-07-31,Selangor,64,22,42,2014
2014-08-01,Selangor,43,16,27,2014
2014-08-02,Selangor,60,26,34,2014
2014-08-03,Selangor,221,27,194,2014
2014-08-04,Selangor,13,3,10,2014
2014-08-05,Selangor,38,6,32,2014
2014-08-06,Selangor,27,5,22,2014
2014-08-07,Selangor,51,26,25,2014
2014-08-08,Selangor,30,10,20,2014
2014-08-09,Selangor,177,50,127,2014
2014-08-10,Selangor,96,36,60,2014
2014-08-11,Selangor,45,11,34,2014
2014-08-12,Selangor,110,43,67,2014
2014-08-13,Selangor,17,3,14,2014
2014-08-14,Selangor,187,67,120,2014
2014-08-15,Selangor,37,10,27,2014
2014-08-16,Selangor,28,12,16,2014
2014-08-17,Selangor,16,3,13,2014
2014-08-18,Selangor,16,1,15,2014
2014-08-19,Selangor,20,7,13,2014
2014-08-20,Selangor,113,37,76,2014
2014-08-21,Selangor,61,19,42,2014
2014-08-22,Selangor,87,14,73,2014
2014-08-23,Selangor,42,13,29,2014
2014-08-24,Selangor,162,86,76,2014
2014-08-25,Selangor,86,24,62,2014
2014-08-26,Selangor,73,17,56,2014
2014-08-27,Selangor,116,57,59,2014
2014-08-28,Selangor,19,0,19,2014
2014-08-29,Selangor,41,9,32,2014
2014-08-30,Selangor,69,25,44,2014
2014-08-31,Selangor,84,28,56,2014
2014-09-01,Selangor,46,20,26,2014
2014-09-02,Selangor,53,24,29,2014
2014-09-03,Selangor,55,9,46,2014
2014-09-04,Selangor,98,29,69,2014
2014-09-05,Selangor,19,5,14,2014
2014-09-06,Selangor,91,41,50,2014
2014-09-07,Selangor,121,32,89,2014
2014-09-08,Selangor,130,111,19,2014
2014-09-09,Selangor,55,18,37,2014
2014-09-10,Selangor,54,12,42,2014
2014-09-11,Selangor,39,5,34,2014
2014-09-12,Selangor,19,3,16,2014
2014-09-13,Selangor,24,11,13,2014
2014-09-14,Selangor,271,43,228,2014
2014-09-15,Selangor,28,6,22,2014
2014-09-16,Selangor,28,16,12,2014
2014-09-17,Selangor,16,1,15,2014
2014-09-18,Selangor,9,0,9,2014
2014-09-19,Selangor,38,14,24,2014
2014-09-20,Selangor,41,18,23,2014
2014-09-21,Selangor,85,19,66,2014
2014-09-22,Selangor,82,20,62,2014
2014-09-23,Selangor,42,18,24,2014
2014-09-24,Selangor,234,143,91,2014
2014-09-25,Selangor,38,16,22,2014
2014-09-26,Selangor,5,1,4,2014
2014-09-27,Selangor,221,90,131,2014
2014-09-28,Selangor,230,50,180,2014
2014-09-29,Selangor,14,2,12,2014
2014-09-30,Selangor,24,8,16,2014
2014-10-01,Selangor,14,2,12,2014
2014-10-02,Selangor,79,60,19,2014
2014-10-03,Selangor,28,5,23,2014
2014-10-04,Selangor,12,7,5,2014
2014-10-05,Selangor,0,0,0,2014
2014-10-06,Selangor,14,8,6,2014
2014-10-07,Selangor,26,9,17,2014
2014-10-08,Selangor,81,16,65,2014
2014-10-09,Selangor,51,17,34,2014
2014-10-10,Selangor,87,24,63,2014
2014-10-11,Selangor,47,20,27,2014
2014-10-12,Selangor,138,60,78,2014
2014-10-13,Selangor,60,22,38,2014
2014-10-14,Selangor,12,2,10,2014
2014-10-15,Selangor,90,22,68,2014
2014-10-16,Selangor,120,37,83,2014
2014-10-17,Selangor,43,10,33,2014
2014-10-18,Selangor,64,46,18,2014
2014-10-19,Selangor,237,58,179,2014
2014-10-20,Selangor,48,13,35,2014
2014-10-21,Selangor,35,11,24,2014
2014-10-22,Selangor,89,27,62,2014
2014-10-23,Selangor,28,10,18,2014
2014-10-24,Selangor,25,5,20,2014
2014-10-25,Selangor,30,17,13,2014
2014-10-26,Selangor,98,28,70,2014
2014-10-27,Selangor,56,13,43,2014
2014-10-28,Selangor,25,7,18,2014
2014-10-29,Selangor,39,11,28,2014
2014-10-30,Selangor,39,10,29,2014
2014-10-31,Selangor,42,15,27,2014
2014-11-01,Selangor,26,6,20,2014
2014-11-02,Selangor,52,4,48,2014
2014-11-03,Selangor,56,36,20,2014
2014-11-04,Selangor,23,7,16,2014
2014-11-05,Selangor,54,15,39,2014
2014-11-06,Selangor,53,27,26,2014
2014-11-07,Selangor,91,55,36,2014
2014-11-08,Selangor,159,64,95,2014
2014-11-09,Selangor,244,71,173,2014
2014-11-10,Selangor,134,39,95,2014
2014-11-11,Selangor,133,44,89,2014
2014-11-12,Selangor,86,37,49,2014
2014-11-13,Selangor,127,74,53,2014
2014-11-14,Selangor,15,2,13,2014
2014-11-15,Selangor,48,27,21,2014
2014-11-16,Selangor,62,27,35,2014
2014-11-17,Selangor,58,22,36,2014
2014-11-18,Selangor,134,44,90,2014
2014-11-19,Selangor,96,21,75,2014
2014-11-20,Selangor,79,17,62,2014
2014-11-21,Selangor,36,7,29,2014
2014-11-22,Selangor,35,15,20,2014
2014-11-23,Selangor,217,76,141,2014
2014-11-24,Selangor,46,26,20,2014
2014-11-25,Selangor,92,34,58,2014
2014-11-26,Selangor,40,13,27,2014
2014-11-27,Selangor,38,19,19,2014
2014-11-28,Selangor,9,0,9,2014
2014-11-29,Selangor,36,15,21,2014
2014-11-30,Selangor,34,11,23,2014
2014-12-01,Selangor,24,4,20,2014
2014-12-02,Selangor,9,0,9,2014
2014-12-03,Selangor,83,33,50,2014
2014-12-04,Selangor,39,18,21,2014
2014-12-05,Selangor,32,15,17,2014
2014-12-06,Selangor,29,12,17,2014
2014-12-07,Selangor,78,26,52,2014
2014-12-08,Selangor,29,6,23,2014
2014-12-09,Selangor,140,73,67,2014
2014-12-10,Selangor,40,11,29,2014
2014-12-11,Selangor,44,13,31,2014
2014-12-12,Selangor,41,9,32,2014
2014-12-13,Selangor,23,5,18,2014
2014-12-14,Selangor,87,22,65,2014
2014-12-15,Selangor,56,10,46,2014
2014-12-16,Selangor,65,21,44,2014
2014-12-17,Selangor,48,14,34,2014
2014-12-18,Selangor,119,31,88,2014
2014-12-19,Selangor,55,18,37,2014
2014-12-20,Selangor,45,21,24,2014
2014-12-21,Selangor,62,17,45,2014
2014-12-22,Selangor,24,4,20,2014
2014-12-23,Selangor,32,11,21,2014
2014-12-24,Selangor,51,17,34,2014
2014-12-25,Selangor,70,25,45,2014
2014-12-26,Selangor,40,10,30,2014
2014-12-27,Selangor,61,22,39,2014
2014-12-28,Selangor,54,25,29,2014
2014-12-29,Selangor,45,21,24,2014
2014-12-30,Selangor,75,20,55,2014
2014-12-31,Selangor,81,26,55,2014
2015-01-01,Selangor,143,59,84,2015
2015-01-02,Selangor,81,37,44,2015
2015-01-03,Selangor,203,80,123,2015
2015-01-04,Selangor,199,71,128,2015
2015-01-05,Selangor,137,26,111,2015
2015-01-06,Selangor,43,19,24,2015
2015-01-07,Selangor,139,41,98,2015
2015-01-08,Selangor,35,7,28,2015
2015-01-09,Selangor,175,105,70,2015
2015-01-10,Selangor,156,69,87,2015
2015-01-11,Selangor,193,73,120,2015
2015-01-12,Selangor,47,8,39,2015
2015-01-13,Selangor,72,19,53,2015
2015-01-14,Selangor,138,62,76,2015
2015-01-15,Selangor,17,6,11,2015
2015-01-16,Selangor,30,8,22,2015
2015-01-17,Selangor,160,71,89,2015
2015-01-18,Selangor,55,16,39,2015
2015-01-19,Selangor,118,34,84,2015
2015-01-20,Selangor,81,54,27,2015
2015-01-21,Selangor,78,36,42,2015
2015-01-22,Selangor,38,4,34,2015
2015-01-23,Selangor,6,0,6,2015
2015-01-24,Selangor,96,88,8,2015
2015-01-25,Selangor,89,32,57,2015
2015-01-26,Selangor,45,15,30,2015
2015-01-27,Selangor,119,59,60,2015
2015-01-28,Selangor,56,34,22,2015
2015-01-29,Selangor,15,1,14,2015
2015-01-30,Selangor,27,10,17,2015
2015-01-31,Selangor,0,0,0,2015
2015-02-01,Selangor,183,72,111,2015
2015-02-02,Selangor,26,12,14,2015
2015-02-03,Selangor,105,46,59,2015
2015-02-04,Selangor,9,0,9,2015
2015-02-05,Selangor,38,9,29,2015
2015-02-06,Selangor,23,7,16,2015
2015-02-07,Selangor,62,32,30,2015
2015-02-08,Selangor,7,4,3,2015
2015-02-09,Selangor,82,42,40,2015
2015-02-10,Selangor,13,3,10,2015
2015-02-11,Selangor,86,30,56,2015
2015-02-12,Selangor,104,27,77,2015
2015-02-13,Selangor,70,31,39,2015
2015-02-14,Selangor,1,1,0,2015
2015-02-15,Selangor,33,10,23,2015
2015-02-16,Selangor,34,2,32,2015
2015-02-17,Selangor,89,42,47,2015
2015-02-18,Selangor,26,6,20,2015
2015-02-19,Selangor,29,7,22,2015
2015-02-20,Selangor,27,8,19,2015
2015-02-21,Selangor,75,28,47,2015
2015-02-22,Selangor,66,18,48,2015
2015-02-23,Selangor,66,23,43,2015
2015-02-24,Selangor,204,121,83,2015
2015-02-25,Selangor,60,36,24,2015
2015-02-26,Selangor,61,33,28,2015
2015-02-27,Selangor,32,8,24,2015
2015-02-28,Selangor,24,16,8,2015
2015-03-01,Selangor,37,21,16,2015
2015-03-02,Selangor,19,7,12,2015
2015-03-03,Selangor,45,11,34,2015
2015-03-04,Selangor,70,18,52,2015
2015-03-05,Selangor,53,21,32,2015
2015-03-06,Selangor,33,5,28,2015
2015-03-07,Selangor,48,17,31,2015
2015-03-08,Selangor,42,18,24,2015
2015-03-09,Selangor,26,7,19,2015
2015-03-10,Selangor,74,11,63,2015
2015-03-11,Selangor,93,24,69,2015
2015-03-12,Selangor,12,0,12,2015
2015-03-13,Selangor,68,15,53,2015
2015-03-14,Selangor,10,4,6,2015
2015-03-15,Selangor,74,15,59,2015
2015-03-16,Selangor,64,20,44,2015
2015-03-17,Selangor,242,88,154,2015
2015-03-18,Selangor,35,8,27,2015
2015-03-19,Selangor,46,11,35,2015
2015-03-20,Selangor,37,11,26,2015
2015-03-21,Selangor,55,22,33,2015
2015-03-22,Selangor,152,14,138,2015
2015-03-23,Selangor,13,4,9,2015
2015-03-24,Selangor,100,48,52,2015
2015-03-25,Selangor,153,65,88,2015
2015-03-26,Selangor,82,25,57,2015
2015-03-27,Selangor,17,3,14,2015
2015-03-28,Selangor,79,33,46,2015
2015-03-29,Selangor,80,34,46,2015
2015-03-30,Selangor,52,16,36,2015
2015-03-31,Selangor,31,8,23,2015
2015-04-01,Selangor,54,40,14,2015
2015-04-02,Selangor,31,8,23,2015
2015-04-03,Selangor,43,13,30,2015
2015-04-04,Selangor,65,26,39,2015
2015-04-05,Selangor,190,66,124,2015
2015-04-06,Selangor,55,16,39,2015
2015-04-07,Selangor,146,64,82,2015
2015-04-08,Selangor,82,31,51,2015
2015-04-09,Selangor,76,27,49,2015
2015-04-10,Selangor,65,25,40,2015
2015-04-11,Selangor,56,21,35,2015
2015-04-12,Selangor,205,40,165,2015
2015-04-13,Selangor,28,6,22,2015
2015-04-14,Selangor,86,14,72,2015
2015-04-15,Selangor,95,24,71,2015
2015-04-16,Selangor,34,9,25,2015
2015-04-17,Selangor,138,48,90,2015
2015-04-18,Selangor,37,13,24,2015
2015-04-19,Selangor,114,33,81,2015
2015-04-20,Selangor,33,8,25,2015
2015-04-21,Selangor,102,45,57,2015
2015-04-22,Selangor,18,4,14,2015
2015-04-23,Selangor,11,1,10,2015
2015-04-24,Selangor,60,20,40,2015
2015-04-25,Selangor,19,9,10,2015
2015-04-26,Selangor,211,39,172,2015
2015-04-27,Selangor,32,10,22,2015
2015-04-28,Selangor,21,1,20,2015
2015-04-29,Selangor,24,7,17,2015
2015-04-30,Selangor,81,38,43,2015
2015-05-01,Selangor,104,35,69,2015
2015-05-02,Selangor,0,0,0,2015
2015-05-03,Selangor,301,77,224,2015
2015-05-04,Selangor,1,0,1,2015
2015-05-05,Selangor,97,22,75,2015
2015-05-06,Selangor,13,4,9,2015
2015-05-07,Selangor,112,62,50,2015
2015-05-08,Selangor,30,13,17,2015
2015-05-09,Selangor,0,0,0,2015
2015-05-10,Selangor,114,22,92,2015
2015-05-11,Selangor,24,3,21,2015
2015-05-12,Selangor,102,21,81,2015
2015-05-13,Selangor,142,56,86,2015
2015-05-14,Selangor,80,25,55,2015
2015-05-15,Selangor,22,6,16,2015
2015-05-16,Selangor,86,33,53,2015
2015-05-17,Selangor,217,57,160,2015
2015-05-18,Selangor,13,1,12,2015
2015-05-19,Selangor,45,11,34,2015
2015-05-20,Selangor,45,13,32,2015
2015-05-21,Selangor,130,46,84,2015
2015-05-22,Selangor,30,8,22,2015
2015-05-23,Selangor,94,50,44,2015
2015-05-24,Selangor,150,31,119,2015
2015-05-25,Selangor,102,49,53,2015
2015-05-26,Selangor,55,22,33,2015
2015-05-27,Selangor,35,14,21,2015
2015-05-28,Selangor,46,20,26,2015
2015-05-29,Selangor,117,31,86,2015
2015-05-30,Selangor,97,28,69,2015
2015-05-31,Selangor,39,15,24,2015
2015-06-01,Selangor,131,28,103,2015
2015-06-02,Selangor,5,0,5,2015
2015-06-03,Selangor,77,2,75,2015
2015-06-04,Selangor,80,15,65,2015
2015-06-05,Selangor,38,11,27,2015
2015-06-06,Selangor,24,12,12,2015
2015-06-07,Selangor,5,4,1,2015
2015-06-08,Selangor,59,36,23,2015
2015-06-09,Selangor,3,0,3,2015
2015-06-10,Selangor,20,4,16,2015
2015-06-11,Selangor,10,1,9,2015
2015-06-12,Selangor,105,47,58,2015
2015-06-13,Selangor,217,74,143,2015
2015-06-14,Selangor,294,102,192,2015
2015-06-15,Selangor,116,35,81,2015
2015-06-16,Selangor,33,12,21,2015
2015-06-17,Selangor,40,10,30,2015
2015-06-18,Selangor,12,2,10,2015
2015-06-19,Selangor,46,11,35,2015
2015-06-20,Selangor,58,9,49,2015
2015-06-21,Selangor,130,24,106,2015
2015-06-22,Selangor,62,40,22,2015
2015-06-23,Selangor,29,10,19,2015
2015-06-24,Selangor,44,8,36,2015
2015-06-25,Selangor,73,21,52,2015
2015-06-26,Selangor,74,19,55,2015
2015-06-27,Selangor,28,17,11,2015
2015-06-28,Selangor,135,36,99,2015
2015-06-29,Selangor,48,35,13,2015
2015-06-30,Selangor,99,68,31,2015
2015-07-01,Selangor,114,45,69,2015
2015-07-02,Selangor,26,7,19,2015
2015-07-03,Selangor,57,16,41,2015
2015-07-04,Selangor,53,19,34,2015
2015-07-05,Selangor,158,45,113,2015
2015-07-06,Selangor,110,44,66,2015
2015-07-07,Selangor,93,63,30,2015
2015-07-08,Selangor,97,73,24,2015
2015-07-09,Selangor,21,9,12,2015
2015-07-10,Selangor,42,14,28,2015
2015-07-11,Selangor,0,0,0,2015
2015-07-12,Selangor,98,28,70,2015
2015-07-13,Selangor,44,13,31,2015
2015-07-14,Selangor,29,9,20,2015
2015-07-15,Selangor,4,1,3,2015
2015-07-16,Selangor,37,5,32,2015
2015-07-17,Selangor,0,0,0,2015
2015-07-18,Selangor,0,0,0,2015
2015-07-19,Selangor,53,17,36,2015
2015-07-20,Selangor,33,10,23,2015
2015-07-21,Selangor,39,13,26,2015
2015-07-22,Selangor,46,10,36,2015
2015-07-23,Selangor,62,17,45,2015
2015-07-24,Selangor,58,10,48,2015
2015-07-25,Selangor,162,81,81,2015
2015-07-26,Selangor,61,17,44,2015
2015-07-27,Selangor,16,1,15,2015
2015-07-28,Selangor,65,30,35,2015
2015-07-29,Selangor,14,2,12,2015
2015-07-30,Selangor,28,9,19,2015
2015-07-31,Selangor,43,6,37,2015
2015-08-01,Selangor,26,11,15,2015
2015-08-02,Selangor,223,54,169,2015
2015-08-03,Selangor,10,0,10,2015
2015-08-04,Selangor,23,6,17,2015
2015-08-05,Selangor,122,47,75,2015
2015-08-06,Selangor,53,25,28,2015
2015-08-07,Selangor,13,5,8,2015
2015-08-08,Selangor,16,4,12,2015
2015-08-09,Selangor,133,42,91,2015
2015-08-10,Selangor,24,4,20,2015
2015-08-11,Selangor,19,3,16,2015
2015-08-12,Selangor,202,107,95,2015
2015-08-13,Selangor,18,7,11,2015
2015-08-14,Selangor,12,4,8,2015
2015-08-15,Selangor,45,20,25,2015
2015-08-16,Selangor,129,42,87,2015
2015-08-17,Selangor,44,11,33,2015
2015-08-18,Selangor,131,87,44,2015
2015-08-19,Selangor,27,4,23,2015
2015-08-20,Selangor,20,4,16,2015
2015-08-21,Selangor,46,11,35,2015
2015-08-22,Selangor,110,37,73,2015
2015-08-23,Selangor,323,53,270,2015
2015-08-24,Selangor,35,7,28,2015
2015-08-25,Selangor,5,0,5,2015
2015-08-26,Selangor,126,86,40,2015
2015-08-27,Selangor,63,28,35,2015
2015-08-28,Selangor,46,11,35,2015
2015-08-29,Selangor,22,9,13,2015
2015-08-30,Selangor,240,62,178,2015
2015-08-31,Selangor,29,6,23,2015
2015-09-01,Selangor,11,2,9,2015
2015-09-02,Selangor,69,26,43,2015
2015-09-03,Selangor,14,4,10,2015
2015-09-04,Selangor,24,3,21,2015
2015-09-05,Selangor,44,5,39,2015
2015-09-06,Selangor,248,38,210,2015
2015-09-07,Selangor,56,11,45,2015
2015-09-08,Selangor,19,6,13,2015
2015-09-09,Selangor,203,58,145,2015
2015-09-10,Selangor,102,21,81,2015
2015-09-11,Selangor,25,13,12,2015
2015-09-12,Selangor,66,44,22,2015
2015-09-13,Selangor,209,42,167,2015
2015-09-14,Selangor,65,18,47,2015
2015-09-15,Selangor,31,11,20,2015
2015-09-16,Selangor,129,47,82,2015
2015-09-17,Selangor,61,8,53,2015
2015-09-18,Selangor,35,9,26,2015
2015-09-19,Selangor,34,7,27,2015
2015-09-20,Selangor,95,14,81,2015
2015-09-21,Selangor,33,9,24,2015
2015-09-22,Selangor,43,11,32,2015
2015-09-23,Selangor,61,32,29,2015
2015-09-24,Selangor,63,19,44,2015
2015-09-25,Selangor,41,14,27,2015
2015-09-26,Selangor,0,0,0,2015
2015-09-27,Selangor,121,51,70,2015
2015-09-28,Selangor,19,6,13,2015
2015-09-29,Selangor,36,6,30,2015
2015-09-30,Selangor,30,3,27,2015
2015-10-01,Selangor,25,6,19,2015
2015-10-02,Selangor,9,0,9,2015
2015-10-03,Selangor,30,11,19,2015
2015-10-04,Selangor,31,15,16,2015
2015-10-05,Selangor,130,56,74,2015
2015-10-06,Selangor,28,10,18,2015
2015-10-07,Selangor,70,38,32,2015
2015-10-08,Selangor,181,60,121,2015
2015-10-09,Selangor,35,12,23,2015
2015-10-10,Selangor,86,30,56,2015
2015-10-11,Selangor,141,50,91,2015
2015-10-12,Selangor,51,18,33,2015
2015-10-13,Selangor,46,5,41,2015
2015-10-14,Selangor,42,12,30,2015
2015-10-15,Selangor,37,15,22,2015
2015-10-16,Selangor,32,9,23,2015
2015-10-17,Selangor,30,15,15,2015
2015-10-18,Selangor,151,32,119,2015
2015-10-19,Selangor,28,1,27,2015
2015-10-20,Selangor,44,24,20,2015
2015-10-21,Selangor,100,67,33,2015
2015-10-22,Selangor,119,22,97,2015
2015-10-23,Selangor,79,16,63,2015
2015-10-24,Selangor,52,17,35,2015
2015-10-25,Selangor,163,71,92,2015
2015-10-26,Selangor,35,19,16,2015
2015-10-27,Selangor,51,20,31,2015
2015-10-28,Selangor,84,19,65,2015
2015-10-29,Selangor,125,32,93,2015
2015-10-30,Selangor,81,32,49,2015
2015-10-31,Selangor,91,27,64,2015
2015-11-01,Selangor,247,51,196,2015
2015-11-02,Selangor,10,5,5,2015
2015-11-03,Selangor,57,22,35,2015
2015-11-04,Selangor,53,18,35,2015
2015-11-05,Selangor,51,20,31,2015
2015-11-06,Selangor,35,6,29,2015
2015-11-07,Selangor,34,13,21,2015
2015-11-08,Selangor,41,14,27,2015
2015-11-09,Selangor,11,1,10,2015
2015-11-10,Selangor,22,3,19,2015
2015-11-11,Selangor,22,6,16,2015
2015-11-12,Selangor,33,14,19,2015
2015-11-13,Selangor,49,14,35,2015
2015-11-14,Selangor,38,8,30,2015
2015-11-15,Selangor,96,27,69,2015
2015-11-16,Selangor,36,10,26,2015
2015-11-17,Selangor,88,16,72,2015
2015-11-18,Selangor,90,21,69,2015
2015-11-19,Selangor,75,22,53,2015
2015-11-20,Selangor,113,49,64,2015
2015-11-21,Selangor,64,21,43,2015
2015-11-22,Selangor,109,35,74,2015
2015-11-23,Selangor,50,28,22,2015
2015-11-24,Selangor,6,1,5,2015
2015-11-25,Selangor,69,26,43,2015
2015-11-26,Selangor,69,42,27,2015
2015-11-27,Selangor,45,9,36,2015
2015-11-28,Selangor,89,28,61,2015
2015-11-29,Selangor,101,28,73,2015
2015-11-30,Selangor,11,1,10,2015
2015-12-01,Selangor,50,40,10,2015
2015-12-02,Selangor,44,16,28,2015
2015-12-03,Selangor,56,22,34,2015
2015-12-04,Selangor,36,4,32,2015
2015-12-05,Selangor,95,27,68,2015
2015-12-06,Selangor,85,30,55,2015
2015-12-07,Selangor,37,3,34,2015
2015-12-08,Selangor,109,45,64,2015
2015-12-09,Selangor,109,44,65,2015
2015-12-10,Selangor,144,40,104,2015
2015-12-11,Selangor,35,7,28,2015
2015-12-12,Selangor,22,6,16,2015
2015-12-13,Selangor,106,15,91,2015
2015-12-14,Selangor,0,0,0,2015
2015-12-15,Selangor,110,21,89,2015
2015-12-16,Selangor,60,28,32,2015
2015-12-17,Selangor,146,28,118,2015
2015-12-18,Selangor,60,18,42,2015
2015-12-19,Selangor,71,27,44,2015
2015-12-20,Selangor,75,26,49,2015
2015-12-21,Selangor,31,8,23,2015
2015-12-22,Selangor,108,26,82,2015
2015-12-23,Selangor,37,8,29,2015
2015-12-24,Selangor,49,15,34,2015
2015-12-25,Selangor,20,7,13,2015
2015-12-26,Selangor,16,5,11,2015
2015-12-27,Selangor,114,15,99,2015
2015-12-28,Selangor,6,0,6,2015
2015-12-29,Selangor,198,73,125,2015
2015-12-30,Selangor,3,0,3,2015
2015-12-31,Selangor,54,19,35,2015
2016-01-01,Selangor,81,26,55,2016
2016-01-02,Selangor,38,9,29,2016
2016-01-03,Selangor,56,16,40,2016
2016-01-04,Selangor,39,13,26,2016
2016-01-05,Selangor,44,6,38,2016
2016-01-06,Selangor,61,29,32,2016
2016-01-07,Selangor,20,2,18,2016
2016-01-08,Selangor,20,14,6,2016
2016-01-09,Selangor,0,0,0,2016
2016-01-10,Selangor,153,70,83,2016
2016-01-11,Selangor,39,19,20,2016
2016-01-12,Selangor,64,21,43,2016
2016-01-13,Selangor,11,2,9,2016
2016-01-14,Selangor,70,13,57,2016
2016-01-15,Selangor,37,10,27,2016
2016-01-16,Selangor,48,33,15,2016
2016-01-17,Selangor,92,22,70,2016
2016-01-18,Selangor,72,19,53,2016
2016-01-19,Selangor,77,38,39,2016
2016-01-20,Selangor,65,25,40,2016
2016-01-21,Selangor,26,2,24,2016
2016-01-22,Selangor,27,10,17,2016
2016-01-23,Selangor,24,9,15,2016
2016-01-24,Selangor,101,33,68,2016
2016-01-25,Selangor,35,15,20,2016
2016-01-26,Selangor,18,3,15,2016
2016-01-27,Selangor,75,48,27,2016
2016-01-28,Selangor,68,56,12,2016
2016-01-29,Selangor,63,21,42,2016
2016-01-30,Selangor,55,18,37,2016
2016-01-31,Selangor,77,30,47,2016
2016-02-01,Selangor,107,43,64,2016
2016-02-02,Selangor,34,23,11,2016
2016-02-03,Selangor,93,33,60,2016
2016-02-04,Selangor,71,24,47,2016
2016-02-05,Selangor,61,16,45,2016
2016-02-06,Selangor,102,32,70,2016
2016-02-07,Selangor,93,28,65,2016
2016-02-08,Selangor,80,26,54,2016
2016-02-09,Selangor,65,21,44,2016
2016-02-10,Selangor,79,23,56,2016
2016-02-11,Selangor,75,16,59,2016
2016-02-12,Selangor,83,22,61,2016
2016-02-13,Selangor,73,29,44,2016
2016-02-14,Selangor,32,9,23,2016
2016-02-15,Selangor,69,21,48,2016
2016-02-16,Selangor,62,11,51,2016
2016-02-17,Selangor,118,58,60,2016
2016-02-18,Selangor,44,26,18,2016
2016-02-19,Selangor,83,33,50,2016
2016-02-20,Selangor,59,25,34,2016
2016-02-21,Selangor,86,26,60,2016
2016-02-22,Selangor,70,41,29,2016
2016-02-23,Selangor,65,40,25,2016
2016-02-24,Selangor,78,19,59,2016
2016-02-25,Selangor,17,0,17,2016
2016-02-26,Selangor,32,6,26,2016
2016-02-27,Selangor,59,21,38,2016
2016-02-28,Selangor,52,24,28,2016
2016-02-29,Selangor,75,19,56,2016
2016-03-01,Selangor,90,10,80,2016
2016-03-02,Selangor,74,52,22,2016
2016-03-03,Selangor,64,14,50,2016
2016-03-04,Selangor,18,2,16,2016
2016-03-05,Selangor,15,4,11,2016
2016-03-06,Selangor,56,20,36,2016
2016-03-07,Selangor,25,3,22,2016
2016-03-08,Selangor,23,4,19,2016
2016-03-09,Selangor,99,29,70,2016
2016-03-10,Selangor,80,42,38,2016
2016-03-11,Selangor,133,44,89,2016
2016-03-12,Selangor,114,39,75,2016
2016-03-13,Selangor,165,39,126,2016
2016-03-14,Selangor,23,6,17,2016
2016-03-15,Selangor,142,63,79,2016
2016-03-16,Selangor,59,19,40,2016
2016-03-17,Selangor,37,11,26,2016
2016-03-18,Selangor,41,18,23,2016
2016-03-19,Selangor,30,17,13,2016
2016-03-20,Selangor,243,32,211,2016
2016-03-21,Selangor,63,15,48,2016
2016-03-22,Selangor,184,48,136,2016
2016-03-23,Selangor,91,40,51,2016
2016-03-24,Selangor,68,20,48,2016
2016-03-25,Selangor,117,42,75,2016
2016-03-26,Selangor,85,36,49,2016
2016-03-27,Selangor,130,39,91,2016
2016-03-28,Selangor,176,87,89,2016
2016-03-29,Selangor,79,25,54,2016
2016-03-30,Selangor,55,23,32,2016
2016-03-31,Selangor,153,85,68,2016
2016-04-01,Selangor,58,12,46,2016
2016-04-02,Selangor,16,10,6,2016
2016-04-03,Selangor,46,11,35,2016
2016-04-04,Selangor,21,4,17,2016
2016-04-05,Selangor,111,35,76,2016
2016-04-06,Selangor,54,17,37,2016
2016-04-07,Selangor,118,31,87,2016
2016-04-08,Selangor,21,4,17,2016
2016-04-09,Selangor,21,8,13,2016
2016-04-10,Selangor,28,12,16,2016
2016-04-11,Selangor,87,56,31,2016
2016-04-12,Selangor,143,63,80,2016
2016-04-13,Selangor,104,45,59,2016
2016-04-14,Selangor,84,30,54,2016
2016-04-15,Selangor,50,19,31,2016
2016-04-16,Selangor,121,46,75,2016
2016-04-17,Selangor,193,61,132,2016
2016-04-18,Selangor,71,17,54,2016
2016-04-19,Selangor,69,38,31,2016
2016-04-20,Selangor,31,10,21,2016
2016-04-21,Selangor,153,43,110,2016
2016-04-22,Selangor,51,20,31,2016
2016-04-23,Selangor,104,38,66,2016
2016-04-24,Selangor,172,29,143,2016
2016-04-25,Selangor,8,2,6,2016
2016-04-26,Selangor,62,18,44,2016
2016-04-27,Selangor,66,32,34,2016
2016-04-28,Selangor,73,43,30,2016
2016-04-29,Selangor,32,10,22,2016
2016-04-30,Selangor,10,2,8,2016
2016-05-01,Selangor,93,18,75,2016
2016-05-02,Selangor,0,0,0,2016
2016-05-03,Selangor,55,17,38,2016
2016-05-04,Selangor,50,5,45,2016
2016-05-05,Selangor,42,13,29,2016
2016-05-06,Selangor,58,10,48,2016
2016-05-07,Selangor,12,5,7,2016
2016-05-08,Selangor,169,43,126,2016
2016-05-09,Selangor,57,16,41,2016
2016-05-10,Selangor,129,43,86,2016
2016-05-11,Selangor,10,1,9,2016
2016-05-12,Selangor,96,13,83,2016
2016-05-13,Selangor,33,6,27,2016
2016-05-14,Selangor,26,13,13,2016
2016-05-15,Selangor,172,30,142,2016
2016-05-16,Selangor,51,11,40,2016
2016-05-17,Selangor,69,20,49,2016
2016-05-18,Selangor,75,21,54,2016
2016-05-19,Selangor,65,12,53,2016
2016-05-20,Selangor,27,7,20,2016
2016-05-21,Selangor,456,85,371,2016
2016-05-22,Selangor,101,25,76,2016
2016-05-23,Selangor,35,9,26,2016
2016-05-24,Selangor,134,42,92,2016
2016-05-25,Selangor,77,33,44,2016
2016-05-26,Selangor,123,29,94,2016
2016-05-27,Selangor,109,19,90,2016
2016-05-28,Selangor,0,0,0,2016
2016-05-29,Selangor,155,32,123,2016
2016-05-30,Selangor,10,3,7,2016
2016-05-31,Selangor,106,52,54,2016
2016-06-01,Selangor,67,22,45,2016
2016-06-02,Selangor,85,31,54,2016
2016-06-03,Selangor,103,27,76,2016
2016-06-04,Selangor,143,46,97,2016
2016-06-05,Selangor,132,43,89,2016
2016-06-06,Selangor,28,7,21,2016
2016-06-07,Selangor,18,7,11,2016
2016-06-08,Selangor,39,11,28,2016
2016-06-09,Selangor,6,1,5,2016
2016-06-10,Selangor,58,7,51,2016
2016-06-11,Selangor,7,2,5,2016
2016-06-12,Selangor,150,26,124,2016
2016-06-13,Selangor,38,7,31,2016
2016-06-14,Selangor,35,10,25,2016
2016-06-15,Selangor,27,5,22,2016
2016-06-16,Selangor,16,5,11,2016
2016-06-17,Selangor,40,8,32,2016
2016-06-18,Selangor,64,17,47,2016
2016-06-19,Selangor,85,30,55,2016
2016-06-20,Selangor,110,46,64,2016
2016-06-21,Selangor,76,40,36,2016
2016-06-22,Selangor,41,16,25,2016
2016-06-23,Selangor,32,11,21,2016
2016-06-24,Selangor,16,7,9,2016
2016-06-25,Selangor,19,2,17,2016
2016-06-26,Selangor,188,44,144,2016
2016-06-27,Selangor,23,3,20,2016
2016-06-28,Selangor,72,53,19,2016
2016-06-29,Selangor,66,38,28,2016
2016-06-30,Selangor,16,6,10,2016
2016-07-01,Selangor,23,9,14,2016
2016-07-02,Selangor,38,10,28,2016
2016-07-03,Selangor,309,69,240,2016
2016-07-04,Selangor,17,2,15,2016
2016-07-05,Selangor,7,0,7,2016
2016-07-06,Selangor,0,0,0,2016
2016-07-07,Selangor,24,6,18,2016
2016-07-08,Selangor,18,7,11,2016
2016-07-09,Selangor,26,8,18,2016
2016-07-10,Selangor,95,24,71,2016
2016-07-11,Selangor,33,6,27,2016
2016-07-12,Selangor,22,3,19,2016
2016-07-13,Selangor,41,16,25,2016
2016-07-14,Selangor,100,66,34,2016
2016-07-15,Selangor,68,13,55,2016
2016-07-16,Selangor,262,153,109,2016
2016-07-17,Selangor,57,13,44,2016
2016-07-18,Selangor,26,3,23,2016
2016-07-19,Selangor,47,9,38,2016
2016-07-20,Selangor,208,61,147,2016
2016-07-21,Selangor,16,3,13,2016
2016-07-22,Selangor,42,8,34,2016
2016-07-23,Selangor,98,49,49,2016
2016-07-24,Selangor,220,57,163,2016
2016-07-25,Selangor,12,0,12,2016
2016-07-26,Selangor,46,9,37,2016
2016-07-27,Selangor,118,59,59,2016
2016-07-28,Selangor,43,21,22,2016
2016-07-29,Selangor,22,4,18,2016
2016-07-30,Selangor,82,13,69,2016
2016-07-31,Selangor,180,29,151,2016
2016-08-01,Selangor,40,15,25,2016
2016-08-02,Selangor,43,7,36,2016
2016-08-03,Selangor,48,8,40,2016
2016-08-04,Selangor,65,36,29,2016
2016-08-05,Selangor,10,0,10,2016
2016-08-06,Selangor,312,99,213,2016
2016-08-07,Selangor,159,44,115,2016
2016-08-08,Selangor,24,4,20,2016
2016-08-09,Selangor,51,29,22,2016
2016-08-10,Selangor,75,24,51,2016
2016-08-11,Selangor,84,26,58,2016
2016-08-12,Selangor,64,21,43,2016
2016-08-13,Selangor,116,49,67,2016
2016-08-14,Selangor,126,9,117,2016
2016-08-15,Selangor,89,28,61,2016
2016-08-16,Selangor,73,38,35,2016
2016-08-17,Selangor,62,40,22,2016
2016-08-18,Selangor,50,27,23,2016
2016-08-19,Selangor,62,17,45,2016
2016-08-20,Selangor,114,53,61,2016
2016-08-21,Selangor,122,52,70,2016
2016-08-22,Selangor,47,13,34,2016
2016-08-23,Selangor,30,14,16,2016
2016-08-24,Selangor,45,8,37,2016
2016-08-25,Selangor,118,26,92,2016
2016-08-26,Selangor,62,41,21,2016
2016-08-27,Selangor,51,24,27,2016
2016-08-28,Selangor,265,50,215,2016
2016-08-29,Selangor,61,15,46,2016
2016-08-30,Selangor,69,27,42,2016
2016-08-31,Selangor,68,22,46,2016
2016-09-01,Selangor,92,15,77,2016
2016-09-02,Selangor,106,77,29,2016
2016-09-03,Selangor,261,217,44,2016
2016-09-04,Selangor,67,24,43,2016
2016-09-05,Selangor,22,2,20,2016
2016-09-06,Selangor,71,19,52,2016
2016-09-07,Selangor,35,8,27,2016
2016-09-08,Selangor,11,2,9,2016
2016-09-09,Selangor,32,13,19,2016
2016-09-10,Selangor,39,20,19,2016
2016-09-11,Selangor,79,25,54,2016
2016-09-12,Selangor,36,12,24,2016
2016-09-13,Selangor,31,7,24,2016
2016-09-14,Selangor,30,9,21,2016
2016-09-15,Selangor,60,18,42,2016
2016-09-16,Selangor,52,11,41,2016
2016-09-17,Selangor,72,29,43,2016
2016-09-18,Selangor,114,30,84,2016
2016-09-19,Selangor,7,0,7,2016
2016-09-20,Selangor,40,18,22,2016
2016-09-21,Selangor,16,1,15,2016
2016-09-22,Selangor,109,63,46,2016
2016-09-23,Selangor,40,7,33,2016
2016-09-24,Selangor,3,0,3,2016
2016-09-25,Selangor,230,34,196,2016
2016-09-26,Selangor,35,7,28,2016
2016-09-27,Selangor,3,0,3,2016
2016-09-28,Selangor,99,57,42,2016
2016-09-29,Selangor,54,13,41,2016
2016-09-30,Selangor,23,3,20,2016
2016-10-01,Selangor,72,30,42,2016
2016-10-02,Selangor,31,12,19,2016
2016-10-03,Selangor,0,0,0,2016
2016-10-04,Selangor,177,96,81,2016
2016-10-05,Selangor,19,2,17,2016
2016-10-06,Selangor,171,80,91,2016
2016-10-07,Selangor,51,19,32,2016
2016-10-08,Selangor,122,44,78,2016
2016-10-09,Selangor,257,55,202,2016
2016-10-10,Selangor,39,7,32,2016
2016-10-11,Selangor,84,19,65,2016
2016-10-12,Selangor,29,8,21,2016
2016-10-13,Selangor,125,62,63,2016
2016-10-14,Selangor,29,13,16,2016
2016-10-15,Selangor,0,0,0,2016
2016-10-16,Selangor,176,37,139,2016
2016-10-17,Selangor,11,2,9,2016
2016-10-18,Selangor,169,62,107,2016
2016-10-19,Selangor,75,10,65,2016
2016-10-20,Selangor,37,7,30,2016
2016-10-21,Selangor,62,11,51,2016
2016-10-22,Selangor,82,22,60,2016
2016-10-23,Selangor,73,20,53,2016
2016-10-24,Selangor,36,8,28,2016
2016-10-25,Selangor,32,4,28,2016
2016-10-26,Selangor,60,22,38,2016
2016-10-27,Selangor,5,0,5,2016
2016-10-28,Selangor,33,10,23,2016
2016-10-29,Selangor,20,10,10,2016
2016-10-30,Selangor,88,26,62,2016
2016-10-31,Selangor,14,3,11,2016
2016-11-01,Selangor,37,19,18,2016
2016-11-02,Selangor,34,5,29,2016
2016-11-03,Selangor,88,9,79,2016
2016-11-04,Selangor,18,7,11,2016
2016-11-05,Selangor,112,38,74,2016
2016-11-06,Selangor,0,0,0,2016
2016-11-07,Selangor,54,12,42,2016
2016-11-08,Selangor,19,3,16,2016
2016-11-09,Selangor,116,46,70,2016
2016-11-10,Selangor,50,17,33,2016
2016-11-11,Selangor,71,33,38,2016
2016-11-12,Selangor,66,11,55,2016
2016-11-13,Selangor,122,31,91,2016
2016-11-14,Selangor,28,10,18,2016
2016-11-15,Selangor,67,22,45,2016
2016-11-16,Selangor,100,44,56,2016
2016-11-17,Selangor,140,42,98,2016
2016-11-18,Selangor,87,32,55,2016
2016-11-19,Selangor,38,15,23,2016
2016-11-20,Selangor,207,65,142,2016
2016-11-21,Selangor,62,19,43,2016
2016-11-22,Selangor,34,12,22,2016
2016-11-23,Selangor,136,24,112,2016
2016-11-24,Selangor,145,105,40,2016
2016-11-25,Selangor,32,3,29,2016
2016-11-26,Selangor,75,22,53,2016
2016-11-27,Selangor,156,20,136,2016
2016-11-28,Selangor,64,23,41,2016
2016-11-29,Selangor,62,21,41,2016
2016-11-30,Selangor,45,3,42,2016
2016-12-01,Selangor,92,50,42,2016
2016-12-02,Selangor,53,14,39,2016
2016-12-03,Selangor,44,15,29,2016
2016-12-04,Selangor,64,24,40,2016
2016-12-05,Selangor,67,37,30,2016
2016-12-06,Selangor,67,29,38,2016
2016-12-07,Selangor,159,74,85,2016
2016-12-08,Selangor,27,1,26,2016
2016-12-09,Selangor,25,7,18,2016
2016-12-10,Selangor,58,17,41,2016
2016-12-11,Selangor,44,9,35,2016
2016-12-12,Selangor,3,2,1,2016
2016-12-13,Selangor,2,1,1,2016
2016-12-14,Selangor,1,1,0,2016
2016-12-15,Selangor,7,0,7,2016
2016-12-16,Selangor,5,1,4,2016
2016-12-17,Selangor,0,0,0,2016
2016-12-18,Selangor,0,0,0,2016
2016-12-19,Selangor,10,1,9,2016
2016-12-20,Selangor,6,1,5,2016
2016-12-21,Selangor,4,0,4,2016
2016-12-22,Selangor,3,0,3,2016
2016-12-23,Selangor,11,0,11,2016
2016-12-24,Selangor,0,0,0,2016
2016-12-25,Selangor,1,0,1,2016
2016-12-26,Selangor,0,0,0,2016
2016-12-27,Selangor,8,0,8,2016
2016-12-28,Selangor,7,1,6,2016
2016-12-29,Selangor,8,1,7,2016
2016-12-30,Selangor,14,2,12,2016
2016-12-31,Selangor,0,0,0,2016
2017-01-01,Selangor,96,26,70,2017
2017-01-02,Selangor,88,19,69,2017
2017-01-03,Selangor,38,6,32,2017
2017-01-04,Selangor,28,3,25,2017
2017-01-05,Selangor,39,7,32,2017
2017-01-06,Selangor,48,13,35,2017
2017-01-07,Selangor,29,15,14,2017
2017-01-08,Selangor,449,65,384,2017
2017-01-09,Selangor,59,30,29,2017
2017-01-10,Selangor,29,13,16,2017
2017-01-11,Selangor,80,20,60,2017
2017-01-12,Selangor,70,16,54,2017
2017-01-13,Selangor,18,3,15,2017
2017-01-14,Selangor,62,13,49,2017
2017-01-15,Selangor,80,14,66,2017
2017-01-16,Selangor,37,10,27,2017
2017-01-17,Selangor,152,81,71,2017
2017-01-18,Selangor,45,22,23,2017
2017-01-19,Selangor,51,11,40,2017
2017-01-20,Selangor,39,21,18,2017
2017-01-21,Selangor,104,33,71,2017
2017-01-22,Selangor,116,31,85,2017
2017-01-23,Selangor,91,26,65,2017
2017-01-24,Selangor,72,9,63,2017
2017-01-25,Selangor,38,9,29,2017
2017-01-26,Selangor,44,12,32,2017
2017-01-27,Selangor,25,7,18,2017
2017-01-28,Selangor,52,16,36,2017
2017-01-29,Selangor,42,16,26,2017
2017-01-30,Selangor,51,16,35,2017
2017-01-31,Selangor,47,12,35,2017
2017-02-01,Selangor,127,23,104,2017
2017-02-02,Selangor,83,21,62,2017
2017-02-03,Selangor,38,14,24,2017
2017-02-04,Selangor,38,14,24,2017
2017-02-05,Selangor,63,27,36,2017
2017-02-06,Selangor,19,2,17,2017
2017-02-07,Selangor,101,56,45,2017
2017-02-08,Selangor,24,4,20,2017
2017-02-09,Selangor,67,13,54,2017
2017-02-10,Selangor,36,7,29,2017
2017-02-11,Selangor,77,53,24,2017
2017-02-12,Selangor,94,61,33,2017
2017-02-13,Selangor,79,50,29,2017
2017-02-14,Selangor,78,34,44,2017
2017-02-15,Selangor,71,26,45,2017
2017-02-16,Selangor,73,19,54,2017
2017-02-17,Selangor,63,28,35,2017
2017-02-18,Selangor,75,24,51,2017
2017-02-19,Selangor,84,26,58,2017
2017-02-20,Selangor,50,12,38,2017
2017-02-21,Selangor,57,16,41,2017
2017-02-22,Selangor,54,27,27,2017
2017-02-23,Selangor,81,26,55,2017
2017-02-24,Selangor,78,21,57,2017
2017-02-25,Selangor,28,6,22,2017
2017-02-26,Selangor,273,63,210,2017
2017-02-27,Selangor,43,14,29,2017
2017-02-28,Selangor,6,2,4,2017
2017-03-01,Selangor,81,40,41,2017
2017-03-02,Selangor,58,12,46,2017
2017-03-03,Selangor,113,76,37,2017
2017-03-04,Selangor,63,25,38,2017
2017-03-05,Selangor,136,32,104,2017
2017-03-06,Selangor,51,9,42,2017
2017-03-07,Selangor,48,23,25,2017
2017-03-08,Selangor,77,37,40,2017
2017-03-09,Selangor,29,12,17,2017
2017-03-10,Selangor,51,19,32,2017
2017-03-11,Selangor,46,12,34,2017
2017-03-12,Selangor,115,26,89,2017
2017-03-13,Selangor,7,1,6,2017
2017-03-14,Selangor,81,27,54,2017
2017-03-15,Selangor,168,48,120,2017
2017-03-16,Selangor,87,35,52,2017
2017-03-17,Selangor,61,17,44,2017
2017-03-18,Selangor,62,20,42,2017
2017-03-19,Selangor,312,47,265,2017
2017-03-20,Selangor,29,6,23,2017
2017-03-21,Selangor,81,10,71,2017
2017-03-22,Selangor,50,34,16,2017
2017-03-23,Selangor,123,50,73,2017
2017-03-24,Selangor,15,0,15,2017
2017-03-25,Selangor,157,49,108,2017
2017-03-26,Selangor,205,61,144,2017
2017-03-27,Selangor,35,9,26,2017
2017-03-28,Selangor,8,2,6,2017
2017-03-29,Selangor,185,96,89,2017
2017-03-30,Selangor,26,5,21,2017
2017-03-31,Selangor,16,1,15,2017
2017-04-01,Selangor,32,9,23,2017
2017-04-02,Selangor,119,28,91,2017
2017-04-03,Selangor,33,12,21,2017
2017-04-04,Selangor,93,39,54,2017
2017-04-05,Selangor,24,5,19,2017
2017-04-06,Selangor,32,14,18,2017
2017-04-07,Selangor,73,26,47,2017
2017-04-08,Selangor,57,30,27,2017
2017-04-09,Selangor,141,43,98,2017
2017-04-10,Selangor,12,0,12,2017
2017-04-11,Selangor,63,11,52,2017
2017-04-12,Selangor,24,9,15,2017
2017-04-13,Selangor,38,3,35,2017
2017-04-14,Selangor,68,18,50,2017
2017-04-15,Selangor,78,19,59,2017
2017-04-16,Selangor,266,67,199,2017
2017-04-17,Selangor,64,9,55,2017
2017-04-18,Selangor,42,7,35,2017
2017-04-19,Selangor,134,52,82,2017
2017-04-20,Selangor,79,25,54,2017
2017-04-21,Selangor,128,31,97,2017
2017-04-22,Selangor,39,14,25,2017
2017-04-23,Selangor,114,35,79,2017
2017-04-24,Selangor,0,0,0,2017
2017-04-25,Selangor,87,39,48,2017
2017-04-26,Selangor,127,36,91,2017
2017-04-27,Selangor,106,38,68,2017
2017-04-28,Selangor,105,54,51,2017
2017-04-29,Selangor,38,8,30,2017
2017-04-30,Selangor,46,11,35,2017
2017-05-01,Selangor,195,57,138,2017
2017-05-02,Selangor,12,2,10,2017
2017-05-03,Selangor,53,17,36,2017
2017-05-04,Selangor,54,26,28,2017
2017-05-05,Selangor,46,18,28,2017
2017-05-06,Selangor,66,29,37,2017
2017-05-07,Selangor,84,12,72,2017
2017-05-08,Selangor,73,35,38,2017
2017-05-09,Selangor,6,1,5,2017
2017-05-10,Selangor,414,80,334,2017
2017-05-11,Selangor,184,53,131,2017
2017-05-12,Selangor,17,3,14,2017
2017-05-13,Selangor,60,13,47,2017
2017-05-14,Selangor,131,16,115,2017
2017-05-15,Selangor,24,8,16,2017
2017-05-16,Selangor,72,18,54,2017
2017-05-17,Selangor,99,15,84,2017
2017-05-18,Selangor,68,17,51,2017
2017-05-19,Selangor,80,27,53,2017
2017-05-20,Selangor,231,86,145,2017
2017-05-21,Selangor,326,115,211,2017
2017-05-22,Selangor,5,0,5,2017
2017-05-23,Selangor,70,18,52,2017
2017-05-24,Selangor,97,36,61,2017
2017-05-25,Selangor,94,27,67,2017
2017-05-26,Selangor,115,71,44,2017
2017-05-27,Selangor,18,7,11,2017
2017-05-28,Selangor,26,2,24,2017
2017-05-29,Selangor,44,12,32,2017
2017-05-30,Selangor,33,13,20,2017
2017-05-31,Selangor,26,4,22,2017
2017-06-01,Selangor,9,4,5,2017
2017-06-02,Selangor,14,2,12,2017
2017-06-03,Selangor,21,6,15,2017
2017-06-04,Selangor,103,27,76,2017
2017-06-05,Selangor,3,1,2,2017
2017-06-06,Selangor,35,5,30,2017
2017-06-07,Selangor,5,0,5,2017
2017-06-08,Selangor,88,80,8,2017
2017-06-09,Selangor,19,5,14,2017
2017-06-10,Selangor,12,4,8,2017
2017-06-11,Selangor,143,32,111,2017
2017-06-12,Selangor,30,10,20,2017
2017-06-13,Selangor,54,28,26,2017
2017-06-14,Selangor,58,39,19,2017
2017-06-15,Selangor,165,144,21,2017
2017-06-16,Selangor,23,3,20,2017
2017-06-17,Selangor,39,14,25,2017
2017-06-18,Selangor,184,26,158,2017
2017-06-19,Selangor,23,2,21,2017
2017-06-20,Selangor,66,46,20,2017
2017-06-21,Selangor,21,2,19,2017
2017-06-22,Selangor,19,4,15,2017
2017-06-23,Selangor,17,1,16,2017
2017-06-24,Selangor,1,0,1,2017
2017-06-25,Selangor,1,0,1,2017
2017-06-26,Selangor,0,0,0,2017
2017-06-27,Selangor,13,5,8,2017
2017-06-28,Selangor,33,14,19,2017
2017-06-29,Selangor,41,12,29,2017
2017-06-30,Selangor,38,7,31,2017
2017-07-01,Selangor,42,15,27,2017
2017-07-02,Selangor,224,54,170,2017
2017-07-03,Selangor,36,10,26,2017
2017-07-04,Selangor,28,4,24,2017
2017-07-05,Selangor,115,74,41,2017
2017-07-06,Selangor,59,13,46,2017
2017-07-07,Selangor,18,5,13,2017
2017-07-08,Selangor,358,194,164,2017
2017-07-09,Selangor,179,26,153,2017
2017-07-10,Selangor,13,1,12,2017
2017-07-11,Selangor,14,4,10,2017
2017-07-12,Selangor,115,30,85,2017
2017-07-13,Selangor,34,11,23,2017
2017-07-14,Selangor,13,1,12,2017
2017-07-15,Selangor,123,39,84,2017
2017-07-16,Selangor,190,55,135,2017
2017-07-17,Selangor,15,2,13,2017
2017-07-18,Selangor,37,17,20,2017
2017-07-19,Selangor,109,59,50,2017
2017-07-20,Selangor,86,27,59,2017
2017-07-21,Selangor,38,15,23,2017
2017-07-22,Selangor,65,25,40,2017
2017-07-23,Selangor,191,31,160,2017
2017-07-24,Selangor,6,2,4,2017
2017-07-25,Selangor,80,22,58,2017
2017-07-26,Selangor,142,95,47,2017
2017-07-27,Selangor,68,15,53,2017
2017-07-28,Selangor,15,5,10,2017
2017-07-29,Selangor,27,10,17,2017
2017-07-30,Selangor,276,63,213,2017
2017-07-31,Selangor,6,1,5,2017
2017-08-01,Selangor,34,14,20,2017
2017-08-02,Selangor,36,5,31,2017
2017-08-03,Selangor,117,50,67,2017
2017-08-04,Selangor,16,2,14,2017
2017-08-05,Selangor,142,34,108,2017
2017-08-06,Selangor,255,59,196,2017
2017-08-07,Selangor,28,7,21,2017
2017-08-08,Selangor,129,39,90,2017
2017-08-09,Selangor,66,15,51,2017
2017-08-10,Selangor,52,12,40,2017
2017-08-11,Selangor,35,5,30,2017
2017-08-12,Selangor,12,5,7,2017
2017-08-13,Selangor,65,24,41,2017
2017-08-14,Selangor,27,11,16,2017
2017-08-15,Selangor,5,1,4,2017
2017-08-16,Selangor,53,21,32,2017
2017-08-17,Selangor,117,71,46,2017
2017-08-18,Selangor,152,102,50,2017
2017-08-19,Selangor,17,9,8,2017
2017-08-20,Selangor,205,23,182,2017
2017-08-21,Selangor,9,5,4,2017
2017-08-22,Selangor,59,4,55,2017
2017-08-23,Selangor,16,4,12,2017
2017-08-24,Selangor,19,2,17,2017
2017-08-25,Selangor,52,21,31,2017
2017-08-26,Selangor,110,41,69,2017
2017-08-27,Selangor,109,28,81,2017
2017-08-28,Selangor,34,15,19,2017
2017-08-29,Selangor,38,6,32,2017
2017-08-30,Selangor,21,4,17,2017
2017-08-31,Selangor,68,26,42,2017
2017-09-01,Selangor,34,8,26,2017
2017-09-02,Selangor,37,5,32,2017
2017-09-03,Selangor,101,3,98,2017
2017-09-04,Selangor,1,0,1,2017
2017-09-05,Selangor,33,6,27,2017
2017-09-06,Selangor,68,24,44,2017
2017-09-07,Selangor,92,13,79,2017
2017-09-08,Selangor,23,4,19,2017
2017-09-09,Selangor,402,113,289,2017
2017-09-10,Selangor,122,25,97,2017
2017-09-11,Selangor,51,22,29,2017
2017-09-12,Selangor,51,6,45,2017
2017-09-13,Selangor,77,33,44,2017
2017-09-14,Selangor,35,16,19,2017
2017-09-15,Selangor,45,8,37,2017
2017-09-16,Selangor,56,17,39,2017
2017-09-17,Selangor,76,27,49,2017
2017-09-18,Selangor,66,17,49,2017
2017-09-19,Selangor,48,17,31,2017
2017-09-20,Selangor,29,8,21,2017
2017-09-21,Selangor,18,3,15,2017
2017-09-22,Selangor,34,12,22,2017
2017-09-23,Selangor,8,3,5,2017
2017-09-24,Selangor,89,29,60,2017
2017-09-25,Selangor,74,26,48,2017
2017-09-26,Selangor,59,24,35,2017
2017-09-27,Selangor,64,22,42,2017
2017-09-28,Selangor,21,6,15,2017
2017-09-29,Selangor,75,30,45,2017
2017-09-30,Selangor,48,14,34,2017
2017-10-01,Selangor,148,40,108,2017
2017-10-02,Selangor,32,11,21,2017
2017-10-03,Selangor,43,22,21,2017
2017-10-04,Selangor,93,17,76,2017
2017-10-05,Selangor,33,8,25,2017
2017-10-06,Selangor,32,12,20,2017
2017-10-07,Selangor,17,4,13,2017
2017-10-08,Selangor,131,38,93,2017
2017-10-09,Selangor,12,0,12,2017
2017-10-10,Selangor,119,28,91,2017
2017-10-11,Selangor,29,8,21,2017
2017-10-12,Selangor,122,46,76,2017
2017-10-13,Selangor,56,29,27,2017
2017-10-14,Selangor,162,62,100,2017
2017-10-15,Selangor,220,45,175,2017
2017-10-16,Selangor,25,7,18,2017
2017-10-17,Selangor,73,15,58,2017
2017-10-18,Selangor,57,12,45,2017
2017-10-19,Selangor,63,12,51,2017
2017-10-20,Selangor,37,5,32,2017
2017-10-21,Selangor,84,30,54,2017
2017-10-22,Selangor,90,19,71,2017
2017-10-23,Selangor,67,13,54,2017
2017-10-24,Selangor,122,56,66,2017
2017-10-25,Selangor,42,7,35,2017
2017-10-26,Selangor,76,22,54,2017
2017-10-27,Selangor,75,26,49,2017
2017-10-28,Selangor,90,26,64,2017
2017-10-29,Selangor,208,40,168,2017
2017-10-30,Selangor,56,40,16,2017
2017-10-31,Selangor,47,13,34,2017
2017-11-01,Selangor,76,47,29,2017
2017-11-02,Selangor,37,12,25,2017
2017-11-03,Selangor,21,3,18,2017
2017-11-04,Selangor,65,22,43,2017
2017-11-05,Selangor,80,9,71,2017
2017-11-06,Selangor,41,6,35,2017
2017-11-07,Selangor,33,16,17,2017
2017-11-08,Selangor,86,22,64,2017
2017-11-09,Selangor,147,34,113,2017
2017-11-10,Selangor,12,3,9,2017
2017-11-11,Selangor,61,22,39,2017
2017-11-12,Selangor,86,24,62,2017
2017-11-13,Selangor,42,14,28,2017
2017-11-14,Selangor,169,98,71,2017
2017-11-15,Selangor,85,29,56,2017
2017-11-16,Selangor,72,39,33,2017
2017-11-17,Selangor,61,17,44,2017
2017-11-18,Selangor,52,21,31,2017
2017-11-19,Selangor,89,33,56,2017
2017-11-20,Selangor,14,1,13,2017
2017-11-21,Selangor,61,24,37,2017
2017-11-22,Selangor,227,171,56,2017
2017-11-23,Selangor,30,6,24,2017
2017-11-24,Selangor,38,13,25,2017
2017-11-25,Selangor,67,27,40,2017
2017-11-26,Selangor,127,24,103,2017
2017-11-27,Selangor,6,3,3,2017
2017-11-28,Selangor,85,16,69,2017
2017-11-29,Selangor,48,23,25,2017
2017-11-30,Selangor,12,4,8,2017
2017-12-01,Selangor,55,16,39,2017
2017-12-02,Selangor,19,7,12,2017
2017-12-03,Selangor,46,9,37,2017
2017-12-04,Selangor,16,5,11,2017
2017-12-05,Selangor,70,29,41,2017
2017-12-06,Selangor,77,14,63,2017
2017-12-07,Selangor,77,42,35,2017
2017-12-08,Selangor,64,19,45,2017
2017-12-09,Selangor,109,37,72,2017
2017-12-10,Selangor,112,22,90,2017
2017-12-11,Selangor,48,11,37,2017
2017-12-12,Selangor,53,25,28,2017
2017-12-13,Selangor,58,20,38,2017
2017-12-14,Selangor,75,29,46,2017
2017-12-15,Selangor,49,4,45,2017
2017-12-16,Selangor,61,25,36,2017
2017-12-17,Selangor,218,53,165,2017
2017-12-18,Selangor,57,24,33,2017
2017-12-19,Selangor,24,6,18,2017
2017-12-20,Selangor,50,17,33,2017
2017-12-21,Selangor,33,17,16,2017
2017-12-22,Selangor,11,1,10,2017
2017-12-23,Selangor,61,19,42,2017
2017-12-24,Selangor,150,49,101,2017
2017-12-25,Selangor,1,0,1,2017
2017-12-26,Selangor,11,3,8,2017
2017-12-27,Selangor,12,1,11,2017
2017-12-28,Selangor,10,0,10,2017
2017-12-29,Selangor,5,0,5,2017
2017-12-30,Selangor,18,6,12,2017
2017-12-31,Selangor,0,0,0,2017
2018-01-01,Selangor,80,15,65,2018
2018-01-02,Selangor,38,10,28,2018
2018-01-03,Selangor,54,19,35,2018
2018-01-04,Selangor,13,3,10,2018
2018-01-05,Selangor,25,5,20,2018
2018-01-06,Selangor,94,11,83,2018
2018-01-07,Selangor,223,73,150,2018
2018-01-08,Selangor,47,24,23,2018
2018-01-09,Selangor,44,17,27,2018
2018-01-10,Selangor,28,5,23,2018
2018-01-11,Selangor,124,33,91,2018
2018-01-12,Selangor,33,6,27,2018
2018-01-13,Selangor,17,4,13,2018
2018-01-14,Selangor,99,41,58,2018
2018-01-15,Selangor,14,6,8,2018
2018-01-16,Selangor,58,8,50,2018
2018-01-17,Selangor,72,23,49,2018
2018-01-18,Selangor,97,63,34,2018
2018-01-19,Selangor,35,8,27,2018
2018-01-20,Selangor,56,13,43,2018
2018-01-21,Selangor,155,58,97,2018
2018-01-22,Selangor,29,7,22,2018
2018-01-23,Selangor,38,12,26,2018
2018-01-24,Selangor,20,9,11,2018
2018-01-25,Selangor,73,28,45,2018
2018-01-26,Selangor,68,15,53,2018
2018-01-27,Selangor,50,12,38,2018
2018-01-28,Selangor,121,41,80,2018
2018-01-29,Selangor,11,3,8,2018
2018-01-30,Selangor,50,8,42,2018
2018-01-31,Selangor,83,15,68,2018
2018-02-01,Selangor,21,6,15,2018
2018-02-02,Selangor,50,12,38,2018
2018-02-03,Selangor,64,26,38,2018
2018-02-04,Selangor,79,26,53,2018
2018-02-05,Selangor,37,9,28,2018
2018-02-06,Selangor,179,150,29,2018
2018-02-07,Selangor,65,33,32,2018
2018-02-08,Selangor,16,5,11,2018
2018-02-09,Selangor,49,5,44,2018
2018-02-10,Selangor,89,22,67,2018
2018-02-11,Selangor,91,20,71,2018
2018-02-12,Selangor,45,22,23,2018
2018-02-13,Selangor,160,121,39,2018
2018-02-14,Selangor,63,45,18,2018
2018-02-15,Selangor,69,15,54,2018
2018-02-16,Selangor,118,35,83,2018
2018-02-17,Selangor,103,38,65,2018
2018-02-18,Selangor,110,42,68,2018
2018-02-19,Selangor,17,5,12,2018
2018-02-20,Selangor,117,70,47,2018
2018-02-21,Selangor,129,33,96,2018
2018-02-22,Selangor,76,9,67,2018
2018-02-23,Selangor,69,23,46,2018
2018-02-24,Selangor,85,33,52,2018
2018-02-25,Selangor,112,37,75,2018
2018-02-26,Selangor,64,24,40,2018
2018-02-27,Selangor,52,19,33,2018
2018-02-28,Selangor,104,65,39,2018
2018-03-01,Selangor,52,10,42,2018
2018-03-02,Selangor,20,4,16,2018
2018-03-03,Selangor,144,37,107,2018
2018-03-04,Selangor,23,6,17,2018
2018-03-05,Selangor,39,11,28,2018
2018-03-06,Selangor,61,18,43,2018
2018-03-07,Selangor,86,33,53,2018
2018-03-08,Selangor,25,7,18,2018
2018-03-09,Selangor,39,12,27,2018
2018-03-10,Selangor,20,7,13,2018
2018-03-11,Selangor,122,23,99,2018
2018-03-12,Selangor,33,7,26,2018
2018-03-13,Selangor,114,46,68,2018
2018-03-14,Selangor,131,51,80,2018
2018-03-15,Selangor,130,33,97,2018
2018-03-16,Selangor,44,18,26,2018
2018-03-17,Selangor,83,29,54,2018
2018-03-18,Selangor,196,51,145,2018
2018-03-19,Selangor,27,5,22,2018
2018-03-20,Selangor,17,5,12,2018
2018-03-21,Selangor,130,72,58,2018
2018-03-22,Selangor,35,13,22,2018
2018-03-23,Selangor,38,17,21,2018
2018-03-24,Selangor,65,24,41,2018
2018-03-25,Selangor,148,48,100,2018
2018-03-26,Selangor,39,9,30,2018
2018-03-27,Selangor,106,27,79,2018
2018-03-28,Selangor,39,9,30,2018
2018-03-29,Selangor,120,31,89,2018
2018-03-30,Selangor,44,11,33,2018
2018-03-31,Selangor,9,1,8,2018
2018-04-01,Selangor,35,11,24,2018
2018-04-02,Selangor,11,2,9,2018
2018-04-03,Selangor,118,18,100,2018
2018-04-04,Selangor,44,8,36,2018
2018-04-05,Selangor,101,31,70,2018
2018-04-06,Selangor,21,14,7,2018
2018-04-07,Selangor,126,45,81,2018
2018-04-08,Selangor,106,30,76,2018
2018-04-09,Selangor,74,32,42,2018
2018-04-10,Selangor,77,45,32,2018
2018-04-11,Selangor,76,16,60,2018
2018-04-12,Selangor,110,47,63,2018
2018-04-13,Selangor,82,23,59,2018
2018-04-14,Selangor,98,27,71,2018
2018-04-15,Selangor,462,83,379,2018
2018-04-16,Selangor,49,9,40,2018
2018-04-17,Selangor,47,24,23,2018
2018-04-18,Selangor,83,22,61,2018
2018-04-19,Selangor,93,41,52,2018
2018-04-20,Selangor,90,19,71,2018
2018-04-21,Selangor,65,13,52,2018
2018-04-22,Selangor,189,43,146,2018
2018-04-23,Selangor,127,59,68,2018
2018-04-24,Selangor,26,9,17,2018
2018-04-25,Selangor,95,33,62,2018
2018-04-26,Selangor,84,22,62,2018
2018-04-27,Selangor,97,38,59,2018
2018-04-28,Selangor,32,13,19,2018
2018-04-29,Selangor,118,30,88,2018
2018-04-30,Selangor,23,9,14,2018
2018-05-01,Selangor,207,45,162,2018
2018-05-02,Selangor,7,1,6,2018
2018-05-03,Selangor,69,28,41,2018
2018-05-04,Selangor,35,12,23,2018
2018-05-05,Selangor,61,21,40,2018
2018-05-06,Selangor,182,47,135,2018
2018-05-07,Selangor,76,16,60,2018
2018-05-08,Selangor,19,3,16,2018
2018-05-09,Selangor,0,0,0,2018
2018-05-10,Selangor,0,0,0,2018
2018-05-11,Selangor,236,71,165,2018
2018-05-12,Selangor,300,85,215,2018
2018-05-13,Selangor,356,98,258,2018
2018-05-14,Selangor,46,25,21,2018
2018-05-15,Selangor,79,16,63,2018
2018-05-16,Selangor,33,13,20,2018
2018-05-17,Selangor,2,0,2,2018
2018-05-18,Selangor,49,15,34,2018
2018-05-19,Selangor,54,11,43,2018
2018-05-20,Selangor,23,8,15,2018
2018-05-21,Selangor,20,4,16,2018
2018-05-22,Selangor,21,2,19,2018
2018-05-23,Selangor,176,105,71,2018
2018-05-24,Selangor,8,1,7,2018
2018-05-25,Selangor,11,2,9,2018
2018-05-26,Selangor,7,2,5,2018
2018-05-27,Selangor,140,22,118,2018
2018-05-28,Selangor,28,8,20,2018
2018-05-29,Selangor,541,95,446,2018
2018-05-30,Selangor,5,0,5,2018
2018-05-31,Selangor,31,6,25,2018
2018-06-01,Selangor,23,7,16,2018
2018-06-02,Selangor,41,18,23,2018
2018-06-03,Selangor,171,30,141,2018
2018-06-04,Selangor,21,2,19,2018
2018-06-05,Selangor,32,13,19,2018
2018-06-06,Selangor,4,0,4,2018
2018-06-07,Selangor,12,2,10,2018
2018-06-08,Selangor,7,1,6,2018
2018-06-09,Selangor,26,8,18,2018
2018-06-10,Selangor,39,8,31,2018
2018-06-11,Selangor,12,6,6,2018
2018-06-12,Selangor,19,3,16,2018
2018-06-13,Selangor,6,0,6,2018
2018-06-14,Selangor,11,0,11,2018
2018-06-15,Selangor,0,0,0,2018
2018-06-16,Selangor,0,0,0,2018
2018-06-17,Selangor,1,0,1,2018
2018-06-18,Selangor,26,2,24,2018
2018-06-19,Selangor,21,2,19,2018
2018-06-20,Selangor,45,13,32,2018
2018-06-21,Selangor,39,8,31,2018
2018-06-22,Selangor,130,23,107,2018
2018-06-23,Selangor,101,32,69,2018
2018-06-24,Selangor,245,61,184,2018
2018-06-25,Selangor,27,4,23,2018
2018-06-26,Selangor,126,20,106,2018
2018-06-27,Selangor,87,20,67,2018
2018-06-28,Selangor,5,1,4,2018
2018-06-29,Selangor,24,5,19,2018
2018-06-30,Selangor,337,164,173,2018
2018-07-01,Selangor,0,0,0,2018
2018-07-02,Selangor,11,2,9,2018
2018-07-03,Selangor,11,2,9,2018
2018-07-04,Selangor,86,30,56,2018
2018-07-05,Selangor,32,8,24,2018
2018-07-06,Selangor,57,16,41,2018
2018-07-07,Selangor,0,0,0,2018
2018-07-08,Selangor,209,40,169,2018
2018-07-09,Selangor,22,4,18,2018
2018-07-10,Selangor,43,11,32,2018
2018-07-11,Selangor,56,15,41,2018
2018-07-12,Selangor,146,47,99,2018
2018-07-13,Selangor,26,6,20,2018
2018-07-14,Selangor,104,32,72,2018
2018-07-15,Selangor,674,134,540,2018
2018-07-16,Selangor,1,0,1,2018
2018-07-17,Selangor,33,6,27,2018
2018-07-18,Selangor,96,26,70,2018
2018-07-19,Selangor,28,11,17,2018
2018-07-20,Selangor,6,0,6,2018
2018-07-21,Selangor,31,8,23,2018
2018-07-22,Selangor,77,10,67,2018
2018-07-23,Selangor,10,0,10,2018
2018-07-24,Selangor,19,4,15,2018
2018-07-25,Selangor,62,16,46,2018
2018-07-26,Selangor,28,8,20,2018
2018-07-27,Selangor,52,11,41,2018
2018-07-28,Selangor,50,15,35,2018
2018-07-29,Selangor,126,22,104,2018
2018-07-30,Selangor,172,94,78,2018
2018-07-31,Selangor,92,19,73,2018
2018-08-01,Selangor,22,3,19,2018
2018-08-02,Selangor,126,90,36,2018
2018-08-03,Selangor,75,18,57,2018
2018-08-04,Selangor,21,6,15,2018
2018-08-05,Selangor,130,24,106,2018
2018-08-06,Selangor,42,12,30,2018
2018-08-07,Selangor,40,25,15,2018
2018-08-08,Selangor,92,35,57,2018
2018-08-09,Selangor,122,31,91,2018
2018-08-10,Selangor,11,5,6,2018
2018-08-11,Selangor,233,84,149,2018
2018-08-12,Selangor,100,35,65,2018
2018-08-13,Selangor,7,0,7,2018
2018-08-14,Selangor,57,49,8,2018
2018-08-15,Selangor,48,4,44,2018
2018-08-16,Selangor,77,21,56,2018
2018-08-17,Selangor,29,5,24,2018
2018-08-18,Selangor,238,67,171,2018
2018-08-19,Selangor,387,78,309,2018
2018-08-20,Selangor,26,10,16,2018
2018-08-21,Selangor,30,6,24,2018
2018-08-22,Selangor,0,0,0,2018
2018-08-23,Selangor,36,10,26,2018
2018-08-24,Selangor,28,5,23,2018
2018-08-25,Selangor,100,40,60,2018
2018-08-26,Selangor,220,40,180,2018
2018-08-27,Selangor,8,1,7,2018
2018-08-28,Selangor,51,24,27,2018
2018-08-29,Selangor,51,11,40,2018
2018-08-30,Selangor,28,4,24,2018
2018-08-31,Selangor,36,8,28,2018
2018-09-01,Selangor,1,0,1,2018
2018-09-02,Selangor,32,7,25,2018
2018-09-03,Selangor,40,7,33,2018
2018-09-04,Selangor,6,1,5,2018
2018-09-05,Selangor,89,60,29,2018
2018-09-06,Selangor,172,45,127,2018
2018-09-07,Selangor,48,13,35,2018
2018-09-08,Selangor,312,82,230,2018
2018-09-09,Selangor,197,64,133,2018
2018-09-10,Selangor,42,5,37,2018
2018-09-11,Selangor,30,7,23,2018
2018-09-12,Selangor,9,1,8,2018
2018-09-13,Selangor,46,17,29,2018
2018-09-14,Selangor,17,4,13,2018
2018-09-15,Selangor,14,3,11,2018
2018-09-16,Selangor,167,48,119,2018
2018-09-17,Selangor,34,24,10,2018
2018-09-18,Selangor,6,0,6,2018
2018-09-19,Selangor,71,12,59,2018
2018-09-20,Selangor,75,23,52,2018
2018-09-21,Selangor,46,12,34,2018
2018-09-22,Selangor,46,15,31,2018
2018-09-23,Selangor,155,31,124,2018
2018-09-24,Selangor,30,2,28,2018
2018-09-25,Selangor,42,8,34,2018
2018-09-26,Selangor,163,83,80,2018
2018-09-27,Selangor,33,5,28,2018
2018-09-28,Selangor,35,10,25,2018
2018-09-29,Selangor,54,22,32,2018
2018-09-30,Selangor,142,36,106,2018
2018-10-01,Selangor,12,2,10,2018
2018-10-02,Selangor,66,22,44,2018
2018-10-03,Selangor,9,0,9,2018
2018-10-04,Selangor,23,1,22,2018
2018-10-05,Selangor,19,5,14,2018
2018-10-06,Selangor,64,21,43,2018
2018-10-07,Selangor,208,37,171,2018
2018-10-08,Selangor,82,37,45,2018
2018-10-09,Selangor,91,37,54,2018
2018-10-10,Selangor,87,50,37,2018
2018-10-11,Selangor,86,27,59,2018
2018-10-12,Selangor,36,14,22,2018
2018-10-13,Selangor,89,25,64,2018
2018-10-14,Selangor,106,37,69,2018
2018-10-15,Selangor,6,0,6,2018
2018-10-16,Selangor,74,6,68,2018
2018-10-17,Selangor,30,7,23,2018
2018-10-18,Selangor,200,66,134,2018
2018-10-19,Selangor,52,13,39,2018
2018-10-20,Selangor,28,19,9,2018
2018-10-21,Selangor,244,32,212,2018
2018-10-22,Selangor,11,1,10,2018
2018-10-23,Selangor,74,15,59,2018
2018-10-24,Selangor,79,25,54,2018
2018-10-25,Selangor,51,13,38,2018
2018-10-26,Selangor,138,63,75,2018
2018-10-27,Selangor,35,10,25,2018
2018-10-28,Selangor,53,14,39,2018
2018-10-29,Selangor,8,0,8,2018
2018-10-30,Selangor,149,44,105,2018
2018-10-31,Selangor,74,13,61,2018
2018-11-01,Selangor,64,18,46,2018
2018-11-02,Selangor,42,16,26,2018
2018-11-03,Selangor,105,29,76,2018
2018-11-04,Selangor,116,34,82,2018
2018-11-05,Selangor,30,9,21,2018
2018-11-06,Selangor,51,10,41,2018
2018-11-07,Selangor,29,7,22,2018
2018-11-08,Selangor,50,10,40,2018
2018-11-09,Selangor,106,47,59,2018
2018-11-10,Selangor,100,30,70,2018
2018-11-11,Selangor,174,63,111,2018
2018-11-12,Selangor,82,23,59,2018
2018-11-13,Selangor,49,11,38,2018
2018-11-14,Selangor,86,11,75,2018
2018-11-15,Selangor,7,0,7,2018
2018-11-16,Selangor,81,20,61,2018
2018-11-17,Selangor,17,5,12,2018
2018-11-18,Selangor,101,20,81,2018
2018-11-19,Selangor,9,1,8,2018
2018-11-20,Selangor,1,1,0,2018
2018-11-21,Selangor,45,10,35,2018
2018-11-22,Selangor,133,63,70,2018
2018-11-23,Selangor,11,4,7,2018
2018-11-24,Selangor,59,12,47,2018
2018-11-25,Selangor,200,44,156,2018
2018-11-26,Selangor,76,21,55,2018
2018-11-27,Selangor,108,27,81,2018
2018-11-28,Selangor,117,46,71,2018
2018-11-29,Selangor,94,17,77,2018
2018-11-30,Selangor,57,8,49,2018
2018-12-01,Selangor,48,12,36,2018
2018-12-02,Selangor,189,48,141,2018
2018-12-03,Selangor,35,10,25,2018
2018-12-04,Selangor,61,15,46,2018
2018-12-05,Selangor,98,41,57,2018
2018-12-06,Selangor,16,2,14,2018
2018-12-07,Selangor,24,5,19,2018
2018-12-08,Selangor,40,25,15,2018
2018-12-09,Selangor,114,29,85,2018
2018-12-10,Selangor,8,0,8,2018
2018-12-11,Selangor,42,14,28,2018
2018-12-12,Selangor,20,7,13,2018
2018-12-13,Selangor,136,46,90,2018
2018-12-14,Selangor,28,10,18,2018
2018-12-15,Selangor,25,7,18,2018
2018-12-16,Selangor,248,54,194,2018
2018-12-17,Selangor,5,1,4,2018
2018-12-18,Selangor,36,10,26,2018
2018-12-19,Selangor,60,16,44,2018
2018-12-20,Selangor,6,1,5,2018
2018-12-21,Selangor,11,4,7,2018
2018-12-22,Selangor,104,27,77,2018
2018-12-23,Selangor,164,46,118,2018
2018-12-24,Selangor,18,2,16,2018
2018-12-25,Selangor,118,34,84,2018
2018-12-26,Selangor,12,7,5,2018
2018-12-27,Selangor,37,10,27,2018
2018-12-28,Selangor,27,9,18,2018
2018-12-29,Selangor,53,16,37,2018
2018-12-30,Selangor,67,14,53,2018
2018-12-31,Selangor,33,6,27,2018
2019-01-01,Selangor,49,15,34,2019
2019-01-02,Selangor,48,12,36,2019
2019-01-03,Selangor,62,16,46,2019
2019-01-04,Selangor,35,6,29,2019
2019-01-05,Selangor,90,19,71,2019
2019-01-06,Selangor,51,5,46,2019
2019-01-07,Selangor,68,29,39,2019
2019-01-08,Selangor,24,5,19,2019
2019-01-09,Selangor,73,39,34,2019
2019-01-10,Selangor,85,17,68,2019
2019-01-11,Selangor,61,11,50,2019
2019-01-12,Selangor,109,25,84,2019
2019-01-13,Selangor,160,35,125,2019
2019-01-14,Selangor,20,4,16,2019
2019-01-15,Selangor,36,17,19,2019
2019-01-16,Selangor,72,34,38,2019
2019-01-17,Selangor,98,34,64,2019
2019-01-18,Selangor,33,8,25,2019
2019-01-19,Selangor,54,11,43,2019
2019-01-20,Selangor,92,30,62,2019
2019-01-21,Selangor,89,22,67,2019
2019-01-22,Selangor,69,12,57,2019
2019-01-23,Selangor,90,44,46,2019
2019-01-24,Selangor,86,22,64,2019
2019-01-25,Selangor,13,2,11,2019
2019-01-26,Selangor,21,6,15,2019
2019-01-27,Selangor,148,40,108,2019
2019-01-28,Selangor,9,1,8,2019
2019-01-29,Selangor,70,15,55,2019
2019-01-30,Selangor,136,37,99,2019
2019-01-31,Selangor,47,13,34,2019
2019-02-01,Selangor,39,12,27,2019
2019-02-02,Selangor,93,23,70,2019
2019-02-03,Selangor,153,40,113,2019
2019-02-04,Selangor,37,10,27,2019
2019-02-05,Selangor,98,34,64,2019
2019-02-06,Selangor,78,19,59,2019
2019-02-07,Selangor,54,16,38,2019
2019-02-08,Selangor,36,15,21,2019
2019-02-09,Selangor,59,17,42,2019
2019-02-10,Selangor,52,10,42,2019
2019-02-11,Selangor,85,34,51,2019
2019-02-12,Selangor,35,11,24,2019
2019-02-13,Selangor,53,9,44,2019
2019-02-14,Selangor,147,59,88,2019
2019-02-15,Selangor,104,60,44,2019
2019-02-16,Selangor,102,39,63,2019
2019-02-17,Selangor,175,70,105,2019
2019-02-18,Selangor,76,31,45,2019
2019-02-19,Selangor,149,126,23,2019
2019-02-20,Selangor,71,26,45,2019
2019-02-21,Selangor,77,64,13,2019
2019-02-22,Selangor,111,90,21,2019
2019-02-23,Selangor,64,27,37,2019
2019-02-24,Selangor,185,43,142,2019
2019-02-25,Selangor,6,2,4,2019
2019-02-26,Selangor,6,0,6,2019
2019-02-27,Selangor,31,6,25,2019
2019-02-28,Selangor,28,9,19,2019
2019-03-01,Selangor,131,117,14,2019
2019-03-02,Selangor,95,30,65,2019
2019-03-03,Selangor,147,50,97,2019
2019-03-04,Selangor,40,7,33,2019
2019-03-05,Selangor,99,26,73,2019
2019-03-06,Selangor,34,7,27,2019
2019-03-07,Selangor,37,6,31,2019
2019-03-08,Selangor,48,8,40,2019
2019-03-09,Selangor,48,6,42,2019
2019-03-10,Selangor,92,17,75,2019
2019-03-11,Selangor,34,5,29,2019
2019-03-12,Selangor,87,15,72,2019
2019-03-13,Selangor,140,25,115,2019
2019-03-14,Selangor,82,47,35,2019
2019-03-15,Selangor,55,16,39,2019
2019-03-16,Selangor,29,7,22,2019
2019-03-17,Selangor,252,58,194,2019
2019-03-18,Selangor,14,2,12,2019
2019-03-19,Selangor,79,27,52,2019
2019-03-20,Selangor,182,105,77,2019
2019-03-21,Selangor,110,39,71,2019
2019-03-22,Selangor,101,35,66,2019
2019-03-23,Selangor,35,9,26,2019
2019-03-24,Selangor,142,24,118,2019
2019-03-25,Selangor,43,17,26,2019
2019-03-26,Selangor,33,5,28,2019
2019-03-27,Selangor,25,3,22,2019
2019-03-28,Selangor,91,16,75,2019
2019-03-29,Selangor,6,0,6,2019
2019-03-30,Selangor,41,9,32,2019
2019-03-31,Selangor,97,14,83,2019
2019-04-01,Selangor,32,6,26,2019
2019-04-02,Selangor,16,3,13,2019
2019-04-03,Selangor,152,51,101,2019
2019-04-04,Selangor,54,19,35,2019
2019-04-05,Selangor,45,6,39,2019
2019-04-06,Selangor,71,27,44,2019
2019-04-07,Selangor,177,32,145,2019
2019-04-08,Selangor,40,8,32,2019
2019-04-09,Selangor,97,27,70,2019
2019-04-10,Selangor,115,30,85,2019
2019-04-11,Selangor,34,15,19,2019
2019-04-12,Selangor,143,48,95,2019
2019-04-13,Selangor,84,25,59,2019
2019-04-14,Selangor,121,34,87,2019
2019-04-15,Selangor,45,15,30,2019
2019-04-16,Selangor,68,7,61,2019
2019-04-17,Selangor,43,23,20,2019
2019-04-18,Selangor,7,1,6,2019
2019-04-19,Selangor,74,24,50,2019
2019-04-20,Selangor,71,27,44,2019
2019-04-21,Selangor,216,46,170,2019
2019-04-22,Selangor,6,1,5,2019
2019-04-23,Selangor,89,24,65,2019
2019-04-24,Selangor,43,8,35,2019
2019-04-25,Selangor,6,1,5,2019
2019-04-26,Selangor,127,39,88,2019
2019-04-27,Selangor,188,46,142,2019
2019-04-28,Selangor,301,83,218,2019
2019-04-29,Selangor,8,0,8,2019
2019-04-30,Selangor,91,46,45,2019
2019-05-01,Selangor,236,49,187,2019
2019-05-02,Selangor,93,26,67,2019
2019-05-03,Selangor,50,18,32,2019
2019-05-04,Selangor,154,31,123,2019
2019-05-05,Selangor,163,35,128,2019
2019-05-06,Selangor,4,1,3,2019
2019-05-07,Selangor,30,3,27,2019
2019-05-08,Selangor,13,8,5,2019
2019-05-09,Selangor,21,6,15,2019
2019-05-10,Selangor,27,5,22,2019
2019-05-11,Selangor,42,14,28,2019
2019-05-12,Selangor,24,9,15,2019
2019-05-13,Selangor,8,0,8,2019
2019-05-14,Selangor,3,0,3,2019
2019-05-15,Selangor,51,14,37,2019
2019-05-16,Selangor,3,0,3,2019
2019-05-17,Selangor,6,1,5,2019
2019-05-18,Selangor,0,0,0,2019
2019-05-19,Selangor,459,60,399,2019
2019-05-20,Selangor,0,0,0,2019
2019-05-21,Selangor,34,8,26,2019
2019-05-22,Selangor,40,14,26,2019
2019-05-23,Selangor,31,7,24,2019
2019-05-24,Selangor,15,1,14,2019
2019-05-25,Selangor,47,3,44,2019
2019-05-26,Selangor,124,32,92,2019
2019-05-27,Selangor,3,0,3,2019
2019-05-28,Selangor,55,16,39,2019
2019-05-29,Selangor,28,4,24,2019
2019-05-30,Selangor,13,0,13,2019
2019-05-31,Selangor,14,2,12,2019
2019-06-01,Selangor,30,7,23,2019
2019-06-02,Selangor,27,8,19,2019
2019-06-03,Selangor,29,7,22,2019
2019-06-04,Selangor,5,0,5,2019
2019-06-05,Selangor,0,0,0,2019
2019-06-06,Selangor,0,0,0,2019
2019-06-07,Selangor,11,0,11,2019
2019-06-08,Selangor,15,1,14,2019
2019-06-09,Selangor,100,17,83,2019
2019-06-10,Selangor,34,9,25,2019
2019-06-11,Selangor,36,6,30,2019
2019-06-12,Selangor,69,11,58,2019
2019-06-13,Selangor,85,19,66,2019
2019-06-14,Selangor,78,28,50,2019
2019-06-15,Selangor,210,52,158,2019
2019-06-16,Selangor,168,53,115,2019
2019-06-17,Selangor,20,2,18,2019
2019-06-18,Selangor,30,7,23,2019
2019-06-19,Selangor,133,41,92,2019
2019-06-20,Selangor,113,57,56,2019
2019-06-21,Selangor,27,7,20,2019
2019-06-22,Selangor,65,16,49,2019
2019-06-23,Selangor,208,41,167,2019
2019-06-24,Selangor,97,29,68,2019
2019-06-25,Selangor,77,14,63,2019
2019-06-26,Selangor,59,9,50,2019
2019-06-27,Selangor,72,36,36,2019
2019-06-28,Selangor,7,0,7,2019
2019-06-29,Selangor,87,26,61,2019
2019-06-30,Selangor,125,20,105,2019
2019-07-01,Selangor,48,6,42,2019
2019-07-02,Selangor,13,5,8,2019
2019-07-03,Selangor,81,31,50,2019
2019-07-04,Selangor,33,10,23,2019
2019-07-05,Selangor,65,22,43,2019
2019-07-06,Selangor,146,50,96,2019
2019-07-07,Selangor,216,49,167,2019
2019-07-08,Selangor,11,2,9,2019
2019-07-09,Selangor,126,95,31,2019
2019-07-10,Selangor,73,35,38,2019
2019-07-11,Selangor,11,3,8,2019
2019-07-12,Selangor,55,12,43,2019
2019-07-13,Selangor,91,13,78,2019
2019-07-14,Selangor,181,20,161,2019
2019-07-15,Selangor,17,6,11,2019
2019-07-16,Selangor,49,22,27,2019
2019-07-17,Selangor,19,3,16,2019
2019-07-18,Selangor,76,16,60,2019
2019-07-19,Selangor,46,5,41,2019
2019-07-20,Selangor,12,5,7,2019
2019-07-21,Selangor,476,89,387,2019
2019-07-22,Selangor,7,0,7,2019
2019-07-23,Selangor,46,7,39,2019
2019-07-24,Selangor,52,15,37,2019
2019-07-25,Selangor,43,35,8,2019
2019-07-26,Selangor,64,13,51,2019
2019-07-27,Selangor,124,29,95,2019
2019-07-28,Selangor,181,33,148,2019
2019-07-29,Selangor,34,4,30,2019
2019-07-30,Selangor,63,15,48,2019
2019-07-31,Selangor,63,17,46,2019
2019-08-01,Selangor,66,27,39,2019
2019-08-02,Selangor,82,33,49,2019
2019-08-03,Selangor,485,303,182,2019
2019-08-04,Selangor,214,31,183,2019
2019-08-05,Selangor,8,1,7,2019
2019-08-06,Selangor,64,42,22,2019
2019-08-07,Selangor,107,74,33,2019
2019-08-08,Selangor,116,23,93,2019
2019-08-09,Selangor,27,7,20,2019
2019-08-10,Selangor,0,0,0,2019
2019-08-11,Selangor,0,0,0,2019
2019-08-12,Selangor,137,10,127,2019
2019-08-13,Selangor,23,2,21,2019
2019-08-14,Selangor,22,6,16,2019
2019-08-15,Selangor,151,33,118,2019
2019-08-16,Selangor,33,5,28,2019
2019-08-17,Selangor,119,41,78,2019
2019-08-18,Selangor,155,25,130,2019
2019-08-19,Selangor,12,3,9,2019
2019-08-20,Selangor,111,30,81,2019
2019-08-21,Selangor,72,19,53,2019
2019-08-22,Selangor,29,6,23,2019
2019-08-23,Selangor,43,14,29,2019
2019-08-24,Selangor,181,44,137,2019
2019-08-25,Selangor,314,78,236,2019
2019-08-26,Selangor,13,2,11,2019
2019-08-27,Selangor,74,14,60,2019
2019-08-28,Selangor,93,57,36,2019
2019-08-29,Selangor,68,12,56,2019
2019-08-30,Selangor,55,10,45,2019
2019-08-31,Selangor,78,20,58,2019
2019-09-01,Selangor,225,25,200,2019
2019-09-02,Selangor,0,0,0,2019
2019-09-03,Selangor,28,7,21,2019
2019-09-04,Selangor,66,33,33,2019
2019-09-05,Selangor,100,17,83,2019
2019-09-06,Selangor,26,6,20,2019
2019-09-07,Selangor,77,7,70,2019
2019-09-08,Selangor,90,24,66,2019
2019-09-09,Selangor,65,20,45,2019
2019-09-10,Selangor,27,4,23,2019
2019-09-11,Selangor,45,7,38,2019
2019-09-12,Selangor,24,9,15,2019
2019-09-13,Selangor,63,26,37,2019
2019-09-14,Selangor,41,10,31,2019
2019-09-15,Selangor,221,73,148,2019
2019-09-16,Selangor,226,56,170,2019
2019-09-17,Selangor,31,2,29,2019
2019-09-18,Selangor,49,12,37,2019
2019-09-19,Selangor,58,12,46,2019
2019-09-20,Selangor,8,1,7,2019
2019-09-21,Selangor,0,0,0,2019
2019-09-22,Selangor,210,38,172,2019
2019-09-23,Selangor,9,0,9,2019
2019-09-24,Selangor,88,28,60,2019
2019-09-25,Selangor,82,16,66,2019
2019-09-26,Selangor,40,6,34,2019
2019-09-27,Selangor,55,12,43,2019
2019-09-28,Selangor,110,32,78,2019
2019-09-29,Selangor,138,27,111,2019
2019-09-30,Selangor,67,13,54,2019
2019-10-01,Selangor,81,27,54,2019
2019-10-02,Selangor,36,10,26,2019
2019-10-03,Selangor,59,11,48,2019
2019-10-04,Selangor,66,15,51,2019
2019-10-05,Selangor,33,8,25,2019
2019-10-06,Selangor,121,28,93,2019
2019-10-07,Selangor,27,7,20,2019
2019-10-08,Selangor,29,4,25,2019
2019-10-09,Selangor,65,13,52,2019
2019-10-10,Selangor,208,32,176,2019
2019-10-11,Selangor,27,2,25,2019
2019-10-12,Selangor,101,36,65,2019
2019-10-13,Selangor,143,22,121,2019
2019-10-14,Selangor,7,0,7,2019
2019-10-15,Selangor,126,29,97,2019
2019-10-16,Selangor,114,39,75,2019
2019-10-17,Selangor,96,21,75,2019
2019-10-18,Selangor,43,8,35,2019
2019-10-19,Selangor,70,10,60,2019
2019-10-20,Selangor,110,18,92,2019
2019-10-21,Selangor,12,2,10,2019
2019-10-22,Selangor,53,12,41,2019
2019-10-23,Selangor,89,17,72,2019
2019-10-24,Selangor,79,20,59,2019
2019-10-25,Selangor,84,36,48,2019
2019-10-26,Selangor,90,29,61,2019
2019-10-27,Selangor,190,40,150,2019
2019-10-28,Selangor,61,10,51,2019
2019-10-29,Selangor,37,10,27,2019
2019-10-30,Selangor,72,25,47,2019
2019-10-31,Selangor,50,17,33,2019
2019-11-01,Selangor,24,7,17,2019
2019-11-02,Selangor,118,30,88,2019
2019-11-03,Selangor,109,24,85,2019
2019-11-04,Selangor,44,5,39,2019
2019-11-05,Selangor,65,16,49,2019
2019-11-06,Selangor,70,7,63,2019
2019-11-07,Selangor,95,23,72,2019
2019-11-08,Selangor,23,3,20,2019
2019-11-09,Selangor,39,15,24,2019
2019-11-10,Selangor,161,34,127,2019
2019-11-11,Selangor,11,1,10,2019
2019-11-12,Selangor,131,45,86,2019
2019-11-13,Selangor,76,24,52,2019
2019-11-14,Selangor,97,18,79,2019
2019-11-15,Selangor,50,14,36,2019
2019-11-16,Selangor,155,73,82,2019
2019-11-17,Selangor,115,31,84,2019
2019-11-18,Selangor,15,2,13,2019
2019-11-19,Selangor,61,19,42,2019
2019-11-20,Selangor,58,13,45,2019
2019-11-21,Selangor,122,30,92,2019
2019-11-22,Selangor,27,10,17,2019
2019-11-23,Selangor,124,26,98,2019
2019-11-24,Selangor,177,79,98,2019
2019-11-25,Selangor,62,28,34,2019
2019-11-26,Selangor,120,27,93,2019
2019-11-27,Selangor,91,24,67,2019
2019-11-28,Selangor,143,30,113,2019
2019-11-29,Selangor,25,6,19,2019
2019-11-30,Selangor,65,15,50,2019
2019-12-01,Selangor,92,40,52,2019
2019-12-02,Selangor,38,5,33,2019
2019-12-03,Selangor,130,50,80,2019
2019-12-04,Selangor,42,6,36,2019
2019-12-05,Selangor,63,14,49,2019
2019-12-06,Selangor,25,0,25,2019
2019-12-07,Selangor,125,32,93,2019
2019-12-08,Selangor,153,24,129,2019
2019-12-09,Selangor,59,24,35,2019
2019-12-10,Selangor,62,21,41,2019
2019-12-11,Selangor,90,13,77,2019
2019-12-12,Selangor,29,5,24,2019
2019-12-13,Selangor,19,9,10,2019
2019-12-14,Selangor,57,13,44,2019
2019-12-15,Selangor,213,38,175,2019
2019-12-16,Selangor,7,2,5,2019
2019-12-17,Selangor,93,26,67,2019
2019-12-18,Selangor,70,22,48,2019
2019-12-19,Selangor,87,14,73,2019
2019-12-20,Selangor,42,9,33,2019
2019-12-21,Selangor,73,11,62,2019
2019-12-22,Selangor,123,25,98,2019
2019-12-23,Selangor,8,1,7,2019
2019-12-24,Selangor,73,15,58,2019
2019-12-25,Selangor,132,23,109,2019
2019-12-26,Selangor,28,2,26,2019
2019-12-27,Selangor,65,14,51,2019
2019-12-28,Selangor,86,19,67,2019
2019-12-29,Selangor,107,22,85,2019
2019-12-30,Selangor,56,15,41,2019
2019-12-31,Selangor,100,27,73,2019
2020-01-01,Selangor,166,48,118,2020
2020-01-02,Selangor,39,7,32,2020
2020-01-03,Selangor,52,9,43,2020
2020-01-04,Selangor,70,18,52,2020
2020-01-05,Selangor,134,33,101,2020
2020-01-06,Selangor,46,12,34,2020
2020-01-07,Selangor,15,3,12,2020
2020-01-08,Selangor,126,69,57,2020
2020-01-09,Selangor,111,29,82,2020
2020-01-10,Selangor,148,28,120,2020
2020-01-11,Selangor,101,22,79,2020
2020-01-12,Selangor,132,27,105,2020
2020-01-13,Selangor,27,8,19,2020
2020-01-14,Selangor,54,16,38,2020
2020-01-15,Selangor,145,86,59,2020
2020-01-16,Selangor,47,6,41,2020
2020-01-17,Selangor,10,0,10,2020
2020-01-18,Selangor,88,22,66,2020
2020-01-19,Selangor,173,28,145,2020
2020-01-20,Selangor,30,10,20,2020
2020-01-21,Selangor,37,11,26,2020
2020-01-22,Selangor,50,6,44,2020
2020-01-23,Selangor,88,43,45,2020
2020-01-24,Selangor,44,6,38,2020
2020-01-25,Selangor,128,30,98,2020
2020-01-26,Selangor,95,22,73,2020
2020-01-27,Selangor,102,22,80,2020
2020-01-28,Selangor,49,16,33,2020
2020-01-29,Selangor,41,5,36,2020
2020-01-30,Selangor,75,45,30,2020
2020-01-31,Selangor,63,17,46,2020
2020-02-01,Selangor,54,13,41,2020
2020-02-02,Selangor,121,29,92,2020
2020-02-03,Selangor,97,40,57,2020
2020-02-04,Selangor,112,31,81,2020
2020-02-05,Selangor,119,69,50,2020
2020-02-06,Selangor,101,34,67,2020
2020-02-07,Selangor,96,33,63,2020
2020-02-08,Selangor,118,19,99,2020
2020-02-09,Selangor,89,11,78,2020
2020-02-10,Selangor,34,5,29,2020
2020-02-11,Selangor,108,71,37,2020
2020-02-12,Selangor,52,8,44,2020
2020-02-13,Selangor,67,22,45,2020
2020-02-14,Selangor,47,14,33,2020
2020-02-15,Selangor,132,34,98,2020
2020-02-16,Selangor,121,26,95,2020
2020-02-17,Selangor,32,5,27,2020
2020-02-18,Selangor,62,32,30,2020
2020-02-19,Selangor,85,51,34,2020
2020-02-20,Selangor,137,47,90,2020
2020-02-21,Selangor,107,77,30,2020
2020-02-22,Selangor,71,12,59,2020
2020-02-23,Selangor,110,24,86,2020
2020-02-24,Selangor,23,4,19,2020
2020-02-25,Selangor,49,7,42,2020
2020-02-26,Selangor,54,11,43,2020
2020-02-27,Selangor,119,52,67,2020
2020-02-28,Selangor,72,10,62,2020
2020-02-29,Selangor,296,148,148,2020
2020-03-01,Selangor,177,47,130,2020
2020-03-02,Selangor,77,17,60,2020
2020-03-03,Selangor,60,20,40,2020
2020-03-04,Selangor,200,45,155,2020
2020-03-05,Selangor,93,37,56,2020
2020-03-06,Selangor,54,14,40,2020
2020-03-07,Selangor,97,16,81,2020
2020-03-08,Selangor,147,13,134,2020
2020-03-09,Selangor,48,1,47,2020
2020-03-10,Selangor,72,17,55,2020
2020-03-11,Selangor,102,29,73,2020
2020-03-12,Selangor,10,0,10,2020
2020-03-13,Selangor,54,16,38,2020
2020-03-14,Selangor,109,18,91,2020
2020-03-15,Selangor,54,10,44,2020
2020-03-16,Selangor,52,16,36,2020
2020-03-17,Selangor,30,3,27,2020
2020-03-18,Selangor,9,1,8,2020
2020-03-19,Selangor,35,7,28,2020
2020-03-20,Selangor,71,12,59,2020
2020-03-21,Selangor,53,4,49,2020
2020-03-22,Selangor,62,5,57,2020
2020-03-23,Selangor,91,23,68,2020
2020-03-24,Selangor,98,21,77,2020
2020-03-25,Selangor,133,33,100,2020
2020-03-26,Selangor,169,25,144,2020
2020-03-27,Selangor,161,35,126,2020
2020-03-28,Selangor,77,13,64,2020
2020-03-29,Selangor,54,9,45,2020
2020-03-30,Selangor,108,20,88,2020
2020-03-31,Selangor,111,27,84,2020
2020-04-01,Selangor,18,1,17,2020
2020-04-02,Selangor,20,2,18,2020
2020-04-03,Selangor,23,6,17,2020
2020-04-04,Selangor,9,0,9,2020
2020-04-05,Selangor,13,3,10,2020
2020-04-06,Selangor,17,3,14,2020
2020-04-07,Selangor,27,4,23,2020
2020-04-08,Selangor,54,10,44,2020
2020-04-09,Selangor,46,11,35,2020
2020-04-10,Selangor,42,9,33,2020
2020-04-11,Selangor,38,3,35,2020
2020-04-12,Selangor,30,1,29,2020
2020-04-13,Selangor,77,5,72,2020
2020-04-14,Selangor,96,13,83,2020
2020-04-15,Selangor,58,7,51,2020
2020-04-16,Selangor,49,3,46,2020
2020-04-17,Selangor,44,4,40,2020
2020-04-18,Selangor,55,7,48,2020
2020-04-19,Selangor,82,1,81,2020
2020-04-20,Selangor,129,25,104,2020
2020-04-21,Selangor,86,8,78,2020
2020-04-22,Selangor,137,22,115,2020
2020-04-23,Selangor,100,16,84,2020
2020-04-24,Selangor,26,3,23,2020
2020-04-25,Selangor,19,1,18,2020
2020-04-26,Selangor,65,6,59,2020
2020-04-27,Selangor,25,4,21,2020
2020-04-28,Selangor,39,7,32,2020
2020-04-29,Selangor,49,2,47,2020
2020-04-30,Selangor,61,12,49,2020
2020-05-01,Selangor,33,4,29,2020
2020-05-02,Selangor,48,10,38,2020
2020-05-03,Selangor,18,3,15,2020
2020-05-04,Selangor,24,0,24,2020
2020-05-05,Selangor,27,3,24,2020
2020-05-06,Selangor,37,2,35,2020
2020-05-07,Selangor,171,21,150,2020
2020-05-08,Selangor,64,14,50,2020
2020-05-09,Selangor,134,21,113,2020
2020-05-10,Selangor,160,31,129,2020
2020-05-11,Selangor,77,9,68,2020
2020-05-12,Selangor,21,4,17,2020
2020-05-13,Selangor,33,3,30,2020
2020-05-14,Selangor,19,1,18,2020
2020-05-15,Selangor,59,15,44,2020
2020-05-16,Selangor,148,30,118,2020
2020-05-17,Selangor,137,22,115,2020
2020-05-18,Selangor,21,3,18,2020
2020-05-19,Selangor,80,13,67,2020
2020-05-20,Selangor,94,25,69,2020
2020-05-21,Selangor,108,18,90,2020
2020-05-22,Selangor,108,23,85,2020
2020-05-23,Selangor,0,0,0,2020
2020-05-24,Selangor,0,0,0,2020
2020-05-25,Selangor,0,0,0,2020
2020-05-26,Selangor,46,7,39,2020
2020-05-27,Selangor,110,25,85,2020
2020-05-28,Selangor,109,29,80,2020
2020-05-29,Selangor,134,28,106,2020
2020-05-30,Selangor,311,69,242,2020
2020-05-31,Selangor,370,84,286,2020
2020-06-01,Selangor,100,23,77,2020
2020-06-02,Selangor,115,30,85,2020
2020-06-03,Selangor,88,23,65,2020
2020-06-04,Selangor,58,15,43,2020
2020-06-05,Selangor,69,16,53,2020
2020-06-06,Selangor,145,42,103,2020
2020-06-07,Selangor,306,72,234,2020
2020-06-08,Selangor,134,24,110,2020
2020-06-09,Selangor,53,12,41,2020
2020-06-10,Selangor,55,11,44,2020
2020-06-11,Selangor,58,16,42,2020
2020-06-12,Selangor,14,2,12,2020
2020-06-13,Selangor,68,4,64,2020
2020-06-14,Selangor,144,34,110,2020
2020-06-15,Selangor,69,15,54,2020
2020-06-16,Selangor,64,16,48,2020
2020-06-17,Selangor,140,25,115,2020
2020-06-18,Selangor,46,21,25,2020
2020-06-19,Selangor,76,12,64,2020
2020-06-20,Selangor,92,28,64,2020
2020-06-21,Selangor,165,26,139,2020
2020-06-22,Selangor,47,15,32,2020
2020-06-23,Selangor,81,15,66,2020
2020-06-24,Selangor,51,12,39,2020
2020-06-25,Selangor,50,13,37,2020
2020-06-26,Selangor,13,1,12,2020
2020-06-27,Selangor,112,23,89,2020
2020-06-28,Selangor,366,62,304,2020
2020-06-29,Selangor,5,1,4,2020
2020-06-30,Selangor,72,14,58,2020
2020-07-01,Selangor,35,8,27,2020
2020-07-02,Selangor,33,4,29,2020
2020-07-03,Selangor,39,10,29,2020
2020-07-04,Selangor,99,25,74,2020
2020-07-05,Selangor,152,29,123,2020
2020-07-06,Selangor,69,23,46,2020
2020-07-07,Selangor,42,5,37,2020
2020-07-08,Selangor,65,13,52,2020
2020-07-09,Selangor,46,9,37,2020
2020-07-10,Selangor,60,13,47,2020
2020-07-11,Selangor,88,14,74,2020
2020-07-12,Selangor,144,40,104,2020
2020-07-13,Selangor,73,17,56,2020
2020-07-14,Selangor,97,25,72,2020
2020-07-15,Selangor,80,26,54,2020
2020-07-16,Selangor,69,14,55,2020
2020-07-17,Selangor,111,37,74,2020
2020-07-18,Selangor,79,14,65,2020
2020-07-19,Selangor,114,20,94,2020
2020-07-20,Selangor,42,3,39,2020
2020-07-21,Selangor,62,9,53,2020
2020-07-22,Selangor,96,14,82,2020
2020-07-23,Selangor,32,10,22,2020
2020-07-24,Selangor,39,5,34,2020
2020-07-25,Selangor,88,20,68,2020
2020-07-26,Selangor,221,53,168,2020
2020-07-27,Selangor,33,8,25,2020
2020-07-28,Selangor,43,11,32,2020
2020-07-29,Selangor,47,9,38,2020
2020-07-30,Selangor,47,7,40,2020
2020-07-31,Selangor,0,0,0,2020
2020-08-01,Selangor,0,0,0,2020
2020-08-02,Selangor,0,0,0,2020
2020-08-03,Selangor,41,9,32,2020
2020-08-04,Selangor,72,12,60,2020
2020-08-05,Selangor,63,16,47,2020
2020-08-06,Selangor,77,16,61,2020
2020-08-07,Selangor,82,15,67,2020
2020-08-08,Selangor,172,31,141,2020
2020-08-09,Selangor,270,55,215,2020
2020-08-10,Selangor,20,2,18,2020
2020-08-11,Selangor,85,30,55,2020
2020-08-12,Selangor,69,20,49,2020
2020-08-13,Selangor,21,5,16,2020
2020-08-14,Selangor,151,62,89,2020
2020-08-15,Selangor,91,23,68,2020
2020-08-16,Selangor,149,30,119,2020
2020-08-17,Selangor,21,5,16,2020
2020-08-18,Selangor,130,31,99,2020
2020-08-19,Selangor,41,6,35,2020
2020-08-20,Selangor,78,19,59,2020
2020-08-21,Selangor,82,20,62,2020
2020-08-22,Selangor,138,28,110,2020
2020-08-23,Selangor,180,33,147,2020
2020-08-24,Selangor,59,18,41,2020
2020-08-25,Selangor,132,34,98,2020
2020-08-26,Selangor,63,14,49,2020
2020-08-27,Selangor,29,0,29,2020
2020-08-28,Selangor,65,14,51,2020
2020-08-29,Selangor,83,16,67,2020
2020-08-30,Selangor,213,51,162,2020
2020-08-31,Selangor,170,36,134,2020
2020-09-01,Selangor,14,1,13,2020
2020-09-02,Selangor,41,6,35,2020
2020-09-03,Selangor,61,13,48,2020
2020-09-04,Selangor,46,11,35,2020
2020-09-05,Selangor,111,20,91,2020
2020-09-06,Selangor,254,46,208,2020
2020-09-07,Selangor,12,1,11,2020
2020-09-08,Selangor,29,2,27,2020
2020-09-09,Selangor,54,6,48,2020
2020-09-10,Selangor,42,7,35,2020
2020-09-11,Selangor,35,6,29,2020
2020-09-12,Selangor,135,58,77,2020
2020-09-13,Selangor,36,4,32,2020
2020-09-14,Selangor,13,0,13,2020
2020-09-15,Selangor,25,7,18,2020
2020-09-16,Selangor,154,28,126,2020
2020-09-17,Selangor,86,12,74,2020
2020-09-18,Selangor,35,6,29,2020
2020-09-19,Selangor,115,21,94,2020
2020-09-20,Selangor,220,46,174,2020
2020-09-21,Selangor,35,3,32,2020
2020-09-22,Selangor,49,5,44,2020
2020-09-23,Selangor,58,7,51,2020
2020-09-24,Selangor,77,8,69,2020
2020-09-25,Selangor,38,7,31,2020
2020-09-26,Selangor,123,16,107,2020
2020-09-27,Selangor,221,34,187,2020
2020-09-28,Selangor,11,0,11,2020
2020-09-29,Selangor,38,7,31,2020
2020-09-30,Selangor,37,5,32,2020
2020-10-01,Selangor,35,6,29,2020
2020-10-02,Selangor,44,10,34,2020
2020-10-03,Selangor,43,7,36,2020
2020-10-04,Selangor,179,28,151,2020
2020-10-05,Selangor,22,3,19,2020
2020-10-06,Selangor,59,23,36,2020
2020-10-07,Selangor,45,10,35,2020
2020-10-08,Selangor,108,22,86,2020
2020-10-09,Selangor,30,1,29,2020
2020-10-10,Selangor,40,6,34,2020
2020-10-11,Selangor,102,13,89,2020
2020-10-12,Selangor,13,0,13,2020
2020-10-13,Selangor,41,5,36,2020
2020-10-14,Selangor,41,6,35,2020
2020-10-15,Selangor,67,4,63,2020
2020-10-16,Selangor,110,25,85,2020
2020-10-17,Selangor,157,27,130,2020
2020-10-18,Selangor,73,8,65,2020
2020-10-19,Selangor,64,16,48,2020
2020-10-20,Selangor,53,6,47,2020
2020-10-21,Selangor,107,16,91,2020
2020-10-22,Selangor,91,14,77,2020
2020-10-23,Selangor,119,28,91,2020
2020-10-24,Selangor,221,38,183,2020
2020-10-25,Selangor,168,29,139,2020
2020-10-26,Selangor,58,12,46,2020
2020-10-27,Selangor,130,23,107,2020
2020-10-28,Selangor,127,30,97,2020
2020-10-29,Selangor,276,60,216,2020
2020-10-30,Selangor,158,25,133,2020
2020-10-31,Selangor,217,71,146,2020
2020-11-01,Selangor,158,22,136,2020
2020-11-02,Selangor,37,6,31,2020
2020-11-03,Selangor,56,6,50,2020
2020-11-04,Selangor,61,7,54,2020
2020-11-05,Selangor,46,11,35,2020
2020-11-06,Selangor,8,0,8,2020
2020-11-07,Selangor,103,21,82,2020
2020-11-08,Selangor,64,20,44,2020
2020-11-09,Selangor,18,2,16,2020
2020-11-10,Selangor,32,8,24,2020
2020-11-11,Selangor,48,6,42,2020
2020-11-12,Selangor,27,2,25,2020
2020-11-13,Selangor,24,1,23,2020
2020-11-14,Selangor,94,14,80,2020
2020-11-15,Selangor,128,20,108,2020
2020-11-16,Selangor,42,5,37,2020
2020-11-17,Selangor,43,8,35,2020
2020-11-18,Selangor,42,6,36,2020
2020-11-19,Selangor,26,6,20,2020
2020-11-20,Selangor,38,6,32,2020
2020-11-21,Selangor,347,177,170,2020
2020-11-22,Selangor,147,32,115,2020
2020-11-23,Selangor,14,0,14,2020
2020-11-24,Selangor,31,2,29,2020
2020-11-25,Selangor,50,10,40,2020
2020-11-26,Selangor,79,7,72,2020
2020-11-27,Selangor,38,10,28,2020
2020-11-28,Selangor,152,22,130,2020
2020-11-29,Selangor,252,39,213,2020
2020-11-30,Selangor,14,3,11,2020
2020-12-01,Selangor,37,10,27,2020
2020-12-02,Selangor,35,7,28,2020
2020-12-03,Selangor,23,5,18,2020
2020-12-04,Selangor,71,17,54,2020
2020-12-05,Selangor,108,17,91,2020
2020-12-06,Selangor,175,35,140,2020
2020-12-07,Selangor,10,1,9,2020
2020-12-08,Selangor,17,2,15,2020
2020-12-09,Selangor,59,4,55,2020
2020-12-10,Selangor,42,6,36,2020
2020-12-11,Selangor,19,5,14,2020
2020-12-12,Selangor,75,12,63,2020
2020-12-13,Selangor,137,19,118,2020
2020-12-14,Selangor,13,0,13,2020
2020-12-15,Selangor,26,2,24,2020
2020-12-16,Selangor,28,5,23,2020
2020-12-17,Selangor,66,5,61,2020
2020-12-18,Selangor,39,2,37,2020
2020-12-19,Selangor,62,8,54,2020
2020-12-20,Selangor,220,37,183,2020
2020-12-21,Selangor,27,4,23,2020
2020-12-22,Selangor,29,7,22,2020
2020-12-23,Selangor,57,7,50,2020
2020-12-24,Selangor,37,5,32,2020
2020-12-25,Selangor,115,12,103,2020
2020-12-26,Selangor,38,5,33,2020
2020-12-27,Selangor,62,5,57,2020
2020-12-28,Selangor,30,3,27,2020
2020-12-29,Selangor,26,3,23,2020
2020-12-30,Selangor,50,6,44,2020
2020-12-31,Selangor,57,12,45,2020
2021-01-01,Selangor,92,13,79,2021
2021-01-02,Selangor,114,20,94,2021
2021-01-03,Selangor,107,11,96,2021
2021-01-04,Selangor,16,2,14,2021
2021-01-05,Selangor,67,12,55,2021
2021-01-06,Selangor,35,4,31,2021
2021-01-07,Selangor,36,2,34,2021
2021-01-08,Selangor,28,1,27,2021
2021-01-09,Selangor,53,4,49,2021
2021-01-10,Selangor,66,6,60,2021
2021-01-11,Selangor,8,0,8,2021
2021-01-12,Selangor,51,8,43,2021
2021-01-13,Selangor,30,6,24,2021
2021-01-14,Selangor,12,2,10,2021
2021-01-15,Selangor,27,3,24,2021
2021-01-16,Selangor,172,28,144,2021
2021-01-17,Selangor,206,42,164,2021
2021-01-18,Selangor,28,4,24,2021
2021-01-19,Selangor,37,4,33,2021
2021-01-20,Selangor,23,0,23,2021
2021-01-21,Selangor,30,5,25,2021
2021-01-22,Selangor,34,8,26,2021
2021-01-23,Selangor,77,10,67,2021
2021-01-24,Selangor,165,35,130,2021
2021-01-25,Selangor,28,4,24,2021
2021-01-26,Selangor,30,4,26,2021
2021-01-27,Selangor,84,18,66,2021
2021-01-28,Selangor,76,14,62,2021
2021-01-29,Selangor,45,3,42,2021
2021-01-30,Selangor,123,23,100,2021
2021-01-31,Selangor,138,27,111,2021
2021-02-01,Selangor,32,4,28,2021
2021-02-02,Selangor,111,20,91,2021
2021-02-03,Selangor,31,4,27,2021
2021-02-04,Selangor,48,8,40,2021
2021-02-05,Selangor,86,23,63,2021
2021-02-06,Selangor,68,12,56,2021
2021-02-07,Selangor,147,19,128,2021
2021-02-08,Selangor,27,3,24,2021
2021-02-09,Selangor,54,9,45,2021
2021-02-10,Selangor,46,9,37,2021
2021-02-11,Selangor,62,15,47,2021
2021-02-12,Selangor,94,18,76,2021
2021-02-13,Selangor,160,44,116,2021
2021-02-14,Selangor,231,46,185,2021
2021-02-15,Selangor,20,2,18,2021
2021-02-16,Selangor,60,8,52,2021
2021-02-17,Selangor,78,8,70,2021
2021-02-18,Selangor,117,16,101,2021
2021-02-19,Selangor,78,12,66,2021
2021-02-20,Selangor,197,35,162,2021
2021-02-21,Selangor,183,29,154,2021
2021-02-22,Selangor,64,9,55,2021
2021-02-23,Selangor,63,4,59,2021
2021-02-24,Selangor,68,6,62,2021
2021-02-25,Selangor,71,13,58,2021
2021-02-26,Selangor,62,11,51,2021
2021-02-27,Selangor,81,13,68,2021
2021-02-28,Selangor,193,29,164,2021
2021-03-01,Selangor,21,4,17,2021
2021-03-02,Selangor,47,6,41,2021
2021-03-03,Selangor,55,7,48,2021
2021-03-04,Selangor,79,21,58,2021
2021-03-05,Selangor,80,18,62,2021
2021-03-06,Selangor,142,18,124,2021
2021-03-07,Selangor,220,36,184,2021
2021-03-08,Selangor,29,2,27,2021
2021-03-09,Selangor,48,7,41,2021
2021-03-10,Selangor,105,17,88,2021
2021-03-11,Selangor,56,9,47,2021
2021-03-12,Selangor,85,17,68,2021
2021-03-13,Selangor,68,2,66,2021
2021-03-14,Selangor,138,24,114,2021
2021-03-15,Selangor,26,4,22,2021
2021-03-16,Selangor,45,4,41,2021
2021-03-17,Selangor,77,14,63,2021
2021-03-18,Selangor,52,11,41,2021
2021-03-19,Selangor,67,18,49,2021
2021-03-20,Selangor,81,10,71,2021
2021-03-21,Selangor,272,29,243,2021
2021-03-22,Selangor,95,27,68,2021
2021-03-23,Selangor,37,8,29,2021
2021-03-24,Selangor,64,7,57,2021
2021-03-25,Selangor,66,26,40,2021
2021-03-26,Selangor,47,10,37,2021
2021-03-27,Selangor,157,20,137,2021
2021-03-28,Selangor,228,19,209,2021
2021-03-29,Selangor,23,3,20,2021
2021-03-30,Selangor,39,6,33,2021
2021-03-31,Selangor,31,6,25,2021
2021-04-01,Selangor,38,5,33,2021
2021-04-02,Selangor,56,4,52,2021
2021-04-03,Selangor,106,18,88,2021
2021-04-04,Selangor,190,46,144,2021
2021-04-05,Selangor,68,8,60,2021
2021-04-06,Selangor,84,10,74,2021
2021-04-07,Selangor,74,19,55,2021
2021-04-08,Selangor,30,5,25,2021
2021-04-09,Selangor,87,19,68,2021
2021-04-10,Selangor,236,32,204,2021
2021-04-11,Selangor,250,39,211,2021
2021-04-12,Selangor,52,10,42,2021
2021-04-13,Selangor,13,3,10,2021
2021-04-14,Selangor,40,8,32,2021
2021-04-15,Selangor,36,10,26,2021
2021-04-16,Selangor,42,7,35,2021
2021-04-17,Selangor,30,3,27,2021
2021-04-18,Selangor,31,5,26,2021
2021-04-19,Selangor,12,0,12,2021
2021-04-20,Selangor,35,6,29,2021
2021-04-21,Selangor,33,10,23,2021
2021-04-22,Selangor,38,7,31,2021
2021-04-23,Selangor,50,11,39,2021
2021-04-24,Selangor,90,13,77,2021
2021-04-25,Selangor,125,16,109,2021
2021-04-26,Selangor,36,6,30,2021
2021-04-27,Selangor,77,13,64,2021
2021-04-28,Selangor,35,8,27,2021
2021-04-29,Selangor,48,3,45,2021
2021-04-30,Selangor,73,9,64,2021
2021-05-01,Selangor,135,16,119,2021
2021-05-02,Selangor,96,10,86,2021
2021-05-03,Selangor,43,9,34,2021
2021-05-04,Selangor,25,5,20,2021
2021-05-05,Selangor,55,7,48,2021
2021-05-06,Selangor,41,5,36,2021
2021-05-07,Selangor,87,10,77,2021
2021-05-08,Selangor,156,20,136,2021
2021-05-09,Selangor,174,40,134,2021
2021-05-10,Selangor,62,10,52,2021
2021-05-11,Selangor,63,2,61,2021
2021-05-12,Selangor,24,1,23,2021
2021-05-13,Selangor,0,0,0,2021
2021-05-14,Selangor,0,0,0,2021
2021-05-15,Selangor,0,0,0,2021
2021-05-16,Selangor,188,25,163,2021
2021-05-17,Selangor,88,11,77,2021
2021-05-18,Selangor,120,14,106,2021
2021-05-19,Selangor,120,17,103,2021
2021-05-20,Selangor,103,20,83,2021
2021-05-21,Selangor,78,11,67,2021
2021-05-22,Selangor,168,28,140,2021
2021-05-23,Selangor,272,53,219,2021
2021-05-24,Selangor,48,13,35,2021
2021-05-25,Selangor,51,12,39,2021
2021-05-26,Selangor,161,30,131,2021
2021-05-27,Selangor,26,4,22,2021
2021-05-28,Selangor,78,9,69,2021
2021-05-29,Selangor,124,21,103,2021
2021-05-30,Selangor,103,13,90,2021
2021-05-31,Selangor,44,2,42,2021
2021-06-01,Selangor,13,2,11,2021
2021-06-02,Selangor,108,15,93,2021
2021-06-03,Selangor,131,24,107,2021
2021-06-04,Selangor,64,9,55,2021
2021-06-05,Selangor,126,14,112,2021
2021-06-06,Selangor,93,12,81,2021
2021-06-07,Selangor,90,7,83,2021
2021-06-08,Selangor,47,10,37,2021
2021-06-09,Selangor,123,15,108,2021
2021-06-10,Selangor,110,25,85,2021
2021-06-11,Selangor,75,11,64,2021
2021-06-12,Selangor,53,9,44,2021
2021-06-13,Selangor,252,27,225,2021
2021-06-14,Selangor,36,6,30,2021
2021-06-15,Selangor,67,15,52,2021
2021-06-16,Selangor,70,8,62,2021
2021-06-17,Selangor,79,11,68,2021
2021-06-18,Selangor,40,6,34,2021
2021-06-19,Selangor,69,6,63,2021
2021-06-20,Selangor,46,6,40,2021
2021-06-21,Selangor,24,4,20,2021
2021-06-22,Selangor,61,9,52,2021
2021-06-23,Selangor,92,15,77,2021
2021-06-24,Selangor,55,13,42,2021
2021-06-25,Selangor,15,1,14,2021
2021-06-26,Selangor,127,14,113,2021
2021-06-27,Selangor,202,34,168,2021
2021-06-28,Selangor,43,8,35,2021
2021-06-29,Selangor,49,9,40,2021
2021-06-30,Selangor,80,12,68,2021
2021-07-01,Selangor,32,2,30,2021
2021-07-02,Selangor,69,8,61,2021
2021-07-03,Selangor,29,1,28,2021
2021-07-04,Selangor,21,1,20,2021
2021-07-05,Selangor,21,3,18,2021
2021-07-06,Selangor,24,3,21,2021
2021-07-07,Selangor,38,7,31,2021
2021-07-08,Selangor,28,6,22,2021
2021-07-09,Selangor,22,3,19,2021
2021-07-10,Selangor,14,6,8,2021
2021-07-11,Selangor,14,0,14,2021
2021-07-12,Selangor,9,0,9,2021
2021-07-13,Selangor,19,3,16,2021
2021-07-14,Selangor,23,3,20,2021
2021-07-15,Selangor,12,1,11,2021
2021-07-16,Selangor,31,5,26,2021
2021-07-17,Selangor,20,0,20,2021
2021-07-18,Selangor,7,1,6,2021
2021-07-19,Selangor,9,2,7,2021
2021-07-20,Selangor,0,0,0,2021
2021-07-21,Selangor,9,0,9,2021
2021-07-22,Selangor,23,6,17,2021
2021-07-23,Selangor,50,3,47,2021
2021-07-24,Selangor,52,3,49,2021
2021-07-25,Selangor,51,5,46,2021
2021-07-26,Selangor,36,5,31,2021
2021-07-27,Selangor,26,3,23,2021
2021-07-28,Selangor,40,6,34,2021
2021-07-29,Selangor,44,5,39,2021
2021-07-30,Selangor,26,4,22,2021
2021-07-31,Selangor,74,7,67,2021
2021-08-01,Selangor,109,17,92,2021
2021-08-02,Selangor,111,16,95,2021
2021-08-03,Selangor,58,8,50,2021
2021-08-04,Selangor,51,7,44,2021
2021-08-05,Selangor,31,6,25,2021
2021-08-06,Selangor,38,2,36,2021
2021-08-07,Selangor,68,11,57,2021
2021-08-08,Selangor,143,29,114,2021
2021-08-09,Selangor,34,4,30,2021
2021-08-10,Selangor,84,15,69,2021
2021-08-11,Selangor,43,7,36,2021
2021-08-12,Selangor,56,8,48,2021
2021-08-13,Selangor,51,8,43,2021
2021-08-14,Selangor,51,9,42,2021
2021-08-15,Selangor,101,14,87,2021
2021-08-16,Selangor,68,16,52,2021
2021-08-17,Selangor,64,7,57,2021
2021-08-18,Selangor,71,9,62,2021
2021-08-19,Selangor,54,10,44,2021
2021-08-20,Selangor,68,18,50,2021
2021-08-21,Selangor,75,15,60,2021
2021-08-22,Selangor,145,17,128,2021
2021-08-23,Selangor,48,5,43,2021
2021-08-24,Selangor,65,9,56,2021
2021-08-25,Selangor,58,4,54,2021
2021-08-26,Selangor,61,9,52,2021
2021-08-27,Selangor,63,16,47,2021
2021-08-28,Selangor,71,8,63,2021
2021-08-29,Selangor,232,31,201,2021
2021-08-30,Selangor,57,11,46,2021
2021-08-31,Selangor,177,30,147,2021
2021-09-01,Selangor,60,14,46,2021
2021-09-02,Selangor,59,17,42,2021
2021-09-03,Selangor,97,18,79,2021
2021-09-04,Selangor,48,6,42,2021
2021-09-05,Selangor,79,13,66,2021
2021-09-06,Selangor,26,2,24,2021
2021-09-07,Selangor,59,6,53,2021
2021-09-08,Selangor,102,11,91,2021
2021-09-09,Selangor,65,15,50,2021
2021-09-10,Selangor,82,11,71,2021
2021-09-11,Selangor,89,10,79,2021
2021-09-12,Selangor,113,17,96,2021
2021-09-13,Selangor,37,9,28,2021
2021-09-14,Selangor,39,6,33,2021
2021-09-15,Selangor,8,0,8,2021
2021-09-16,Selangor,157,48,109,2021
2021-09-17,Selangor,81,14,67,2021
2021-09-18,Selangor,77,12,65,2021
2021-09-19,Selangor,121,14,107,2021
2021-09-20,Selangor,68,5,63,2021
2021-09-21,Selangor,119,29,90,2021
2021-09-22,Selangor,102,27,75,2021
2021-09-23,Selangor,42,3,39,2021
2021-09-24,Selangor,56,7,49,2021
2021-09-25,Selangor,98,13,85,2021
2021-09-26,Selangor,124,16,108,2021
2021-09-27,Selangor,31,3,28,2021
2021-09-28,Selangor,64,6,58,2021
2021-09-29,Selangor,45,9,36,2021
2021-09-30,Selangor,73,10,63,2021
2021-10-01,Selangor,58,12,46,2021
2021-10-02,Selangor,60,10,50,2021
2021-10-03,Selangor,133,23,110,2021
2021-10-04,Selangor,17,4,13,2021
2021-10-05,Selangor,47,9,38,2021
2021-10-06,Selangor,48,5,43,2021
2021-10-07,Selangor,47,7,40,2021
2021-10-08,Selangor,33,6,27,2021
2021-10-09,Selangor,76,7,69,2021
2021-10-10,Selangor,254,30,224,2021
2021-10-11,Selangor,21,1,20,2021
2021-10-12,Selangor,26,5,21,2021
2021-10-13,Selangor,52,22,30,2021
2021-10-14,Selangor,27,2,25,2021
2021-10-15,Selangor,22,8,14,2021
2021-10-16,Selangor,76,34,42,2021
2021-10-17,Selangor,158,36,122,2021
2021-10-18,Selangor,15,2,13,2021
2021-10-19,Selangor,150,17,133,2021
2021-10-20,Selangor,32,5,27,2021
2021-10-21,Selangor,41,2,39,2021
2021-10-22,Selangor,29,3,26,2021
2021-10-23,Selangor,78,13,65,2021
2021-10-24,Selangor,123,20,103,2021
2021-10-25,Selangor,21,2,19,2021
2021-10-26,Selangor,30,5,25,2021
2021-10-27,Selangor,21,5,16,2021
2021-10-28,Selangor,37,13,24,2021
2021-10-29,Selangor,29,2,27,2021
2021-10-30,Selangor,41,3,38,2021
2021-10-31,Selangor,239,35,204,2021
2021-11-01,Selangor,14,5,9,2021
2021-11-02,Selangor,43,7,36,2021
2021-11-03,Selangor,42,8,34,2021
2021-11-04,Selangor,119,25,94,2021
2021-11-05,Selangor,51,10,41,2021
2021-11-06,Selangor,114,31,83,2021
2021-11-07,Selangor,135,19,116,2021
2021-11-08,Selangor,10,1,9,2021
2021-11-09,Selangor,50,8,42,2021
2021-11-10,Selangor,35,6,29,2021
2021-11-11,Selangor,90,24,66,2021
2021-11-12,Selangor,86,12,74,2021
2021-11-13,Selangor,133,24,109,2021
2021-11-14,Selangor,211,45,166,2021
2021-11-15,Selangor,11,2,9,2021
2021-11-16,Selangor,25,0,25,2021
2021-11-17,Selangor,88,14,74,2021
2021-11-18,Selangor,51,6,45,2021
2021-11-19,Selangor,63,12,51,2021
2021-11-20,Selangor,95,13,82,2021
2021-11-21,Selangor,170,34,136,2021
2021-11-22,Selangor,20,2,18,2021
2021-11-23,Selangor,54,11,43,2021
2021-11-24,Selangor,48,9,39,2021
2021-11-25,Selangor,41,6,35,2021
2021-11-26,Selangor,32,3,29,2021
2021-11-27,Selangor,64,8,56,2021
2021-11-28,Selangor,101,21,80,2021
2021-11-29,Selangor,22,6,16,2021
2021-11-30,Selangor,72,15,57,2021
2021-12-01,Selangor,101,20,81,2021
2021-12-02,Selangor,43,5,38,2021
2021-12-03,Selangor,43,11,32,2021
2021-12-04,Selangor,102,19,83,2021
2021-12-05,Selangor,97,14,83,2021
2021-12-06,Selangor,14,3,11,2021
2021-12-07,Selangor,53,8,45,2021
2021-12-08,Selangor,73,22,51,2021
2021-12-09,Selangor,79,22,57,2021
2021-12-10,Selangor,95,32,63,2021
2021-12-11,Selangor,174,46,128,2021
2021-12-12,Selangor,232,30,202,2021
2021-12-13,Selangor,6,0,6,2021
2021-12-14,Selangor,32,3,29,2021
2021-12-15,Selangor,55,13,42,2021
2021-12-16,Selangor,33,5,28,2021
2021-12-17,Selangor,65,12,53,2021
2021-12-18,Selangor,1,0,1,2021
2021-12-19,Selangor,0,0,0,2021
2021-12-20,Selangor,6,2,4,2021
2021-12-21,Selangor,36,2,34,2021
2021-12-22,Selangor,51,7,44,2021
2021-12-23,Selangor,43,7,36,2021
2021-12-24,Selangor,60,10,50,2021
2021-12-25,Selangor,119,20,99,2021
2021-12-26,Selangor,193,35,158,2021
2021-12-27,Selangor,15,1,14,2021
2021-12-28,Selangor,52,7,45,2021
2021-12-29,Selangor,45,7,38,2021
2021-12-30,Selangor,44,8,36,2021
2021-12-31,Selangor,63,8,55,2021
2022-01-01,Selangor,126,12,114,2022
2022-01-02,Selangor,134,12,122,2022
2022-01-03,Selangor,12,1,11,2022
2022-01-04,Selangor,47,5,42,2022
2022-01-05,Selangor,40,7,33,2022
2022-01-06,Selangor,41,7,34,2022
2022-01-07,Selangor,28,3,25,2022
2022-01-08,Selangor,197,40,157,2022
2022-01-09,Selangor,154,26,128,2022
2022-01-10,Selangor,24,2,22,2022
2022-01-11,Selangor,35,7,28,2022
2022-01-12,Selangor,56,5,51,2022
2022-01-13,Selangor,33,4,29,2022
2022-01-14,Selangor,56,11,45,2022
2022-01-15,Selangor,99,10,89,2022
2022-01-16,Selangor,120,16,104,2022
2022-01-17,Selangor,31,8,23,2022
2022-01-18,Selangor,131,28,103,2022
2022-01-19,Selangor,58,10,48,2022
2022-01-20,Selangor,84,18,66,2022
2022-01-21,Selangor,37,4,33,2022
2022-01-22,Selangor,126,9,117,2022
2022-01-23,Selangor,170,35,135,2022
2022-01-24,Selangor,38,7,31,2022
2022-01-25,Selangor,80,23,57,2022
2022-01-26,Selangor,45,3,42,2022
2022-01-27,Selangor,48,6,42,2022
2022-01-28,Selangor,61,10,51,2022
2022-01-29,Selangor,70,9,61,2022
2022-01-30,Selangor,180,21,159,2022
2022-01-31,Selangor,31,2,29,2022
2022-02-01,Selangor,69,7,62,2022
2022-02-02,Selangor,78,12,66,2022
2022-02-03,Selangor,63,15,48,2022
2022-02-04,Selangor,62,16,46,2022
2022-02-05,Selangor,73,10,63,2022
2022-02-06,Selangor,159,22,137,2022
2022-02-07,Selangor,22,3,19,2022
2022-02-08,Selangor,38,5,33,2022
2022-02-09,Selangor,46,7,39,2022
2022-02-10,Selangor,62,26,36,2022
2022-02-11,Selangor,67,21,46,2022
2022-02-12,Selangor,189,41,148,2022
2022-02-13,Selangor,153,26,127,2022
2022-02-14,Selangor,55,14,41,2022
2022-02-15,Selangor,44,4,40,2022
2022-02-16,Selangor,38,1,37,2022
2022-02-17,Selangor,65,8,57,2022
2022-02-18,Selangor,58,17,41,2022
2022-02-19,Selangor,84,21,63,2022
2022-02-20,Selangor,94,19,75,2022
2022-02-21,Selangor,13,0,13,2022
2022-02-22,Selangor,36,3,33,2022
2022-02-23,Selangor,42,4,38,2022
2022-02-24,Selangor,97,26,71,2022
2022-02-25,Selangor,53,7,46,2022
2022-02-26,Selangor,100,16,84,2022
2022-02-27,Selangor,175,37,138,2022
2022-02-28,Selangor,23,9,14,2022
2022-03-01,Selangor,45,8,37,2022
2022-03-02,Selangor,48,6,42,2022
2022-03-03,Selangor,45,7,38,2022
2022-03-04,Selangor,77,11,66,2022
2022-03-05,Selangor,35,8,27,2022
2022-03-06,Selangor,200,44,156,2022
2022-03-07,Selangor,20,3,17,2022
2022-03-08,Selangor,30,4,26,2022
2022-03-09,Selangor,33,7,26,2022
2022-03-10,Selangor,36,4,32,2022
2022-03-11,Selangor,41,5,36,2022
2022-03-12,Selangor,92,10,82,2022
2022-03-13,Selangor,169,26,143,2022
2022-03-14,Selangor,19,2,17,2022
2022-03-15,Selangor,77,12,65,2022
2022-03-16,Selangor,53,8,45,2022
2022-03-17,Selangor,29,3,26,2022
2022-03-18,Selangor,47,17,30,2022
2022-03-19,Selangor,76,27,49,2022
2022-03-20,Selangor,159,26,133,2022
2022-03-21,Selangor,21,2,19,2022
2022-03-22,Selangor,42,5,37,2022
2022-03-23,Selangor,78,42,36,2022
2022-03-24,Selangor,68,16,52,2022
2022-03-25,Selangor,63,10,53,2022
2022-03-26,Selangor,128,10,118,2022
2022-03-27,Selangor,201,42,159,2022
2022-03-28,Selangor,30,2,28,2022
2022-03-29,Selangor,58,10,48,2022
2022-03-30,Selangor,60,10,50,2022
2022-03-31,Selangor,46,7,39,2022
2022-04-01,Selangor,93,12,81,2022
2022-04-02,Selangor,219,41,178,2022
2022-04-03,Selangor,144,40,104,2022
2022-04-04,Selangor,61,15,46,2022
2022-04-05,Selangor,57,8,49,2022
2022-04-06,Selangor,36,6,30,2022
2022-04-07,Selangor,70,14,56,2022
2022-04-08,Selangor,75,25,50,2022
2022-04-09,Selangor,25,8,17,2022
2022-04-10,Selangor,225,36,189,2022
2022-04-11,Selangor,34,9,25,2022
2022-04-12,Selangor,18,6,12,2022
2022-04-13,Selangor,91,15,76,2022
2022-04-14,Selangor,73,16,57,2022
2022-04-15,Selangor,80,28,52,2022
2022-04-16,Selangor,75,23,52,2022
2022-04-17,Selangor,160,12,148,2022
2022-04-18,Selangor,14,0,14,2022
2022-04-19,Selangor,109,20,89,2022
2022-04-20,Selangor,44,17,27,2022
2022-04-21,Selangor,44,8,36,2022
2022-04-22,Selangor,61,13,48,2022
2022-04-23,Selangor,108,15,93,2022
2022-04-24,Selangor,139,35,104,2022
2022-04-25,Selangor,27,5,22,2022
2022-04-26,Selangor,47,15,32,2022
2022-04-27,Selangor,34,9,25,2022
2022-04-28,Selangor,36,2,34,2022
2022-04-29,Selangor,61,13,48,2022
2022-04-30,Selangor,65,7,58,2022
2022-05-01,Selangor,247,37,210,2022
2022-05-02,Selangor,0,0,0,2022
2022-05-03,Selangor,0,0,0,2022
2022-05-04,Selangor,0,0,0,2022
2022-05-05,Selangor,15,0,15,2022
2022-05-06,Selangor,38,8,30,2022
2022-05-07,Selangor,41,3,38,2022
2022-05-08,Selangor,145,14,131,2022
2022-05-09,Selangor,45,5,40,2022
2022-05-10,Selangor,108,24,84,2022
2022-05-11,Selangor,57,7,50,2022
2022-05-12,Selangor,62,10,52,2022
2022-05-13,Selangor,86,17,69,2022
2022-05-14,Selangor,125,25,100,2022
2022-05-15,Selangor,157,29,128,2022
2022-05-16,Selangor,110,19,91,2022
2022-05-17,Selangor,62,10,52,2022
2022-05-18,Selangor,67,12,55,2022
2022-05-19,Selangor,109,21,88,2022
2022-05-20,Selangor,52,6,46,2022
2022-05-21,Selangor,83,11,72,2022
2022-05-22,Selangor,217,26,191,2022
2022-05-23,Selangor,21,2,19,2022
2022-05-24,Selangor,97,30,67,2022
2022-05-25,Selangor,40,8,32,2022
2022-05-26,Selangor,49,11,38,2022
2022-05-27,Selangor,62,13,49,2022
2022-05-28,Selangor,88,19,69,2022
2022-05-29,Selangor,144,25,119,2022
2022-05-30,Selangor,8,0,8,2022
2022-05-31,Selangor,127,38,89,2022
2022-06-01,Selangor,103,42,61,2022
2022-06-02,Selangor,35,7,28,2022
2022-06-03,Selangor,83,17,66,2022
2022-06-04,Selangor,123,16,107,2022
2022-06-05,Selangor,158,29,129,2022
2022-06-06,Selangor,137,33,104,2022
2022-06-07,Selangor,80,4,76,2022
2022-06-08,Selangor,62,12,50,2022
2022-06-09,Selangor,72,13,59,2022
2022-06-10,Selangor,16,1,15,2022
2022-06-11,Selangor,98,19,79,2022
2022-06-12,Selangor,327,69,258,2022
2022-06-13,Selangor,15,0,15,2022
2022-06-14,Selangor,107,25,82,2022
2022-06-15,Selangor,66,16,50,2022
2022-06-16,Selangor,111,67,44,2022
2022-06-17,Selangor,157,34,123,2022
2022-06-18,Selangor,83,9,74,2022
2022-06-19,Selangor,216,31,185,2022
2022-06-20,Selangor,10,0,10,2022
2022-06-21,Selangor,76,7,69,2022
2022-06-22,Selangor,108,50,58,2022
2022-06-23,Selangor,72,17,55,2022
2022-06-24,Selangor,50,10,40,2022
2022-06-25,Selangor,81,15,66,2022
2022-06-26,Selangor,124,25,99,2022
2022-06-27,Selangor,28,3,25,2022
2022-06-28,Selangor,49,5,44,2022
2022-06-29,Selangor,95,33,62,2022
2022-06-30,Selangor,99,17,82,2022
2022-07-01,Selangor,87,17,70,2022
2022-07-02,Selangor,146,49,97,2022
2022-07-03,Selangor,155,34,121,2022
2022-07-04,Selangor,34,3,31,2022
2022-07-05,Selangor,105,26,79,2022
2022-07-06,Selangor,51,5,46,2022
2022-07-07,Selangor,90,34,56,2022
2022-07-08,Selangor,55,7,48,2022
2022-07-09,Selangor,90,11,79,2022
2022-07-10,Selangor,0,0,0,2022
2022-07-11,Selangor,44,1,43,2022
2022-07-12,Selangor,40,6,34,2022
2022-07-13,Selangor,98,15,83,2022
2022-07-14,Selangor,50,8,42,2022
2022-07-15,Selangor,14,2,12,2022
2022-07-16,Selangor,333,166,167,2022
2022-07-17,Selangor,45,24,21,2022
2022-07-18,Selangor,50,15,35,2022
2022-07-19,Selangor,111,25,86,2022
2022-07-20,Selangor,71,10,61,2022
2022-07-21,Selangor,97,29,68,2022
2022-07-22,Selangor,36,4,32,2022
2022-07-23,Selangor,124,30,94,2022
2022-07-24,Selangor,246,44,202,2022
2022-07-25,Selangor,6,1,5,2022
2022-07-26,Selangor,79,9,70,2022
2022-07-27,Selangor,88,37,51,2022
2022-07-28,Selangor,70,29,41,2022
2022-07-29,Selangor,68,25,43,2022
2022-07-30,Selangor,29,6,23,2022
2022-07-31,Selangor,406,99,307,2022
2022-08-01,Selangor,4,0,4,2022
2022-08-02,Selangor,52,12,40,2022
2022-08-03,Selangor,35,3,32,2022
2022-08-04,Selangor,48,11,37,2022
2022-08-05,Selangor,28,6,22,2022
2022-08-06,Selangor,41,8,33,2022
2022-08-07,Selangor,211,24,187,2022
2022-08-08,Selangor,10,0,10,2022
2022-08-09,Selangor,28,4,24,2022
2022-08-10,Selangor,98,11,87,2022
2022-08-11,Selangor,47,16,31,2022
2022-08-12,Selangor,42,1,41,2022
2022-08-13,Selangor,31,8,23,2022
2022-08-14,Selangor,195,25,170,2022
2022-08-15,Selangor,59,8,51,2022
2022-08-16,Selangor,35,4,31,2022
2022-08-17,Selangor,62,14,48,2022
2022-08-18,Selangor,64,20,44,2022
2022-08-19,Selangor,99,20,79,2022
2022-08-20,Selangor,163,23,140,2022
2022-08-21,Selangor,203,32,171,2022
2022-08-22,Selangor,13,0,13,2022
2022-08-23,Selangor,104,33,71,2022
2022-08-24,Selangor,93,35,58,2022
2022-08-25,Selangor,62,12,50,2022
2022-08-26,Selangor,60,19,41,2022
2022-08-27,Selangor,143,27,116,2022
2022-08-28,Selangor,97,20,77,2022
2022-08-29,Selangor,34,10,24,2022
2022-08-30,Selangor,72,19,53,2022
2022-08-31,Selangor,220,37,183,2022
2022-09-01,Selangor,48,22,26,2022
2022-09-02,Selangor,25,4,21,2022
2022-09-03,Selangor,136,40,96,2022
2022-09-04,Selangor,176,39,137,2022
2022-09-05,Selangor,27,6,21,2022
2022-09-06,Selangor,36,6,30,2022
2022-09-07,Selangor,50,7,43,2022
2022-09-08,Selangor,79,17,62,2022
2022-09-09,Selangor,47,8,39,2022
2022-09-10,Selangor,49,14,35,2022
2022-09-11,Selangor,153,21,132,2022
2022-09-12,Selangor,5,0,5,2022
2022-09-13,Selangor,63,31,32,2022
2022-09-14,Selangor,58,15,43,2022
2022-09-15,Selangor,46,14,32,2022
2022-09-16,Selangor,179,35,144,2022
2022-09-17,Selangor,205,38,167,2022
2022-09-18,Selangor,255,64,191,2022
2022-09-19,Selangor,10,1,9,2022
2022-09-20,Selangor,9,0,9,2022
2022-09-21,Selangor,62,16,46,2022
2022-09-22,Selangor,64,23,41,2022
2022-09-23,Selangor,88,13,75,2022
2022-09-24,Selangor,64,5,59,2022
2022-09-25,Selangor,200,31,169,2022
2022-09-26,Selangor,8,0,8,2022
2022-09-27,Selangor,74,47,27,2022
2022-09-28,Selangor,47,10,37,2022
2022-09-29,Selangor,21,4,17,2022
2022-09-30,Selangor,37,18,19,2022
2022-10-01,Selangor,154,16,138,2022
2022-10-02,Selangor,146,28,118,2022
2022-10-03,Selangor,13,0,13,2022
2022-10-04,Selangor,84,13,71,2022
2022-10-05,Selangor,99,22,77,2022
2022-10-06,Selangor,80,18,62,2022
2022-10-07,Selangor,66,13,53,2022
2022-10-08,Selangor,137,22,115,2022
2022-10-09,Selangor,254,41,213,2022
2022-10-10,Selangor,0,0,0,2022
2022-10-11,Selangor,9,0,9,2022
2022-10-12,Selangor,94,34,60,2022
2022-10-13,Selangor,70,29,41,2022
2022-10-14,Selangor,88,9,79,2022
2022-10-15,Selangor,128,16,112,2022
2022-10-16,Selangor,223,44,179,2022
2022-10-17,Selangor,36,9,27,2022
2022-10-18,Selangor,39,17,22,2022
2022-10-19,Selangor,53,4,49,2022
2022-10-20,Selangor,41,5,36,2022
2022-10-21,Selangor,21,3,18,2022
2022-10-22,Selangor,149,42,107,2022
2022-10-23,Selangor,130,22,108,2022
2022-10-24,Selangor,129,22,107,2022
2022-10-25,Selangor,5,0,5,2022
2022-10-26,Selangor,48,12,36,2022
2022-10-27,Selangor,42,32,10,2022
2022-10-28,Selangor,38,5,33,2022
2022-10-29,Selangor,58,9,49,2022
2022-10-30,Selangor,175,23,152,2022
2022-10-31,Selangor,92,5,87,2022
2022-11-01,Selangor,3,0,3,2022
2022-11-02,Selangor,78,7,71,2022
2022-11-03,Selangor,29,5,24,2022
2022-11-04,Selangor,53,11,42,2022
2022-11-05,Selangor,36,8,28,2022
2022-11-06,Selangor,255,33,222,2022
2022-11-07,Selangor,10,0,10,2022
2022-11-08,Selangor,100,25,75,2022
2022-11-09,Selangor,127,65,62,2022
2022-11-10,Selangor,125,53,72,2022
2022-11-11,Selangor,40,8,32,2022
2022-11-12,Selangor,66,17,49,2022
2022-11-13,Selangor,175,34,141,2022
2022-11-14,Selangor,10,1,9,2022
2022-11-15,Selangor,36,4,32,2022
2022-11-16,Selangor,56,10,46,2022
2022-11-17,Selangor,42,14,28,2022
2022-11-18,Selangor,0,0,0,2022
2022-11-19,Selangor,0,0,0,2022
2022-11-20,Selangor,64,5,59,2022
2022-11-21,Selangor,42,4,38,2022
2022-11-22,Selangor,114,31,83,2022
2022-11-23,Selangor,88,41,47,2022
2022-11-24,Selangor,107,34,73,2022
2022-11-25,Selangor,72,18,54,2022
2022-11-26,Selangor,138,16,122,2022
2022-11-27,Selangor,206,21,185,2022
2022-11-28,Selangor,0,0,0,2022
2022-11-29,Selangor,69,15,54,2022
2022-11-30,Selangor,52,5,47,2022
2022-12-01,Selangor,92,67,25,2022
2022-12-02,Selangor,110,49,61,2022
2022-12-03,Selangor,131,61,70,2022
2022-12-04,Selangor,224,32,192,2022
2022-12-05,Selangor,6,0,6,2022
2022-12-06,Selangor,107,36,71,2022
2022-12-07,Selangor,82,11,71,2022
2022-12-08,Selangor,56,12,44,2022
2022-12-09,Selangor,45,5,40,2022
2022-12-10,Selangor,57,11,46,2022
2022-12-11,Selangor,112,16,96,2022
2022-12-12,Selangor,226,65,161,2022
2022-12-13,Selangor,16,1,15,2022
2022-12-14,Selangor,32,10,22,2022
2022-12-15,Selangor,3,0,3,2022
2022-12-16,Selangor,104,19,85,2022
2022-12-17,Selangor,93,22,71,2022
2022-12-18,Selangor,77,7,70,2022
2022-12-19,Selangor,0,0,0,2022
2022-12-20,Selangor,57,11,46,2022
2022-12-21,Selangor,71,9,62,2022
2022-12-22,Selangor,43,9,34,2022
2022-12-23,Selangor,53,6,47,2022
2022-12-24,Selangor,90,19,71,2022
2022-12-25,Selangor,190,32,158,2022
2022-12-26,Selangor,203,42,161,2022
2022-12-27,Selangor,10,1,9,2022
2022-12-28,Selangor,103,20,83,2022
2022-12-29,Selangor,84,33,51,2022
2022-12-30,Selangor,46,7,39,2022
2022-12-31,Selangor,0,0,0,2022
2023-01-01,Selangor,138,22,116,2023
2023-01-02,Selangor,173,26,147,2023
2023-01-03,Selangor,46,11,35,2023
2023-01-04,Selangor,21,3,18,2023
2023-01-05,Selangor,58,9,49,2023
2023-01-06,Selangor,53,7,46,2023
2023-01-07,Selangor,63,23,40,2023
2023-01-08,Selangor,121,37,84,2023
2023-01-09,Selangor,8,1,7,2023
2023-01-10,Selangor,83,39,44,2023
2023-01-11,Selangor,48,11,37,2023
2023-01-12,Selangor,124,28,96,2023
2023-01-13,Selangor,42,9,33,2023
2023-01-14,Selangor,131,13,118,2023
2023-01-15,Selangor,221,32,189,2023
2023-01-16,Selangor,57,12,45,2023
2023-01-17,Selangor,73,4,69,2023
2023-01-18,Selangor,40,13,27,2023
2023-01-19,Selangor,45,4,41,2023
2023-01-20,Selangor,57,11,46,2023
2023-01-21,Selangor,0,0,0,2023
2023-01-22,Selangor,60,9,51,2023
2023-01-23,Selangor,108,19,89,2023
2023-01-24,Selangor,108,15,93,2023
2023-01-25,Selangor,36,1,35,2023
2023-01-26,Selangor,108,27,81,2023
2023-01-27,Selangor,32,0,32,2023
2023-01-28,Selangor,76,17,59,2023
2023-01-29,Selangor,86,11,75,2023
2023-01-30,Selangor,40,5,35,2023
2023-01-31,Selangor,152,23,129,2023
2023-02-01,Selangor,65,18,47,2023
2023-02-02,Selangor,61,12,49,2023
2023-02-03,Selangor,49,9,40,2023
2023-02-04,Selangor,102,17,85,2023
2023-02-05,Selangor,253,36,217,2023
2023-02-06,Selangor,123,10,113,2023
2023-02-07,Selangor,36,3,33,2023
2023-02-08,Selangor,28,2,26,2023
2023-02-09,Selangor,102,29,73,2023
2023-02-10,Selangor,34,9,25,2023
2023-02-11,Selangor,111,16,95,2023
2023-02-12,Selangor,151,21,130,2023
2023-02-13,Selangor,9,0,9,2023
2023-02-14,Selangor,67,11,56,2023
2023-02-15,Selangor,41,10,31,2023
2023-02-16,Selangor,95,53,42,2023
2023-02-17,Selangor,42,14,28,2023
2023-02-18,Selangor,184,32,152,2023
2023-02-19,Selangor,268,36,232,2023
2023-02-20,Selangor,7,0,7,2023
2023-02-21,Selangor,77,8,69,2023
2023-02-22,Selangor,40,3,37,2023
2023-02-23,Selangor,88,33,55,2023
2023-02-24,Selangor,50,7,43,2023
2023-02-25,Selangor,86,19,67,2023
2023-02-26,Selangor,143,19,124,2023
2023-02-27,Selangor,10,0,10,2023
2023-02-28,Selangor,61,14,47,2023
2023-03-01,Selangor,24,3,21,2023
2023-03-02,Selangor,22,3,19,2023
2023-03-03,Selangor,32,13,19,2023
2023-03-04,Selangor,189,37,152,2023
2023-03-05,Selangor,213,41,172,2023
2023-03-06,Selangor,12,0,12,2023
2023-03-07,Selangor,86,28,58,2023
2023-03-08,Selangor,42,4,38,2023
2023-03-09,Selangor,156,37,119,2023
2023-03-10,Selangor,35,5,30,2023
2023-03-11,Selangor,0,0,0,2023
2023-03-12,Selangor,238,35,203,2023
2023-03-13,Selangor,61,19,42,2023
2023-03-14,Selangor,93,32,61,2023
2023-03-15,Selangor,87,14,73,2023
2023-03-16,Selangor,75,12,63,2023
2023-03-17,Selangor,36,6,30,2023
2023-03-18,Selangor,127,26,101,2023
2023-03-19,Selangor,186,28,158,2023
2023-03-20,Selangor,24,2,22,2023
2023-03-21,Selangor,105,46,59,2023
2023-03-22,Selangor,47,3,44,2023
2023-03-23,Selangor,5,1,4,2023
2023-03-24,Selangor,33,3,30,2023
2023-03-25,Selangor,69,8,61,2023
2023-03-26,Selangor,94,17,77,2023
2023-03-27,Selangor,11,1,10,2023
2023-03-28,Selangor,112,32,80,2023
2023-03-29,Selangor,57,14,43,2023
2023-03-30,Selangor,48,9,39,2023
2023-03-31,Selangor,39,4,35,2023
2023-04-01,Selangor,43,6,37,2023
2023-04-02,Selangor,186,41,145,2023
2023-04-03,Selangor,10,0,10,2023
2023-04-04,Selangor,87,6,81,2023
2023-04-05,Selangor,54,8,46,2023
2023-04-06,Selangor,93,32,61,2023
2023-04-07,Selangor,73,17,56,2023
2023-04-08,Selangor,0,0,0,2023
2023-04-09,Selangor,325,66,259,2023
2023-04-10,Selangor,4,0,4,2023
2023-04-11,Selangor,75,13,62,2023
2023-04-12,Selangor,68,7,61,2023
2023-04-13,Selangor,85,15,70,2023
2023-04-14,Selangor,46,21,25,2023
2023-04-15,Selangor,106,13,93,2023
2023-04-16,Selangor,218,34,184,2023
2023-04-17,Selangor,24,8,16,2023
2023-04-18,Selangor,51,9,42,2023
2023-04-19,Selangor,35,11,24,2023
2023-04-20,Selangor,22,2,20,2023
2023-04-21,Selangor,0,0,0,2023
2023-04-22,Selangor,0,0,0,2023
2023-04-23,Selangor,0,0,0,2023
2023-04-24,Selangor,0,0,0,2023
2023-04-25,Selangor,24,0,24,2023
2023-04-26,Selangor,36,3,33,2023
2023-04-27,Selangor,38,9,29,2023
2023-04-28,Selangor,83,10,73,2023
2023-04-29,Selangor,130,19,111,2023
2023-04-30,Selangor,172,22,150,2023
2023-05-01,Selangor,296,61,235,2023
2023-05-02,Selangor,8,1,7,2023
2023-05-03,Selangor,43,19,24,2023
2023-05-04,Selangor,262,42,220,2023
2023-05-05,Selangor,38,2,36,2023
2023-05-06,Selangor,181,44,137,2023
2023-05-07,Selangor,257,72,185,2023
2023-05-08,Selangor,41,5,36,2023
2023-05-09,Selangor,28,4,24,2023
2023-05-10,Selangor,59,7,52,2023
2023-05-11,Selangor,104,31,73,2023
2023-05-12,Selangor,29,11,18,2023
2023-05-13,Selangor,0,0,0,2023
2023-05-14,Selangor,141,14,127,2023
2023-05-15,Selangor,5,1,4,2023
2023-05-16,Selangor,63,28,35,2023
2023-05-17,Selangor,76,44,32,2023
2023-05-18,Selangor,56,12,44,2023
2023-05-19,Selangor,52,9,43,2023
2023-05-20,Selangor,208,42,166,2023
2023-05-21,Selangor,165,33,132,2023
2023-05-22,Selangor,6,1,5,2023
2023-05-23,Selangor,78,12,66,2023
2023-05-24,Selangor,62,8,54,2023
2023-05-25,Selangor,33,4,29,2023
2023-05-26,Selangor,72,16,56,2023
2023-05-27,Selangor,103,15,88,2023
2023-05-28,Selangor,147,24,123,2023
2023-05-29,Selangor,58,14,44,2023
2023-05-30,Selangor,94,24,70,2023
2023-05-31,Selangor,114,31,83,2023
2023-06-01,Selangor,58,11,47,2023
2023-06-02,Selangor,117,15,102,2023
2023-06-03,Selangor,50,10,40,2023
2023-06-04,Selangor,51,6,45,2023
2023-06-05,Selangor,148,33,115,2023
2023-06-06,Selangor,10,0,10,2023
2023-06-07,Selangor,95,22,73,2023
2023-06-08,Selangor,95,44,51,2023
2023-06-09,Selangor,13,0,13,2023
2023-06-10,Selangor,48,24,24,2023
2023-06-11,Selangor,196,29,167,2023
2023-06-12,Selangor,13,1,12,2023
2023-06-13,Selangor,104,22,82,2023
2023-06-14,Selangor,127,21,106,2023
2023-06-15,Selangor,118,42,76,2023
2023-06-16,Selangor,109,18,91,2023
2023-06-17,Selangor,199,15,184,2023
2023-06-18,Selangor,200,42,158,2023
2023-06-19,Selangor,13,1,12,2023
2023-06-20,Selangor,43,4,39,2023
2023-06-21,Selangor,46,9,37,2023
2023-06-22,Selangor,110,70,40,2023
2023-06-23,Selangor,93,21,72,2023
2023-06-24,Selangor,135,17,118,2023
2023-06-25,Selangor,278,39,239,2023
2023-06-26,Selangor,45,5,40,2023
2023-06-27,Selangor,67,11,56,2023
2023-06-28,Selangor,18,2,16,2023
2023-06-29,Selangor,0,0,0,2023
2023-06-30,Selangor,5,0,5,2023
2023-07-01,Selangor,23,7,16,2023
2023-07-02,Selangor,153,29,124,2023
2023-07-03,Selangor,9,0,9,2023
2023-07-04,Selangor,70,14,56,2023
2023-07-05,Selangor,38,7,31,2023
2023-07-06,Selangor,106,22,84,2023
2023-07-07,Selangor,33,13,20,2023
2023-07-08,Selangor,117,27,90,2023
2023-07-09,Selangor,191,34,157,2023
2023-07-10,Selangor,8,0,8,2023
2023-07-11,Selangor,51,13,38,2023
2023-07-12,Selangor,58,7,51,2023
2023-07-13,Selangor,59,34,25,2023
2023-07-14,Selangor,66,30,36,2023
2023-07-15,Selangor,71,8,63,2023
2023-07-16,Selangor,210,28,182,2023
2023-07-17,Selangor,7,2,5,2023
2023-07-18,Selangor,31,1,30,2023
2023-07-19,Selangor,141,31,110,2023
2023-07-20,Selangor,42,5,37,2023
2023-07-21,Selangor,34,6,28,2023
2023-07-22,Selangor,105,21,84,2023
2023-07-23,Selangor,62,19,43,2023
2023-07-24,Selangor,2,0,2,2023
2023-07-25,Selangor,82,9,73,2023
2023-07-26,Selangor,39,7,32,2023
2023-07-27,Selangor,80,39,41,2023
2023-07-28,Selangor,60,17,43,2023
2023-07-29,Selangor,46,8,38,2023
2023-07-30,Selangor,198,41,157,2023
2023-07-31,Selangor,25,7,18,2023
2023-08-01,Selangor,26,1,25,2023
2023-08-02,Selangor,32,21,11,2023
2023-08-03,Selangor,7,0,7,2023
2023-08-04,Selangor,69,22,47,2023
2023-08-05,Selangor,480,241,239,2023
2023-08-06,Selangor,0,0,0,2023
2023-08-07,Selangor,38,3,35,2023
2023-08-08,Selangor,88,14,74,2023
2023-08-09,Selangor,59,7,52,2023
2023-08-10,Selangor,111,24,87,2023
2023-08-11,Selangor,63,8,55,2023
2023-08-12,Selangor,0,0,0,2023
2023-08-13,Selangor,169,23,146,2023
2023-08-14,Selangor,44,11,33,2023
2023-08-15,Selangor,90,37,53,2023
2023-08-16,Selangor,116,32,84,2023
2023-08-17,Selangor,92,34,58,2023
2023-08-18,Selangor,120,41,79,2023
2023-08-19,Selangor,110,22,88,2023
2023-08-20,Selangor,220,26,194,2023
2023-08-21,Selangor,10,1,9,2023
2023-08-22,Selangor,25,1,24,2023
2023-08-23,Selangor,34,1,33,2023
2023-08-24,Selangor,136,23,113,2023
2023-08-25,Selangor,70,49,21,2023
2023-08-26,Selangor,88,18,70,2023
2023-08-27,Selangor,162,16,146,2023
2023-08-28,Selangor,18,3,15,2023
2023-08-29,Selangor,103,28,75,2023
2023-08-30,Selangor,85,9,76,2023
2023-08-31,Selangor,221,37,184,2023
2023-09-01,Selangor,39,5,34,2023
2023-09-02,Selangor,68,20,48,2023
2023-09-03,Selangor,178,24,154,2023
2023-09-04,Selangor,22,5,17,2023
2023-09-05,Selangor,75,15,60,2023
2023-09-06,Selangor,49,8,41,2023
2023-09-07,Selangor,60,16,44,2023
2023-09-08,Selangor,36,14,22,2023
2023-09-09,Selangor,0,0,0,2023
2023-09-10,Selangor,144,23,121,2023
2023-09-11,Selangor,53,18,35,2023
2023-09-12,Selangor,71,38,33,2023
2023-09-13,Selangor,69,19,50,2023
2023-09-14,Selangor,175,64,111,2023
2023-09-15,Selangor,143,14,129,2023
2023-09-16,Selangor,285,50,235,2023
2023-09-17,Selangor,246,47,199,2023
2023-09-18,Selangor,8,3,5,2023
2023-09-19,Selangor,88,11,77,2023
2023-09-20,Selangor,60,17,43,2023
2023-09-21,Selangor,109,28,81,2023
2023-09-22,Selangor,53,23,30,2023
2023-09-23,Selangor,33,13,20,2023
2023-09-24,Selangor,189,17,172,2023
2023-09-25,Selangor,11,0,11,2023
2023-09-26,Selangor,23,2,21,2023
2023-09-27,Selangor,61,6,55,2023
2023-09-28,Selangor,129,20,109,2023
2023-09-29,Selangor,0,0,0,2023
2023-09-30,Selangor,0,0,0,2023
2023-10-01,Selangor,200,20,180,2023
2023-10-02,Selangor,12,0,12,2023
2023-10-03,Selangor,39,14,25,2023
2023-10-04,Selangor,140,42,98,2023
2023-10-05,Selangor,75,24,51,2023
2023-10-06,Selangor,70,19,51,2023
2023-10-07,Selangor,126,15,111,2023
2023-10-08,Selangor,211,25,186,2023
2023-10-09,Selangor,13,0,13,2023
2023-10-10,Selangor,61,9,52,2023
2023-10-11,Selangor,53,5,48,2023
2023-10-12,Selangor,31,1,30,2023
2023-10-13,Selangor,27,5,22,2023
2023-10-14,Selangor,80,9,71,2023
2023-10-15,Selangor,300,34,266,2023
2023-10-16,Selangor,11,0,11,2023
2023-10-17,Selangor,63,18,45,2023
2023-10-18,Selangor,123,23,100,2023
2023-10-19,Selangor,54,13,41,2023
2023-10-20,Selangor,34,14,20,2023
2023-10-21,Selangor,172,23,149,2023
2023-10-22,Selangor,103,18,85,2023
2023-10-23,Selangor,7,1,6,2023
2023-10-24,Selangor,50,9,41,2023
2023-10-25,Selangor,33,4,29,2023
2023-10-26,Selangor,91,21,70,2023
2023-10-27,Selangor,123,102,21,2023
2023-10-28,Selangor,0,0,0,2023
2023-10-29,Selangor,148,40,108,2023
2023-10-30,Selangor,27,5,22,2023
2023-10-31,Selangor,87,44,43,2023
2023-11-01,Selangor,110,41,69,2023
2023-11-02,Selangor,74,16,58,2023
2023-11-03,Selangor,40,5,35,2023
2023-11-04,Selangor,175,24,151,2023
2023-11-05,Selangor,189,32,157,2023
2023-11-06,Selangor,6,0,6,2023
2023-11-07,Selangor,54,6,48,2023
2023-11-08,Selangor,46,7,39,2023
2023-11-09,Selangor,106,19,87,2023
2023-11-10,Selangor,33,9,24,2023
2023-11-11,Selangor,125,17,108,2023
2023-11-12,Selangor,146,23,123,2023
2023-11-13,Selangor,81,9,72,2023
2023-11-14,Selangor,17,0,17,2023
2023-11-15,Selangor,95,35,60,2023
2023-11-16,Selangor,68,23,45,2023
2023-11-17,Selangor,55,11,44,2023
2023-11-18,Selangor,0,0,0,2023
2023-11-19,Selangor,233,36,197,2023
2023-11-20,Selangor,7,0,7,2023
2023-11-21,Selangor,179,58,121,2023
2023-11-22,Selangor,54,3,51,2023
2023-11-23,Selangor,96,24,72,2023
2023-11-24,Selangor,65,6,59,2023
2023-11-25,Selangor,102,18,84,2023
2023-11-26,Selangor,137,18,119,2023
2023-11-27,Selangor,10,1,9,2023
2023-11-28,Selangor,134,36,98,2023
2023-11-29,Selangor,111,28,83,2023
2023-11-30,Selangor,96,20,76,2023
2023-12-01,Selangor,8,1,7,2023
2023-12-02,Selangor,63,12,51,2023
2023-12-03,Selangor,70,8,62,2023
2023-12-04,Selangor,33,9,24,2023
2023-12-05,Selangor,69,36,33,2023
2023-12-06,Selangor,87,65,22,2023
2023-12-07,Selangor,68,16,52,2023
2023-12-08,Selangor,0,0,0,2023
2023-12-09,Selangor,0,0,0,2023
2023-12-10,Selangor,177,22,155,2023
2023-12-11,Selangor,226,29,197,2023
2023-12-12,Selangor,7,0,7,2023
2023-12-13,Selangor,87,24,63,2023
2023-12-14,Selangor,94,15,79,2023
2023-12-15,Selangor,38,14,24,2023
2023-12-16,Selangor,79,22,57,2023
2023-12-17,Selangor,128,17,111,2023
2023-12-18,Selangor,9,0,9,2023
2023-12-19,Selangor,85,14,71,2023
2023-12-20,Selangor,64,8,56,2023
2023-12-21,Selangor,85,23,62,2023
2023-12-22,Selangor,22,3,19,2023
2023-12-23,Selangor,85,9,76,2023
2023-12-24,Selangor,101,12,89,2023
2023-12-25,Selangor,96,10,86,2023
2023-12-26,Selangor,14,3,11,2023
2023-12-27,Selangor,104,11,93,2023
2023-12-28,Selangor,66,16,50,2023
2023-12-29,Selangor,137,14,123,2023
2023-12-30,Selangor,244,36,208,2023
2023-12-31,Selangor,278,29,249,2023
2024-01-01,Selangor,248,33,215,2024
2024-01-02,Selangor,3,0,3,2024
2024-01-03,Selangor,45,7,38,2024
2024-01-04,Selangor,53,4,49,2024
2024-01-05,Selangor,43,9,34,2024
2024-01-06,Selangor,0,0,0,2024
2024-01-07,Selangor,199,33,166,2024
2024-01-08,Selangor,15,2,13,2024
2024-01-09,Selangor,78,10,68,2024
2024-01-10,Selangor,58,9,49,2024
2024-01-11,Selangor,42,5,37,2024
2024-01-12,Selangor,31,4,27,2024
2024-01-13,Selangor,128,33,95,2024
2024-01-14,Selangor,133,14,119,2024
2024-01-15,Selangor,11,2,9,2024
2024-01-16,Selangor,74,12,62,2024
2024-01-17,Selangor,54,15,39,2024
2024-01-18,Selangor,47,2,45,2024
2024-01-19,Selangor,48,18,30,2024
2024-01-20,Selangor,82,15,67,2024
2024-01-21,Selangor,218,28,190,2024
2024-01-22,Selangor,6,0,6,2024
2024-01-23,Selangor,107,27,80,2024
2024-01-24,Selangor,89,21,68,2024
2024-01-25,Selangor,151,27,124,2024
2024-01-26,Selangor,27,4,23,2024
2024-01-27,Selangor,59,16,43,2024
2024-01-28,Selangor,104,19,85,2024
2024-01-29,Selangor,10,0,10,2024
2024-01-30,Selangor,39,9,30,2024
2024-01-31,Selangor,45,7,38,2024
2024-02-01,Selangor,107,20,87,2024
2024-02-02,Selangor,25,3,22,2024
2006-01-01,Terengganu,10,2,8,2006
2006-01-02,Terengganu,10,1,9,2006
2006-01-03,Terengganu,6,0,6,2006
2006-01-04,Terengganu,26,8,18,2006
2006-01-05,Terengganu,43,36,7,2006
2006-01-06,Terengganu,0,0,0,2006
2006-01-07,Terengganu,0,0,0,2006
2006-01-08,Terengganu,52,28,24,2006
2006-01-09,Terengganu,18,4,14,2006
2006-01-10,Terengganu,0,0,0,2006
2006-01-11,Terengganu,0,0,0,2006
2006-01-12,Terengganu,12,2,10,2006
2006-01-13,Terengganu,0,0,0,2006
2006-01-14,Terengganu,0,0,0,2006
2006-01-15,Terengganu,32,10,22,2006
2006-01-16,Terengganu,17,8,9,2006
2006-01-17,Terengganu,339,291,48,2006
2006-01-18,Terengganu,7,4,3,2006
2006-01-19,Terengganu,107,78,29,2006
2006-01-20,Terengganu,0,0,0,2006
2006-01-21,Terengganu,92,50,42,2006
2006-01-22,Terengganu,11,5,6,2006
2006-01-23,Terengganu,6,4,2,2006
2006-01-24,Terengganu,495,359,136,2006
2006-01-25,Terengganu,4,2,2,2006
2006-01-26,Terengganu,238,180,58,2006
2006-01-27,Terengganu,0,0,0,2006
2006-01-28,Terengganu,0,0,0,2006
2006-01-29,Terengganu,0,0,0,2006
2006-01-30,Terengganu,0,0,0,2006
2006-01-31,Terengganu,0,0,0,2006
2006-02-01,Terengganu,22,13,9,2006
2006-02-02,Terengganu,11,4,7,2006
2006-02-03,Terengganu,0,0,0,2006
2006-02-04,Terengganu,0,0,0,2006
2006-02-05,Terengganu,11,6,5,2006
2006-02-06,Terengganu,18,8,10,2006
2006-02-07,Terengganu,89,56,33,2006
2006-02-08,Terengganu,285,187,98,2006
2006-02-09,Terengganu,323,208,115,2006
2006-02-10,Terengganu,0,0,0,2006
2006-02-11,Terengganu,232,215,17,2006
2006-02-12,Terengganu,12,3,9,2006
2006-02-13,Terengganu,2,0,2,2006
2006-02-14,Terengganu,10,2,8,2006
2006-02-15,Terengganu,82,58,24,2006
2006-02-16,Terengganu,11,4,7,2006
2006-02-17,Terengganu,98,80,18,2006
2006-02-18,Terengganu,144,119,25,2006
2006-02-19,Terengganu,14,4,10,2006
2006-02-20,Terengganu,13,1,12,2006
2006-02-21,Terengganu,8,2,6,2006
2006-02-22,Terengganu,18,8,10,2006
2006-02-23,Terengganu,71,46,25,2006
2006-02-24,Terengganu,0,0,0,2006
2006-02-25,Terengganu,260,256,4,2006
2006-02-26,Terengganu,20,8,12,2006
2006-02-27,Terengganu,12,4,8,2006
2006-02-28,Terengganu,15,4,11,2006
2006-03-01,Terengganu,167,101,66,2006
2006-03-02,Terengganu,7,0,7,2006
2006-03-03,Terengganu,72,55,17,2006
2006-03-04,Terengganu,238,230,8,2006
2006-03-05,Terengganu,15,4,11,2006
2006-03-06,Terengganu,8,2,6,2006
2006-03-07,Terengganu,19,8,11,2006
2006-03-08,Terengganu,13,4,9,2006
2006-03-09,Terengganu,62,53,9,2006
2006-03-10,Terengganu,0,0,0,2006
2006-03-11,Terengganu,219,214,5,2006
2006-03-12,Terengganu,80,61,19,2006
2006-03-13,Terengganu,12,0,12,2006
2006-03-14,Terengganu,238,127,111,2006
2006-03-15,Terengganu,459,284,175,2006
2006-03-16,Terengganu,115,62,53,2006
2006-03-17,Terengganu,0,0,0,2006
2006-03-18,Terengganu,204,198,6,2006
2006-03-19,Terengganu,18,6,12,2006
2006-03-20,Terengganu,13,4,9,2006
2006-03-21,Terengganu,10,2,8,2006
2006-03-22,Terengganu,19,4,15,2006
2006-03-23,Terengganu,13,4,9,2006
2006-03-24,Terengganu,0,0,0,2006
2006-03-25,Terengganu,17,0,17,2006
2006-03-26,Terengganu,17,6,11,2006
2006-03-27,Terengganu,68,39,29,2006
2006-03-28,Terengganu,18,2,16,2006
2006-03-29,Terengganu,21,8,13,2006
2006-03-30,Terengganu,12,6,6,2006
2006-03-31,Terengganu,86,22,64,2006
2006-04-01,Terengganu,0,0,0,2006
2006-04-02,Terengganu,19,4,15,2006
2006-04-03,Terengganu,31,6,25,2006
2006-04-04,Terengganu,2,0,2,2006
2006-04-05,Terengganu,11,0,11,2006
2006-04-06,Terengganu,115,69,46,2006
2006-04-07,Terengganu,0,0,0,2006
2006-04-08,Terengganu,196,193,3,2006
2006-04-09,Terengganu,32,12,20,2006
2006-04-10,Terengganu,180,140,40,2006
2006-04-11,Terengganu,0,0,0,2006
2006-04-12,Terengganu,13,2,11,2006
2006-04-13,Terengganu,20,2,18,2006
2006-04-14,Terengganu,0,0,0,2006
2006-04-15,Terengganu,121,109,12,2006
2006-04-16,Terengganu,10,6,4,2006
2006-04-17,Terengganu,12,0,12,2006
2006-04-18,Terengganu,13,4,9,2006
2006-04-19,Terengganu,189,167,22,2006
2006-04-20,Terengganu,11,6,5,2006
2006-04-21,Terengganu,0,0,0,2006
2006-04-22,Terengganu,34,34,0,2006
2006-04-23,Terengganu,21,16,5,2006
2006-04-24,Terengganu,14,8,6,2006
2006-04-25,Terengganu,11,4,7,2006
2006-04-26,Terengganu,107,95,12,2006
2006-04-27,Terengganu,10,2,8,2006
2006-04-28,Terengganu,0,0,0,2006
2006-04-29,Terengganu,0,0,0,2006
2006-04-30,Terengganu,20,8,12,2006
2006-05-01,Terengganu,0,0,0,2006
2006-05-02,Terengganu,4,0,4,2006
2006-05-03,Terengganu,114,101,13,2006
2006-05-04,Terengganu,12,4,8,2006
2006-05-05,Terengganu,0,0,0,2006
2006-05-06,Terengganu,166,165,1,2006
2006-05-07,Terengganu,11,4,7,2006
2006-05-08,Terengganu,19,2,17,2006
2006-05-09,Terengganu,10,4,6,2006
2006-05-10,Terengganu,91,56,35,2006
2006-05-11,Terengganu,69,48,21,2006
2006-05-12,Terengganu,0,0,0,2006
2006-05-13,Terengganu,228,222,6,2006
2006-05-14,Terengganu,40,30,10,2006
2006-05-15,Terengganu,16,8,8,2006
2006-05-16,Terengganu,19,6,13,2006
2006-05-17,Terengganu,20,10,10,2006
2006-05-18,Terengganu,97,48,49,2006
2006-05-19,Terengganu,0,0,0,2006
2006-05-20,Terengganu,42,26,16,2006
2006-05-21,Terengganu,18,2,16,2006
2006-05-22,Terengganu,6,0,6,2006
2006-05-23,Terengganu,79,50,29,2006
2006-05-24,Terengganu,46,38,8,2006
2006-05-25,Terengganu,6,0,6,2006
2006-05-26,Terengganu,0,0,0,2006
2006-05-27,Terengganu,181,119,62,2006
2006-05-28,Terengganu,11,2,9,2006
2006-05-29,Terengganu,6,0,6,2006
2006-05-30,Terengganu,87,24,63,2006
2006-05-31,Terengganu,26,16,10,2006
2006-06-01,Terengganu,55,44,11,2006
2006-06-02,Terengganu,0,0,0,2006
2006-06-03,Terengganu,0,0,0,2006
2006-06-04,Terengganu,14,0,14,2006
2006-06-05,Terengganu,20,2,18,2006
2006-06-06,Terengganu,6,2,4,2006
2006-06-07,Terengganu,6,0,6,2006
2006-06-08,Terengganu,42,30,12,2006
2006-06-09,Terengganu,0,0,0,2006
2006-06-10,Terengganu,73,62,11,2006
2006-06-11,Terengganu,84,68,16,2006
2006-06-12,Terengganu,10,0,10,2006
2006-06-13,Terengganu,7,0,7,2006
2006-06-14,Terengganu,13,0,13,2006
2006-06-15,Terengganu,92,67,25,2006
2006-06-16,Terengganu,0,0,0,2006
2006-06-17,Terengganu,73,58,15,2006
2006-06-18,Terengganu,18,4,14,2006
2006-06-19,Terengganu,179,151,28,2006
2006-06-20,Terengganu,18,4,14,2006
2006-06-21,Terengganu,15,2,13,2006
2006-06-22,Terengganu,9,0,9,2006
2006-06-23,Terengganu,134,68,66,2006
2006-06-24,Terengganu,0,0,0,2006
2006-06-25,Terengganu,70,54,16,2006
2006-06-26,Terengganu,42,23,19,2006
2006-06-27,Terengganu,84,71,13,2006
2006-06-28,Terengganu,19,8,11,2006
2006-06-29,Terengganu,200,154,46,2006
2006-06-30,Terengganu,30,28,2,2006
2006-07-01,Terengganu,0,0,0,2006
2006-07-02,Terengganu,14,2,12,2006
2006-07-03,Terengganu,150,130,20,2006
2006-07-04,Terengganu,13,6,7,2006
2006-07-05,Terengganu,186,152,34,2006
2006-07-06,Terengganu,4,0,4,2006
2006-07-07,Terengganu,0,0,0,2006
2006-07-08,Terengganu,0,0,0,2006
2006-07-09,Terengganu,26,10,16,2006
2006-07-10,Terengganu,20,16,4,2006
2006-07-11,Terengganu,104,74,30,2006
2006-07-12,Terengganu,13,6,7,2006
2006-07-13,Terengganu,95,69,26,2006
2006-07-14,Terengganu,54,32,22,2006
2006-07-15,Terengganu,0,0,0,2006
2006-07-16,Terengganu,6,0,6,2006
2006-07-17,Terengganu,125,118,7,2006
2006-07-18,Terengganu,30,9,21,2006
2006-07-19,Terengganu,128,95,33,2006
2006-07-20,Terengganu,0,0,0,2006
2006-07-21,Terengganu,0,0,0,2006
2006-07-22,Terengganu,0,0,0,2006
2006-07-23,Terengganu,126,99,27,2006
2006-07-24,Terengganu,19,8,11,2006
2006-07-25,Terengganu,14,6,8,2006
2006-07-26,Terengganu,360,181,179,2006
2006-07-27,Terengganu,6,0,6,2006
2006-07-28,Terengganu,382,201,181,2006
2006-07-29,Terengganu,326,195,131,2006
2006-07-30,Terengganu,99,73,26,2006
2006-07-31,Terengganu,10,2,8,2006
2006-08-01,Terengganu,6,3,3,2006
2006-08-02,Terengganu,11,0,11,2006
2006-08-03,Terengganu,52,31,21,2006
2006-08-04,Terengganu,28,20,8,2006
2006-08-05,Terengganu,0,0,0,2006
2006-08-06,Terengganu,17,0,17,2006
2006-08-07,Terengganu,8,0,8,2006
2006-08-08,Terengganu,11,4,7,2006
2006-08-09,Terengganu,308,180,128,2006
2006-08-10,Terengganu,481,330,151,2006
2006-08-11,Terengganu,0,0,0,2006
2006-08-12,Terengganu,0,0,0,2006
2006-08-13,Terengganu,6,0,6,2006
2006-08-14,Terengganu,351,192,159,2006
2006-08-15,Terengganu,387,282,105,2006
2006-08-16,Terengganu,8,0,8,2006
2006-08-17,Terengganu,24,8,16,2006
2006-08-18,Terengganu,0,0,0,2006
2006-08-19,Terengganu,0,0,0,2006
2006-08-20,Terengganu,15,2,13,2006
2006-08-21,Terengganu,13,2,11,2006
2006-08-22,Terengganu,10,4,6,2006
2006-08-23,Terengganu,6,0,6,2006
2006-08-24,Terengganu,85,64,21,2006
2006-08-25,Terengganu,52,44,8,2006
2006-08-26,Terengganu,92,89,3,2006
2006-08-27,Terengganu,38,18,20,2006
2006-08-28,Terengganu,18,10,8,2006
2006-08-29,Terengganu,135,95,40,2006
2006-08-30,Terengganu,63,53,10,2006
2006-08-31,Terengganu,0,0,0,2006
2006-09-01,Terengganu,0,0,0,2006
2006-09-02,Terengganu,95,57,38,2006
2006-09-03,Terengganu,74,61,13,2006
2006-09-04,Terengganu,2,0,2,2006
2006-09-05,Terengganu,392,269,123,2006
2006-09-06,Terengganu,22,12,10,2006
2006-09-07,Terengganu,37,33,4,2006
2006-09-08,Terengganu,0,0,0,2006
2006-09-09,Terengganu,0,0,0,2006
2006-09-10,Terengganu,161,105,56,2006
2006-09-11,Terengganu,131,61,70,2006
2006-09-12,Terengganu,64,53,11,2006
2006-09-13,Terengganu,156,106,50,2006
2006-09-14,Terengganu,171,110,61,2006
2006-09-15,Terengganu,132,48,84,2006
2006-09-16,Terengganu,0,0,0,2006
2006-09-17,Terengganu,16,4,12,2006
2006-09-18,Terengganu,56,30,26,2006
2006-09-19,Terengganu,8,0,8,2006
2006-09-20,Terengganu,404,214,190,2006
2006-09-21,Terengganu,413,256,157,2006
2006-09-22,Terengganu,160,75,85,2006
2006-09-23,Terengganu,0,0,0,2006
2006-09-24,Terengganu,1,0,1,2006
2006-09-25,Terengganu,0,0,0,2006
2006-09-26,Terengganu,4,0,4,2006
2006-09-27,Terengganu,1,0,1,2006
2006-09-28,Terengganu,162,72,90,2006
2006-09-29,Terengganu,79,48,31,2006
2006-09-30,Terengganu,0,0,0,2006
2006-10-01,Terengganu,0,0,0,2006
2006-10-02,Terengganu,0,0,0,2006
2006-10-03,Terengganu,2,0,2,2006
2006-10-04,Terengganu,155,124,31,2006
2006-10-05,Terengganu,190,144,46,2006
2006-10-06,Terengganu,0,0,0,2006
2006-10-07,Terengganu,0,0,0,2006
2006-10-08,Terengganu,0,0,0,2006
2006-10-09,Terengganu,43,28,15,2006
2006-10-10,Terengganu,0,0,0,2006
2006-10-11,Terengganu,0,0,0,2006
2006-10-12,Terengganu,75,34,41,2006
2006-10-13,Terengganu,109,39,70,2006
2006-10-14,Terengganu,45,32,13,2006
2006-10-15,Terengganu,0,0,0,2006
2006-10-16,Terengganu,196,136,60,2006
2006-10-17,Terengganu,2,0,2,2006
2006-10-18,Terengganu,0,0,0,2006
2006-10-19,Terengganu,3,0,3,2006
2006-10-20,Terengganu,19,12,7,2006
2006-10-21,Terengganu,0,0,0,2006
2006-10-22,Terengganu,4,0,4,2006
2006-10-23,Terengganu,17,14,3,2006
2006-10-24,Terengganu,0,0,0,2006
2006-10-25,Terengganu,0,0,0,2006
2006-10-26,Terengganu,4,2,2,2006
2006-10-27,Terengganu,0,0,0,2006
2006-10-28,Terengganu,0,0,0,2006
2006-10-29,Terengganu,29,10,19,2006
2006-10-30,Terengganu,115,49,66,2006
2006-10-31,Terengganu,25,12,13,2006
2006-11-01,Terengganu,111,69,42,2006
2006-11-02,Terengganu,51,40,11,2006
2006-11-03,Terengganu,0,0,0,2006
2006-11-04,Terengganu,0,0,0,2006
2006-11-05,Terengganu,26,13,13,2006
2006-11-06,Terengganu,33,26,7,2006
2006-11-07,Terengganu,70,22,48,2006
2006-11-08,Terengganu,68,30,38,2006
2006-11-09,Terengganu,92,61,31,2006
2006-11-10,Terengganu,0,0,0,2006
2006-11-11,Terengganu,2,0,2,2006
2006-11-12,Terengganu,23,18,5,2006
2006-11-13,Terengganu,108,67,41,2006
2006-11-14,Terengganu,36,19,17,2006
2006-11-15,Terengganu,29,18,11,2006
2006-11-16,Terengganu,150,128,22,2006
2006-11-17,Terengganu,0,0,0,2006
2006-11-18,Terengganu,0,0,0,2006
2006-11-19,Terengganu,52,33,19,2006
2006-11-20,Terengganu,20,7,13,2006
2006-11-21,Terengganu,30,12,18,2006
2006-11-22,Terengganu,263,93,170,2006
2006-11-23,Terengganu,64,47,17,2006
2006-11-24,Terengganu,42,33,9,2006
2006-11-25,Terengganu,0,0,0,2006
2006-11-26,Terengganu,142,91,51,2006
2006-11-27,Terengganu,183,152,31,2006
2006-11-28,Terengganu,83,65,18,2006
2006-11-29,Terengganu,74,45,29,2006
2006-11-30,Terengganu,76,37,39,2006
2006-12-01,Terengganu,0,0,0,2006
2006-12-02,Terengganu,0,0,0,2006
2006-12-03,Terengganu,29,9,20,2006
2006-12-04,Terengganu,67,33,34,2006
2006-12-05,Terengganu,19,2,17,2006
2006-12-06,Terengganu,10,0,10,2006
2006-12-07,Terengganu,4,0,4,2006
2006-12-08,Terengganu,0,0,0,2006
2006-12-09,Terengganu,0,0,0,2006
2006-12-10,Terengganu,30,4,26,2006
2006-12-11,Terengganu,16,6,10,2006
2006-12-12,Terengganu,14,8,6,2006
2006-12-13,Terengganu,7,0,7,2006
2006-12-14,Terengganu,8,2,6,2006
2006-12-15,Terengganu,0,0,0,2006
2006-12-16,Terengganu,48,16,32,2006
2006-12-17,Terengganu,19,10,9,2006
2006-12-18,Terengganu,25,3,22,2006
2006-12-19,Terengganu,93,42,51,2006
2006-12-20,Terengganu,16,5,11,2006
2006-12-21,Terengganu,53,36,17,2006
2006-12-22,Terengganu,0,0,0,2006
2006-12-23,Terengganu,86,81,5,2006
2006-12-24,Terengganu,29,15,14,2006
2006-12-25,Terengganu,0,0,0,2006
2006-12-26,Terengganu,28,7,21,2006
2006-12-27,Terengganu,26,7,19,2006
2006-12-28,Terengganu,62,34,28,2006
2006-12-29,Terengganu,40,32,8,2006
2006-12-30,Terengganu,0,0,0,2006
2006-12-31,Terengganu,0,0,0,2006
2007-01-01,Terengganu,0,0,0,2007
2007-01-02,Terengganu,10,2,8,2007
2007-01-03,Terengganu,125,76,49,2007
2007-01-04,Terengganu,46,28,18,2007
2007-01-05,Terengganu,0,0,0,2007
2007-01-06,Terengganu,25,16,9,2007
2007-01-07,Terengganu,21,0,21,2007
2007-01-08,Terengganu,25,7,18,2007
2007-01-09,Terengganu,3,2,1,2007
2007-01-10,Terengganu,38,16,22,2007
2007-01-11,Terengganu,77,61,16,2007
2007-01-12,Terengganu,78,35,43,2007
2007-01-13,Terengganu,41,18,23,2007
2007-01-14,Terengganu,28,10,18,2007
2007-01-15,Terengganu,18,6,12,2007
2007-01-16,Terengganu,180,157,23,2007
2007-01-17,Terengganu,13,9,4,2007
2007-01-18,Terengganu,97,91,6,2007
2007-01-19,Terengganu,0,0,0,2007
2007-01-20,Terengganu,48,36,12,2007
2007-01-21,Terengganu,32,23,9,2007
2007-01-22,Terengganu,26,9,17,2007
2007-01-23,Terengganu,27,0,27,2007
2007-01-24,Terengganu,188,0,188,2007
2007-01-25,Terengganu,172,34,138,2007
2007-01-26,Terengganu,107,0,107,2007
2007-01-27,Terengganu,0,0,0,2007
2007-01-28,Terengganu,48,0,48,2007
2007-01-29,Terengganu,25,0,25,2007
2007-01-30,Terengganu,293,111,182,2007
2007-01-31,Terengganu,298,159,139,2007
2007-02-01,Terengganu,28,16,12,2007
2007-02-02,Terengganu,0,0,0,2007
2007-02-03,Terengganu,77,23,54,2007
2007-02-04,Terengganu,23,2,21,2007
2007-02-05,Terengganu,9,0,9,2007
2007-02-06,Terengganu,12,0,12,2007
2007-02-07,Terengganu,72,0,72,2007
2007-02-08,Terengganu,14,0,14,2007
2007-02-09,Terengganu,0,0,0,2007
2007-02-10,Terengganu,0,0,0,2007
2007-02-11,Terengganu,2,0,2,2007
2007-02-12,Terengganu,253,0,253,2007
2007-02-13,Terengganu,237,0,237,2007
2007-02-14,Terengganu,315,0,315,2007
2007-02-15,Terengganu,75,2,73,2007
2007-02-16,Terengganu,0,0,0,2007
2007-02-17,Terengganu,0,0,0,2007
2007-02-18,Terengganu,0,0,0,2007
2007-02-19,Terengganu,4,0,4,2007
2007-02-20,Terengganu,25,0,25,2007
2007-02-21,Terengganu,18,0,18,2007
2007-02-22,Terengganu,6,0,6,2007
2007-02-23,Terengganu,0,0,0,2007
2007-02-24,Terengganu,171,3,168,2007
2007-02-25,Terengganu,2,0,2,2007
2007-02-26,Terengganu,80,0,80,2007
2007-02-27,Terengganu,17,0,17,2007
2007-02-28,Terengganu,8,0,8,2007
2007-03-01,Terengganu,185,0,185,2007
2007-03-02,Terengganu,0,0,0,2007
2007-03-03,Terengganu,0,0,0,2007
2007-03-04,Terengganu,0,0,0,2007
2007-03-05,Terengganu,16,0,16,2007
2007-03-06,Terengganu,359,0,359,2007
2007-03-07,Terengganu,48,0,48,2007
2007-03-08,Terengganu,68,1,67,2007
2007-03-09,Terengganu,0,0,0,2007
2007-03-10,Terengganu,0,0,0,2007
2007-03-11,Terengganu,18,0,18,2007
2007-03-12,Terengganu,14,0,14,2007
2007-03-13,Terengganu,19,0,19,2007
2007-03-14,Terengganu,64,0,64,2007
2007-03-15,Terengganu,185,0,185,2007
2007-03-16,Terengganu,2,0,2,2007
2007-03-17,Terengganu,0,0,0,2007
2007-03-18,Terengganu,9,0,9,2007
2007-03-19,Terengganu,89,0,89,2007
2007-03-20,Terengganu,9,0,9,2007
2007-03-21,Terengganu,8,0,8,2007
2007-03-22,Terengganu,266,0,266,2007
2007-03-23,Terengganu,293,0,293,2007
2007-03-24,Terengganu,174,0,174,2007
2007-03-25,Terengganu,84,0,84,2007
2007-03-26,Terengganu,10,0,10,2007
2007-03-27,Terengganu,11,0,11,2007
2007-03-28,Terengganu,122,0,122,2007
2007-03-29,Terengganu,10,0,10,2007
2007-03-30,Terengganu,0,0,0,2007
2007-03-31,Terengganu,0,0,0,2007
2007-04-01,Terengganu,0,0,0,2007
2007-04-02,Terengganu,18,0,18,2007
2007-04-03,Terengganu,8,0,8,2007
2007-04-04,Terengganu,13,0,13,2007
2007-04-05,Terengganu,111,2,109,2007
2007-04-06,Terengganu,4,0,4,2007
2007-04-07,Terengganu,0,0,0,2007
2007-04-08,Terengganu,25,0,25,2007
2007-04-09,Terengganu,97,0,97,2007
2007-04-10,Terengganu,24,0,24,2007
2007-04-11,Terengganu,14,0,14,2007
2007-04-12,Terengganu,13,0,13,2007
2007-04-13,Terengganu,0,0,0,2007
2007-04-14,Terengganu,0,0,0,2007
2007-04-15,Terengganu,7,0,7,2007
2007-04-16,Terengganu,16,0,16,2007
2007-04-17,Terengganu,204,6,198,2007
2007-04-18,Terengganu,158,0,158,2007
2007-04-19,Terengganu,63,0,63,2007
2007-04-20,Terengganu,0,0,0,2007
2007-04-21,Terengganu,0,0,0,2007
2007-04-22,Terengganu,14,0,14,2007
2007-04-23,Terengganu,14,0,14,2007
2007-04-24,Terengganu,14,0,14,2007
2007-04-25,Terengganu,127,0,127,2007
2007-04-26,Terengganu,0,0,0,2007
2007-04-27,Terengganu,56,0,56,2007
2007-04-28,Terengganu,44,0,44,2007
2007-04-29,Terengganu,21,0,21,2007
2007-04-30,Terengganu,21,0,21,2007
2007-05-01,Terengganu,0,0,0,2007
2007-05-02,Terengganu,0,0,0,2007
2007-05-03,Terengganu,47,0,47,2007
2007-05-04,Terengganu,0,0,0,2007
2007-05-05,Terengganu,0,0,0,2007
2007-05-06,Terengganu,18,0,18,2007
2007-05-07,Terengganu,12,0,12,2007
2007-05-08,Terengganu,21,0,21,2007
2007-05-09,Terengganu,9,0,9,2007
2007-05-10,Terengganu,269,1,268,2007
2007-05-11,Terengganu,0,0,0,2007
2007-05-12,Terengganu,92,0,92,2007
2007-05-13,Terengganu,42,0,42,2007
2007-05-14,Terengganu,12,0,12,2007
2007-05-15,Terengganu,104,0,104,2007
2007-05-16,Terengganu,6,0,6,2007
2007-05-17,Terengganu,52,0,52,2007
2007-05-18,Terengganu,0,0,0,2007
2007-05-19,Terengganu,112,0,112,2007
2007-05-20,Terengganu,91,0,91,2007
2007-05-21,Terengganu,17,0,17,2007
2007-05-22,Terengganu,9,0,9,2007
2007-05-23,Terengganu,358,0,358,2007
2007-05-24,Terengganu,16,0,16,2007
2007-05-25,Terengganu,2,0,2,2007
2007-05-26,Terengganu,103,0,103,2007
2007-05-27,Terengganu,16,0,16,2007
2007-05-28,Terengganu,44,0,44,2007
2007-05-29,Terengganu,16,0,16,2007
2007-05-30,Terengganu,64,0,64,2007
2007-05-31,Terengganu,74,0,74,2007
2007-06-01,Terengganu,0,0,0,2007
2007-06-02,Terengganu,0,0,0,2007
2007-06-03,Terengganu,0,0,0,2007
2007-06-04,Terengganu,14,0,14,2007
2007-06-05,Terengganu,18,0,18,2007
2007-06-06,Terengganu,13,0,13,2007
2007-06-07,Terengganu,184,2,182,2007
2007-06-08,Terengganu,54,0,54,2007
2007-06-09,Terengganu,0,0,0,2007
2007-06-10,Terengganu,68,0,68,2007
2007-06-11,Terengganu,13,0,13,2007
2007-06-12,Terengganu,14,0,14,2007
2007-06-13,Terengganu,111,0,111,2007
2007-06-14,Terengganu,9,0,9,2007
2007-06-15,Terengganu,24,0,24,2007
2007-06-16,Terengganu,0,0,0,2007
2007-06-17,Terengganu,16,0,16,2007
2007-06-18,Terengganu,117,0,117,2007
2007-06-19,Terengganu,32,0,32,2007
2007-06-20,Terengganu,116,0,116,2007
2007-06-21,Terengganu,10,0,10,2007
2007-06-22,Terengganu,0,0,0,2007
2007-06-23,Terengganu,0,0,0,2007
2007-06-24,Terengganu,23,0,23,2007
2007-06-25,Terengganu,17,0,17,2007
2007-06-26,Terengganu,46,0,46,2007
2007-06-27,Terengganu,12,0,12,2007
2007-06-28,Terengganu,14,0,14,2007
2007-06-29,Terengganu,0,0,0,2007
2007-06-30,Terengganu,0,0,0,2007
2007-07-01,Terengganu,14,0,14,2007
2007-07-02,Terengganu,8,0,8,2007
2007-07-03,Terengganu,128,0,128,2007
2007-07-04,Terengganu,133,1,132,2007
2007-07-05,Terengganu,54,0,54,2007
2007-07-06,Terengganu,146,0,146,2007
2007-07-07,Terengganu,206,0,206,2007
2007-07-08,Terengganu,10,0,10,2007
2007-07-09,Terengganu,17,0,17,2007
2007-07-10,Terengganu,105,1,104,2007
2007-07-11,Terengganu,6,0,6,2007
2007-07-12,Terengganu,67,0,67,2007
2007-07-13,Terengganu,0,0,0,2007
2007-07-14,Terengganu,0,0,0,2007
2007-07-15,Terengganu,18,0,18,2007
2007-07-16,Terengganu,11,0,11,2007
2007-07-17,Terengganu,18,0,18,2007
2007-07-18,Terengganu,119,0,119,2007
2007-07-19,Terengganu,40,0,40,2007
2007-07-20,Terengganu,0,0,0,2007
2007-07-21,Terengganu,0,0,0,2007
2007-07-22,Terengganu,17,0,17,2007
2007-07-23,Terengganu,14,0,14,2007
2007-07-24,Terengganu,7,0,7,2007
2007-07-25,Terengganu,6,0,6,2007
2007-07-26,Terengganu,54,0,54,2007
2007-07-27,Terengganu,0,0,0,2007
2007-07-28,Terengganu,322,0,322,2007
2007-07-29,Terengganu,14,0,14,2007
2007-07-30,Terengganu,131,0,131,2007
2007-07-31,Terengganu,3,0,3,2007
2007-08-01,Terengganu,257,0,257,2007
2007-08-02,Terengganu,311,0,311,2007
2007-08-03,Terengganu,0,0,0,2007
2007-08-04,Terengganu,148,1,147,2007
2007-08-05,Terengganu,8,0,8,2007
2007-08-06,Terengganu,81,0,81,2007
2007-08-07,Terengganu,15,0,15,2007
2007-08-08,Terengganu,12,0,12,2007
2007-08-09,Terengganu,126,0,126,2007
2007-08-10,Terengganu,0,0,0,2007
2007-08-11,Terengganu,0,0,0,2007
2007-08-12,Terengganu,6,0,6,2007
2007-08-13,Terengganu,10,0,10,2007
2007-08-14,Terengganu,31,0,31,2007
2007-08-15,Terengganu,7,0,7,2007
2007-08-16,Terengganu,39,0,39,2007
2007-08-17,Terengganu,0,0,0,2007
2007-08-18,Terengganu,0,0,0,2007
2007-08-19,Terengganu,14,0,14,2007
2007-08-20,Terengganu,7,0,7,2007
2007-08-21,Terengganu,312,0,312,2007
2007-08-22,Terengganu,259,0,259,2007
2007-08-23,Terengganu,127,0,127,2007
2007-08-24,Terengganu,14,0,14,2007
2007-08-25,Terengganu,56,0,56,2007
2007-08-26,Terengganu,13,0,13,2007
2007-08-27,Terengganu,62,0,62,2007
2007-08-28,Terengganu,196,0,196,2007
2007-08-29,Terengganu,215,0,215,2007
2007-08-30,Terengganu,156,0,156,2007
2007-08-31,Terengganu,0,0,0,2007
2007-09-01,Terengganu,0,0,0,2007
2007-09-02,Terengganu,10,0,10,2007
2007-09-03,Terengganu,4,0,4,2007
2007-09-04,Terengganu,130,0,130,2007
2007-09-05,Terengganu,74,0,74,2007
2007-09-06,Terengganu,171,0,171,2007
2007-09-07,Terengganu,99,0,99,2007
2007-09-08,Terengganu,86,0,86,2007
2007-09-09,Terengganu,63,0,63,2007
2007-09-10,Terengganu,73,0,73,2007
2007-09-11,Terengganu,314,4,310,2007
2007-09-12,Terengganu,113,0,113,2007
2007-09-13,Terengganu,0,0,0,2007
2007-09-14,Terengganu,0,0,0,2007
2007-09-15,Terengganu,0,0,0,2007
2007-09-16,Terengganu,7,0,7,2007
2007-09-17,Terengganu,67,0,67,2007
2007-09-18,Terengganu,4,0,4,2007
2007-09-19,Terengganu,50,0,50,2007
2007-09-20,Terengganu,0,0,0,2007
2007-09-21,Terengganu,106,0,106,2007
2007-09-22,Terengganu,0,0,0,2007
2007-09-23,Terengganu,0,0,0,2007
2007-09-24,Terengganu,194,2,192,2007
2007-09-25,Terengganu,0,0,0,2007
2007-09-26,Terengganu,0,0,0,2007
2007-09-27,Terengganu,12,0,12,2007
2007-09-28,Terengganu,128,0,128,2007
2007-09-29,Terengganu,0,0,0,2007
2007-09-30,Terengganu,0,0,0,2007
2007-10-01,Terengganu,70,0,70,2007
2007-10-02,Terengganu,40,0,40,2007
2007-10-03,Terengganu,77,0,77,2007
2007-10-04,Terengganu,0,0,0,2007
2007-10-05,Terengganu,118,0,118,2007
2007-10-06,Terengganu,63,0,63,2007
2007-10-07,Terengganu,54,6,48,2007
2007-10-08,Terengganu,167,0,167,2007
2007-10-09,Terengganu,2,0,2,2007
2007-10-10,Terengganu,2,0,2,2007
2007-10-11,Terengganu,43,0,43,2007
2007-10-12,Terengganu,0,0,0,2007
2007-10-13,Terengganu,0,0,0,2007
2007-10-14,Terengganu,0,0,0,2007
2007-10-15,Terengganu,0,0,0,2007
2007-10-16,Terengganu,21,0,21,2007
2007-10-17,Terengganu,26,0,26,2007
2007-10-18,Terengganu,16,0,16,2007
2007-10-19,Terengganu,74,0,74,2007
2007-10-20,Terengganu,0,0,0,2007
2007-10-21,Terengganu,47,0,47,2007
2007-10-22,Terengganu,24,0,24,2007
2007-10-23,Terengganu,16,0,16,2007
2007-10-24,Terengganu,92,0,92,2007
2007-10-25,Terengganu,26,0,26,2007
2007-10-26,Terengganu,0,0,0,2007
2007-10-27,Terengganu,0,0,0,2007
2007-10-28,Terengganu,193,0,193,2007
2007-10-29,Terengganu,142,0,142,2007
2007-10-30,Terengganu,7,0,7,2007
2007-10-31,Terengganu,15,0,15,2007
2007-11-01,Terengganu,24,0,24,2007
2007-11-02,Terengganu,28,0,28,2007
2007-11-03,Terengganu,78,0,78,2007
2007-11-04,Terengganu,18,0,18,2007
2007-11-05,Terengganu,14,0,14,2007
2007-11-06,Terengganu,74,0,74,2007
2007-11-07,Terengganu,37,0,37,2007
2007-11-08,Terengganu,0,0,0,2007
2007-11-09,Terengganu,0,0,0,2007
2007-11-10,Terengganu,46,0,46,2007
2007-11-11,Terengganu,39,0,39,2007
2007-11-12,Terengganu,19,0,19,2007
2007-11-13,Terengganu,117,0,117,2007
2007-11-14,Terengganu,10,0,10,2007
2007-11-15,Terengganu,111,0,111,2007
2007-11-16,Terengganu,0,0,0,2007
2007-11-17,Terengganu,14,0,14,2007
2007-11-18,Terengganu,22,0,22,2007
2007-11-19,Terengganu,256,0,256,2007
2007-11-20,Terengganu,14,1,13,2007
2007-11-21,Terengganu,18,0,18,2007
2007-11-22,Terengganu,74,0,74,2007
2007-11-23,Terengganu,0,0,0,2007
2007-11-24,Terengganu,0,0,0,2007
2007-11-25,Terengganu,20,0,20,2007
2007-11-26,Terengganu,15,0,15,2007
2007-11-27,Terengganu,82,0,82,2007
2007-11-28,Terengganu,34,0,34,2007
2007-11-29,Terengganu,40,0,40,2007
2007-11-30,Terengganu,0,0,0,2007
2007-12-01,Terengganu,0,0,0,2007
2007-12-02,Terengganu,70,2,68,2007
2007-12-03,Terengganu,48,2,46,2007
2007-12-04,Terengganu,48,0,48,2007
2007-12-05,Terengganu,150,0,150,2007
2007-12-06,Terengganu,104,0,104,2007
2007-12-07,Terengganu,0,0,0,2007
2007-12-08,Terengganu,0,0,0,2007
2007-12-09,Terengganu,19,0,19,2007
2007-12-10,Terengganu,26,0,26,2007
2007-12-11,Terengganu,10,0,10,2007
2007-12-12,Terengganu,24,0,24,2007
2007-12-13,Terengganu,83,0,83,2007
2007-12-14,Terengganu,0,0,0,2007
2007-12-15,Terengganu,97,0,97,2007
2007-12-16,Terengganu,73,0,73,2007
2007-12-17,Terengganu,114,0,114,2007
2007-12-18,Terengganu,10,0,10,2007
2007-12-19,Terengganu,18,0,18,2007
2007-12-20,Terengganu,0,0,0,2007
2007-12-21,Terengganu,0,0,0,2007
2007-12-22,Terengganu,0,0,0,2007
2007-12-23,Terengganu,41,2,39,2007
2007-12-24,Terengganu,38,0,38,2007
2007-12-25,Terengganu,0,0,0,2007
2007-12-26,Terengganu,8,0,8,2007
2007-12-27,Terengganu,70,0,70,2007
2007-12-28,Terengganu,0,0,0,2007
2007-12-29,Terengganu,0,0,0,2007
2007-12-30,Terengganu,14,0,14,2007
2007-12-31,Terengganu,6,0,6,2007
2008-01-01,Terengganu,8,0,8,2008
2008-01-02,Terengganu,14,0,14,2008
2008-01-03,Terengganu,53,0,53,2008
2008-01-04,Terengganu,0,0,0,2008
2008-01-05,Terengganu,64,0,64,2008
2008-01-06,Terengganu,13,0,13,2008
2008-01-07,Terengganu,22,1,21,2008
2008-01-08,Terengganu,33,0,33,2008
2008-01-09,Terengganu,68,0,68,2008
2008-01-10,Terengganu,0,0,0,2008
2008-01-11,Terengganu,0,0,0,2008
2008-01-12,Terengganu,181,3,178,2008
2008-01-13,Terengganu,144,2,142,2008
2008-01-14,Terengganu,14,0,14,2008
2008-01-15,Terengganu,18,0,18,2008
2008-01-16,Terengganu,13,0,13,2008
2008-01-17,Terengganu,141,0,141,2008
2008-01-18,Terengganu,0,0,0,2008
2008-01-19,Terengganu,90,2,88,2008
2008-01-20,Terengganu,240,3,237,2008
2008-01-21,Terengganu,8,0,8,2008
2008-01-22,Terengganu,12,0,12,2008
2008-01-23,Terengganu,364,3,361,2008
2008-01-24,Terengganu,142,0,142,2008
2008-01-25,Terengganu,0,0,0,2008
2008-01-26,Terengganu,0,0,0,2008
2008-01-27,Terengganu,178,0,178,2008
2008-01-28,Terengganu,194,0,194,2008
2008-01-29,Terengganu,15,0,15,2008
2008-01-30,Terengganu,142,0,142,2008
2008-01-31,Terengganu,7,0,7,2008
2008-02-01,Terengganu,0,0,0,2008
2008-02-02,Terengganu,0,0,0,2008
2008-02-03,Terengganu,7,0,7,2008
2008-02-04,Terengganu,4,0,4,2008
2008-02-05,Terengganu,17,0,17,2008
2008-02-06,Terengganu,104,0,104,2008
2008-02-07,Terengganu,0,0,0,2008
2008-02-08,Terengganu,0,0,0,2008
2008-02-09,Terengganu,0,0,0,2008
2008-02-10,Terengganu,26,0,26,2008
2008-02-11,Terengganu,234,51,183,2008
2008-02-12,Terengganu,13,1,12,2008
2008-02-13,Terengganu,12,0,12,2008
2008-02-14,Terengganu,173,34,139,2008
2008-02-15,Terengganu,17,16,1,2008
2008-02-16,Terengganu,0,0,0,2008
2008-02-17,Terengganu,6,0,6,2008
2008-02-18,Terengganu,9,2,7,2008
2008-02-19,Terengganu,10,0,10,2008
2008-02-20,Terengganu,8,2,6,2008
2008-02-21,Terengganu,179,38,141,2008
2008-02-22,Terengganu,41,14,27,2008
2008-02-23,Terengganu,76,72,4,2008
2008-02-24,Terengganu,8,2,6,2008
2008-02-25,Terengganu,1,0,1,2008
2008-02-26,Terengganu,17,1,16,2008
2008-02-27,Terengganu,2,0,2,2008
2008-02-28,Terengganu,138,65,73,2008
2008-02-29,Terengganu,0,0,0,2008
2008-03-01,Terengganu,0,0,0,2008
2008-03-02,Terengganu,16,1,15,2008
2008-03-03,Terengganu,88,74,14,2008
2008-03-04,Terengganu,0,0,0,2008
2008-03-05,Terengganu,16,1,15,2008
2008-03-06,Terengganu,5,1,4,2008
2008-03-07,Terengganu,0,0,0,2008
2008-03-08,Terengganu,0,0,0,2008
2008-03-09,Terengganu,19,1,18,2008
2008-03-10,Terengganu,18,4,14,2008
2008-03-11,Terengganu,27,15,12,2008
2008-03-12,Terengganu,6,0,6,2008
2008-03-13,Terengganu,158,91,67,2008
2008-03-14,Terengganu,0,0,0,2008
2008-03-15,Terengganu,0,0,0,2008
2008-03-16,Terengganu,19,3,16,2008
2008-03-17,Terengganu,7,1,6,2008
2008-03-18,Terengganu,9,0,9,2008
2008-03-19,Terengganu,33,16,17,2008
2008-03-20,Terengganu,0,0,0,2008
2008-03-21,Terengganu,0,0,0,2008
2008-03-22,Terengganu,0,0,0,2008
2008-03-23,Terengganu,13,3,10,2008
2008-03-24,Terengganu,8,0,8,2008
2008-03-25,Terengganu,66,23,43,2008
2008-03-26,Terengganu,29,7,22,2008
2008-03-27,Terengganu,18,4,14,2008
2008-03-28,Terengganu,0,0,0,2008
2008-03-29,Terengganu,40,7,33,2008
2008-03-30,Terengganu,166,45,121,2008
2008-03-31,Terengganu,6,0,6,2008
2008-04-01,Terengganu,100,40,60,2008
2008-04-02,Terengganu,5,0,5,2008
2008-04-03,Terengganu,102,33,69,2008
2008-04-04,Terengganu,0,0,0,2008
2008-04-05,Terengganu,0,0,0,2008
2008-04-06,Terengganu,17,1,16,2008
2008-04-07,Terengganu,22,1,21,2008
2008-04-08,Terengganu,46,11,35,2008
2008-04-09,Terengganu,22,1,21,2008
2008-04-10,Terengganu,18,2,16,2008
2008-04-11,Terengganu,0,0,0,2008
2008-04-12,Terengganu,77,11,66,2008
2008-04-13,Terengganu,113,32,81,2008
2008-04-14,Terengganu,12,0,12,2008
2008-04-15,Terengganu,7,0,7,2008
2008-04-16,Terengganu,76,28,48,2008
2008-04-17,Terengganu,177,83,94,2008
2008-04-18,Terengganu,0,0,0,2008
2008-04-19,Terengganu,0,0,0,2008
2008-04-20,Terengganu,15,1,14,2008
2008-04-21,Terengganu,92,43,49,2008
2008-04-22,Terengganu,11,1,10,2008
2008-04-23,Terengganu,7,4,3,2008
2008-04-24,Terengganu,61,34,27,2008
2008-04-25,Terengganu,0,0,0,2008
2008-04-26,Terengganu,0,0,0,2008
2008-04-27,Terengganu,29,1,28,2008
2008-04-28,Terengganu,61,42,19,2008
2008-04-29,Terengganu,11,1,10,2008
2008-04-30,Terengganu,5,1,4,2008
2008-05-01,Terengganu,0,0,0,2008
2008-05-02,Terengganu,0,0,0,2008
2008-05-03,Terengganu,0,0,0,2008
2008-05-04,Terengganu,127,21,106,2008
2008-05-05,Terengganu,18,2,16,2008
2008-05-06,Terengganu,194,41,153,2008
2008-05-07,Terengganu,8,2,6,2008
2008-05-08,Terengganu,55,24,31,2008
2008-05-09,Terengganu,121,24,97,2008
2008-05-10,Terengganu,0,0,0,2008
2008-05-11,Terengganu,22,2,20,2008
2008-05-12,Terengganu,31,20,11,2008
2008-05-13,Terengganu,52,16,36,2008
2008-05-14,Terengganu,20,1,19,2008
2008-05-15,Terengganu,36,17,19,2008
2008-05-16,Terengganu,0,0,0,2008
2008-05-17,Terengganu,61,57,4,2008
2008-05-18,Terengganu,13,2,11,2008
2008-05-19,Terengganu,0,0,0,2008
2008-05-20,Terengganu,6,1,5,2008
2008-05-21,Terengganu,65,16,49,2008
2008-05-22,Terengganu,10,0,10,2008
2008-05-23,Terengganu,0,0,0,2008
2008-05-24,Terengganu,0,0,0,2008
2008-05-25,Terengganu,12,0,12,2008
2008-05-26,Terengganu,25,2,23,2008
2008-05-27,Terengganu,18,1,17,2008
2008-05-28,Terengganu,62,17,45,2008
2008-05-29,Terengganu,49,9,40,2008
2008-05-30,Terengganu,0,0,0,2008
2008-05-31,Terengganu,0,0,0,2008
2008-06-01,Terengganu,13,1,12,2008
2008-06-02,Terengganu,36,12,24,2008
2008-06-03,Terengganu,13,0,13,2008
2008-06-04,Terengganu,8,1,7,2008
2008-06-05,Terengganu,13,1,12,2008
2008-06-06,Terengganu,16,6,10,2008
2008-06-07,Terengganu,42,36,6,2008
2008-06-08,Terengganu,0,0,0,2008
2008-06-09,Terengganu,7,1,6,2008
2008-06-10,Terengganu,0,0,0,2008
2008-06-11,Terengganu,12,1,11,2008
2008-06-12,Terengganu,34,17,17,2008
2008-06-13,Terengganu,0,0,0,2008
2008-06-14,Terengganu,0,0,0,2008
2008-06-15,Terengganu,20,2,18,2008
2008-06-16,Terengganu,5,1,4,2008
2008-06-17,Terengganu,54,43,11,2008
2008-06-18,Terengganu,11,1,10,2008
2008-06-19,Terengganu,58,8,50,2008
2008-06-20,Terengganu,37,7,30,2008
2008-06-21,Terengganu,0,0,0,2008
2008-06-22,Terengganu,64,26,38,2008
2008-06-23,Terengganu,11,3,8,2008
2008-06-24,Terengganu,10,2,8,2008
2008-06-25,Terengganu,26,9,17,2008
2008-06-26,Terengganu,75,58,17,2008
2008-06-27,Terengganu,26,12,14,2008
2008-06-28,Terengganu,56,52,4,2008
2008-06-29,Terengganu,18,0,18,2008
2008-06-30,Terengganu,9,0,9,2008
2008-07-01,Terengganu,8,3,5,2008
2008-07-02,Terengganu,16,2,14,2008
2008-07-03,Terengganu,60,37,23,2008
2008-07-04,Terengganu,0,0,0,2008
2008-07-05,Terengganu,0,0,0,2008
2008-07-06,Terengganu,15,1,14,2008
2008-07-07,Terengganu,101,63,38,2008
2008-07-08,Terengganu,165,104,61,2008
2008-07-09,Terengganu,105,51,54,2008
2008-07-10,Terengganu,74,60,14,2008
2008-07-11,Terengganu,0,0,0,2008
2008-07-12,Terengganu,0,0,0,2008
2008-07-13,Terengganu,7,0,7,2008
2008-07-14,Terengganu,88,52,36,2008
2008-07-15,Terengganu,46,32,14,2008
2008-07-16,Terengganu,12,1,11,2008
2008-07-17,Terengganu,29,2,27,2008
2008-07-18,Terengganu,44,12,32,2008
2008-07-19,Terengganu,27,11,16,2008
2008-07-20,Terengganu,0,0,0,2008
2008-07-21,Terengganu,213,76,137,2008
2008-07-22,Terengganu,80,53,27,2008
2008-07-23,Terengganu,7,2,5,2008
2008-07-24,Terengganu,17,1,16,2008
2008-07-25,Terengganu,16,7,9,2008
2008-07-26,Terengganu,257,89,168,2008
2008-07-27,Terengganu,91,58,33,2008
2008-07-28,Terengganu,4,0,4,2008
2008-07-29,Terengganu,60,15,45,2008
2008-07-30,Terengganu,147,56,91,2008
2008-07-31,Terengganu,92,55,37,2008
2008-08-01,Terengganu,0,0,0,2008
2008-08-02,Terengganu,0,0,0,2008
2008-08-03,Terengganu,63,52,11,2008
2008-08-04,Terengganu,3,0,3,2008
2008-08-05,Terengganu,14,0,14,2008
2008-08-06,Terengganu,1,0,1,2008
2008-08-07,Terengganu,92,14,78,2008
2008-08-08,Terengganu,0,0,0,2008
2008-08-09,Terengganu,0,0,0,2008
2008-08-10,Terengganu,52,38,14,2008
2008-08-11,Terengganu,56,34,22,2008
2008-08-12,Terengganu,57,37,20,2008
2008-08-13,Terengganu,50,37,13,2008
2008-08-14,Terengganu,8,0,8,2008
2008-08-15,Terengganu,80,45,35,2008
2008-08-16,Terengganu,0,0,0,2008
2008-08-17,Terengganu,18,3,15,2008
2008-08-18,Terengganu,101,73,28,2008
2008-08-19,Terengganu,9,0,9,2008
2008-08-20,Terengganu,6,0,6,2008
2008-08-21,Terengganu,125,60,65,2008
2008-08-22,Terengganu,0,0,0,2008
2008-08-23,Terengganu,62,56,6,2008
2008-08-24,Terengganu,27,11,16,2008
2008-08-25,Terengganu,159,39,120,2008
2008-08-26,Terengganu,159,39,120,2008
2008-08-27,Terengganu,12,2,10,2008
2008-08-28,Terengganu,40,9,31,2008
2008-08-29,Terengganu,87,8,79,2008
2008-08-30,Terengganu,91,46,45,2008
2008-08-31,Terengganu,0,0,0,2008
2008-09-01,Terengganu,0,0,0,2008
2008-09-02,Terengganu,0,0,0,2008
2008-09-03,Terengganu,48,14,34,2008
2008-09-04,Terengganu,0,0,0,2008
2008-09-05,Terengganu,0,0,0,2008
2008-09-06,Terengganu,0,0,0,2008
2008-09-07,Terengganu,32,9,23,2008
2008-09-08,Terengganu,2,0,2,2008
2008-09-09,Terengganu,4,0,4,2008
2008-09-10,Terengganu,0,0,0,2008
2008-09-11,Terengganu,0,0,0,2008
2008-09-12,Terengganu,65,18,47,2008
2008-09-13,Terengganu,0,0,0,2008
2008-09-14,Terengganu,0,0,0,2008
2008-09-15,Terengganu,73,32,41,2008
2008-09-16,Terengganu,0,0,0,2008
2008-09-17,Terengganu,0,0,0,2008
2008-09-18,Terengganu,46,22,24,2008
2008-09-19,Terengganu,49,10,39,2008
2008-09-20,Terengganu,142,74,68,2008
2008-09-21,Terengganu,27,5,22,2008
2008-09-22,Terengganu,2,0,2,2008
2008-09-23,Terengganu,83,53,30,2008
2008-09-24,Terengganu,3,0,3,2008
2008-09-25,Terengganu,0,0,0,2008
2008-09-26,Terengganu,103,11,92,2008
2008-09-27,Terengganu,16,7,9,2008
2008-09-28,Terengganu,0,0,0,2008
2008-09-29,Terengganu,5,0,5,2008
2008-09-30,Terengganu,0,0,0,2008
2008-10-01,Terengganu,0,0,0,2008
2008-10-02,Terengganu,0,0,0,2008
2008-10-03,Terengganu,0,0,0,2008
2008-10-04,Terengganu,0,0,0,2008
2008-10-05,Terengganu,34,0,34,2008
2008-10-06,Terengganu,34,3,31,2008
2008-10-07,Terengganu,109,49,60,2008
2008-10-08,Terengganu,21,7,14,2008
2008-10-09,Terengganu,76,40,36,2008
2008-10-10,Terengganu,0,0,0,2008
2008-10-11,Terengganu,0,0,0,2008
2008-10-12,Terengganu,117,84,33,2008
2008-10-13,Terengganu,74,26,48,2008
2008-10-14,Terengganu,128,54,74,2008
2008-10-15,Terengganu,83,30,53,2008
2008-10-16,Terengganu,18,3,15,2008
2008-10-17,Terengganu,0,0,0,2008
2008-10-18,Terengganu,20,8,12,2008
2008-10-19,Terengganu,25,5,20,2008
2008-10-20,Terengganu,88,29,59,2008
2008-10-21,Terengganu,10,1,9,2008
2008-10-22,Terengganu,168,50,118,2008
2008-10-23,Terengganu,32,23,9,2008
2008-10-24,Terengganu,15,8,7,2008
2008-10-25,Terengganu,14,5,9,2008
2008-10-26,Terengganu,80,31,49,2008
2008-10-27,Terengganu,0,0,0,2008
2008-10-28,Terengganu,17,1,16,2008
2008-10-29,Terengganu,33,17,16,2008
2008-10-30,Terengganu,95,53,42,2008
2008-10-31,Terengganu,0,0,0,2008
2008-11-01,Terengganu,9,4,5,2008
2008-11-02,Terengganu,41,18,23,2008
2008-11-03,Terengganu,14,1,13,2008
2008-11-04,Terengganu,80,33,47,2008
2008-11-05,Terengganu,9,1,8,2008
2008-11-06,Terengganu,4,2,2,2008
2008-11-07,Terengganu,110,72,38,2008
2008-11-08,Terengganu,0,0,0,2008
2008-11-09,Terengganu,38,13,25,2008
2008-11-10,Terengganu,9,1,8,2008
2008-11-11,Terengganu,4,0,4,2008
2008-11-12,Terengganu,13,0,13,2008
2008-11-13,Terengganu,31,14,17,2008
2008-11-14,Terengganu,0,0,0,2008
2008-11-15,Terengganu,0,0,0,2008
2008-11-16,Terengganu,25,12,13,2008
2008-11-17,Terengganu,67,32,35,2008
2008-11-18,Terengganu,54,32,22,2008
2008-11-19,Terengganu,84,54,30,2008
2008-11-20,Terengganu,113,71,42,2008
2008-11-21,Terengganu,0,0,0,2008
2008-11-22,Terengganu,25,22,3,2008
2008-11-23,Terengganu,18,8,10,2008
2008-11-24,Terengganu,131,108,23,2008
2008-11-25,Terengganu,44,26,18,2008
2008-11-26,Terengganu,10,4,6,2008
2008-11-27,Terengganu,72,14,58,2008
2008-11-28,Terengganu,0,0,0,2008
2008-11-29,Terengganu,0,0,0,2008
2008-11-30,Terengganu,12,1,11,2008
2008-12-01,Terengganu,9,0,9,2008
2008-12-02,Terengganu,47,31,16,2008
2008-12-03,Terengganu,6,0,6,2008
2008-12-04,Terengganu,39,10,29,2008
2008-12-05,Terengganu,0,0,0,2008
2008-12-06,Terengganu,9,4,5,2008
2008-12-07,Terengganu,13,1,12,2008
2008-12-08,Terengganu,0,0,0,2008
2008-12-09,Terengganu,0,0,0,2008
2008-12-10,Terengganu,34,15,19,2008
2008-12-11,Terengganu,33,6,27,2008
2008-12-12,Terengganu,0,0,0,2008
2008-12-13,Terengganu,0,0,0,2008
2008-12-14,Terengganu,30,2,28,2008
2008-12-15,Terengganu,41,7,34,2008
2008-12-16,Terengganu,45,17,28,2008
2008-12-17,Terengganu,75,58,17,2008
2008-12-18,Terengganu,53,10,43,2008
2008-12-19,Terengganu,0,0,0,2008
2008-12-20,Terengganu,0,0,0,2008
2008-12-21,Terengganu,69,64,5,2008
2008-12-22,Terengganu,38,23,15,2008
2008-12-23,Terengganu,28,9,19,2008
2008-12-24,Terengganu,27,19,8,2008
2008-12-25,Terengganu,0,0,0,2008
2008-12-26,Terengganu,0,0,0,2008
2008-12-27,Terengganu,42,16,26,2008
2008-12-28,Terengganu,62,18,44,2008
2008-12-29,Terengganu,0,0,0,2008
2008-12-30,Terengganu,64,26,38,2008
2008-12-31,Terengganu,37,18,19,2008
2009-01-01,Terengganu,9,3,6,2009
2009-01-02,Terengganu,99,81,18,2009
2009-01-03,Terengganu,0,0,0,2009
2009-01-04,Terengganu,8,1,7,2009
2009-01-05,Terengganu,4,1,3,2009
2009-01-06,Terengganu,4,0,4,2009
2009-01-07,Terengganu,149,33,116,2009
2009-01-08,Terengganu,9,2,7,2009
2009-01-09,Terengganu,33,16,17,2009
2009-01-10,Terengganu,39,21,18,2009
2009-01-11,Terengganu,13,2,11,2009
2009-01-12,Terengganu,143,83,60,2009
2009-01-13,Terengganu,4,1,3,2009
2009-01-14,Terengganu,57,45,12,2009
2009-01-15,Terengganu,23,11,12,2009
2009-01-16,Terengganu,0,0,0,2009
2009-01-17,Terengganu,0,0,0,2009
2009-01-18,Terengganu,9,3,6,2009
2009-01-19,Terengganu,203,79,124,2009
2009-01-20,Terengganu,5,0,5,2009
2009-01-21,Terengganu,161,66,95,2009
2009-01-22,Terengganu,10,0,10,2009
2009-01-23,Terengganu,25,14,11,2009
2009-01-24,Terengganu,58,30,28,2009
2009-01-25,Terengganu,24,3,21,2009
2009-01-26,Terengganu,0,0,0,2009
2009-01-27,Terengganu,0,0,0,2009
2009-01-28,Terengganu,30,3,27,2009
2009-01-29,Terengganu,37,14,23,2009
2009-01-30,Terengganu,0,0,0,2009
2009-01-31,Terengganu,0,0,0,2009
2009-02-01,Terengganu,16,2,14,2009
2009-02-02,Terengganu,148,51,97,2009
2009-02-03,Terengganu,207,80,127,2009
2009-02-04,Terengganu,5,2,3,2009
2009-02-05,Terengganu,75,46,29,2009
2009-02-06,Terengganu,0,0,0,2009
2009-02-07,Terengganu,0,0,0,2009
2009-02-08,Terengganu,15,0,15,2009
2009-02-09,Terengganu,20,6,14,2009
2009-02-10,Terengganu,119,30,89,2009
2009-02-11,Terengganu,85,19,66,2009
2009-02-12,Terengganu,9,1,8,2009
2009-02-13,Terengganu,0,0,0,2009
2009-02-14,Terengganu,0,0,0,2009
2009-02-15,Terengganu,15,1,14,2009
2009-02-16,Terengganu,68,34,34,2009
2009-02-17,Terengganu,6,0,6,2009
2009-02-18,Terengganu,14,1,13,2009
2009-02-19,Terengganu,62,18,44,2009
2009-02-20,Terengganu,61,16,45,2009
2009-02-21,Terengganu,114,110,4,2009
2009-02-22,Terengganu,9,0,9,2009
2009-02-23,Terengganu,47,34,13,2009
2009-02-24,Terengganu,0,0,0,2009
2009-02-25,Terengganu,9,5,4,2009
2009-02-26,Terengganu,10,2,8,2009
2009-02-27,Terengganu,37,12,25,2009
2009-02-28,Terengganu,0,0,0,2009
2009-03-01,Terengganu,134,49,85,2009
2009-03-02,Terengganu,11,2,9,2009
2009-03-03,Terengganu,10,2,8,2009
2009-03-04,Terengganu,0,0,0,2009
2009-03-05,Terengganu,40,34,6,2009
2009-03-06,Terengganu,0,0,0,2009
2009-03-07,Terengganu,0,0,0,2009
2009-03-08,Terengganu,23,11,12,2009
2009-03-09,Terengganu,0,0,0,2009
2009-03-10,Terengganu,4,0,4,2009
2009-03-11,Terengganu,33,12,21,2009
2009-03-12,Terengganu,13,0,13,2009
2009-03-13,Terengganu,0,0,0,2009
2009-03-14,Terengganu,0,0,0,2009
2009-03-15,Terengganu,15,1,14,2009
2009-03-16,Terengganu,158,50,108,2009
2009-03-17,Terengganu,3,0,3,2009
2009-03-18,Terengganu,12,1,11,2009
2009-03-19,Terengganu,118,57,61,2009
2009-03-20,Terengganu,21,10,11,2009
2009-03-21,Terengganu,57,43,14,2009
2009-03-22,Terengganu,40,16,24,2009
2009-03-23,Terengganu,10,5,5,2009
2009-03-24,Terengganu,6,0,6,2009
2009-03-25,Terengganu,75,24,51,2009
2009-03-26,Terengganu,128,73,55,2009
2009-03-27,Terengganu,0,0,0,2009
2009-03-28,Terengganu,59,25,34,2009
2009-03-29,Terengganu,10,3,7,2009
2009-03-30,Terengganu,6,0,6,2009
2009-03-31,Terengganu,59,37,22,2009
2009-04-01,Terengganu,12,1,11,2009
2009-04-02,Terengganu,6,0,6,2009
2009-04-03,Terengganu,0,0,0,2009
2009-04-04,Terengganu,55,43,12,2009
2009-04-05,Terengganu,6,1,5,2009
2009-04-06,Terengganu,8,1,7,2009
2009-04-07,Terengganu,104,30,74,2009
2009-04-08,Terengganu,12,0,12,2009
2009-04-09,Terengganu,10,2,8,2009
2009-04-10,Terengganu,30,19,11,2009
2009-04-11,Terengganu,112,28,84,2009
2009-04-12,Terengganu,155,68,87,2009
2009-04-13,Terengganu,20,2,18,2009
2009-04-14,Terengganu,4,1,3,2009
2009-04-15,Terengganu,5,0,5,2009
2009-04-16,Terengganu,45,17,28,2009
2009-04-17,Terengganu,0,0,0,2009
2009-04-18,Terengganu,93,46,47,2009
2009-04-19,Terengganu,11,1,10,2009
2009-04-20,Terengganu,8,0,8,2009
2009-04-21,Terengganu,57,12,45,2009
2009-04-22,Terengganu,212,128,84,2009
2009-04-23,Terengganu,29,18,11,2009
2009-04-24,Terengganu,0,0,0,2009
2009-04-25,Terengganu,28,21,7,2009
2009-04-26,Terengganu,16,2,14,2009
2009-04-27,Terengganu,8,0,8,2009
2009-04-28,Terengganu,203,78,125,2009
2009-04-29,Terengganu,5,2,3,2009
2009-04-30,Terengganu,33,14,19,2009
2009-05-01,Terengganu,0,0,0,2009
2009-05-02,Terengganu,43,29,14,2009
2009-05-03,Terengganu,106,21,85,2009
2009-05-04,Terengganu,85,30,55,2009
2009-05-05,Terengganu,10,0,10,2009
2009-05-06,Terengganu,11,1,10,2009
2009-05-07,Terengganu,8,1,7,2009
2009-05-08,Terengganu,0,0,0,2009
2009-05-09,Terengganu,22,14,8,2009
2009-05-10,Terengganu,0,0,0,2009
2009-05-11,Terengganu,13,1,12,2009
2009-05-12,Terengganu,48,34,14,2009
2009-05-13,Terengganu,100,66,34,2009
2009-05-14,Terengganu,154,48,106,2009
2009-05-15,Terengganu,0,0,0,2009
2009-05-16,Terengganu,62,31,31,2009
2009-05-17,Terengganu,14,3,11,2009
2009-05-18,Terengganu,63,37,26,2009
2009-05-19,Terengganu,41,14,27,2009
2009-05-20,Terengganu,19,7,12,2009
2009-05-21,Terengganu,11,0,11,2009
2009-05-22,Terengganu,128,12,116,2009
2009-05-23,Terengganu,11,5,6,2009
2009-05-24,Terengganu,4,0,4,2009
2009-05-25,Terengganu,3,0,3,2009
2009-05-26,Terengganu,16,0,16,2009
2009-05-27,Terengganu,84,49,35,2009
2009-05-28,Terengganu,5,1,4,2009
2009-05-29,Terengganu,42,16,26,2009
2009-05-30,Terengganu,40,20,20,2009
2009-05-31,Terengganu,7,1,6,2009
2009-06-01,Terengganu,87,64,23,2009
2009-06-02,Terengganu,8,0,8,2009
2009-06-03,Terengganu,24,12,12,2009
2009-06-04,Terengganu,14,9,5,2009
2009-06-05,Terengganu,0,0,0,2009
2009-06-06,Terengganu,0,0,0,2009
2009-06-07,Terengganu,0,0,0,2009
2009-06-08,Terengganu,24,10,14,2009
2009-06-09,Terengganu,7,1,6,2009
2009-06-10,Terengganu,49,34,15,2009
2009-06-11,Terengganu,27,7,20,2009
2009-06-12,Terengganu,0,0,0,2009
2009-06-13,Terengganu,44,40,4,2009
2009-06-14,Terengganu,71,14,57,2009
2009-06-15,Terengganu,44,29,15,2009
2009-06-16,Terengganu,72,30,42,2009
2009-06-17,Terengganu,36,23,13,2009
2009-06-18,Terengganu,7,1,6,2009
2009-06-19,Terengganu,0,0,0,2009
2009-06-20,Terengganu,70,47,23,2009
2009-06-21,Terengganu,7,0,7,2009
2009-06-22,Terengganu,50,30,20,2009
2009-06-23,Terengganu,57,31,26,2009
2009-06-24,Terengganu,41,31,10,2009
2009-06-25,Terengganu,29,13,16,2009
2009-06-26,Terengganu,0,0,0,2009
2009-06-27,Terengganu,36,28,8,2009
2009-06-28,Terengganu,55,28,27,2009
2009-06-29,Terengganu,68,55,13,2009
2009-06-30,Terengganu,59,51,8,2009
2009-07-01,Terengganu,11,3,8,2009
2009-07-02,Terengganu,50,40,10,2009
2009-07-03,Terengganu,0,0,0,2009
2009-07-04,Terengganu,0,0,0,2009
2009-07-05,Terengganu,61,40,21,2009
2009-07-06,Terengganu,12,4,8,2009
2009-07-07,Terengganu,9,0,9,2009
2009-07-08,Terengganu,56,47,9,2009
2009-07-09,Terengganu,29,13,16,2009
2009-07-10,Terengganu,0,0,0,2009
2009-07-11,Terengganu,135,81,54,2009
2009-07-12,Terengganu,15,2,13,2009
2009-07-13,Terengganu,49,40,9,2009
2009-07-14,Terengganu,41,12,29,2009
2009-07-15,Terengganu,115,75,40,2009
2009-07-16,Terengganu,24,17,7,2009
2009-07-17,Terengganu,39,11,28,2009
2009-07-18,Terengganu,96,47,49,2009
2009-07-19,Terengganu,60,48,12,2009
2009-07-20,Terengganu,0,0,0,2009
2009-07-21,Terengganu,61,35,26,2009
2009-07-22,Terengganu,6,2,4,2009
2009-07-23,Terengganu,63,44,19,2009
2009-07-24,Terengganu,0,0,0,2009
2009-07-25,Terengganu,60,25,35,2009
2009-07-26,Terengganu,17,0,17,2009
2009-07-27,Terengganu,35,10,25,2009
2009-07-28,Terengganu,7,1,6,2009
2009-07-29,Terengganu,2,0,2,2009
2009-07-30,Terengganu,59,50,9,2009
2009-07-31,Terengganu,0,0,0,2009
2009-08-01,Terengganu,0,0,0,2009
2009-08-02,Terengganu,110,76,34,2009
2009-08-03,Terengganu,95,72,23,2009
2009-08-04,Terengganu,53,46,7,2009
2009-08-05,Terengganu,31,9,22,2009
2009-08-06,Terengganu,107,54,53,2009
2009-08-07,Terengganu,0,0,0,2009
2009-08-08,Terengganu,240,87,153,2009
2009-08-09,Terengganu,52,24,28,2009
2009-08-10,Terengganu,11,2,9,2009
2009-08-11,Terengganu,60,32,28,2009
2009-08-12,Terengganu,77,39,38,2009
2009-08-13,Terengganu,63,34,29,2009
2009-08-14,Terengganu,60,41,19,2009
2009-08-15,Terengganu,51,27,24,2009
2009-08-16,Terengganu,43,25,18,2009
2009-08-17,Terengganu,10,0,10,2009
2009-08-18,Terengganu,148,62,86,2009
2009-08-19,Terengganu,23,4,19,2009
2009-08-20,Terengganu,41,15,26,2009
2009-08-21,Terengganu,0,0,0,2009
2009-08-22,Terengganu,0,0,0,2009
2009-08-23,Terengganu,0,0,0,2009
2009-08-24,Terengganu,30,8,22,2009
2009-08-25,Terengganu,2,0,2,2009
2009-08-26,Terengganu,0,0,0,2009
2009-08-27,Terengganu,53,19,34,2009
2009-08-28,Terengganu,62,14,48,2009
2009-08-29,Terengganu,0,0,0,2009
2009-08-30,Terengganu,0,0,0,2009
2009-08-31,Terengganu,0,0,0,2009
2009-09-01,Terengganu,72,25,47,2009
2009-09-02,Terengganu,1,0,1,2009
2009-09-03,Terengganu,60,23,37,2009
2009-09-04,Terengganu,117,13,104,2009
2009-09-05,Terengganu,145,58,87,2009
2009-09-06,Terengganu,3,1,2,2009
2009-09-07,Terengganu,0,0,0,2009
2009-09-08,Terengganu,7,4,3,2009
2009-09-09,Terengganu,131,80,51,2009
2009-09-10,Terengganu,54,8,46,2009
2009-09-11,Terengganu,0,0,0,2009
2009-09-12,Terengganu,62,34,28,2009
2009-09-13,Terengganu,55,16,39,2009
2009-09-14,Terengganu,82,18,64,2009
2009-09-15,Terengganu,0,0,0,2009
2009-09-16,Terengganu,11,6,5,2009
2009-09-17,Terengganu,22,10,12,2009
2009-09-18,Terengganu,45,2,43,2009
2009-09-19,Terengganu,0,0,0,2009
2009-09-20,Terengganu,0,0,0,2009
2009-09-21,Terengganu,0,0,0,2009
2009-09-22,Terengganu,5,0,5,2009
2009-09-23,Terengganu,13,1,12,2009
2009-09-24,Terengganu,17,6,11,2009
2009-09-25,Terengganu,0,0,0,2009
2009-09-26,Terengganu,27,11,16,2009
2009-09-27,Terengganu,31,10,21,2009
2009-09-28,Terengganu,98,68,30,2009
2009-09-29,Terengganu,108,36,72,2009
2009-09-30,Terengganu,67,34,33,2009
2009-10-01,Terengganu,6,1,5,2009
2009-10-02,Terengganu,22,16,6,2009
2009-10-03,Terengganu,20,10,10,2009
2009-10-04,Terengganu,103,42,61,2009
2009-10-05,Terengganu,142,56,86,2009
2009-10-06,Terengganu,12,0,12,2009
2009-10-07,Terengganu,163,84,79,2009
2009-10-08,Terengganu,7,0,7,2009
2009-10-09,Terengganu,0,0,0,2009
2009-10-10,Terengganu,29,14,15,2009
2009-10-11,Terengganu,24,1,23,2009
2009-10-12,Terengganu,175,95,80,2009
2009-10-13,Terengganu,51,39,12,2009
2009-10-14,Terengganu,60,50,10,2009
2009-10-15,Terengganu,4,1,3,2009
2009-10-16,Terengganu,0,0,0,2009
2009-10-17,Terengganu,43,12,31,2009
2009-10-18,Terengganu,0,0,0,2009
2009-10-19,Terengganu,14,1,13,2009
2009-10-20,Terengganu,10,1,9,2009
2009-10-21,Terengganu,45,28,17,2009
2009-10-22,Terengganu,3,1,2,2009
2009-10-23,Terengganu,37,23,14,2009
2009-10-24,Terengganu,31,20,11,2009
2009-10-25,Terengganu,23,0,23,2009
2009-10-26,Terengganu,13,0,13,2009
2009-10-27,Terengganu,133,40,93,2009
2009-10-28,Terengganu,14,4,10,2009
2009-10-29,Terengganu,6,0,6,2009
2009-10-30,Terengganu,0,0,0,2009
2009-10-31,Terengganu,37,14,23,2009
2009-11-01,Terengganu,14,1,13,2009
2009-11-02,Terengganu,55,14,41,2009
2009-11-03,Terengganu,14,3,11,2009
2009-11-04,Terengganu,4,0,4,2009
2009-11-05,Terengganu,63,27,36,2009
2009-11-06,Terengganu,0,0,0,2009
2009-11-07,Terengganu,136,106,30,2009
2009-11-08,Terengganu,46,28,18,2009
2009-11-09,Terengganu,6,0,6,2009
2009-11-10,Terengganu,6,1,5,2009
2009-11-11,Terengganu,8,0,8,2009
2009-11-12,Terengganu,62,40,22,2009
2009-11-13,Terengganu,0,0,0,2009
2009-11-14,Terengganu,33,19,14,2009
2009-11-15,Terengganu,123,55,68,2009
2009-11-16,Terengganu,104,47,57,2009
2009-11-17,Terengganu,50,29,21,2009
2009-11-18,Terengganu,6,4,2,2009
2009-11-19,Terengganu,4,0,4,2009
2009-11-20,Terengganu,104,17,87,2009
2009-11-21,Terengganu,50,28,22,2009
2009-11-22,Terengganu,79,29,50,2009
2009-11-23,Terengganu,115,45,70,2009
2009-11-24,Terengganu,11,1,10,2009
2009-11-25,Terengganu,67,44,23,2009
2009-11-26,Terengganu,13,1,12,2009
2009-11-27,Terengganu,0,0,0,2009
2009-11-28,Terengganu,0,0,0,2009
2009-11-29,Terengganu,0,0,0,2009
2009-11-30,Terengganu,33,15,18,2009
2009-12-01,Terengganu,7,2,5,2009
2009-12-02,Terengganu,22,5,17,2009
2009-12-03,Terengganu,18,10,8,2009
2009-12-04,Terengganu,75,36,39,2009
2009-12-05,Terengganu,0,0,0,2009
2009-12-06,Terengganu,52,25,27,2009
2009-12-07,Terengganu,13,1,12,2009
2009-12-08,Terengganu,7,0,7,2009
2009-12-09,Terengganu,79,35,44,2009
2009-12-10,Terengganu,140,64,76,2009
2009-12-11,Terengganu,0,0,0,2009
2009-12-12,Terengganu,19,18,1,2009
2009-12-13,Terengganu,21,5,16,2009
2009-12-14,Terengganu,9,3,6,2009
2009-12-15,Terengganu,73,36,37,2009
2009-12-16,Terengganu,136,83,53,2009
2009-12-17,Terengganu,119,46,73,2009
2009-12-18,Terengganu,0,0,0,2009
2009-12-19,Terengganu,10,5,5,2009
2009-12-20,Terengganu,17,0,17,2009
2009-12-21,Terengganu,86,40,46,2009
2009-12-22,Terengganu,5,0,5,2009
2009-12-23,Terengganu,41,6,35,2009
2009-12-24,Terengganu,127,44,83,2009
2009-12-25,Terengganu,0,0,0,2009
2009-12-26,Terengganu,50,24,26,2009
2009-12-27,Terengganu,13,0,13,2009
2009-12-28,Terengganu,45,11,34,2009
2009-12-29,Terengganu,75,45,30,2009
2009-12-30,Terengganu,16,2,14,2009
2009-12-31,Terengganu,12,1,11,2009
2010-01-01,Terengganu,32,12,20,2010
2010-01-02,Terengganu,0,0,0,2010
2010-01-03,Terengganu,5,0,5,2010
2010-01-04,Terengganu,12,2,10,2010
2010-01-05,Terengganu,94,63,31,2010
2010-01-06,Terengganu,116,36,80,2010
2010-01-07,Terengganu,111,35,76,2010
2010-01-08,Terengganu,0,0,0,2010
2010-01-09,Terengganu,47,28,19,2010
2010-01-10,Terengganu,16,1,15,2010
2010-01-11,Terengganu,126,40,86,2010
2010-01-12,Terengganu,42,25,17,2010
2010-01-13,Terengganu,11,0,11,2010
2010-01-14,Terengganu,7,0,7,2010
2010-01-15,Terengganu,0,0,0,2010
2010-01-16,Terengganu,36,30,6,2010
2010-01-17,Terengganu,126,45,81,2010
2010-01-18,Terengganu,109,27,82,2010
2010-01-19,Terengganu,49,31,18,2010
2010-01-20,Terengganu,109,46,63,2010
2010-01-21,Terengganu,96,61,35,2010
2010-01-22,Terengganu,0,0,0,2010
2010-01-23,Terengganu,0,0,0,2010
2010-01-24,Terengganu,11,0,11,2010
2010-01-25,Terengganu,8,2,6,2010
2010-01-26,Terengganu,81,54,27,2010
2010-01-27,Terengganu,133,63,70,2010
2010-01-28,Terengganu,175,96,79,2010
2010-01-29,Terengganu,0,0,0,2010
2010-01-30,Terengganu,20,14,6,2010
2010-01-31,Terengganu,22,2,20,2010
2010-02-01,Terengganu,5,2,3,2010
2010-02-02,Terengganu,12,2,10,2010
2010-02-03,Terengganu,84,44,40,2010
2010-02-04,Terengganu,40,20,20,2010
2010-02-05,Terengganu,58,25,33,2010
2010-02-06,Terengganu,0,0,0,2010
2010-02-07,Terengganu,59,42,17,2010
2010-02-08,Terengganu,9,1,8,2010
2010-02-09,Terengganu,68,40,28,2010
2010-02-10,Terengganu,52,34,18,2010
2010-02-11,Terengganu,8,1,7,2010
2010-02-12,Terengganu,26,11,15,2010
2010-02-13,Terengganu,8,5,3,2010
2010-02-14,Terengganu,0,0,0,2010
2010-02-15,Terengganu,0,0,0,2010
2010-02-16,Terengganu,14,0,14,2010
2010-02-17,Terengganu,112,41,71,2010
2010-02-18,Terengganu,100,29,71,2010
2010-02-19,Terengganu,77,31,46,2010
2010-02-20,Terengganu,0,0,0,2010
2010-02-21,Terengganu,9,1,8,2010
2010-02-22,Terengganu,9,0,9,2010
2010-02-23,Terengganu,12,1,11,2010
2010-02-24,Terengganu,114,56,58,2010
2010-02-25,Terengganu,17,8,9,2010
2010-02-26,Terengganu,0,0,0,2010
2010-02-27,Terengganu,28,21,7,2010
2010-02-28,Terengganu,19,0,19,2010
2010-03-01,Terengganu,64,42,22,2010
2010-03-02,Terengganu,129,60,69,2010
2010-03-03,Terengganu,20,1,19,2010
2010-03-04,Terengganu,0,0,0,2010
2010-03-05,Terengganu,46,18,28,2010
2010-03-06,Terengganu,0,0,0,2010
2010-03-07,Terengganu,42,16,26,2010
2010-03-08,Terengganu,58,22,36,2010
2010-03-09,Terengganu,59,21,38,2010
2010-03-10,Terengganu,5,0,5,2010
2010-03-11,Terengganu,155,86,69,2010
2010-03-12,Terengganu,66,39,27,2010
2010-03-13,Terengganu,0,0,0,2010
2010-03-14,Terengganu,8,0,8,2010
2010-03-15,Terengganu,68,50,18,2010
2010-03-16,Terengganu,127,70,57,2010
2010-03-17,Terengganu,12,0,12,2010
2010-03-18,Terengganu,18,1,17,2010
2010-03-19,Terengganu,68,13,55,2010
2010-03-20,Terengganu,66,38,28,2010
2010-03-21,Terengganu,23,1,22,2010
2010-03-22,Terengganu,9,2,7,2010
2010-03-23,Terengganu,113,42,71,2010
2010-03-24,Terengganu,128,54,74,2010
2010-03-25,Terengganu,13,2,11,2010
2010-03-26,Terengganu,0,0,0,2010
2010-03-27,Terengganu,0,0,0,2010
2010-03-28,Terengganu,33,3,30,2010
2010-03-29,Terengganu,125,67,58,2010
2010-03-30,Terengganu,156,55,101,2010
2010-03-31,Terengganu,46,38,8,2010
2010-04-01,Terengganu,13,1,12,2010
2010-04-02,Terengganu,0,0,0,2010
2010-04-03,Terengganu,0,0,0,2010
2010-04-04,Terengganu,15,0,15,2010
2010-04-05,Terengganu,72,38,34,2010
2010-04-06,Terengganu,90,45,45,2010
2010-04-07,Terengganu,65,29,36,2010
2010-04-08,Terengganu,56,24,32,2010
2010-04-09,Terengganu,0,0,0,2010
2010-04-10,Terengganu,0,0,0,2010
2010-04-11,Terengganu,86,59,27,2010
2010-04-12,Terengganu,14,1,13,2010
2010-04-13,Terengganu,157,49,108,2010
2010-04-14,Terengganu,5,0,5,2010
2010-04-15,Terengganu,48,19,29,2010
2010-04-16,Terengganu,30,7,23,2010
2010-04-17,Terengganu,0,0,0,2010
2010-04-18,Terengganu,43,21,22,2010
2010-04-19,Terengganu,11,3,8,2010
2010-04-20,Terengganu,42,18,24,2010
2010-04-21,Terengganu,53,27,26,2010
2010-04-22,Terengganu,14,3,11,2010
2010-04-23,Terengganu,0,0,0,2010
2010-04-24,Terengganu,42,29,13,2010
2010-04-25,Terengganu,90,30,60,2010
2010-04-26,Terengganu,2,0,2,2010
2010-04-27,Terengganu,69,20,49,2010
2010-04-28,Terengganu,96,48,48,2010
2010-04-29,Terengganu,41,25,16,2010
2010-04-30,Terengganu,0,0,0,2010
2010-05-01,Terengganu,0,0,0,2010
2010-05-02,Terengganu,0,0,0,2010
2010-05-03,Terengganu,14,1,13,2010
2010-05-04,Terengganu,54,25,29,2010
2010-05-05,Terengganu,12,2,10,2010
2010-05-06,Terengganu,44,28,16,2010
2010-05-07,Terengganu,0,0,0,2010
2010-05-08,Terengganu,24,8,16,2010
2010-05-09,Terengganu,44,11,33,2010
2010-05-10,Terengganu,8,2,6,2010
2010-05-11,Terengganu,12,1,11,2010
2010-05-12,Terengganu,8,0,8,2010
2010-05-13,Terengganu,58,19,39,2010
2010-05-14,Terengganu,0,0,0,2010
2010-05-15,Terengganu,173,66,107,2010
2010-05-16,Terengganu,15,4,11,2010
2010-05-17,Terengganu,3,0,3,2010
2010-05-18,Terengganu,115,54,61,2010
2010-05-19,Terengganu,8,2,6,2010
2010-05-20,Terengganu,6,0,6,2010
2010-05-21,Terengganu,0,0,0,2010
2010-05-22,Terengganu,89,86,3,2010
2010-05-23,Terengganu,2,0,2,2010
2010-05-24,Terengganu,60,28,32,2010
2010-05-25,Terengganu,56,18,38,2010
2010-05-26,Terengganu,99,53,46,2010
2010-05-27,Terengganu,27,9,18,2010
2010-05-28,Terengganu,0,0,0,2010
2010-05-29,Terengganu,58,32,26,2010
2010-05-30,Terengganu,6,0,6,2010
2010-05-31,Terengganu,14,2,12,2010
2010-06-01,Terengganu,70,29,41,2010
2010-06-02,Terengganu,19,3,16,2010
2010-06-03,Terengganu,25,20,5,2010
2010-06-04,Terengganu,66,8,58,2010
2010-06-05,Terengganu,0,0,0,2010
2010-06-06,Terengganu,0,0,0,2010
2010-06-07,Terengganu,55,20,35,2010
2010-06-08,Terengganu,11,0,11,2010
2010-06-09,Terengganu,4,0,4,2010
2010-06-10,Terengganu,33,18,15,2010
2010-06-11,Terengganu,0,0,0,2010
2010-06-12,Terengganu,0,0,0,2010
2010-06-13,Terengganu,25,1,24,2010
2010-06-14,Terengganu,59,25,34,2010
2010-06-15,Terengganu,32,16,16,2010
2010-06-16,Terengganu,126,32,94,2010
2010-06-17,Terengganu,1,0,1,2010
2010-06-18,Terengganu,29,15,14,2010
2010-06-19,Terengganu,0,0,0,2010
2010-06-20,Terengganu,14,1,13,2010
2010-06-21,Terengganu,28,11,17,2010
2010-06-22,Terengganu,29,16,13,2010
2010-06-23,Terengganu,5,0,5,2010
2010-06-24,Terengganu,11,3,8,2010
2010-06-25,Terengganu,0,0,0,2010
2010-06-26,Terengganu,0,0,0,2010
2010-06-27,Terengganu,0,0,0,2010
2010-06-28,Terengganu,52,29,23,2010
2010-06-29,Terengganu,26,3,23,2010
2010-06-30,Terengganu,36,15,21,2010
2010-07-01,Terengganu,32,22,10,2010
2010-07-02,Terengganu,0,0,0,2010
2010-07-03,Terengganu,52,33,19,2010
2010-07-04,Terengganu,76,48,28,2010
2010-07-05,Terengganu,62,49,13,2010
2010-07-06,Terengganu,76,51,25,2010
2010-07-07,Terengganu,9,0,9,2010
2010-07-08,Terengganu,69,58,11,2010
2010-07-09,Terengganu,0,0,0,2010
2010-07-10,Terengganu,0,0,0,2010
2010-07-11,Terengganu,47,23,24,2010
2010-07-12,Terengganu,40,35,5,2010
2010-07-13,Terengganu,63,42,21,2010
2010-07-14,Terengganu,95,81,14,2010
2010-07-15,Terengganu,48,35,13,2010
2010-07-16,Terengganu,0,0,0,2010
2010-07-17,Terengganu,43,12,31,2010
2010-07-18,Terengganu,15,3,12,2010
2010-07-19,Terengganu,68,36,32,2010
2010-07-20,Terengganu,0,0,0,2010
2010-07-21,Terengganu,57,21,36,2010
2010-07-22,Terengganu,65,49,16,2010
2010-07-23,Terengganu,0,0,0,2010
2010-07-24,Terengganu,61,58,3,2010
2010-07-25,Terengganu,7,3,4,2010
2010-07-26,Terengganu,53,37,16,2010
2010-07-27,Terengganu,94,62,32,2010
2010-07-28,Terengganu,60,22,38,2010
2010-07-29,Terengganu,6,1,5,2010
2010-07-30,Terengganu,0,0,0,2010
2010-07-31,Terengganu,227,50,177,2010
2010-08-01,Terengganu,11,0,11,2010
2010-08-02,Terengganu,17,0,17,2010
2010-08-03,Terengganu,154,77,77,2010
2010-08-04,Terengganu,171,87,84,2010
2010-08-05,Terengganu,115,41,74,2010
2010-08-06,Terengganu,95,17,78,2010
2010-08-07,Terengganu,0,0,0,2010
2010-08-08,Terengganu,127,58,69,2010
2010-08-09,Terengganu,145,77,68,2010
2010-08-10,Terengganu,13,5,8,2010
2010-08-11,Terengganu,2,0,2,2010
2010-08-12,Terengganu,4,0,4,2010
2010-08-13,Terengganu,0,0,0,2010
2010-08-14,Terengganu,0,0,0,2010
2010-08-15,Terengganu,56,10,46,2010
2010-08-16,Terengganu,2,2,0,2010
2010-08-17,Terengganu,83,23,60,2010
2010-08-18,Terengganu,7,0,7,2010
2010-08-19,Terengganu,4,0,4,2010
2010-08-20,Terengganu,119,14,105,2010
2010-08-21,Terengganu,0,0,0,2010
2010-08-22,Terengganu,30,7,23,2010
2010-08-23,Terengganu,101,18,83,2010
2010-08-24,Terengganu,76,22,54,2010
2010-08-25,Terengganu,0,0,0,2010
2010-08-26,Terengganu,32,12,20,2010
2010-08-27,Terengganu,0,0,0,2010
2010-08-28,Terengganu,35,10,25,2010
2010-08-29,Terengganu,0,0,0,2010
2010-08-30,Terengganu,174,68,106,2010
2010-08-31,Terengganu,0,0,0,2010
2010-09-01,Terengganu,0,0,0,2010
2010-09-02,Terengganu,2,1,1,2010
2010-09-03,Terengganu,66,33,33,2010
2010-09-04,Terengganu,93,19,74,2010
2010-09-05,Terengganu,53,35,18,2010
2010-09-06,Terengganu,0,0,0,2010
2010-09-07,Terengganu,34,13,21,2010
2010-09-08,Terengganu,0,0,0,2010
2010-09-09,Terengganu,4,0,4,2010
2010-09-10,Terengganu,0,0,0,2010
2010-09-11,Terengganu,0,0,0,2010
2010-09-12,Terengganu,0,0,0,2010
2010-09-13,Terengganu,7,1,6,2010
2010-09-14,Terengganu,15,0,15,2010
2010-09-15,Terengganu,26,7,19,2010
2010-09-16,Terengganu,0,0,0,2010
2010-09-17,Terengganu,0,0,0,2010
2010-09-18,Terengganu,0,0,0,2010
2010-09-19,Terengganu,80,50,30,2010
2010-09-20,Terengganu,73,30,43,2010
2010-09-21,Terengganu,18,1,17,2010
2010-09-22,Terengganu,108,39,69,2010
2010-09-23,Terengganu,70,19,51,2010
2010-09-24,Terengganu,17,4,13,2010
2010-09-25,Terengganu,0,0,0,2010
2010-09-26,Terengganu,114,52,62,2010
2010-09-27,Terengganu,92,37,55,2010
2010-09-28,Terengganu,10,0,10,2010
2010-09-29,Terengganu,49,29,20,2010
2010-09-30,Terengganu,51,27,24,2010
2010-10-01,Terengganu,0,0,0,2010
2010-10-02,Terengganu,0,0,0,2010
2010-10-03,Terengganu,15,2,13,2010
2010-10-04,Terengganu,141,49,92,2010
2010-10-05,Terengganu,23,1,22,2010
2010-10-06,Terengganu,59,38,21,2010
2010-10-07,Terengganu,1,1,0,2010
2010-10-08,Terengganu,0,0,0,2010
2010-10-09,Terengganu,49,26,23,2010
2010-10-10,Terengganu,16,3,13,2010
2010-10-11,Terengganu,4,0,4,2010
2010-10-12,Terengganu,46,22,24,2010
2010-10-13,Terengganu,16,1,15,2010
2010-10-14,Terengganu,66,28,38,2010
2010-10-15,Terengganu,21,11,10,2010
2010-10-16,Terengganu,57,14,43,2010
2010-10-17,Terengganu,90,18,72,2010
2010-10-18,Terengganu,30,9,21,2010
2010-10-19,Terengganu,64,23,41,2010
2010-10-20,Terengganu,155,101,54,2010
2010-10-21,Terengganu,3,0,3,2010
2010-10-22,Terengganu,0,0,0,2010
2010-10-23,Terengganu,0,0,0,2010
2010-10-24,Terengganu,100,38,62,2010
2010-10-25,Terengganu,79,24,55,2010
2010-10-26,Terengganu,9,3,6,2010
2010-10-27,Terengganu,105,80,25,2010
2010-10-28,Terengganu,4,0,4,2010
2010-10-29,Terengganu,21,7,14,2010
2010-10-30,Terengganu,0,0,0,2010
2010-10-31,Terengganu,28,10,18,2010
2010-11-01,Terengganu,13,0,13,2010
2010-11-02,Terengganu,7,1,6,2010
2010-11-03,Terengganu,87,25,62,2010
2010-11-04,Terengganu,61,29,32,2010
2010-11-05,Terengganu,0,0,0,2010
2010-11-06,Terengganu,0,0,0,2010
2010-11-07,Terengganu,33,6,27,2010
2010-11-08,Terengganu,41,17,24,2010
2010-11-09,Terengganu,45,6,39,2010
2010-11-10,Terengganu,11,0,11,2010
2010-11-11,Terengganu,120,54,66,2010
2010-11-12,Terengganu,0,0,0,2010
2010-11-13,Terengganu,80,63,17,2010
2010-11-14,Terengganu,56,7,49,2010
2010-11-15,Terengganu,34,11,23,2010
2010-11-16,Terengganu,19,1,18,2010
2010-11-17,Terengganu,0,0,0,2010
2010-11-18,Terengganu,0,0,0,2010
2010-11-19,Terengganu,0,0,0,2010
2010-11-20,Terengganu,45,15,30,2010
2010-11-21,Terengganu,31,3,28,2010
2010-11-22,Terengganu,61,33,28,2010
2010-11-23,Terengganu,29,10,19,2010
2010-11-24,Terengganu,64,16,48,2010
2010-11-25,Terengganu,83,19,64,2010
2010-11-26,Terengganu,0,0,0,2010
2010-11-27,Terengganu,55,27,28,2010
2010-11-28,Terengganu,59,46,13,2010
2010-11-29,Terengganu,87,55,32,2010
2010-11-30,Terengganu,91,32,59,2010
2010-12-01,Terengganu,52,22,30,2010
2010-12-02,Terengganu,33,12,21,2010
2010-12-03,Terengganu,101,52,49,2010
2010-12-04,Terengganu,54,5,49,2010
2010-12-05,Terengganu,5,1,4,2010
2010-12-06,Terengganu,46,21,25,2010
2010-12-07,Terengganu,0,0,0,2010
2010-12-08,Terengganu,11,0,11,2010
2010-12-09,Terengganu,40,13,27,2010
2010-12-10,Terengganu,30,13,17,2010
2010-12-11,Terengganu,78,19,59,2010
2010-12-12,Terengganu,13,2,11,2010
2010-12-13,Terengganu,26,7,19,2010
2010-12-14,Terengganu,25,7,18,2010
2010-12-15,Terengganu,28,8,20,2010
2010-12-16,Terengganu,37,21,16,2010
2010-12-17,Terengganu,14,8,6,2010
2010-12-18,Terengganu,67,45,22,2010
2010-12-19,Terengganu,11,2,9,2010
2010-12-20,Terengganu,26,10,16,2010
2010-12-21,Terengganu,49,16,33,2010
2010-12-22,Terengganu,125,52,73,2010
2010-12-23,Terengganu,68,22,46,2010
2010-12-24,Terengganu,0,0,0,2010
2010-12-25,Terengganu,21,11,10,2010
2010-12-26,Terengganu,0,0,0,2010
2010-12-27,Terengganu,46,21,25,2010
2010-12-28,Terengganu,13,1,12,2010
2010-12-29,Terengganu,42,16,26,2010
2010-12-30,Terengganu,45,18,27,2010
2010-12-31,Terengganu,0,0,0,2010
2011-01-01,Terengganu,22,7,15,2011
2011-01-02,Terengganu,0,0,0,2011
2011-01-03,Terengganu,11,3,8,2011
2011-01-04,Terengganu,38,21,17,2011
2011-01-05,Terengganu,67,33,34,2011
2011-01-06,Terengganu,83,52,31,2011
2011-01-07,Terengganu,0,0,0,2011
2011-01-08,Terengganu,36,13,23,2011
2011-01-09,Terengganu,13,3,10,2011
2011-01-10,Terengganu,113,46,67,2011
2011-01-11,Terengganu,7,1,6,2011
2011-01-12,Terengganu,10,1,9,2011
2011-01-13,Terengganu,60,44,16,2011
2011-01-14,Terengganu,0,0,0,2011
2011-01-15,Terengganu,53,23,30,2011
2011-01-16,Terengganu,17,2,15,2011
2011-01-17,Terengganu,173,76,97,2011
2011-01-18,Terengganu,4,1,3,2011
2011-01-19,Terengganu,157,71,86,2011
2011-01-20,Terengganu,177,72,105,2011
2011-01-21,Terengganu,31,10,21,2011
2011-01-22,Terengganu,0,0,0,2011
2011-01-23,Terengganu,6,0,6,2011
2011-01-24,Terengganu,167,50,117,2011
2011-01-25,Terengganu,155,44,111,2011
2011-01-26,Terengganu,2,1,1,2011
2011-01-27,Terengganu,3,0,3,2011
2011-01-28,Terengganu,0,0,0,2011
2011-01-29,Terengganu,59,22,37,2011
2011-01-30,Terengganu,75,44,31,2011
2011-01-31,Terengganu,189,92,97,2011
2011-02-01,Terengganu,67,48,19,2011
2011-02-02,Terengganu,41,25,16,2011
2011-02-03,Terengganu,0,0,0,2011
2011-02-04,Terengganu,0,0,0,2011
2011-02-05,Terengganu,0,0,0,2011
2011-02-06,Terengganu,15,0,15,2011
2011-02-07,Terengganu,50,27,23,2011
2011-02-08,Terengganu,110,51,59,2011
2011-02-09,Terengganu,33,6,27,2011
2011-02-10,Terengganu,90,21,69,2011
2011-02-11,Terengganu,0,0,0,2011
2011-02-12,Terengganu,0,0,0,2011
2011-02-13,Terengganu,9,0,9,2011
2011-02-14,Terengganu,10,0,10,2011
2011-02-15,Terengganu,0,0,0,2011
2011-02-16,Terengganu,45,35,10,2011
2011-02-17,Terengganu,38,18,20,2011
2011-02-18,Terengganu,0,0,0,2011
2011-02-19,Terengganu,14,7,7,2011
2011-02-20,Terengganu,4,0,4,2011
2011-02-21,Terengganu,32,15,17,2011
2011-02-22,Terengganu,87,53,34,2011
2011-02-23,Terengganu,8,1,7,2011
2011-02-24,Terengganu,151,87,64,2011
2011-02-25,Terengganu,0,0,0,2011
2011-02-26,Terengganu,0,0,0,2011
2011-02-27,Terengganu,102,70,32,2011
2011-02-28,Terengganu,7,0,7,2011
2011-03-01,Terengganu,8,0,8,2011
2011-03-02,Terengganu,165,55,110,2011
2011-03-03,Terengganu,66,33,33,2011
2011-03-04,Terengganu,0,0,0,2011
2011-03-05,Terengganu,105,102,3,2011
2011-03-06,Terengganu,13,0,13,2011
2011-03-07,Terengganu,6,1,5,2011
2011-03-08,Terengganu,13,0,13,2011
2011-03-09,Terengganu,12,0,12,2011
2011-03-10,Terengganu,49,21,28,2011
2011-03-11,Terengganu,0,0,0,2011
2011-03-12,Terengganu,17,10,7,2011
2011-03-13,Terengganu,5,0,5,2011
2011-03-14,Terengganu,16,1,15,2011
2011-03-15,Terengganu,9,0,9,2011
2011-03-16,Terengganu,11,5,6,2011
2011-03-17,Terengganu,28,11,17,2011
2011-03-18,Terengganu,39,16,23,2011
2011-03-19,Terengganu,127,69,58,2011
2011-03-20,Terengganu,9,2,7,2011
2011-03-21,Terengganu,67,27,40,2011
2011-03-22,Terengganu,31,10,21,2011
2011-03-23,Terengganu,10,2,8,2011
2011-03-24,Terengganu,14,0,14,2011
2011-03-25,Terengganu,0,0,0,2011
2011-03-26,Terengganu,55,14,41,2011
2011-03-27,Terengganu,27,1,26,2011
2011-03-28,Terengganu,43,9,34,2011
2011-03-29,Terengganu,5,0,5,2011
2011-03-30,Terengganu,158,63,95,2011
2011-03-31,Terengganu,68,27,41,2011
2011-04-01,Terengganu,0,0,0,2011
2011-04-02,Terengganu,69,34,35,2011
2011-04-03,Terengganu,7,0,7,2011
2011-04-04,Terengganu,55,40,15,2011
2011-04-05,Terengganu,83,35,48,2011
2011-04-06,Terengganu,93,49,44,2011
2011-04-07,Terengganu,71,17,54,2011
2011-04-08,Terengganu,0,0,0,2011
2011-04-09,Terengganu,107,23,84,2011
2011-04-10,Terengganu,64,26,38,2011
2011-04-11,Terengganu,34,14,20,2011
2011-04-12,Terengganu,12,1,11,2011
2011-04-13,Terengganu,51,21,30,2011
2011-04-14,Terengganu,41,20,21,2011
2011-04-15,Terengganu,0,0,0,2011
2011-04-16,Terengganu,41,11,30,2011
2011-04-17,Terengganu,18,1,17,2011
2011-04-18,Terengganu,32,15,17,2011
2011-04-19,Terengganu,14,2,12,2011
2011-04-20,Terengganu,107,72,35,2011
2011-04-21,Terengganu,40,15,25,2011
2011-04-22,Terengganu,48,17,31,2011
2011-04-23,Terengganu,104,42,62,2011
2011-04-24,Terengganu,2,0,2,2011
2011-04-25,Terengganu,80,29,51,2011
2011-04-26,Terengganu,103,61,42,2011
2011-04-27,Terengganu,43,16,27,2011
2011-04-28,Terengganu,2,0,2,2011
2011-04-29,Terengganu,0,0,0,2011
2011-04-30,Terengganu,0,0,0,2011
2011-05-01,Terengganu,0,0,0,2011
2011-05-02,Terengganu,36,24,12,2011
2011-05-03,Terengganu,73,40,33,2011
2011-05-04,Terengganu,7,0,7,2011
2011-05-05,Terengganu,14,0,14,2011
2011-05-06,Terengganu,0,0,0,2011
2011-05-07,Terengganu,0,0,0,2011
2011-05-08,Terengganu,42,20,22,2011
2011-05-09,Terengganu,9,2,7,2011
2011-05-10,Terengganu,16,1,15,2011
2011-05-11,Terengganu,85,37,48,2011
2011-05-12,Terengganu,54,21,33,2011
2011-05-13,Terengganu,0,0,0,2011
2011-05-14,Terengganu,87,53,34,2011
2011-05-15,Terengganu,10,0,10,2011
2011-05-16,Terengganu,12,2,10,2011
2011-05-17,Terengganu,0,0,0,2011
2011-05-18,Terengganu,31,20,11,2011
2011-05-19,Terengganu,84,38,46,2011
2011-05-20,Terengganu,0,0,0,2011
2011-05-21,Terengganu,0,0,0,2011
2011-05-22,Terengganu,72,40,32,2011
2011-05-23,Terengganu,63,39,24,2011
2011-05-24,Terengganu,80,46,34,2011
2011-05-25,Terengganu,181,73,108,2011
2011-05-26,Terengganu,7,0,7,2011
2011-05-27,Terengganu,0,0,0,2011
2011-05-28,Terengganu,0,0,0,2011
2011-05-29,Terengganu,43,15,28,2011
2011-05-30,Terengganu,8,0,8,2011
2011-05-31,Terengganu,50,16,34,2011
2011-06-01,Terengganu,4,1,3,2011
2011-06-02,Terengganu,40,31,9,2011
2011-06-03,Terengganu,0,0,0,2011
2011-06-04,Terengganu,0,0,0,2011
2011-06-05,Terengganu,0,0,0,2011
2011-06-06,Terengganu,28,11,17,2011
2011-06-07,Terengganu,4,1,3,2011
2011-06-08,Terengganu,83,37,46,2011
2011-06-09,Terengganu,4,0,4,2011
2011-06-10,Terengganu,0,0,0,2011
2011-06-11,Terengganu,0,0,0,2011
2011-06-12,Terengganu,21,10,11,2011
2011-06-13,Terengganu,25,9,16,2011
2011-06-14,Terengganu,136,90,46,2011
2011-06-15,Terengganu,96,63,33,2011
2011-06-16,Terengganu,11,4,7,2011
2011-06-17,Terengganu,96,9,87,2011
2011-06-18,Terengganu,0,0,0,2011
2011-06-19,Terengganu,0,0,0,2011
2011-06-20,Terengganu,28,9,19,2011
2011-06-21,Terengganu,72,30,42,2011
2011-06-22,Terengganu,157,76,81,2011
2011-06-23,Terengganu,26,22,4,2011
2011-06-24,Terengganu,0,0,0,2011
2011-06-25,Terengganu,0,0,0,2011
2011-06-26,Terengganu,92,62,30,2011
2011-06-27,Terengganu,41,5,36,2011
2011-06-28,Terengganu,51,32,19,2011
2011-06-29,Terengganu,69,47,22,2011
2011-06-30,Terengganu,12,0,12,2011
2011-07-01,Terengganu,0,0,0,2011
2011-07-02,Terengganu,66,63,3,2011
2011-07-03,Terengganu,9,1,8,2011
2011-07-04,Terengganu,75,41,34,2011
2011-07-05,Terengganu,66,30,36,2011
2011-07-06,Terengganu,67,53,14,2011
2011-07-07,Terengganu,0,0,0,2011
2011-07-08,Terengganu,28,8,20,2011
2011-07-09,Terengganu,55,48,7,2011
2011-07-10,Terengganu,45,15,30,2011
2011-07-11,Terengganu,8,0,8,2011
2011-07-12,Terengganu,122,32,90,2011
2011-07-13,Terengganu,10,0,10,2011
2011-07-14,Terengganu,4,0,4,2011
2011-07-15,Terengganu,0,0,0,2011
2011-07-16,Terengganu,0,0,0,2011
2011-07-17,Terengganu,13,1,12,2011
2011-07-18,Terengganu,117,59,58,2011
2011-07-19,Terengganu,111,60,51,2011
2011-07-20,Terengganu,0,0,0,2011
2011-07-21,Terengganu,56,39,17,2011
2011-07-22,Terengganu,0,0,0,2011
2011-07-23,Terengganu,133,51,82,2011
2011-07-24,Terengganu,77,37,40,2011
2011-07-25,Terengganu,56,25,31,2011
2011-07-26,Terengganu,202,134,68,2011
2011-07-27,Terengganu,23,5,18,2011
2011-07-28,Terengganu,130,70,60,2011
2011-07-29,Terengganu,0,0,0,2011
2011-07-30,Terengganu,0,0,0,2011
2011-07-31,Terengganu,52,16,36,2011
2011-08-01,Terengganu,0,0,0,2011
2011-08-02,Terengganu,0,0,0,2011
2011-08-03,Terengganu,2,0,2,2011
2011-08-04,Terengganu,52,16,36,2011
2011-08-05,Terengganu,48,30,18,2011
2011-08-06,Terengganu,0,0,0,2011
2011-08-07,Terengganu,2,0,2,2011
2011-08-08,Terengganu,0,0,0,2011
2011-08-09,Terengganu,64,11,53,2011
2011-08-10,Terengganu,0,0,0,2011
2011-08-11,Terengganu,48,15,33,2011
2011-08-12,Terengganu,105,12,93,2011
2011-08-13,Terengganu,0,0,0,2011
2011-08-14,Terengganu,1,0,1,2011
2011-08-15,Terengganu,20,9,11,2011
2011-08-16,Terengganu,78,42,36,2011
2011-08-17,Terengganu,74,7,67,2011
2011-08-18,Terengganu,1,0,1,2011
2011-08-19,Terengganu,65,31,34,2011
2011-08-20,Terengganu,48,15,33,2011
2011-08-21,Terengganu,1,0,1,2011
2011-08-22,Terengganu,18,14,4,2011
2011-08-23,Terengganu,54,14,40,2011
2011-08-24,Terengganu,43,15,28,2011
2011-08-25,Terengganu,78,20,58,2011
2011-08-26,Terengganu,0,0,0,2011
2011-08-27,Terengganu,0,0,0,2011
2011-08-28,Terengganu,42,13,29,2011
2011-08-29,Terengganu,6,1,5,2011
2011-08-30,Terengganu,0,0,0,2011
2011-08-31,Terengganu,0,0,0,2011
2011-09-01,Terengganu,3,0,3,2011
2011-09-02,Terengganu,0,0,0,2011
2011-09-03,Terengganu,0,0,0,2011
2011-09-04,Terengganu,37,13,24,2011
2011-09-05,Terengganu,5,2,3,2011
2011-09-06,Terengganu,71,42,29,2011
2011-09-07,Terengganu,83,41,42,2011
2011-09-08,Terengganu,44,15,29,2011
2011-09-09,Terengganu,50,33,17,2011
2011-09-10,Terengganu,83,61,22,2011
2011-09-11,Terengganu,74,27,47,2011
2011-09-12,Terengganu,9,0,9,2011
2011-09-13,Terengganu,48,35,13,2011
2011-09-14,Terengganu,127,34,93,2011
2011-09-15,Terengganu,144,59,85,2011
2011-09-16,Terengganu,0,0,0,2011
2011-09-17,Terengganu,31,12,19,2011
2011-09-18,Terengganu,7,0,7,2011
2011-09-19,Terengganu,111,39,72,2011
2011-09-20,Terengganu,21,2,19,2011
2011-09-21,Terengganu,113,58,55,2011
2011-09-22,Terengganu,29,16,13,2011
2011-09-23,Terengganu,0,0,0,2011
2011-09-24,Terengganu,86,45,41,2011
2011-09-25,Terengganu,10,2,8,2011
2011-09-26,Terengganu,14,3,11,2011
2011-09-27,Terengganu,99,41,58,2011
2011-09-28,Terengganu,125,66,59,2011
2011-09-29,Terengganu,136,60,76,2011
2011-09-30,Terengganu,0,0,0,2011
2011-10-01,Terengganu,71,27,44,2011
2011-10-02,Terengganu,14,0,14,2011
2011-10-03,Terengganu,72,22,50,2011
2011-10-04,Terengganu,17,0,17,2011
2011-10-05,Terengganu,12,0,12,2011
2011-10-06,Terengganu,37,25,12,2011
2011-10-07,Terengganu,1,0,1,2011
2011-10-08,Terengganu,41,13,28,2011
2011-10-09,Terengganu,19,1,18,2011
2011-10-10,Terengganu,69,12,57,2011
2011-10-11,Terengganu,32,14,18,2011
2011-10-12,Terengganu,34,9,25,2011
2011-10-13,Terengganu,71,20,51,2011
2011-10-14,Terengganu,43,9,34,2011
2011-10-15,Terengganu,0,0,0,2011
2011-10-16,Terengganu,19,2,17,2011
2011-10-17,Terengganu,54,23,31,2011
2011-10-18,Terengganu,103,38,65,2011
2011-10-19,Terengganu,38,11,27,2011
2011-10-20,Terengganu,22,5,17,2011
2011-10-21,Terengganu,0,0,0,2011
2011-10-22,Terengganu,199,158,41,2011
2011-10-23,Terengganu,12,0,12,2011
2011-10-24,Terengganu,48,18,30,2011
2011-10-25,Terengganu,12,0,12,2011
2011-10-26,Terengganu,0,0,0,2011
2011-10-27,Terengganu,15,0,15,2011
2011-10-28,Terengganu,132,31,101,2011
2011-10-29,Terengganu,105,20,85,2011
2011-10-30,Terengganu,14,3,11,2011
2011-10-31,Terengganu,72,17,55,2011
2011-11-01,Terengganu,80,34,46,2011
2011-11-02,Terengganu,53,30,23,2011
2011-11-03,Terengganu,2,0,2,2011
2011-11-04,Terengganu,30,19,11,2011
2011-11-05,Terengganu,0,0,0,2011
2011-11-06,Terengganu,0,0,0,2011
2011-11-07,Terengganu,0,0,0,2011
2011-11-08,Terengganu,54,13,41,2011
2011-11-09,Terengganu,36,16,20,2011
2011-11-10,Terengganu,27,17,10,2011
2011-11-11,Terengganu,27,12,15,2011
2011-11-12,Terengganu,73,64,9,2011
2011-11-13,Terengganu,6,2,4,2011
2011-11-14,Terengganu,100,45,55,2011
2011-11-15,Terengganu,43,26,17,2011
2011-11-16,Terengganu,72,33,39,2011
2011-11-17,Terengganu,42,13,29,2011
2011-11-18,Terengganu,0,0,0,2011
2011-11-19,Terengganu,70,66,4,2011
2011-11-20,Terengganu,7,1,6,2011
2011-11-21,Terengganu,44,14,30,2011
2011-11-22,Terengganu,42,24,18,2011
2011-11-23,Terengganu,48,10,38,2011
2011-11-24,Terengganu,2,1,1,2011
2011-11-25,Terengganu,51,24,27,2011
2011-11-26,Terengganu,0,0,0,2011
2011-11-27,Terengganu,0,0,0,2011
2011-11-28,Terengganu,19,2,17,2011
2011-11-29,Terengganu,93,62,31,2011
2011-11-30,Terengganu,29,11,18,2011
2011-12-01,Terengganu,35,10,25,2011
2011-12-02,Terengganu,0,0,0,2011
2011-12-03,Terengganu,92,44,48,2011
2011-12-04,Terengganu,12,0,12,2011
2011-12-05,Terengganu,5,2,3,2011
2011-12-06,Terengganu,152,97,55,2011
2011-12-07,Terengganu,192,104,88,2011
2011-12-08,Terengganu,34,6,28,2011
2011-12-09,Terengganu,0,0,0,2011
2011-12-10,Terengganu,32,12,20,2011
2011-12-11,Terengganu,5,1,4,2011
2011-12-12,Terengganu,14,0,14,2011
2011-12-13,Terengganu,7,0,7,2011
2011-12-14,Terengganu,15,2,13,2011
2011-12-15,Terengganu,21,3,18,2011
2011-12-16,Terengganu,0,0,0,2011
2011-12-17,Terengganu,15,10,5,2011
2011-12-18,Terengganu,15,0,15,2011
2011-12-19,Terengganu,10,0,10,2011
2011-12-20,Terengganu,35,17,18,2011
2011-12-21,Terengganu,117,52,65,2011
2011-12-22,Terengganu,49,16,33,2011
2011-12-23,Terengganu,0,0,0,2011
2011-12-24,Terengganu,39,20,19,2011
2011-12-25,Terengganu,0,0,0,2011
2011-12-26,Terengganu,46,14,32,2011
2011-12-27,Terengganu,67,26,41,2011
2011-12-28,Terengganu,71,34,37,2011
2011-12-29,Terengganu,24,1,23,2011
2011-12-30,Terengganu,0,0,0,2011
2011-12-31,Terengganu,38,8,30,2011
2012-01-01,Terengganu,8,4,4,2012
2012-01-02,Terengganu,45,20,25,2012
2012-01-03,Terengganu,58,27,31,2012
2012-01-04,Terengganu,24,10,14,2012
2012-01-05,Terengganu,60,18,42,2012
2012-01-06,Terengganu,0,0,0,2012
2012-01-07,Terengganu,48,37,11,2012
2012-01-08,Terengganu,4,0,4,2012
2012-01-09,Terengganu,12,3,9,2012
2012-01-10,Terengganu,81,29,52,2012
2012-01-11,Terengganu,56,21,35,2012
2012-01-12,Terengganu,36,24,12,2012
2012-01-13,Terengganu,36,9,27,2012
2012-01-14,Terengganu,0,0,0,2012
2012-01-15,Terengganu,152,84,68,2012
2012-01-16,Terengganu,169,103,66,2012
2012-01-17,Terengganu,12,0,12,2012
2012-01-18,Terengganu,73,31,42,2012
2012-01-19,Terengganu,59,26,33,2012
2012-01-20,Terengganu,47,27,20,2012
2012-01-21,Terengganu,20,6,14,2012
2012-01-22,Terengganu,25,3,22,2012
2012-01-23,Terengganu,0,0,0,2012
2012-01-24,Terengganu,0,0,0,2012
2012-01-25,Terengganu,38,13,25,2012
2012-01-26,Terengganu,7,0,7,2012
2012-01-27,Terengganu,78,40,38,2012
2012-01-28,Terengganu,245,110,135,2012
2012-01-29,Terengganu,16,1,15,2012
2012-01-30,Terengganu,208,85,123,2012
2012-01-31,Terengganu,16,2,14,2012
2012-02-01,Terengganu,19,2,17,2012
2012-02-02,Terengganu,40,14,26,2012
2012-02-03,Terengganu,84,36,48,2012
2012-02-04,Terengganu,0,0,0,2012
2012-02-05,Terengganu,0,0,0,2012
2012-02-06,Terengganu,63,33,30,2012
2012-02-07,Terengganu,8,0,8,2012
2012-02-08,Terengganu,8,1,7,2012
2012-02-09,Terengganu,42,32,10,2012
2012-02-10,Terengganu,0,0,0,2012
2012-02-11,Terengganu,33,9,24,2012
2012-02-12,Terengganu,7,1,6,2012
2012-02-13,Terengganu,95,39,56,2012
2012-02-14,Terengganu,47,23,24,2012
2012-02-15,Terengganu,60,23,37,2012
2012-02-16,Terengganu,140,53,87,2012
2012-02-17,Terengganu,0,0,0,2012
2012-02-18,Terengganu,61,55,6,2012
2012-02-19,Terengganu,7,1,6,2012
2012-02-20,Terengganu,8,3,5,2012
2012-02-21,Terengganu,5,2,3,2012
2012-02-22,Terengganu,83,54,29,2012
2012-02-23,Terengganu,190,100,90,2012
2012-02-24,Terengganu,46,15,31,2012
2012-02-25,Terengganu,26,10,16,2012
2012-02-26,Terengganu,15,2,13,2012
2012-02-27,Terengganu,6,0,6,2012
2012-02-28,Terengganu,159,43,116,2012
2012-02-29,Terengganu,166,48,118,2012
2012-03-01,Terengganu,3,0,3,2012
2012-03-02,Terengganu,18,17,1,2012
2012-03-03,Terengganu,60,60,0,2012
2012-03-04,Terengganu,0,0,0,2012
2012-03-05,Terengganu,14,2,12,2012
2012-03-06,Terengganu,53,11,42,2012
2012-03-07,Terengganu,5,0,5,2012
2012-03-08,Terengganu,51,30,21,2012
2012-03-09,Terengganu,0,0,0,2012
2012-03-10,Terengganu,15,5,10,2012
2012-03-11,Terengganu,14,1,13,2012
2012-03-12,Terengganu,14,2,12,2012
2012-03-13,Terengganu,6,0,6,2012
2012-03-14,Terengganu,77,58,19,2012
2012-03-15,Terengganu,6,0,6,2012
2012-03-16,Terengganu,0,0,0,2012
2012-03-17,Terengganu,77,20,57,2012
2012-03-18,Terengganu,7,2,5,2012
2012-03-19,Terengganu,93,30,63,2012
2012-03-20,Terengganu,52,16,36,2012
2012-03-21,Terengganu,53,33,20,2012
2012-03-22,Terengganu,47,26,21,2012
2012-03-23,Terengganu,0,0,0,2012
2012-03-24,Terengganu,71,25,46,2012
2012-03-25,Terengganu,16,1,15,2012
2012-03-26,Terengganu,79,49,30,2012
2012-03-27,Terengganu,71,40,31,2012
2012-03-28,Terengganu,38,5,33,2012
2012-03-29,Terengganu,71,19,52,2012
2012-03-30,Terengganu,25,3,22,2012
2012-03-31,Terengganu,0,0,0,2012
2012-04-01,Terengganu,7,0,7,2012
2012-04-02,Terengganu,47,13,34,2012
2012-04-03,Terengganu,16,0,16,2012
2012-04-04,Terengganu,34,8,26,2012
2012-04-05,Terengganu,56,25,31,2012
2012-04-06,Terengganu,0,0,0,2012
2012-04-07,Terengganu,0,0,0,2012
2012-04-08,Terengganu,10,1,9,2012
2012-04-09,Terengganu,36,9,27,2012
2012-04-10,Terengganu,45,13,32,2012
2012-04-11,Terengganu,0,0,0,2012
2012-04-12,Terengganu,38,28,10,2012
2012-04-13,Terengganu,0,0,0,2012
2012-04-14,Terengganu,0,0,0,2012
2012-04-15,Terengganu,13,0,13,2012
2012-04-16,Terengganu,35,13,22,2012
2012-04-17,Terengganu,73,25,48,2012
2012-04-18,Terengganu,87,31,56,2012
2012-04-19,Terengganu,66,15,51,2012
2012-04-20,Terengganu,0,0,0,2012
2012-04-21,Terengganu,38,10,28,2012
2012-04-22,Terengganu,66,20,46,2012
2012-04-23,Terengganu,10,1,9,2012
2012-04-24,Terengganu,59,29,30,2012
2012-04-25,Terengganu,39,11,28,2012
2012-04-26,Terengganu,8,2,6,2012
2012-04-27,Terengganu,0,0,0,2012
2012-04-28,Terengganu,49,19,30,2012
2012-04-29,Terengganu,99,24,75,2012
2012-04-30,Terengganu,125,36,89,2012
2012-05-01,Terengganu,0,0,0,2012
2012-05-02,Terengganu,75,22,53,2012
2012-05-03,Terengganu,25,12,13,2012
2012-05-04,Terengganu,23,11,12,2012
2012-05-05,Terengganu,0,0,0,2012
2012-05-06,Terengganu,57,14,43,2012
2012-05-07,Terengganu,9,0,9,2012
2012-05-08,Terengganu,31,9,22,2012
2012-05-09,Terengganu,81,37,44,2012
2012-05-10,Terengganu,71,19,52,2012
2012-05-11,Terengganu,0,0,0,2012
2012-05-12,Terengganu,236,187,49,2012
2012-05-13,Terengganu,98,15,83,2012
2012-05-14,Terengganu,2,0,2,2012
2012-05-15,Terengganu,4,0,4,2012
2012-05-16,Terengganu,14,1,13,2012
2012-05-17,Terengganu,77,30,47,2012
2012-05-18,Terengganu,99,17,82,2012
2012-05-19,Terengganu,72,18,54,2012
2012-05-20,Terengganu,59,30,29,2012
2012-05-21,Terengganu,8,1,7,2012
2012-05-22,Terengganu,65,52,13,2012
2012-05-23,Terengganu,58,29,29,2012
2012-05-24,Terengganu,5,1,4,2012
2012-05-25,Terengganu,132,57,75,2012
2012-05-26,Terengganu,29,7,22,2012
2012-05-27,Terengganu,31,16,15,2012
2012-05-28,Terengganu,33,9,24,2012
2012-05-29,Terengganu,7,0,7,2012
2012-05-30,Terengganu,43,15,28,2012
2012-05-31,Terengganu,4,0,4,2012
2012-06-01,Terengganu,0,0,0,2012
2012-06-02,Terengganu,0,0,0,2012
2012-06-03,Terengganu,0,0,0,2012
2012-06-04,Terengganu,8,2,6,2012
2012-06-05,Terengganu,63,13,50,2012
2012-06-06,Terengganu,35,10,25,2012
2012-06-07,Terengganu,11,1,10,2012
2012-06-08,Terengganu,0,0,0,2012
2012-06-09,Terengganu,0,0,0,2012
2012-06-10,Terengganu,17,1,16,2012
2012-06-11,Terengganu,14,2,12,2012
2012-06-12,Terengganu,56,25,31,2012
2012-06-13,Terengganu,72,26,46,2012
2012-06-14,Terengganu,69,38,31,2012
2012-06-15,Terengganu,0,0,0,2012
2012-06-16,Terengganu,59,51,8,2012
2012-06-17,Terengganu,60,20,40,2012
2012-06-18,Terengganu,116,75,41,2012
2012-06-19,Terengganu,135,100,35,2012
2012-06-20,Terengganu,85,45,40,2012
2012-06-21,Terengganu,99,44,55,2012
2012-06-22,Terengganu,0,0,0,2012
2012-06-23,Terengganu,53,47,6,2012
2012-06-24,Terengganu,129,45,84,2012
2012-06-25,Terengganu,43,35,8,2012
2012-06-26,Terengganu,53,35,18,2012
2012-06-27,Terengganu,58,44,14,2012
2012-06-28,Terengganu,37,15,22,2012
2012-06-29,Terengganu,0,0,0,2012
2012-06-30,Terengganu,0,0,0,2012
2012-07-01,Terengganu,85,42,43,2012
2012-07-02,Terengganu,10,2,8,2012
2012-07-03,Terengganu,56,16,40,2012
2012-07-04,Terengganu,83,61,22,2012
2012-07-05,Terengganu,5,0,5,2012
2012-07-06,Terengganu,54,39,15,2012
2012-07-07,Terengganu,20,7,13,2012
2012-07-08,Terengganu,90,26,64,2012
2012-07-09,Terengganu,4,0,4,2012
2012-07-10,Terengganu,88,18,70,2012
2012-07-11,Terengganu,51,37,14,2012
2012-07-12,Terengganu,13,1,12,2012
2012-07-13,Terengganu,13,4,9,2012
2012-07-14,Terengganu,0,0,0,2012
2012-07-15,Terengganu,22,1,21,2012
2012-07-16,Terengganu,112,63,49,2012
2012-07-17,Terengganu,67,24,43,2012
2012-07-18,Terengganu,7,1,6,2012
2012-07-19,Terengganu,78,18,60,2012
2012-07-20,Terengganu,41,24,17,2012
2012-07-21,Terengganu,0,0,0,2012
2012-07-22,Terengganu,0,0,0,2012
2012-07-23,Terengganu,0,0,0,2012
2012-07-24,Terengganu,3,0,3,2012
2012-07-25,Terengganu,56,17,39,2012
2012-07-26,Terengganu,0,0,0,2012
2012-07-27,Terengganu,104,17,87,2012
2012-07-28,Terengganu,68,18,50,2012
2012-07-29,Terengganu,2,0,2,2012
2012-07-30,Terengganu,30,11,19,2012
2012-07-31,Terengganu,0,0,0,2012
2012-08-01,Terengganu,50,7,43,2012
2012-08-02,Terengganu,113,40,73,2012
2012-08-03,Terengganu,56,10,46,2012
2012-08-04,Terengganu,0,0,0,2012
2012-08-05,Terengganu,73,33,40,2012
2012-08-06,Terengganu,26,15,11,2012
2012-08-07,Terengganu,32,14,18,2012
2012-08-08,Terengganu,2,0,2,2012
2012-08-09,Terengganu,81,20,61,2012
2012-08-10,Terengganu,147,23,124,2012
2012-08-11,Terengganu,42,12,30,2012
2012-08-12,Terengganu,42,21,21,2012
2012-08-13,Terengganu,50,6,44,2012
2012-08-14,Terengganu,0,0,0,2012
2012-08-15,Terengganu,45,10,35,2012
2012-08-16,Terengganu,38,11,27,2012
2012-08-17,Terengganu,0,0,0,2012
2012-08-18,Terengganu,0,0,0,2012
2012-08-19,Terengganu,0,0,0,2012
2012-08-20,Terengganu,0,0,0,2012
2012-08-21,Terengganu,11,2,9,2012
2012-08-22,Terengganu,21,11,10,2012
2012-08-23,Terengganu,131,34,97,2012
2012-08-24,Terengganu,11,7,4,2012
2012-08-25,Terengganu,0,0,0,2012
2012-08-26,Terengganu,15,3,12,2012
2012-08-27,Terengganu,121,50,71,2012
2012-08-28,Terengganu,86,54,32,2012
2012-08-29,Terengganu,54,13,41,2012
2012-08-30,Terengganu,37,12,25,2012
2012-08-31,Terengganu,39,9,30,2012
2012-09-01,Terengganu,0,0,0,2012
2012-09-02,Terengganu,10,1,9,2012
2012-09-03,Terengganu,49,24,25,2012
2012-09-04,Terengganu,40,19,21,2012
2012-09-05,Terengganu,84,55,29,2012
2012-09-06,Terengganu,17,3,14,2012
2012-09-07,Terengganu,36,14,22,2012
2012-09-08,Terengganu,32,17,15,2012
2012-09-09,Terengganu,11,4,7,2012
2012-09-10,Terengganu,36,13,23,2012
2012-09-11,Terengganu,136,78,58,2012
2012-09-12,Terengganu,11,2,9,2012
2012-09-13,Terengganu,136,58,78,2012
2012-09-14,Terengganu,7,2,5,2012
2012-09-15,Terengganu,0,0,0,2012
2012-09-16,Terengganu,0,0,0,2012
2012-09-17,Terengganu,67,16,51,2012
2012-09-18,Terengganu,91,47,44,2012
2012-09-19,Terengganu,7,0,7,2012
2012-09-20,Terengganu,12,1,11,2012
2012-09-21,Terengganu,115,21,94,2012
2012-09-22,Terengganu,0,0,0,2012
2012-09-23,Terengganu,62,28,34,2012
2012-09-24,Terengganu,13,1,12,2012
2012-09-25,Terengganu,160,57,103,2012
2012-09-26,Terengganu,156,70,86,2012
2012-09-27,Terengganu,52,19,33,2012
2012-09-28,Terengganu,0,0,0,2012
2012-09-29,Terengganu,0,0,0,2012
2012-09-30,Terengganu,16,1,15,2012
2012-10-01,Terengganu,11,1,10,2012
2012-10-02,Terengganu,88,48,40,2012
2012-10-03,Terengganu,4,0,4,2012
2012-10-04,Terengganu,25,13,12,2012
2012-10-05,Terengganu,30,15,15,2012
2012-10-06,Terengganu,121,32,89,2012
2012-10-07,Terengganu,54,23,31,2012
2012-10-08,Terengganu,12,2,10,2012
2012-10-09,Terengganu,6,0,6,2012
2012-10-10,Terengganu,9,0,9,2012
2012-10-11,Terengganu,41,25,16,2012
2012-10-12,Terengganu,0,0,0,2012
2012-10-13,Terengganu,0,0,0,2012
2012-10-14,Terengganu,8,1,7,2012
2012-10-15,Terengganu,41,13,28,2012
2012-10-16,Terengganu,106,43,63,2012
2012-10-17,Terengganu,3,1,2,2012
2012-10-18,Terengganu,71,23,48,2012
2012-10-19,Terengganu,0,0,0,2012
2012-10-20,Terengganu,0,0,0,2012
2012-10-21,Terengganu,21,6,15,2012
2012-10-22,Terengganu,23,6,17,2012
2012-10-23,Terengganu,43,15,28,2012
2012-10-24,Terengganu,43,11,32,2012
2012-10-25,Terengganu,11,1,10,2012
2012-10-26,Terengganu,0,0,0,2012
2012-10-27,Terengganu,0,0,0,2012
2012-10-28,Terengganu,0,0,0,2012
2012-10-29,Terengganu,43,9,34,2012
2012-10-30,Terengganu,28,10,18,2012
2012-10-31,Terengganu,11,5,6,2012
2012-11-01,Terengganu,8,3,5,2012
2012-11-02,Terengganu,51,46,5,2012
2012-11-03,Terengganu,0,0,0,2012
2012-11-04,Terengganu,6,0,6,2012
2012-11-05,Terengganu,57,15,42,2012
2012-11-06,Terengganu,29,10,19,2012
2012-11-07,Terengganu,39,11,28,2012
2012-11-08,Terengganu,35,29,6,2012
2012-11-09,Terengganu,0,0,0,2012
2012-11-10,Terengganu,40,37,3,2012
2012-11-11,Terengganu,18,4,14,2012
2012-11-12,Terengganu,24,6,18,2012
2012-11-13,Terengganu,0,0,0,2012
2012-11-14,Terengganu,17,3,14,2012
2012-11-15,Terengganu,0,0,0,2012
2012-11-16,Terengganu,15,4,11,2012
2012-11-17,Terengganu,0,0,0,2012
2012-11-18,Terengganu,15,8,7,2012
2012-11-19,Terengganu,53,21,32,2012
2012-11-20,Terengganu,62,39,23,2012
2012-11-21,Terengganu,68,31,37,2012
2012-11-22,Terengganu,25,12,13,2012
2012-11-23,Terengganu,0,0,0,2012
2012-11-24,Terengganu,32,32,0,2012
2012-11-25,Terengganu,75,11,64,2012
2012-11-26,Terengganu,34,19,15,2012
2012-11-27,Terengganu,65,23,42,2012
2012-11-28,Terengganu,37,15,22,2012
2012-11-29,Terengganu,5,0,5,2012
2012-11-30,Terengganu,0,0,0,2012
2012-12-01,Terengganu,26,5,21,2012
2012-12-02,Terengganu,47,19,28,2012
2012-12-03,Terengganu,35,10,25,2012
2012-12-04,Terengganu,37,29,8,2012
2012-12-05,Terengganu,43,8,35,2012
2012-12-06,Terengganu,6,1,5,2012
2012-12-07,Terengganu,82,32,50,2012
2012-12-08,Terengganu,0,0,0,2012
2012-12-09,Terengganu,8,2,6,2012
2012-12-10,Terengganu,7,1,6,2012
2012-12-11,Terengganu,99,45,54,2012
2012-12-12,Terengganu,70,25,45,2012
2012-12-13,Terengganu,114,46,68,2012
2012-12-14,Terengganu,44,21,23,2012
2012-12-15,Terengganu,0,0,0,2012
2012-12-16,Terengganu,6,0,6,2012
2012-12-17,Terengganu,64,28,36,2012
2012-12-18,Terengganu,72,33,39,2012
2012-12-19,Terengganu,96,58,38,2012
2012-12-20,Terengganu,112,47,65,2012
2012-12-21,Terengganu,0,0,0,2012
2012-12-22,Terengganu,23,5,18,2012
2012-12-23,Terengganu,59,21,38,2012
2012-12-24,Terengganu,10,0,10,2012
2012-12-25,Terengganu,0,0,0,2012
2012-12-26,Terengganu,28,6,22,2012
2012-12-27,Terengganu,20,1,19,2012
2012-12-28,Terengganu,0,0,0,2012
2012-12-29,Terengganu,222,156,66,2012
2012-12-30,Terengganu,10,0,10,2012
2012-12-31,Terengganu,11,3,8,2012
2013-01-01,Terengganu,17,2,15,2013
2013-01-02,Terengganu,44,28,16,2013
2013-01-03,Terengganu,130,76,54,2013
2013-01-04,Terengganu,0,0,0,2013
2013-01-05,Terengganu,0,0,0,2013
2013-01-06,Terengganu,22,2,20,2013
2013-01-07,Terengganu,9,0,9,2013
2013-01-08,Terengganu,12,0,12,2013
2013-01-09,Terengganu,34,4,30,2013
2013-01-10,Terengganu,27,19,8,2013
2013-01-11,Terengganu,0,0,0,2013
2013-01-12,Terengganu,206,163,43,2013
2013-01-13,Terengganu,8,0,8,2013
2013-01-14,Terengganu,11,2,9,2013
2013-01-15,Terengganu,8,2,6,2013
2013-01-16,Terengganu,92,57,35,2013
2013-01-17,Terengganu,48,29,19,2013
2013-01-18,Terengganu,0,0,0,2013
2013-01-19,Terengganu,0,0,0,2013
2013-01-20,Terengganu,48,12,36,2013
2013-01-21,Terengganu,38,16,22,2013
2013-01-22,Terengganu,91,32,59,2013
2013-01-23,Terengganu,2,0,2,2013
2013-01-24,Terengganu,0,0,0,2013
2013-01-25,Terengganu,55,8,47,2013
2013-01-26,Terengganu,0,0,0,2013
2013-01-27,Terengganu,15,1,14,2013
2013-01-28,Terengganu,140,62,78,2013
2013-01-29,Terengganu,8,0,8,2013
2013-01-30,Terengganu,6,0,6,2013
2013-01-31,Terengganu,158,73,85,2013
2013-02-01,Terengganu,0,0,0,2013
2013-02-02,Terengganu,40,19,21,2013
2013-02-03,Terengganu,16,2,14,2013
2013-02-04,Terengganu,67,40,27,2013
2013-02-05,Terengganu,13,2,11,2013
2013-02-06,Terengganu,40,17,23,2013
2013-02-07,Terengganu,5,0,5,2013
2013-02-08,Terengganu,0,0,0,2013
2013-02-09,Terengganu,54,16,38,2013
2013-02-10,Terengganu,0,0,0,2013
2013-02-11,Terengganu,0,0,0,2013
2013-02-12,Terengganu,20,6,14,2013
2013-02-13,Terengganu,38,13,25,2013
2013-02-14,Terengganu,26,15,11,2013
2013-02-15,Terengganu,0,0,0,2013
2013-02-16,Terengganu,80,76,4,2013
2013-02-17,Terengganu,14,7,7,2013
2013-02-18,Terengganu,48,18,30,2013
2013-02-19,Terengganu,21,11,10,2013
2013-02-20,Terengganu,74,15,59,2013
2013-02-21,Terengganu,13,5,8,2013
2013-02-22,Terengganu,0,0,0,2013
2013-02-23,Terengganu,61,41,20,2013
2013-02-24,Terengganu,14,0,14,2013
2013-02-25,Terengganu,3,0,3,2013
2013-02-26,Terengganu,138,89,49,2013
2013-02-27,Terengganu,164,86,78,2013
2013-02-28,Terengganu,70,26,44,2013
2013-03-01,Terengganu,55,35,20,2013
2013-03-02,Terengganu,86,82,4,2013
2013-03-03,Terengganu,11,2,9,2013
2013-03-04,Terengganu,0,0,0,2013
2013-03-05,Terengganu,10,1,9,2013
2013-03-06,Terengganu,141,44,97,2013
2013-03-07,Terengganu,156,54,102,2013
2013-03-08,Terengganu,122,77,45,2013
2013-03-09,Terengganu,91,33,58,2013
2013-03-10,Terengganu,7,1,6,2013
2013-03-11,Terengganu,11,0,11,2013
2013-03-12,Terengganu,32,16,16,2013
2013-03-13,Terengganu,1,0,1,2013
2013-03-14,Terengganu,26,15,11,2013
2013-03-15,Terengganu,77,31,46,2013
2013-03-16,Terengganu,113,18,95,2013
2013-03-17,Terengganu,89,42,47,2013
2013-03-18,Terengganu,12,3,9,2013
2013-03-19,Terengganu,99,45,54,2013
2013-03-20,Terengganu,75,35,40,2013
2013-03-21,Terengganu,58,6,52,2013
2013-03-22,Terengganu,21,4,17,2013
2013-03-23,Terengganu,0,0,0,2013
2013-03-24,Terengganu,6,0,6,2013
2013-03-25,Terengganu,47,23,24,2013
2013-03-26,Terengganu,40,15,25,2013
2013-03-27,Terengganu,8,2,6,2013
2013-03-28,Terengganu,70,33,37,2013
2013-03-29,Terengganu,0,0,0,2013
2013-03-30,Terengganu,0,0,0,2013
2013-03-31,Terengganu,12,0,12,2013
2013-04-01,Terengganu,43,8,35,2013
2013-04-02,Terengganu,10,1,9,2013
2013-04-03,Terengganu,26,12,14,2013
2013-04-04,Terengganu,88,32,56,2013
2013-04-05,Terengganu,0,0,0,2013
2013-04-06,Terengganu,32,6,26,2013
2013-04-07,Terengganu,14,1,13,2013
2013-04-08,Terengganu,45,14,31,2013
2013-04-09,Terengganu,10,1,9,2013
2013-04-10,Terengganu,42,16,26,2013
2013-04-11,Terengganu,10,1,9,2013
2013-04-12,Terengganu,0,0,0,2013
2013-04-13,Terengganu,35,20,15,2013
2013-04-14,Terengganu,35,14,21,2013
2013-04-15,Terengganu,10,0,10,2013
2013-04-16,Terengganu,63,22,41,2013
2013-04-17,Terengganu,12,2,10,2013
2013-04-18,Terengganu,40,20,20,2013
2013-04-19,Terengganu,0,0,0,2013
2013-04-20,Terengganu,0,0,0,2013
2013-04-21,Terengganu,55,10,45,2013
2013-04-22,Terengganu,49,17,32,2013
2013-04-23,Terengganu,36,17,19,2013
2013-04-24,Terengganu,2,0,2,2013
2013-04-25,Terengganu,45,23,22,2013
2013-04-26,Terengganu,67,19,48,2013
2013-04-27,Terengganu,0,0,0,2013
2013-04-28,Terengganu,33,6,27,2013
2013-04-29,Terengganu,24,7,17,2013
2013-04-30,Terengganu,16,11,5,2013
2013-05-01,Terengganu,0,0,0,2013
2013-05-02,Terengganu,12,1,11,2013
2013-05-03,Terengganu,17,3,14,2013
2013-05-04,Terengganu,124,98,26,2013
2013-05-05,Terengganu,0,0,0,2013
2013-05-06,Terengganu,6,0,6,2013
2013-05-07,Terengganu,52,39,13,2013
2013-05-08,Terengganu,16,6,10,2013
2013-05-09,Terengganu,27,8,19,2013
2013-05-10,Terengganu,0,0,0,2013
2013-05-11,Terengganu,24,7,17,2013
2013-05-12,Terengganu,50,19,31,2013
2013-05-13,Terengganu,7,0,7,2013
2013-05-14,Terengganu,36,12,24,2013
2013-05-15,Terengganu,74,33,41,2013
2013-05-16,Terengganu,99,45,54,2013
2013-05-17,Terengganu,0,0,0,2013
2013-05-18,Terengganu,70,68,2,2013
2013-05-19,Terengganu,42,19,23,2013
2013-05-20,Terengganu,93,30,63,2013
2013-05-21,Terengganu,89,25,64,2013
2013-05-22,Terengganu,95,32,63,2013
2013-05-23,Terengganu,69,23,46,2013
2013-05-24,Terengganu,28,13,15,2013
2013-05-25,Terengganu,59,59,0,2013
2013-05-26,Terengganu,7,1,6,2013
2013-05-27,Terengganu,9,1,8,2013
2013-05-28,Terengganu,41,11,30,2013
2013-05-29,Terengganu,27,8,19,2013
2013-05-30,Terengganu,20,15,5,2013
2013-05-31,Terengganu,0,0,0,2013
2013-06-01,Terengganu,28,14,14,2013
2013-06-02,Terengganu,31,20,11,2013
2013-06-03,Terengganu,4,0,4,2013
2013-06-04,Terengganu,8,0,8,2013
2013-06-05,Terengganu,18,3,15,2013
2013-06-06,Terengganu,2,0,2,2013
2013-06-07,Terengganu,50,45,5,2013
2013-06-08,Terengganu,147,43,104,2013
2013-06-09,Terengganu,9,1,8,2013
2013-06-10,Terengganu,9,0,9,2013
2013-06-11,Terengganu,37,26,11,2013
2013-06-12,Terengganu,68,40,28,2013
2013-06-13,Terengganu,6,0,6,2013
2013-06-14,Terengganu,124,25,99,2013
2013-06-15,Terengganu,95,73,22,2013
2013-06-16,Terengganu,22,0,22,2013
2013-06-17,Terengganu,58,34,24,2013
2013-06-18,Terengganu,92,42,50,2013
2013-06-19,Terengganu,3,0,3,2013
2013-06-20,Terengganu,25,20,5,2013
2013-06-21,Terengganu,28,13,15,2013
2013-06-22,Terengganu,40,12,28,2013
2013-06-23,Terengganu,58,39,19,2013
2013-06-24,Terengganu,63,44,19,2013
2013-06-25,Terengganu,6,0,6,2013
2013-06-26,Terengganu,49,41,8,2013
2013-06-27,Terengganu,86,16,70,2013
2013-06-28,Terengganu,0,0,0,2013
2013-06-29,Terengganu,0,0,0,2013
2013-06-30,Terengganu,76,51,25,2013
2013-07-01,Terengganu,111,37,74,2013
2013-07-02,Terengganu,93,42,51,2013
2013-07-03,Terengganu,98,48,50,2013
2013-07-04,Terengganu,78,29,49,2013
2013-07-05,Terengganu,12,3,9,2013
2013-07-06,Terengganu,0,0,0,2013
2013-07-07,Terengganu,49,21,28,2013
2013-07-08,Terengganu,87,51,36,2013
2013-07-09,Terengganu,11,1,10,2013
2013-07-10,Terengganu,0,0,0,2013
2013-07-11,Terengganu,5,2,3,2013
2013-07-12,Terengganu,84,9,75,2013
2013-07-13,Terengganu,0,0,0,2013
2013-07-14,Terengganu,5,0,5,2013
2013-07-15,Terengganu,40,9,31,2013
2013-07-16,Terengganu,0,0,0,2013
2013-07-17,Terengganu,76,40,36,2013
2013-07-18,Terengganu,37,7,30,2013
2013-07-19,Terengganu,79,20,59,2013
2013-07-20,Terengganu,16,3,13,2013
2013-07-21,Terengganu,1,0,1,2013
2013-07-22,Terengganu,64,36,28,2013
2013-07-23,Terengganu,2,0,2,2013
2013-07-24,Terengganu,34,19,15,2013
2013-07-25,Terengganu,136,43,93,2013
2013-07-26,Terengganu,67,16,51,2013
2013-07-27,Terengganu,39,8,31,2013
2013-07-28,Terengganu,70,35,35,2013
2013-07-29,Terengganu,61,18,43,2013
2013-07-30,Terengganu,57,10,47,2013
2013-07-31,Terengganu,2,0,2,2013
2013-08-01,Terengganu,32,22,10,2013
2013-08-02,Terengganu,0,0,0,2013
2013-08-03,Terengganu,72,13,59,2013
2013-08-04,Terengganu,32,14,18,2013
2013-08-05,Terengganu,39,8,31,2013
2013-08-06,Terengganu,0,0,0,2013
2013-08-07,Terengganu,2,0,2,2013
2013-08-08,Terengganu,0,0,0,2013
2013-08-09,Terengganu,0,0,0,2013
2013-08-10,Terengganu,0,0,0,2013
2013-08-11,Terengganu,11,0,11,2013
2013-08-12,Terengganu,30,5,25,2013
2013-08-13,Terengganu,3,0,3,2013
2013-08-14,Terengganu,134,25,109,2013
2013-08-15,Terengganu,57,20,37,2013
2013-08-16,Terengganu,0,0,0,2013
2013-08-17,Terengganu,72,58,14,2013
2013-08-18,Terengganu,10,2,8,2013
2013-08-19,Terengganu,6,0,6,2013
2013-08-20,Terengganu,24,14,10,2013
2013-08-21,Terengganu,53,19,34,2013
2013-08-22,Terengganu,6,0,6,2013
2013-08-23,Terengganu,96,20,76,2013
2013-08-24,Terengganu,0,0,0,2013
2013-08-25,Terengganu,5,0,5,2013
2013-08-26,Terengganu,53,16,37,2013
2013-08-27,Terengganu,71,41,30,2013
2013-08-28,Terengganu,13,1,12,2013
2013-08-29,Terengganu,116,47,69,2013
2013-08-30,Terengganu,14,3,11,2013
2013-08-31,Terengganu,0,0,0,2013
2013-09-01,Terengganu,0,0,0,2013
2013-09-02,Terengganu,39,11,28,2013
2013-09-03,Terengganu,45,21,24,2013
2013-09-04,Terengganu,21,5,16,2013
2013-09-05,Terengganu,25,12,13,2013
2013-09-06,Terengganu,0,0,0,2013
2013-09-07,Terengganu,77,60,17,2013
2013-09-08,Terengganu,32,10,22,2013
2013-09-09,Terengganu,91,62,29,2013
2013-09-10,Terengganu,73,32,41,2013
2013-09-11,Terengganu,136,85,51,2013
2013-09-12,Terengganu,36,18,18,2013
2013-09-13,Terengganu,18,8,10,2013
2013-09-14,Terengganu,0,0,0,2013
2013-09-15,Terengganu,39,10,29,2013
2013-09-16,Terengganu,0,0,0,2013
2013-09-17,Terengganu,94,34,60,2013
2013-09-18,Terengganu,16,1,15,2013
2013-09-19,Terengganu,5,1,4,2013
2013-09-20,Terengganu,21,6,15,2013
2013-09-21,Terengganu,0,0,0,2013
2013-09-22,Terengganu,51,4,47,2013
2013-09-23,Terengganu,60,30,30,2013
2013-09-24,Terengganu,144,36,108,2013
2013-09-25,Terengganu,173,49,124,2013
2013-09-26,Terengganu,33,19,14,2013
2013-09-27,Terengganu,0,0,0,2013
2013-09-28,Terengganu,0,0,0,2013
2013-09-29,Terengganu,52,14,38,2013
2013-09-30,Terengganu,4,0,4,2013
2013-10-01,Terengganu,63,29,34,2013
2013-10-02,Terengganu,44,17,27,2013
2013-10-03,Terengganu,39,28,11,2013
2013-10-04,Terengganu,0,0,0,2013
2013-10-05,Terengganu,62,51,11,2013
2013-10-06,Terengganu,104,35,69,2013
2013-10-07,Terengganu,70,33,37,2013
2013-10-08,Terengganu,69,30,39,2013
2013-10-09,Terengganu,40,13,27,2013
2013-10-10,Terengganu,18,8,10,2013
2013-10-11,Terengganu,0,0,0,2013
2013-10-12,Terengganu,61,52,9,2013
2013-10-13,Terengganu,72,40,32,2013
2013-10-14,Terengganu,10,5,5,2013
2013-10-15,Terengganu,0,0,0,2013
2013-10-16,Terengganu,0,0,0,2013
2013-10-17,Terengganu,47,15,32,2013
2013-10-18,Terengganu,0,0,0,2013
2013-10-19,Terengganu,43,36,7,2013
2013-10-20,Terengganu,20,6,14,2013
2013-10-21,Terengganu,15,6,9,2013
2013-10-22,Terengganu,28,6,22,2013
2013-10-23,Terengganu,57,31,26,2013
2013-10-24,Terengganu,23,8,15,2013
2013-10-25,Terengganu,0,0,0,2013
2013-10-26,Terengganu,87,9,78,2013
2013-10-27,Terengganu,37,8,29,2013
2013-10-28,Terengganu,13,2,11,2013
2013-10-29,Terengganu,70,20,50,2013
2013-10-30,Terengganu,8,1,7,2013
2013-10-31,Terengganu,23,14,9,2013
2013-11-01,Terengganu,47,35,12,2013
2013-11-02,Terengganu,47,16,31,2013
2013-11-03,Terengganu,0,0,0,2013
2013-11-04,Terengganu,39,10,29,2013
2013-11-05,Terengganu,0,0,0,2013
2013-11-06,Terengganu,14,7,7,2013
2013-11-07,Terengganu,27,17,10,2013
2013-11-08,Terengganu,0,0,0,2013
2013-11-09,Terengganu,18,9,9,2013
2013-11-10,Terengganu,1,0,1,2013
2013-11-11,Terengganu,42,17,25,2013
2013-11-12,Terengganu,8,0,8,2013
2013-11-13,Terengganu,28,9,19,2013
2013-11-14,Terengganu,30,16,14,2013
2013-11-15,Terengganu,63,33,30,2013
2013-11-16,Terengganu,35,10,25,2013
2013-11-17,Terengganu,9,2,7,2013
2013-11-18,Terengganu,25,10,15,2013
2013-11-19,Terengganu,115,46,69,2013
2013-11-20,Terengganu,83,30,53,2013
2013-11-21,Terengganu,111,36,75,2013
2013-11-22,Terengganu,48,7,41,2013
2013-11-23,Terengganu,0,0,0,2013
2013-11-24,Terengganu,4,0,4,2013
2013-11-25,Terengganu,68,48,20,2013
2013-11-26,Terengganu,8,0,8,2013
2013-11-27,Terengganu,53,15,38,2013
2013-11-28,Terengganu,9,2,7,2013
2013-11-29,Terengganu,49,16,33,2013
2013-11-30,Terengganu,37,13,24,2013
2013-12-01,Terengganu,9,0,9,2013
2013-12-02,Terengganu,27,12,15,2013
2013-12-03,Terengganu,1,0,1,2013
2013-12-04,Terengganu,17,2,15,2013
2013-12-05,Terengganu,45,27,18,2013
2013-12-06,Terengganu,37,7,30,2013
2013-12-07,Terengganu,12,3,9,2013
2013-12-08,Terengganu,71,12,59,2013
2013-12-09,Terengganu,25,7,18,2013
2013-12-10,Terengganu,31,5,26,2013
2013-12-11,Terengganu,50,23,27,2013
2013-12-12,Terengganu,40,19,21,2013
2013-12-13,Terengganu,4,1,3,2013
2013-12-14,Terengganu,14,8,6,2013
2013-12-15,Terengganu,20,3,17,2013
2013-12-16,Terengganu,117,64,53,2013
2013-12-17,Terengganu,145,62,83,2013
2013-12-18,Terengganu,38,20,18,2013
2013-12-19,Terengganu,22,6,16,2013
2013-12-20,Terengganu,142,103,39,2013
2013-12-21,Terengganu,0,0,0,2013
2013-12-22,Terengganu,56,4,52,2013
2013-12-23,Terengganu,11,1,10,2013
2013-12-24,Terengganu,26,6,20,2013
2013-12-25,Terengganu,13,6,7,2013
2013-12-26,Terengganu,14,0,14,2013
2013-12-27,Terengganu,39,16,23,2013
2013-12-28,Terengganu,31,16,15,2013
2013-12-29,Terengganu,43,14,29,2013
2013-12-30,Terengganu,14,2,12,2013
2013-12-31,Terengganu,9,0,9,2013
2014-01-01,Terengganu,94,45,49,2014
2014-01-02,Terengganu,127,81,46,2014
2014-01-03,Terengganu,0,0,0,2014
2014-01-04,Terengganu,33,10,23,2014
2014-01-05,Terengganu,13,1,12,2014
2014-01-06,Terengganu,9,0,9,2014
2014-01-07,Terengganu,73,20,53,2014
2014-01-08,Terengganu,75,50,25,2014
2014-01-09,Terengganu,36,30,6,2014
2014-01-10,Terengganu,0,0,0,2014
2014-01-11,Terengganu,0,0,0,2014
2014-01-12,Terengganu,24,4,20,2014
2014-01-13,Terengganu,45,21,24,2014
2014-01-14,Terengganu,0,0,0,2014
2014-01-15,Terengganu,27,5,22,2014
2014-01-16,Terengganu,15,8,7,2014
2014-01-17,Terengganu,37,7,30,2014
2014-01-18,Terengganu,0,0,0,2014
2014-01-19,Terengganu,29,7,22,2014
2014-01-20,Terengganu,85,45,40,2014
2014-01-21,Terengganu,21,10,11,2014
2014-01-22,Terengganu,59,39,20,2014
2014-01-23,Terengganu,98,41,57,2014
2014-01-24,Terengganu,0,0,0,2014
2014-01-25,Terengganu,56,27,29,2014
2014-01-26,Terengganu,6,0,6,2014
2014-01-27,Terengganu,95,27,68,2014
2014-01-28,Terengganu,50,27,23,2014
2014-01-29,Terengganu,28,8,20,2014
2014-01-30,Terengganu,83,34,49,2014
2014-01-31,Terengganu,2,2,0,2014
2014-02-01,Terengganu,16,10,6,2014
2014-02-02,Terengganu,0,0,0,2014
2014-02-03,Terengganu,66,38,28,2014
2014-02-04,Terengganu,23,5,18,2014
2014-02-05,Terengganu,20,6,14,2014
2014-02-06,Terengganu,33,15,18,2014
2014-02-07,Terengganu,24,6,18,2014
2014-02-08,Terengganu,20,10,10,2014
2014-02-09,Terengganu,22,4,18,2014
2014-02-10,Terengganu,14,5,9,2014
2014-02-11,Terengganu,44,19,25,2014
2014-02-12,Terengganu,11,3,8,2014
2014-02-13,Terengganu,71,35,36,2014
2014-02-14,Terengganu,62,16,46,2014
2014-02-15,Terengganu,0,0,0,2014
2014-02-16,Terengganu,45,15,30,2014
2014-02-17,Terengganu,20,4,16,2014
2014-02-18,Terengganu,26,4,22,2014
2014-02-19,Terengganu,42,30,12,2014
2014-02-20,Terengganu,53,23,30,2014
2014-02-21,Terengganu,138,55,83,2014
2014-02-22,Terengganu,21,10,11,2014
2014-02-23,Terengganu,13,1,12,2014
2014-02-24,Terengganu,93,85,8,2014
2014-02-25,Terengganu,58,29,29,2014
2014-02-26,Terengganu,9,3,6,2014
2014-02-27,Terengganu,32,22,10,2014
2014-02-28,Terengganu,0,0,0,2014
2014-03-01,Terengganu,30,10,20,2014
2014-03-02,Terengganu,33,13,20,2014
2014-03-03,Terengganu,31,7,24,2014
2014-03-04,Terengganu,122,119,3,2014
2014-03-05,Terengganu,10,2,8,2014
2014-03-06,Terengganu,24,19,5,2014
2014-03-07,Terengganu,59,17,42,2014
2014-03-08,Terengganu,200,192,8,2014
2014-03-09,Terengganu,5,3,2,2014
2014-03-10,Terengganu,86,57,29,2014
2014-03-11,Terengganu,78,18,60,2014
2014-03-12,Terengganu,4,0,4,2014
2014-03-13,Terengganu,24,11,13,2014
2014-03-14,Terengganu,33,10,23,2014
2014-03-15,Terengganu,17,8,9,2014
2014-03-16,Terengganu,17,0,17,2014
2014-03-17,Terengganu,23,10,13,2014
2014-03-18,Terengganu,85,21,64,2014
2014-03-19,Terengganu,113,42,71,2014
2014-03-20,Terengganu,25,13,12,2014
2014-03-21,Terengganu,0,0,0,2014
2014-03-22,Terengganu,76,12,64,2014
2014-03-23,Terengganu,71,15,56,2014
2014-03-24,Terengganu,44,17,27,2014
2014-03-25,Terengganu,32,15,17,2014
2014-03-26,Terengganu,49,23,26,2014
2014-03-27,Terengganu,51,16,35,2014
2014-03-28,Terengganu,43,11,32,2014
2014-03-29,Terengganu,0,0,0,2014
2014-03-30,Terengganu,29,3,26,2014
2014-03-31,Terengganu,29,5,24,2014
2014-04-01,Terengganu,87,17,70,2014
2014-04-02,Terengganu,7,1,6,2014
2014-04-03,Terengganu,69,24,45,2014
2014-04-04,Terengganu,0,0,0,2014
2014-04-05,Terengganu,3,0,3,2014
2014-04-06,Terengganu,35,19,16,2014
2014-04-07,Terengganu,19,10,9,2014
2014-04-08,Terengganu,5,1,4,2014
2014-04-09,Terengganu,21,5,16,2014
2014-04-10,Terengganu,16,4,12,2014
2014-04-11,Terengganu,65,24,41,2014
2014-04-12,Terengganu,89,29,60,2014
2014-04-13,Terengganu,32,11,21,2014
2014-04-14,Terengganu,32,8,24,2014
2014-04-15,Terengganu,112,63,49,2014
2014-04-16,Terengganu,24,7,17,2014
2014-04-17,Terengganu,59,24,35,2014
2014-04-18,Terengganu,0,0,0,2014
2014-04-19,Terengganu,110,31,79,2014
2014-04-20,Terengganu,42,24,18,2014
2014-04-21,Terengganu,48,19,29,2014
2014-04-22,Terengganu,41,13,28,2014
2014-04-23,Terengganu,5,0,5,2014
2014-04-24,Terengganu,40,27,13,2014
2014-04-25,Terengganu,43,18,25,2014
2014-04-26,Terengganu,25,11,14,2014
2014-04-27,Terengganu,0,0,0,2014
2014-04-28,Terengganu,51,18,33,2014
2014-04-29,Terengganu,74,35,39,2014
2014-04-30,Terengganu,5,0,5,2014
2014-05-01,Terengganu,14,8,6,2014
2014-05-02,Terengganu,18,3,15,2014
2014-05-03,Terengganu,40,24,16,2014
2014-05-04,Terengganu,13,1,12,2014
2014-05-05,Terengganu,80,56,24,2014
2014-05-06,Terengganu,60,20,40,2014
2014-05-07,Terengganu,3,0,3,2014
2014-05-08,Terengganu,29,11,18,2014
2014-05-09,Terengganu,0,0,0,2014
2014-05-10,Terengganu,40,16,24,2014
2014-05-11,Terengganu,5,0,5,2014
2014-05-12,Terengganu,98,47,51,2014
2014-05-13,Terengganu,0,0,0,2014
2014-05-14,Terengganu,72,8,64,2014
2014-05-15,Terengganu,10,5,5,2014
2014-05-16,Terengganu,115,12,103,2014
2014-05-17,Terengganu,23,11,12,2014
2014-05-18,Terengganu,5,0,5,2014
2014-05-19,Terengganu,54,22,32,2014
2014-05-20,Terengganu,36,21,15,2014
2014-05-21,Terengganu,18,8,10,2014
2014-05-22,Terengganu,13,2,11,2014
2014-05-23,Terengganu,89,84,5,2014
2014-05-24,Terengganu,15,9,6,2014
2014-05-25,Terengganu,22,10,12,2014
2014-05-26,Terengganu,5,1,4,2014
2014-05-27,Terengganu,2,0,2,2014
2014-05-28,Terengganu,32,8,24,2014
2014-05-29,Terengganu,4,0,4,2014
2014-05-30,Terengganu,11,9,2,2014
2014-05-31,Terengganu,25,11,14,2014
2014-06-01,Terengganu,18,6,12,2014
2014-06-02,Terengganu,7,0,7,2014
2014-06-03,Terengganu,31,5,26,2014
2014-06-04,Terengganu,5,0,5,2014
2014-06-05,Terengganu,42,13,29,2014
2014-06-06,Terengganu,6,1,5,2014
2014-06-07,Terengganu,47,39,8,2014
2014-06-08,Terengganu,41,39,2,2014
2014-06-09,Terengganu,6,1,5,2014
2014-06-10,Terengganu,24,6,18,2014
2014-06-11,Terengganu,76,63,13,2014
2014-06-12,Terengganu,22,5,17,2014
2014-06-13,Terengganu,10,4,6,2014
2014-06-14,Terengganu,81,77,4,2014
2014-06-15,Terengganu,93,56,37,2014
2014-06-16,Terengganu,44,12,32,2014
2014-06-17,Terengganu,131,83,48,2014
2014-06-18,Terengganu,67,28,39,2014
2014-06-19,Terengganu,185,85,100,2014
2014-06-20,Terengganu,0,0,0,2014
2014-06-21,Terengganu,19,8,11,2014
2014-06-22,Terengganu,85,62,23,2014
2014-06-23,Terengganu,10,1,9,2014
2014-06-24,Terengganu,84,34,50,2014
2014-06-25,Terengganu,92,41,51,2014
2014-06-26,Terengganu,98,21,77,2014
2014-06-27,Terengganu,0,0,0,2014
2014-06-28,Terengganu,31,9,22,2014
2014-06-29,Terengganu,1,0,1,2014
2014-06-30,Terengganu,2,0,2,2014
2014-07-01,Terengganu,58,14,44,2014
2014-07-02,Terengganu,41,7,34,2014
2014-07-03,Terengganu,0,0,0,2014
2014-07-04,Terengganu,73,12,61,2014
2014-07-05,Terengganu,54,22,32,2014
2014-07-06,Terengganu,0,0,0,2014
2014-07-07,Terengganu,47,14,33,2014
2014-07-08,Terengganu,34,10,24,2014
2014-07-09,Terengganu,0,0,0,2014
2014-07-10,Terengganu,93,26,67,2014
2014-07-11,Terengganu,0,0,0,2014
2014-07-12,Terengganu,48,12,36,2014
2014-07-13,Terengganu,3,0,3,2014
2014-07-14,Terengganu,78,42,36,2014
2014-07-15,Terengganu,64,8,56,2014
2014-07-16,Terengganu,41,12,29,2014
2014-07-17,Terengganu,2,0,2,2014
2014-07-18,Terengganu,123,41,82,2014
2014-07-19,Terengganu,84,15,69,2014
2014-07-20,Terengganu,20,7,13,2014
2014-07-21,Terengganu,40,24,16,2014
2014-07-22,Terengganu,37,3,34,2014
2014-07-23,Terengganu,19,5,14,2014
2014-07-24,Terengganu,0,0,0,2014
2014-07-25,Terengganu,26,4,22,2014
2014-07-26,Terengganu,5,0,5,2014
2014-07-27,Terengganu,1,0,1,2014
2014-07-28,Terengganu,0,0,0,2014
2014-07-29,Terengganu,0,0,0,2014
2014-07-30,Terengganu,9,2,7,2014
2014-07-31,Terengganu,25,9,16,2014
2014-08-01,Terengganu,28,6,22,2014
2014-08-02,Terengganu,46,34,12,2014
2014-08-03,Terengganu,17,1,16,2014
2014-08-04,Terengganu,34,6,28,2014
2014-08-05,Terengganu,55,8,47,2014
2014-08-06,Terengganu,84,78,6,2014
2014-08-07,Terengganu,142,69,73,2014
2014-08-08,Terengganu,0,0,0,2014
2014-08-09,Terengganu,0,0,0,2014
2014-08-10,Terengganu,45,27,18,2014
2014-08-11,Terengganu,61,43,18,2014
2014-08-12,Terengganu,38,24,14,2014
2014-08-13,Terengganu,10,1,9,2014
2014-08-14,Terengganu,145,80,65,2014
2014-08-15,Terengganu,0,0,0,2014
2014-08-16,Terengganu,0,0,0,2014
2014-08-17,Terengganu,53,46,7,2014
2014-08-18,Terengganu,93,25,68,2014
2014-08-19,Terengganu,81,60,21,2014
2014-08-20,Terengganu,56,28,28,2014
2014-08-21,Terengganu,39,22,17,2014
2014-08-22,Terengganu,104,22,82,2014
2014-08-23,Terengganu,18,5,13,2014
2014-08-24,Terengganu,40,25,15,2014
2014-08-25,Terengganu,51,9,42,2014
2014-08-26,Terengganu,49,22,27,2014
2014-08-27,Terengganu,28,14,14,2014
2014-08-28,Terengganu,67,46,21,2014
2014-08-29,Terengganu,22,6,16,2014
2014-08-30,Terengganu,24,11,13,2014
2014-08-31,Terengganu,0,0,0,2014
2014-09-01,Terengganu,13,1,12,2014
2014-09-02,Terengganu,25,5,20,2014
2014-09-03,Terengganu,44,20,24,2014
2014-09-04,Terengganu,12,2,10,2014
2014-09-05,Terengganu,0,0,0,2014
2014-09-06,Terengganu,0,0,0,2014
2014-09-07,Terengganu,118,72,46,2014
2014-09-08,Terengganu,97,38,59,2014
2014-09-09,Terengganu,100,55,45,2014
2014-09-10,Terengganu,62,17,45,2014
2014-09-11,Terengganu,36,9,27,2014
2014-09-12,Terengganu,0,0,0,2014
2014-09-13,Terengganu,5,1,4,2014
2014-09-14,Terengganu,30,6,24,2014
2014-09-15,Terengganu,36,5,31,2014
2014-09-16,Terengganu,80,29,51,2014
2014-09-17,Terengganu,42,24,18,2014
2014-09-18,Terengganu,33,3,30,2014
2014-09-19,Terengganu,0,0,0,2014
2014-09-20,Terengganu,36,21,15,2014
2014-09-21,Terengganu,60,5,55,2014
2014-09-22,Terengganu,63,37,26,2014
2014-09-23,Terengganu,66,25,41,2014
2014-09-24,Terengganu,73,33,40,2014
2014-09-25,Terengganu,28,17,11,2014
2014-09-26,Terengganu,0,0,0,2014
2014-09-27,Terengganu,40,28,12,2014
2014-09-28,Terengganu,110,38,72,2014
2014-09-29,Terengganu,5,1,4,2014
2014-09-30,Terengganu,136,48,88,2014
2014-10-01,Terengganu,184,74,110,2014
2014-10-02,Terengganu,11,0,11,2014
2014-10-03,Terengganu,0,0,0,2014
2014-10-04,Terengganu,52,10,42,2014
2014-10-05,Terengganu,0,0,0,2014
2014-10-06,Terengganu,0,0,0,2014
2014-10-07,Terengganu,41,12,29,2014
2014-10-08,Terengganu,5,0,5,2014
2014-10-09,Terengganu,22,7,15,2014
2014-10-10,Terengganu,0,0,0,2014
2014-10-11,Terengganu,35,35,0,2014
2014-10-12,Terengganu,53,10,43,2014
2014-10-13,Terengganu,52,13,39,2014
2014-10-14,Terengganu,78,28,50,2014
2014-10-15,Terengganu,77,39,38,2014
2014-10-16,Terengganu,25,10,15,2014
2014-10-17,Terengganu,52,46,6,2014
2014-10-18,Terengganu,79,68,11,2014
2014-10-19,Terengganu,55,36,19,2014
2014-10-20,Terengganu,9,0,9,2014
2014-10-21,Terengganu,34,5,29,2014
2014-10-22,Terengganu,47,19,28,2014
2014-10-23,Terengganu,16,5,11,2014
2014-10-24,Terengganu,35,13,22,2014
2014-10-25,Terengganu,61,58,3,2014
2014-10-26,Terengganu,0,0,0,2014
2014-10-27,Terengganu,35,27,8,2014
2014-10-28,Terengganu,2,0,2,2014
2014-10-29,Terengganu,62,17,45,2014
2014-10-30,Terengganu,104,49,55,2014
2014-10-31,Terengganu,0,0,0,2014
2014-11-01,Terengganu,0,0,0,2014
2014-11-02,Terengganu,12,4,8,2014
2014-11-03,Terengganu,36,8,28,2014
2014-11-04,Terengganu,3,0,3,2014
2014-11-05,Terengganu,17,3,14,2014
2014-11-06,Terengganu,14,6,8,2014
2014-11-07,Terengganu,0,0,0,2014
2014-11-08,Terengganu,0,0,0,2014
2014-11-09,Terengganu,25,11,14,2014
2014-11-10,Terengganu,39,6,33,2014
2014-11-11,Terengganu,37,17,20,2014
2014-11-12,Terengganu,54,25,29,2014
2014-11-13,Terengganu,34,16,18,2014
2014-11-14,Terengganu,48,10,38,2014
2014-11-15,Terengganu,0,0,0,2014
2014-11-16,Terengganu,10,1,9,2014
2014-11-17,Terengganu,24,8,16,2014
2014-11-18,Terengganu,11,1,10,2014
2014-11-19,Terengganu,28,9,19,2014
2014-11-20,Terengganu,45,15,30,2014
2014-11-21,Terengganu,19,6,13,2014
2014-11-22,Terengganu,16,2,14,2014
2014-11-23,Terengganu,7,1,6,2014
2014-11-24,Terengganu,38,19,19,2014
2014-11-25,Terengganu,17,6,11,2014
2014-11-26,Terengganu,28,18,10,2014
2014-11-27,Terengganu,17,3,14,2014
2014-11-28,Terengganu,57,32,25,2014
2014-11-29,Terengganu,0,0,0,2014
2014-11-30,Terengganu,16,1,15,2014
2014-12-01,Terengganu,13,3,10,2014
2014-12-02,Terengganu,36,19,17,2014
2014-12-03,Terengganu,83,29,54,2014
2014-12-04,Terengganu,97,47,50,2014
2014-12-05,Terengganu,0,0,0,2014
2014-12-06,Terengganu,37,13,24,2014
2014-12-07,Terengganu,10,1,9,2014
2014-12-08,Terengganu,63,35,28,2014
2014-12-09,Terengganu,6,0,6,2014
2014-12-10,Terengganu,33,16,17,2014
2014-12-11,Terengganu,62,41,21,2014
2014-12-12,Terengganu,0,0,0,2014
2014-12-13,Terengganu,47,23,24,2014
2014-12-14,Terengganu,25,1,24,2014
2014-12-15,Terengganu,29,5,24,2014
2014-12-16,Terengganu,60,19,41,2014
2014-12-17,Terengganu,75,34,41,2014
2014-12-18,Terengganu,26,4,22,2014
2014-12-19,Terengganu,0,0,0,2014
2014-12-20,Terengganu,57,16,41,2014
2014-12-21,Terengganu,63,7,56,2014
2014-12-22,Terengganu,31,7,24,2014
2014-12-23,Terengganu,8,1,7,2014
2014-12-24,Terengganu,101,38,63,2014
2014-12-25,Terengganu,12,7,5,2014
2014-12-26,Terengganu,0,0,0,2014
2014-12-27,Terengganu,20,7,13,2014
2014-12-28,Terengganu,19,4,15,2014
2014-12-29,Terengganu,50,14,36,2014
2014-12-30,Terengganu,50,13,37,2014
2014-12-31,Terengganu,27,6,21,2014
2015-01-01,Terengganu,20,3,17,2015
2015-01-02,Terengganu,0,0,0,2015
2015-01-03,Terengganu,63,33,30,2015
2015-01-04,Terengganu,48,17,31,2015
2015-01-05,Terengganu,82,23,59,2015
2015-01-06,Terengganu,40,10,30,2015
2015-01-07,Terengganu,56,16,40,2015
2015-01-08,Terengganu,42,6,36,2015
2015-01-09,Terengganu,28,12,16,2015
2015-01-10,Terengganu,0,0,0,2015
2015-01-11,Terengganu,43,8,35,2015
2015-01-12,Terengganu,13,0,13,2015
2015-01-13,Terengganu,60,31,29,2015
2015-01-14,Terengganu,11,3,8,2015
2015-01-15,Terengganu,42,29,13,2015
2015-01-16,Terengganu,0,0,0,2015
2015-01-17,Terengganu,85,79,6,2015
2015-01-18,Terengganu,45,9,36,2015
2015-01-19,Terengganu,143,62,81,2015
2015-01-20,Terengganu,79,43,36,2015
2015-01-21,Terengganu,65,26,39,2015
2015-01-22,Terengganu,43,32,11,2015
2015-01-23,Terengganu,0,0,0,2015
2015-01-24,Terengganu,76,67,9,2015
2015-01-25,Terengganu,54,24,30,2015
2015-01-26,Terengganu,124,27,97,2015
2015-01-27,Terengganu,24,11,13,2015
2015-01-28,Terengganu,2,0,2,2015
2015-01-29,Terengganu,171,69,102,2015
2015-01-30,Terengganu,0,0,0,2015
2015-01-31,Terengganu,153,152,1,2015
2015-02-01,Terengganu,13,2,11,2015
2015-02-02,Terengganu,117,55,62,2015
2015-02-03,Terengganu,131,75,56,2015
2015-02-04,Terengganu,132,64,68,2015
2015-02-05,Terengganu,3,0,3,2015
2015-02-06,Terengganu,0,0,0,2015
2015-02-07,Terengganu,62,47,15,2015
2015-02-08,Terengganu,17,2,15,2015
2015-02-09,Terengganu,120,93,27,2015
2015-02-10,Terengganu,11,1,10,2015
2015-02-11,Terengganu,43,15,28,2015
2015-02-12,Terengganu,26,23,3,2015
2015-02-13,Terengganu,0,0,0,2015
2015-02-14,Terengganu,9,0,9,2015
2015-02-15,Terengganu,17,2,15,2015
2015-02-16,Terengganu,87,24,63,2015
2015-02-17,Terengganu,148,71,77,2015
2015-02-18,Terengganu,4,0,4,2015
2015-02-19,Terengganu,20,7,13,2015
2015-02-20,Terengganu,0,0,0,2015
2015-02-21,Terengganu,34,11,23,2015
2015-02-22,Terengganu,9,0,9,2015
2015-02-23,Terengganu,24,5,19,2015
2015-02-24,Terengganu,17,3,14,2015
2015-02-25,Terengganu,49,35,14,2015
2015-02-26,Terengganu,22,5,17,2015
2015-02-27,Terengganu,6,5,1,2015
2015-02-28,Terengganu,70,18,52,2015
2015-03-01,Terengganu,12,3,9,2015
2015-03-02,Terengganu,71,26,45,2015
2015-03-03,Terengganu,84,34,50,2015
2015-03-04,Terengganu,0,0,0,2015
2015-03-05,Terengganu,56,35,21,2015
2015-03-06,Terengganu,0,0,0,2015
2015-03-07,Terengganu,17,5,12,2015
2015-03-08,Terengganu,19,4,15,2015
2015-03-09,Terengganu,7,1,6,2015
2015-03-10,Terengganu,78,27,51,2015
2015-03-11,Terengganu,77,47,30,2015
2015-03-12,Terengganu,135,44,91,2015
2015-03-13,Terengganu,0,0,0,2015
2015-03-14,Terengganu,21,8,13,2015
2015-03-15,Terengganu,2,0,2,2015
2015-03-16,Terengganu,32,14,18,2015
2015-03-17,Terengganu,66,24,42,2015
2015-03-18,Terengganu,35,12,23,2015
2015-03-19,Terengganu,5,0,5,2015
2015-03-20,Terengganu,65,38,27,2015
2015-03-21,Terengganu,76,41,35,2015
2015-03-22,Terengganu,109,60,49,2015
2015-03-23,Terengganu,4,1,3,2015
2015-03-24,Terengganu,17,9,8,2015
2015-03-25,Terengganu,155,39,116,2015
2015-03-26,Terengganu,143,49,94,2015
2015-03-27,Terengganu,25,11,14,2015
2015-03-28,Terengganu,65,10,55,2015
2015-03-29,Terengganu,6,0,6,2015
2015-03-30,Terengganu,88,38,50,2015
2015-03-31,Terengganu,6,0,6,2015
2015-04-01,Terengganu,33,13,20,2015
2015-04-02,Terengganu,53,16,37,2015
2015-04-03,Terengganu,29,11,18,2015
2015-04-04,Terengganu,34,20,14,2015
2015-04-05,Terengganu,38,7,31,2015
2015-04-06,Terengganu,21,6,15,2015
2015-04-07,Terengganu,6,0,6,2015
2015-04-08,Terengganu,62,27,35,2015
2015-04-09,Terengganu,68,30,38,2015
2015-04-10,Terengganu,18,6,12,2015
2015-04-11,Terengganu,0,0,0,2015
2015-04-12,Terengganu,58,22,36,2015
2015-04-13,Terengganu,43,13,30,2015
2015-04-14,Terengganu,56,14,42,2015
2015-04-15,Terengganu,13,2,11,2015
2015-04-16,Terengganu,34,13,21,2015
2015-04-17,Terengganu,0,0,0,2015
2015-04-18,Terengganu,24,13,11,2015
2015-04-19,Terengganu,124,63,61,2015
2015-04-20,Terengganu,46,20,26,2015
2015-04-21,Terengganu,88,38,50,2015
2015-04-22,Terengganu,5,0,5,2015
2015-04-23,Terengganu,56,27,29,2015
2015-04-24,Terengganu,22,7,15,2015
2015-04-25,Terengganu,18,8,10,2015
2015-04-26,Terengganu,0,0,0,2015
2015-04-27,Terengganu,31,8,23,2015
2015-04-28,Terengganu,37,8,29,2015
2015-04-29,Terengganu,64,41,23,2015
2015-04-30,Terengganu,31,23,8,2015
2015-05-01,Terengganu,0,0,0,2015
2015-05-02,Terengganu,44,12,32,2015
2015-05-03,Terengganu,0,0,0,2015
2015-05-04,Terengganu,34,5,29,2015
2015-05-05,Terengganu,4,1,3,2015
2015-05-06,Terengganu,61,49,12,2015
2015-05-07,Terengganu,51,18,33,2015
2015-05-08,Terengganu,43,20,23,2015
2015-05-09,Terengganu,56,18,38,2015
2015-05-10,Terengganu,4,0,4,2015
2015-05-11,Terengganu,112,91,21,2015
2015-05-12,Terengganu,16,1,15,2015
2015-05-13,Terengganu,27,11,16,2015
2015-05-14,Terengganu,101,26,75,2015
2015-05-15,Terengganu,29,11,18,2015
2015-05-16,Terengganu,49,23,26,2015
2015-05-17,Terengganu,6,0,6,2015
2015-05-18,Terengganu,33,10,23,2015
2015-05-19,Terengganu,38,22,16,2015
2015-05-20,Terengganu,6,0,6,2015
2015-05-21,Terengganu,213,64,149,2015
2015-05-22,Terengganu,0,0,0,2015
2015-05-23,Terengganu,20,7,13,2015
2015-05-24,Terengganu,40,7,33,2015
2015-05-25,Terengganu,53,23,30,2015
2015-05-26,Terengganu,41,14,27,2015
2015-05-27,Terengganu,32,4,28,2015
2015-05-28,Terengganu,79,13,66,2015
2015-05-29,Terengganu,97,10,87,2015
2015-05-30,Terengganu,9,6,3,2015
2015-05-31,Terengganu,16,1,15,2015
2015-06-01,Terengganu,32,4,28,2015
2015-06-02,Terengganu,6,0,6,2015
2015-06-03,Terengganu,48,10,38,2015
2015-06-04,Terengganu,64,18,46,2015
2015-06-05,Terengganu,0,0,0,2015
2015-06-06,Terengganu,8,1,7,2015
2015-06-07,Terengganu,0,0,0,2015
2015-06-08,Terengganu,19,7,12,2015
2015-06-09,Terengganu,35,7,28,2015
2015-06-10,Terengganu,6,0,6,2015
2015-06-11,Terengganu,183,81,102,2015
2015-06-12,Terengganu,0,0,0,2015
2015-06-13,Terengganu,0,0,0,2015
2015-06-14,Terengganu,0,0,0,2015
2015-06-15,Terengganu,74,31,43,2015
2015-06-16,Terengganu,74,26,48,2015
2015-06-17,Terengganu,62,17,45,2015
2015-06-18,Terengganu,0,0,0,2015
2015-06-19,Terengganu,0,0,0,2015
2015-06-20,Terengganu,43,9,34,2015
2015-06-21,Terengganu,48,12,36,2015
2015-06-22,Terengganu,29,20,9,2015
2015-06-23,Terengganu,0,0,0,2015
2015-06-24,Terengganu,60,14,46,2015
2015-06-25,Terengganu,1,0,1,2015
2015-06-26,Terengganu,59,9,50,2015
2015-06-27,Terengganu,0,0,0,2015
2015-06-28,Terengganu,42,10,32,2015
2015-06-29,Terengganu,53,25,28,2015
2015-06-30,Terengganu,41,13,28,2015
2015-07-01,Terengganu,28,10,18,2015
2015-07-02,Terengganu,173,45,128,2015
2015-07-03,Terengganu,0,0,0,2015
2015-07-04,Terengganu,79,21,58,2015
2015-07-05,Terengganu,53,8,45,2015
2015-07-06,Terengganu,12,0,12,2015
2015-07-07,Terengganu,63,23,40,2015
2015-07-08,Terengganu,33,14,19,2015
2015-07-09,Terengganu,1,0,1,2015
2015-07-10,Terengganu,77,14,63,2015
2015-07-11,Terengganu,33,19,14,2015
2015-07-12,Terengganu,47,9,38,2015
2015-07-13,Terengganu,28,12,16,2015
2015-07-14,Terengganu,3,0,3,2015
2015-07-15,Terengganu,42,8,34,2015
2015-07-16,Terengganu,4,0,4,2015
2015-07-17,Terengganu,0,0,0,2015
2015-07-18,Terengganu,0,0,0,2015
2015-07-19,Terengganu,13,4,9,2015
2015-07-20,Terengganu,24,8,16,2015
2015-07-21,Terengganu,24,7,17,2015
2015-07-22,Terengganu,14,2,12,2015
2015-07-23,Terengganu,26,12,14,2015
2015-07-24,Terengganu,16,0,16,2015
2015-07-25,Terengganu,36,14,22,2015
2015-07-26,Terengganu,23,5,18,2015
2015-07-27,Terengganu,60,22,38,2015
2015-07-28,Terengganu,169,85,84,2015
2015-07-29,Terengganu,94,43,51,2015
2015-07-30,Terengganu,219,93,126,2015
2015-07-31,Terengganu,66,31,35,2015
2015-08-01,Terengganu,39,11,28,2015
2015-08-02,Terengganu,52,21,31,2015
2015-08-03,Terengganu,33,12,21,2015
2015-08-04,Terengganu,226,142,84,2015
2015-08-05,Terengganu,111,80,31,2015
2015-08-06,Terengganu,9,2,7,2015
2015-08-07,Terengganu,20,12,8,2015
2015-08-08,Terengganu,37,13,24,2015
2015-08-09,Terengganu,45,31,14,2015
2015-08-10,Terengganu,76,62,14,2015
2015-08-11,Terengganu,127,71,56,2015
2015-08-12,Terengganu,31,14,17,2015
2015-08-13,Terengganu,49,34,15,2015
2015-08-14,Terengganu,79,22,57,2015
2015-08-15,Terengganu,0,0,0,2015
2015-08-16,Terengganu,45,25,20,2015
2015-08-17,Terengganu,11,3,8,2015
2015-08-18,Terengganu,76,11,65,2015
2015-08-19,Terengganu,37,18,19,2015
2015-08-20,Terengganu,28,12,16,2015
2015-08-21,Terengganu,0,0,0,2015
2015-08-22,Terengganu,0,0,0,2015
2015-08-23,Terengganu,67,38,29,2015
2015-08-24,Terengganu,77,32,45,2015
2015-08-25,Terengganu,72,43,29,2015
2015-08-26,Terengganu,16,1,15,2015
2015-08-27,Terengganu,27,18,9,2015
2015-08-28,Terengganu,0,0,0,2015
2015-08-29,Terengganu,0,0,0,2015
2015-08-30,Terengganu,21,10,11,2015
2015-08-31,Terengganu,0,0,0,2015
2015-09-01,Terengganu,37,14,23,2015
2015-09-02,Terengganu,40,22,18,2015
2015-09-03,Terengganu,27,20,7,2015
2015-09-04,Terengganu,13,5,8,2015
2015-09-05,Terengganu,69,19,50,2015
2015-09-06,Terengganu,16,0,16,2015
2015-09-07,Terengganu,134,87,47,2015
2015-09-08,Terengganu,38,17,21,2015
2015-09-09,Terengganu,30,19,11,2015
2015-09-10,Terengganu,86,54,32,2015
2015-09-11,Terengganu,0,0,0,2015
2015-09-12,Terengganu,31,19,12,2015
2015-09-13,Terengganu,79,12,67,2015
2015-09-14,Terengganu,68,17,51,2015
2015-09-15,Terengganu,40,9,31,2015
2015-09-16,Terengganu,0,0,0,2015
2015-09-17,Terengganu,111,54,57,2015
2015-09-18,Terengganu,48,23,25,2015
2015-09-19,Terengganu,27,8,19,2015
2015-09-20,Terengganu,40,2,38,2015
2015-09-21,Terengganu,18,7,11,2015
2015-09-22,Terengganu,45,19,26,2015
2015-09-23,Terengganu,18,2,16,2015
2015-09-24,Terengganu,0,0,0,2015
2015-09-25,Terengganu,0,0,0,2015
2015-09-26,Terengganu,16,5,11,2015
2015-09-27,Terengganu,20,3,17,2015
2015-09-28,Terengganu,32,8,24,2015
2015-09-29,Terengganu,55,23,32,2015
2015-09-30,Terengganu,162,50,112,2015
2015-10-01,Terengganu,163,58,105,2015
2015-10-02,Terengganu,0,0,0,2015
2015-10-03,Terengganu,0,0,0,2015
2015-10-04,Terengganu,76,27,49,2015
2015-10-05,Terengganu,109,43,66,2015
2015-10-06,Terengganu,20,4,16,2015
2015-10-07,Terengganu,11,2,9,2015
2015-10-08,Terengganu,10,5,5,2015
2015-10-09,Terengganu,21,11,10,2015
2015-10-10,Terengganu,102,69,33,2015
2015-10-11,Terengganu,46,14,32,2015
2015-10-12,Terengganu,55,19,36,2015
2015-10-13,Terengganu,92,33,59,2015
2015-10-14,Terengganu,0,0,0,2015
2015-10-15,Terengganu,26,7,19,2015
2015-10-16,Terengganu,17,6,11,2015
2015-10-17,Terengganu,64,4,60,2015
2015-10-18,Terengganu,50,12,38,2015
2015-10-19,Terengganu,46,25,21,2015
2015-10-20,Terengganu,82,20,62,2015
2015-10-21,Terengganu,24,13,11,2015
2015-10-22,Terengganu,104,44,60,2015
2015-10-23,Terengganu,45,19,26,2015
2015-10-24,Terengganu,35,20,15,2015
2015-10-25,Terengganu,10,0,10,2015
2015-10-26,Terengganu,47,26,21,2015
2015-10-27,Terengganu,63,20,43,2015
2015-10-28,Terengganu,73,27,46,2015
2015-10-29,Terengganu,11,0,11,2015
2015-10-30,Terengganu,0,0,0,2015
2015-10-31,Terengganu,12,4,8,2015
2015-11-01,Terengganu,10,4,6,2015
2015-11-02,Terengganu,78,64,14,2015
2015-11-03,Terengganu,13,2,11,2015
2015-11-04,Terengganu,23,4,19,2015
2015-11-05,Terengganu,28,11,17,2015
2015-11-06,Terengganu,0,0,0,2015
2015-11-07,Terengganu,28,10,18,2015
2015-11-08,Terengganu,33,8,25,2015
2015-11-09,Terengganu,43,11,32,2015
2015-11-10,Terengganu,0,0,0,2015
2015-11-11,Terengganu,32,10,22,2015
2015-11-12,Terengganu,50,29,21,2015
2015-11-13,Terengganu,47,22,25,2015
2015-11-14,Terengganu,0,0,0,2015
2015-11-15,Terengganu,45,10,35,2015
2015-11-16,Terengganu,4,0,4,2015
2015-11-17,Terengganu,48,15,33,2015
2015-11-18,Terengganu,4,0,4,2015
2015-11-19,Terengganu,57,14,43,2015
2015-11-20,Terengganu,0,0,0,2015
2015-11-21,Terengganu,0,0,0,2015
2015-11-22,Terengganu,31,5,26,2015
2015-11-23,Terengganu,79,40,39,2015
2015-11-24,Terengganu,15,2,13,2015
2015-11-25,Terengganu,1,1,0,2015
2015-11-26,Terengganu,69,23,46,2015
2015-11-27,Terengganu,0,0,0,2015
2015-11-28,Terengganu,32,6,26,2015
2015-11-29,Terengganu,35,12,23,2015
2015-11-30,Terengganu,61,15,46,2015
2015-12-01,Terengganu,41,18,23,2015
2015-12-02,Terengganu,30,12,18,2015
2015-12-03,Terengganu,85,35,50,2015
2015-12-04,Terengganu,0,0,0,2015
2015-12-05,Terengganu,39,19,20,2015
2015-12-06,Terengganu,11,0,11,2015
2015-12-07,Terengganu,105,49,56,2015
2015-12-08,Terengganu,7,3,4,2015
2015-12-09,Terengganu,45,12,33,2015
2015-12-10,Terengganu,33,11,22,2015
2015-12-11,Terengganu,0,0,0,2015
2015-12-12,Terengganu,62,51,11,2015
2015-12-13,Terengganu,39,17,22,2015
2015-12-14,Terengganu,50,14,36,2015
2015-12-15,Terengganu,40,28,12,2015
2015-12-16,Terengganu,35,9,26,2015
2015-12-17,Terengganu,102,65,37,2015
2015-12-18,Terengganu,0,0,0,2015
2015-12-19,Terengganu,40,20,20,2015
2015-12-20,Terengganu,17,1,16,2015
2015-12-21,Terengganu,19,0,19,2015
2015-12-22,Terengganu,61,22,39,2015
2015-12-23,Terengganu,33,12,21,2015
2015-12-24,Terengganu,14,3,11,2015
2015-12-25,Terengganu,0,0,0,2015
2015-12-26,Terengganu,22,9,13,2015
2015-12-27,Terengganu,52,13,39,2015
2015-12-28,Terengganu,12,0,12,2015
2015-12-29,Terengganu,36,7,29,2015
2015-12-30,Terengganu,68,15,53,2015
2015-12-31,Terengganu,42,20,22,2015
2016-01-01,Terengganu,0,0,0,2016
2016-01-02,Terengganu,0,0,0,2016
2016-01-03,Terengganu,50,14,36,2016
2016-01-04,Terengganu,47,19,28,2016
2016-01-05,Terengganu,7,1,6,2016
2016-01-06,Terengganu,46,29,17,2016
2016-01-07,Terengganu,33,19,14,2016
2016-01-08,Terengganu,24,11,13,2016
2016-01-09,Terengganu,40,7,33,2016
2016-01-10,Terengganu,90,32,58,2016
2016-01-11,Terengganu,36,15,21,2016
2016-01-12,Terengganu,85,43,42,2016
2016-01-13,Terengganu,129,67,62,2016
2016-01-14,Terengganu,39,30,9,2016
2016-01-15,Terengganu,0,0,0,2016
2016-01-16,Terengganu,36,24,12,2016
2016-01-17,Terengganu,4,0,4,2016
2016-01-18,Terengganu,79,26,53,2016
2016-01-19,Terengganu,172,102,70,2016
2016-01-20,Terengganu,131,83,48,2016
2016-01-21,Terengganu,33,18,15,2016
2016-01-22,Terengganu,0,0,0,2016
2016-01-23,Terengganu,0,0,0,2016
2016-01-24,Terengganu,56,28,28,2016
2016-01-25,Terengganu,13,1,12,2016
2016-01-26,Terengganu,50,25,25,2016
2016-01-27,Terengganu,117,94,23,2016
2016-01-28,Terengganu,191,83,108,2016
2016-01-29,Terengganu,19,4,15,2016
2016-01-30,Terengganu,37,12,25,2016
2016-01-31,Terengganu,29,9,20,2016
2016-02-01,Terengganu,5,1,4,2016
2016-02-02,Terengganu,194,101,93,2016
2016-02-03,Terengganu,68,14,54,2016
2016-02-04,Terengganu,65,24,41,2016
2016-02-05,Terengganu,36,12,24,2016
2016-02-06,Terengganu,51,27,24,2016
2016-02-07,Terengganu,34,7,27,2016
2016-02-08,Terengganu,0,0,0,2016
2016-02-09,Terengganu,0,0,0,2016
2016-02-10,Terengganu,86,64,22,2016
2016-02-11,Terengganu,29,13,16,2016
2016-02-12,Terengganu,39,9,30,2016
2016-02-13,Terengganu,79,15,64,2016
2016-02-14,Terengganu,97,37,60,2016
2016-02-15,Terengganu,4,1,3,2016
2016-02-16,Terengganu,21,6,15,2016
2016-02-17,Terengganu,98,38,60,2016
2016-02-18,Terengganu,23,3,20,2016
2016-02-19,Terengganu,0,0,0,2016
2016-02-20,Terengganu,10,2,8,2016
2016-02-21,Terengganu,46,12,34,2016
2016-02-22,Terengganu,63,18,45,2016
2016-02-23,Terengganu,56,13,43,2016
2016-02-24,Terengganu,123,28,95,2016
2016-02-25,Terengganu,148,54,94,2016
2016-02-26,Terengganu,33,17,16,2016
2016-02-27,Terengganu,40,16,24,2016
2016-02-28,Terengganu,43,21,22,2016
2016-02-29,Terengganu,5,0,5,2016
2016-03-01,Terengganu,26,3,23,2016
2016-03-02,Terengganu,40,11,29,2016
2016-03-03,Terengganu,61,15,46,2016
2016-03-04,Terengganu,0,0,0,2016
2016-03-05,Terengganu,0,0,0,2016
2016-03-06,Terengganu,25,9,16,2016
2016-03-07,Terengganu,66,33,33,2016
2016-03-08,Terengganu,5,1,4,2016
2016-03-09,Terengganu,19,3,16,2016
2016-03-10,Terengganu,23,7,16,2016
2016-03-11,Terengganu,0,0,0,2016
2016-03-12,Terengganu,35,12,23,2016
2016-03-13,Terengganu,31,6,25,2016
2016-03-14,Terengganu,22,4,18,2016
2016-03-15,Terengganu,25,6,19,2016
2016-03-16,Terengganu,72,21,51,2016
2016-03-17,Terengganu,13,5,8,2016
2016-03-18,Terengganu,0,0,0,2016
2016-03-19,Terengganu,58,7,51,2016
2016-03-20,Terengganu,6,0,6,2016
2016-03-21,Terengganu,74,54,20,2016
2016-03-22,Terengganu,90,55,35,2016
2016-03-23,Terengganu,40,21,19,2016
2016-03-24,Terengganu,35,25,10,2016
2016-03-25,Terengganu,25,6,19,2016
2016-03-26,Terengganu,78,19,59,2016
2016-03-27,Terengganu,29,9,20,2016
2016-03-28,Terengganu,86,40,46,2016
2016-03-29,Terengganu,21,4,17,2016
2016-03-30,Terengganu,9,3,6,2016
2016-03-31,Terengganu,254,83,171,2016
2016-04-01,Terengganu,0,0,0,2016
2016-04-02,Terengganu,21,8,13,2016
2016-04-03,Terengganu,43,8,35,2016
2016-04-04,Terengganu,51,23,28,2016
2016-04-05,Terengganu,13,2,11,2016
2016-04-06,Terengganu,36,23,13,2016
2016-04-07,Terengganu,43,14,29,2016
2016-04-08,Terengganu,0,0,0,2016
2016-04-09,Terengganu,71,28,43,2016
2016-04-10,Terengganu,46,12,34,2016
2016-04-11,Terengganu,39,12,27,2016
2016-04-12,Terengganu,69,25,44,2016
2016-04-13,Terengganu,11,1,10,2016
2016-04-14,Terengganu,24,8,16,2016
2016-04-15,Terengganu,38,15,23,2016
2016-04-16,Terengganu,75,68,7,2016
2016-04-17,Terengganu,51,30,21,2016
2016-04-18,Terengganu,12,2,10,2016
2016-04-19,Terengganu,49,12,37,2016
2016-04-20,Terengganu,10,0,10,2016
2016-04-21,Terengganu,4,2,2,2016
2016-04-22,Terengganu,0,0,0,2016
2016-04-23,Terengganu,29,10,19,2016
2016-04-24,Terengganu,40,13,27,2016
2016-04-25,Terengganu,9,0,9,2016
2016-04-26,Terengganu,21,4,17,2016
2016-04-27,Terengganu,90,50,40,2016
2016-04-28,Terengganu,45,11,34,2016
2016-04-29,Terengganu,59,5,54,2016
2016-04-30,Terengganu,75,72,3,2016
2016-05-01,Terengganu,51,46,5,2016
2016-05-02,Terengganu,55,17,38,2016
2016-05-03,Terengganu,24,17,7,2016
2016-05-04,Terengganu,41,13,28,2016
2016-05-05,Terengganu,45,8,37,2016
2016-05-06,Terengganu,0,0,0,2016
2016-05-07,Terengganu,27,10,17,2016
2016-05-08,Terengganu,9,0,9,2016
2016-05-09,Terengganu,80,60,20,2016
2016-05-10,Terengganu,6,0,6,2016
2016-05-11,Terengganu,27,17,10,2016
2016-05-12,Terengganu,47,18,29,2016
2016-05-13,Terengganu,37,15,22,2016
2016-05-14,Terengganu,0,0,0,2016
2016-05-15,Terengganu,44,11,33,2016
2016-05-16,Terengganu,4,0,4,2016
2016-05-17,Terengganu,94,47,47,2016
2016-05-18,Terengganu,59,30,29,2016
2016-05-19,Terengganu,91,34,57,2016
2016-05-20,Terengganu,11,3,8,2016
2016-05-21,Terengganu,0,0,0,2016
2016-05-22,Terengganu,24,5,19,2016
2016-05-23,Terengganu,65,15,50,2016
2016-05-24,Terengganu,75,15,60,2016
2016-05-25,Terengganu,50,11,39,2016
2016-05-26,Terengganu,35,14,21,2016
2016-05-27,Terengganu,0,0,0,2016
2016-05-28,Terengganu,12,6,6,2016
2016-05-29,Terengganu,46,6,40,2016
2016-05-30,Terengganu,89,66,23,2016
2016-05-31,Terengganu,71,49,22,2016
2016-06-01,Terengganu,14,0,14,2016
2016-06-02,Terengganu,78,23,55,2016
2016-06-03,Terengganu,78,6,72,2016
2016-06-04,Terengganu,19,5,14,2016
2016-06-05,Terengganu,19,3,16,2016
2016-06-06,Terengganu,5,0,5,2016
2016-06-07,Terengganu,0,0,0,2016
2016-06-08,Terengganu,45,12,33,2016
2016-06-09,Terengganu,30,14,16,2016
2016-06-10,Terengganu,48,13,35,2016
2016-06-11,Terengganu,22,4,18,2016
2016-06-12,Terengganu,10,0,10,2016
2016-06-13,Terengganu,26,8,18,2016
2016-06-14,Terengganu,54,19,35,2016
2016-06-15,Terengganu,36,14,22,2016
2016-06-16,Terengganu,1,0,1,2016
2016-06-17,Terengganu,227,73,154,2016
2016-06-18,Terengganu,0,0,0,2016
2016-06-19,Terengganu,47,12,35,2016
2016-06-20,Terengganu,50,11,39,2016
2016-06-21,Terengganu,108,29,79,2016
2016-06-22,Terengganu,0,0,0,2016
2016-06-23,Terengganu,0,0,0,2016
2016-06-24,Terengganu,126,27,99,2016
2016-06-25,Terengganu,0,0,0,2016
2016-06-26,Terengganu,25,17,8,2016
2016-06-27,Terengganu,31,4,27,2016
2016-06-28,Terengganu,2,0,2,2016
2016-06-29,Terengganu,55,37,18,2016
2016-06-30,Terengganu,112,18,94,2016
2016-07-01,Terengganu,46,15,31,2016
2016-07-02,Terengganu,20,8,12,2016
2016-07-03,Terengganu,32,10,22,2016
2016-07-04,Terengganu,39,11,28,2016
2016-07-05,Terengganu,4,0,4,2016
2016-07-06,Terengganu,0,0,0,2016
2016-07-07,Terengganu,0,0,0,2016
2016-07-08,Terengganu,21,11,10,2016
2016-07-09,Terengganu,29,7,22,2016
2016-07-10,Terengganu,20,7,13,2016
2016-07-11,Terengganu,21,4,17,2016
2016-07-12,Terengganu,73,56,17,2016
2016-07-13,Terengganu,77,31,46,2016
2016-07-14,Terengganu,22,1,21,2016
2016-07-15,Terengganu,25,10,15,2016
2016-07-16,Terengganu,0,0,0,2016
2016-07-17,Terengganu,69,52,17,2016
2016-07-18,Terengganu,11,1,10,2016
2016-07-19,Terengganu,10,0,10,2016
2016-07-20,Terengganu,75,22,53,2016
2016-07-21,Terengganu,125,63,62,2016
2016-07-22,Terengganu,92,20,72,2016
2016-07-23,Terengganu,45,23,22,2016
2016-07-24,Terengganu,42,12,30,2016
2016-07-25,Terengganu,12,2,10,2016
2016-07-26,Terengganu,231,104,127,2016
2016-07-27,Terengganu,73,25,48,2016
2016-07-28,Terengganu,34,13,21,2016
2016-07-29,Terengganu,0,0,0,2016
2016-07-30,Terengganu,0,0,0,2016
2016-07-31,Terengganu,38,16,22,2016
2016-08-01,Terengganu,39,14,25,2016
2016-08-02,Terengganu,57,27,30,2016
2016-08-03,Terengganu,48,12,36,2016
2016-08-04,Terengganu,32,10,22,2016
2016-08-05,Terengganu,0,0,0,2016
2016-08-06,Terengganu,30,13,17,2016
2016-08-07,Terengganu,84,21,63,2016
2016-08-08,Terengganu,11,0,11,2016
2016-08-09,Terengganu,101,70,31,2016
2016-08-10,Terengganu,82,30,52,2016
2016-08-11,Terengganu,72,48,24,2016
2016-08-12,Terengganu,0,0,0,2016
2016-08-13,Terengganu,39,13,26,2016
2016-08-14,Terengganu,4,0,4,2016
2016-08-15,Terengganu,45,33,12,2016
2016-08-16,Terengganu,11,2,9,2016
2016-08-17,Terengganu,23,4,19,2016
2016-08-18,Terengganu,10,0,10,2016
2016-08-19,Terengganu,66,21,45,2016
2016-08-20,Terengganu,72,26,46,2016
2016-08-21,Terengganu,51,29,22,2016
2016-08-22,Terengganu,92,66,26,2016
2016-08-23,Terengganu,64,38,26,2016
2016-08-24,Terengganu,14,1,13,2016
2016-08-25,Terengganu,25,20,5,2016
2016-08-26,Terengganu,0,0,0,2016
2016-08-27,Terengganu,0,0,0,2016
2016-08-28,Terengganu,142,72,70,2016
2016-08-29,Terengganu,150,86,64,2016
2016-08-30,Terengganu,75,49,26,2016
2016-08-31,Terengganu,0,0,0,2016
2016-09-01,Terengganu,25,2,23,2016
2016-09-02,Terengganu,0,0,0,2016
2016-09-03,Terengganu,112,28,84,2016
2016-09-04,Terengganu,58,40,18,2016
2016-09-05,Terengganu,69,33,36,2016
2016-09-06,Terengganu,43,17,26,2016
2016-09-07,Terengganu,70,36,34,2016
2016-09-08,Terengganu,98,57,41,2016
2016-09-09,Terengganu,0,0,0,2016
2016-09-10,Terengganu,0,0,0,2016
2016-09-11,Terengganu,29,2,27,2016
2016-09-12,Terengganu,0,0,0,2016
2016-09-13,Terengganu,0,0,0,2016
2016-09-14,Terengganu,29,5,24,2016
2016-09-15,Terengganu,41,7,34,2016
2016-09-16,Terengganu,0,0,0,2016
2016-09-17,Terengganu,0,0,0,2016
2016-09-18,Terengganu,84,13,71,2016
2016-09-19,Terengganu,15,1,14,2016
2016-09-20,Terengganu,70,34,36,2016
2016-09-21,Terengganu,32,3,29,2016
2016-09-22,Terengganu,50,16,34,2016
2016-09-23,Terengganu,0,0,0,2016
2016-09-24,Terengganu,30,20,10,2016
2016-09-25,Terengganu,100,44,56,2016
2016-09-26,Terengganu,74,37,37,2016
2016-09-27,Terengganu,169,53,116,2016
2016-09-28,Terengganu,175,67,108,2016
2016-09-29,Terengganu,142,57,85,2016
2016-09-30,Terengganu,35,8,27,2016
2016-10-01,Terengganu,53,36,17,2016
2016-10-02,Terengganu,0,0,0,2016
2016-10-03,Terengganu,6,0,6,2016
2016-10-04,Terengganu,145,59,86,2016
2016-10-05,Terengganu,62,33,29,2016
2016-10-06,Terengganu,41,28,13,2016
2016-10-07,Terengganu,0,0,0,2016
2016-10-08,Terengganu,0,0,0,2016
2016-10-09,Terengganu,15,1,14,2016
2016-10-10,Terengganu,136,32,104,2016
2016-10-11,Terengganu,7,0,7,2016
2016-10-12,Terengganu,26,13,13,2016
2016-10-13,Terengganu,15,2,13,2016
2016-10-14,Terengganu,0,0,0,2016
2016-10-15,Terengganu,55,7,48,2016
2016-10-16,Terengganu,7,0,7,2016
2016-10-17,Terengganu,5,0,5,2016
2016-10-18,Terengganu,71,28,43,2016
2016-10-19,Terengganu,11,0,11,2016
2016-10-20,Terengganu,70,44,26,2016
2016-10-21,Terengganu,0,0,0,2016
2016-10-22,Terengganu,34,10,24,2016
2016-10-23,Terengganu,14,4,10,2016
2016-10-24,Terengganu,105,58,47,2016
2016-10-25,Terengganu,9,1,8,2016
2016-10-26,Terengganu,21,2,19,2016
2016-10-27,Terengganu,8,2,6,2016
2016-10-28,Terengganu,0,0,0,2016
2016-10-29,Terengganu,28,10,18,2016
2016-10-30,Terengganu,0,0,0,2016
2016-10-31,Terengganu,19,0,19,2016
2016-11-01,Terengganu,15,3,12,2016
2016-11-02,Terengganu,56,12,44,2016
2016-11-03,Terengganu,68,11,57,2016
2016-11-04,Terengganu,0,0,0,2016
2016-11-05,Terengganu,79,28,51,2016
2016-11-06,Terengganu,43,14,29,2016
2016-11-07,Terengganu,83,35,48,2016
2016-11-08,Terengganu,9,0,9,2016
2016-11-09,Terengganu,34,10,24,2016
2016-11-10,Terengganu,40,11,29,2016
2016-11-11,Terengganu,7,1,6,2016
2016-11-12,Terengganu,16,4,12,2016
2016-11-13,Terengganu,25,5,20,2016
2016-11-14,Terengganu,11,1,10,2016
2016-11-15,Terengganu,16,9,7,2016
2016-11-16,Terengganu,46,9,37,2016
2016-11-17,Terengganu,74,23,51,2016
2016-11-18,Terengganu,0,0,0,2016
2016-11-19,Terengganu,23,6,17,2016
2016-11-20,Terengganu,20,4,16,2016
2016-11-21,Terengganu,30,10,20,2016
2016-11-22,Terengganu,19,9,10,2016
2016-11-23,Terengganu,40,14,26,2016
2016-11-24,Terengganu,39,8,31,2016
2016-11-25,Terengganu,0,0,0,2016
2016-11-26,Terengganu,50,22,28,2016
2016-11-27,Terengganu,89,35,54,2016
2016-11-28,Terengganu,12,3,9,2016
2016-11-29,Terengganu,34,21,13,2016
2016-11-30,Terengganu,32,8,24,2016
2016-12-01,Terengganu,137,83,54,2016
2016-12-02,Terengganu,64,23,41,2016
2016-12-03,Terengganu,0,0,0,2016
2016-12-04,Terengganu,16,4,12,2016
2016-12-05,Terengganu,67,38,29,2016
2016-12-06,Terengganu,25,10,15,2016
2016-12-07,Terengganu,43,23,20,2016
2016-12-08,Terengganu,21,5,16,2016
2016-12-09,Terengganu,0,0,0,2016
2016-12-10,Terengganu,0,0,0,2016
2016-12-11,Terengganu,18,0,18,2016
2016-12-12,Terengganu,0,0,0,2016
2016-12-13,Terengganu,86,26,60,2016
2016-12-14,Terengganu,68,22,46,2016
2016-12-15,Terengganu,10,0,10,2016
2016-12-16,Terengganu,0,0,0,2016
2016-12-17,Terengganu,11,3,8,2016
2016-12-18,Terengganu,8,1,7,2016
2016-12-19,Terengganu,106,38,68,2016
2016-12-20,Terengganu,172,86,86,2016
2016-12-21,Terengganu,52,8,44,2016
2016-12-22,Terengganu,10,1,9,2016
2016-12-23,Terengganu,0,0,0,2016
2016-12-24,Terengganu,49,21,28,2016
2016-12-25,Terengganu,0,0,0,2016
2016-12-26,Terengganu,34,3,31,2016
2016-12-27,Terengganu,1,1,0,2016
2016-12-28,Terengganu,64,23,41,2016
2016-12-29,Terengganu,80,26,54,2016
2016-12-30,Terengganu,0,0,0,2016
2016-12-31,Terengganu,0,0,0,2016
2017-01-01,Terengganu,32,8,24,2017
2017-01-02,Terengganu,55,13,42,2017
2017-01-03,Terengganu,30,2,28,2017
2017-01-04,Terengganu,15,10,5,2017
2017-01-05,Terengganu,32,9,23,2017
2017-01-06,Terengganu,0,0,0,2017
2017-01-07,Terengganu,0,0,0,2017
2017-01-08,Terengganu,40,23,17,2017
2017-01-09,Terengganu,8,0,8,2017
2017-01-10,Terengganu,59,25,34,2017
2017-01-11,Terengganu,29,7,22,2017
2017-01-12,Terengganu,42,28,14,2017
2017-01-13,Terengganu,54,25,29,2017
2017-01-14,Terengganu,44,18,26,2017
2017-01-15,Terengganu,34,7,27,2017
2017-01-16,Terengganu,201,95,106,2017
2017-01-17,Terengganu,29,11,18,2017
2017-01-18,Terengganu,28,4,24,2017
2017-01-19,Terengganu,108,43,65,2017
2017-01-20,Terengganu,68,16,52,2017
2017-01-21,Terengganu,0,0,0,2017
2017-01-22,Terengganu,9,1,8,2017
2017-01-23,Terengganu,12,0,12,2017
2017-01-24,Terengganu,57,28,29,2017
2017-01-25,Terengganu,12,1,11,2017
2017-01-26,Terengganu,71,32,39,2017
2017-01-27,Terengganu,39,16,23,2017
2017-01-28,Terengganu,0,0,0,2017
2017-01-29,Terengganu,0,0,0,2017
2017-01-30,Terengganu,0,0,0,2017
2017-01-31,Terengganu,44,5,39,2017
2017-02-01,Terengganu,137,29,108,2017
2017-02-02,Terengganu,31,16,15,2017
2017-02-03,Terengganu,0,0,0,2017
2017-02-04,Terengganu,0,0,0,2017
2017-02-05,Terengganu,24,0,24,2017
2017-02-06,Terengganu,101,61,40,2017
2017-02-07,Terengganu,80,35,45,2017
2017-02-08,Terengganu,127,94,33,2017
2017-02-09,Terengganu,28,17,11,2017
2017-02-10,Terengganu,0,0,0,2017
2017-02-11,Terengganu,0,0,0,2017
2017-02-12,Terengganu,151,48,103,2017
2017-02-13,Terengganu,91,23,68,2017
2017-02-14,Terengganu,81,26,55,2017
2017-02-15,Terengganu,68,16,52,2017
2017-02-16,Terengganu,33,6,27,2017
2017-02-17,Terengganu,0,0,0,2017
2017-02-18,Terengganu,0,0,0,2017
2017-02-19,Terengganu,75,12,63,2017
2017-02-20,Terengganu,14,1,13,2017
2017-02-21,Terengganu,131,36,95,2017
2017-02-22,Terengganu,140,46,94,2017
2017-02-23,Terengganu,5,0,5,2017
2017-02-24,Terengganu,0,0,0,2017
2017-02-25,Terengganu,32,7,25,2017
2017-02-26,Terengganu,99,53,46,2017
2017-02-27,Terengganu,29,2,27,2017
2017-02-28,Terengganu,77,24,53,2017
2017-03-01,Terengganu,86,42,44,2017
2017-03-02,Terengganu,35,27,8,2017
2017-03-03,Terengganu,0,0,0,2017
2017-03-04,Terengganu,0,0,0,2017
2017-03-05,Terengganu,0,0,0,2017
2017-03-06,Terengganu,36,6,30,2017
2017-03-07,Terengganu,73,50,23,2017
2017-03-08,Terengganu,16,3,13,2017
2017-03-09,Terengganu,34,9,25,2017
2017-03-10,Terengganu,0,0,0,2017
2017-03-11,Terengganu,53,2,51,2017
2017-03-12,Terengganu,33,2,31,2017
2017-03-13,Terengganu,6,0,6,2017
2017-03-14,Terengganu,49,24,25,2017
2017-03-15,Terengganu,13,2,11,2017
2017-03-16,Terengganu,32,7,25,2017
2017-03-17,Terengganu,50,14,36,2017
2017-03-18,Terengganu,0,0,0,2017
2017-03-19,Terengganu,8,0,8,2017
2017-03-20,Terengganu,104,39,65,2017
2017-03-21,Terengganu,13,1,12,2017
2017-03-22,Terengganu,69,29,40,2017
2017-03-23,Terengganu,12,2,10,2017
2017-03-24,Terengganu,0,0,0,2017
2017-03-25,Terengganu,84,28,56,2017
2017-03-26,Terengganu,27,2,25,2017
2017-03-27,Terengganu,17,2,15,2017
2017-03-28,Terengganu,95,34,61,2017
2017-03-29,Terengganu,46,26,20,2017
2017-03-30,Terengganu,9,1,8,2017
2017-03-31,Terengganu,32,6,26,2017
2017-04-01,Terengganu,0,0,0,2017
2017-04-02,Terengganu,19,3,16,2017
2017-04-03,Terengganu,32,9,23,2017
2017-04-04,Terengganu,70,17,53,2017
2017-04-05,Terengganu,65,40,25,2017
2017-04-06,Terengganu,27,4,23,2017
2017-04-07,Terengganu,36,17,19,2017
2017-04-08,Terengganu,46,17,29,2017
2017-04-09,Terengganu,71,30,41,2017
2017-04-10,Terengganu,73,23,50,2017
2017-04-11,Terengganu,44,16,28,2017
2017-04-12,Terengganu,50,34,16,2017
2017-04-13,Terengganu,56,16,40,2017
2017-04-14,Terengganu,0,0,0,2017
2017-04-15,Terengganu,0,0,0,2017
2017-04-16,Terengganu,6,0,6,2017
2017-04-17,Terengganu,21,4,17,2017
2017-04-18,Terengganu,28,14,14,2017
2017-04-19,Terengganu,5,0,5,2017
2017-04-20,Terengganu,164,132,32,2017
2017-04-21,Terengganu,0,0,0,2017
2017-04-22,Terengganu,56,20,36,2017
2017-04-23,Terengganu,15,1,14,2017
2017-04-24,Terengganu,0,0,0,2017
2017-04-25,Terengganu,50,13,37,2017
2017-04-26,Terengganu,0,0,0,2017
2017-04-27,Terengganu,32,19,13,2017
2017-04-28,Terengganu,55,18,37,2017
2017-04-29,Terengganu,0,0,0,2017
2017-04-30,Terengganu,6,1,5,2017
2017-05-01,Terengganu,60,17,43,2017
2017-05-02,Terengganu,9,0,9,2017
2017-05-03,Terengganu,10,0,10,2017
2017-05-04,Terengganu,200,36,164,2017
2017-05-05,Terengganu,0,0,0,2017
2017-05-06,Terengganu,0,0,0,2017
2017-05-07,Terengganu,75,25,50,2017
2017-05-08,Terengganu,49,27,22,2017
2017-05-09,Terengganu,29,10,19,2017
2017-05-10,Terengganu,75,70,5,2017
2017-05-11,Terengganu,115,31,84,2017
2017-05-12,Terengganu,11,4,7,2017
2017-05-13,Terengganu,15,1,14,2017
2017-05-14,Terengganu,13,2,11,2017
2017-05-15,Terengganu,75,25,50,2017
2017-05-16,Terengganu,68,6,62,2017
2017-05-17,Terengganu,113,50,63,2017
2017-05-18,Terengganu,6,0,6,2017
2017-05-19,Terengganu,98,19,79,2017
2017-05-20,Terengganu,125,42,83,2017
2017-05-21,Terengganu,168,60,108,2017
2017-05-22,Terengganu,77,38,39,2017
2017-05-23,Terengganu,58,21,37,2017
2017-05-24,Terengganu,76,38,38,2017
2017-05-25,Terengganu,150,57,93,2017
2017-05-26,Terengganu,0,0,0,2017
2017-05-27,Terengganu,0,0,0,2017
2017-05-28,Terengganu,1,1,0,2017
2017-05-29,Terengganu,47,12,35,2017
2017-05-30,Terengganu,40,14,26,2017
2017-05-31,Terengganu,27,6,21,2017
2017-06-01,Terengganu,6,0,6,2017
2017-06-02,Terengganu,39,16,23,2017
2017-06-03,Terengganu,62,23,39,2017
2017-06-04,Terengganu,55,10,45,2017
2017-06-05,Terengganu,69,19,50,2017
2017-06-06,Terengganu,94,31,63,2017
2017-06-07,Terengganu,1,0,1,2017
2017-06-08,Terengganu,5,0,5,2017
2017-06-09,Terengganu,70,8,62,2017
2017-06-10,Terengganu,40,13,27,2017
2017-06-11,Terengganu,100,21,79,2017
2017-06-12,Terengganu,145,71,74,2017
2017-06-13,Terengganu,39,17,22,2017
2017-06-14,Terengganu,37,10,27,2017
2017-06-15,Terengganu,33,10,23,2017
2017-06-16,Terengganu,100,21,79,2017
2017-06-17,Terengganu,85,19,66,2017
2017-06-18,Terengganu,38,28,10,2017
2017-06-19,Terengganu,37,4,33,2017
2017-06-20,Terengganu,33,12,21,2017
2017-06-21,Terengganu,4,0,4,2017
2017-06-22,Terengganu,70,6,64,2017
2017-06-23,Terengganu,60,16,44,2017
2017-06-24,Terengganu,0,0,0,2017
2017-06-25,Terengganu,0,0,0,2017
2017-06-26,Terengganu,0,0,0,2017
2017-06-27,Terengganu,21,9,12,2017
2017-06-28,Terengganu,13,2,11,2017
2017-06-29,Terengganu,53,15,38,2017
2017-06-30,Terengganu,0,0,0,2017
2017-07-01,Terengganu,21,11,10,2017
2017-07-02,Terengganu,41,13,28,2017
2017-07-03,Terengganu,42,19,23,2017
2017-07-04,Terengganu,13,1,12,2017
2017-07-05,Terengganu,25,9,16,2017
2017-07-06,Terengganu,15,11,4,2017
2017-07-07,Terengganu,21,7,14,2017
2017-07-08,Terengganu,0,0,0,2017
2017-07-09,Terengganu,77,42,35,2017
2017-07-10,Terengganu,11,1,10,2017
2017-07-11,Terengganu,63,33,30,2017
2017-07-12,Terengganu,29,8,21,2017
2017-07-13,Terengganu,77,19,58,2017
2017-07-14,Terengganu,33,13,20,2017
2017-07-15,Terengganu,17,5,12,2017
2017-07-16,Terengganu,40,14,26,2017
2017-07-17,Terengganu,12,1,11,2017
2017-07-18,Terengganu,175,91,84,2017
2017-07-19,Terengganu,171,103,68,2017
2017-07-20,Terengganu,11,0,11,2017
2017-07-21,Terengganu,79,43,36,2017
2017-07-22,Terengganu,0,0,0,2017
2017-07-23,Terengganu,11,2,9,2017
2017-07-24,Terengganu,122,41,81,2017
2017-07-25,Terengganu,40,21,19,2017
2017-07-26,Terengganu,15,1,14,2017
2017-07-27,Terengganu,96,23,73,2017
2017-07-28,Terengganu,16,4,12,2017
2017-07-29,Terengganu,34,9,25,2017
2017-07-30,Terengganu,11,3,8,2017
2017-07-31,Terengganu,40,16,24,2017
2017-08-01,Terengganu,115,54,61,2017
2017-08-02,Terengganu,58,23,35,2017
2017-08-03,Terengganu,174,150,24,2017
2017-08-04,Terengganu,0,0,0,2017
2017-08-05,Terengganu,40,19,21,2017
2017-08-06,Terengganu,12,0,12,2017
2017-08-07,Terengganu,54,23,31,2017
2017-08-08,Terengganu,65,33,32,2017
2017-08-09,Terengganu,3,0,3,2017
2017-08-10,Terengganu,25,7,18,2017
2017-08-11,Terengganu,0,0,0,2017
2017-08-12,Terengganu,34,9,25,2017
2017-08-13,Terengganu,87,59,28,2017
2017-08-14,Terengganu,9,1,8,2017
2017-08-15,Terengganu,53,15,38,2017
2017-08-16,Terengganu,64,21,43,2017
2017-08-17,Terengganu,76,51,25,2017
2017-08-18,Terengganu,98,22,76,2017
2017-08-19,Terengganu,39,18,21,2017
2017-08-20,Terengganu,25,8,17,2017
2017-08-21,Terengganu,48,29,19,2017
2017-08-22,Terengganu,96,40,56,2017
2017-08-23,Terengganu,17,1,16,2017
2017-08-24,Terengganu,0,0,0,2017
2017-08-25,Terengganu,0,0,0,2017
2017-08-26,Terengganu,22,3,19,2017
2017-08-27,Terengganu,13,0,13,2017
2017-08-28,Terengganu,8,1,7,2017
2017-08-29,Terengganu,221,57,164,2017
2017-08-30,Terengganu,46,12,34,2017
2017-08-31,Terengganu,0,0,0,2017
2017-09-01,Terengganu,0,0,0,2017
2017-09-02,Terengganu,0,0,0,2017
2017-09-03,Terengganu,37,5,32,2017
2017-09-04,Terengganu,0,0,0,2017
2017-09-05,Terengganu,67,29,38,2017
2017-09-06,Terengganu,13,1,12,2017
2017-09-07,Terengganu,49,30,19,2017
2017-09-08,Terengganu,0,0,0,2017
2017-09-09,Terengganu,23,7,16,2017
2017-09-10,Terengganu,0,0,0,2017
2017-09-11,Terengganu,13,1,12,2017
2017-09-12,Terengganu,51,17,34,2017
2017-09-13,Terengganu,48,21,27,2017
2017-09-14,Terengganu,38,7,31,2017
2017-09-15,Terengganu,0,0,0,2017
2017-09-16,Terengganu,17,7,10,2017
2017-09-17,Terengganu,0,0,0,2017
2017-09-18,Terengganu,50,12,38,2017
2017-09-19,Terengganu,101,27,74,2017
2017-09-20,Terengganu,105,31,74,2017
2017-09-21,Terengganu,60,18,42,2017
2017-09-22,Terengganu,0,0,0,2017
2017-09-23,Terengganu,53,17,36,2017
2017-09-24,Terengganu,62,30,32,2017
2017-09-25,Terengganu,19,1,18,2017
2017-09-26,Terengganu,75,27,48,2017
2017-09-27,Terengganu,31,2,29,2017
2017-09-28,Terengganu,43,15,28,2017
2017-09-29,Terengganu,44,11,33,2017
2017-09-30,Terengganu,64,22,42,2017
2017-10-01,Terengganu,18,1,17,2017
2017-10-02,Terengganu,93,49,44,2017
2017-10-03,Terengganu,94,60,34,2017
2017-10-04,Terengganu,11,1,10,2017
2017-10-05,Terengganu,91,48,43,2017
2017-10-06,Terengganu,0,0,0,2017
2017-10-07,Terengganu,115,82,33,2017
2017-10-08,Terengganu,19,5,14,2017
2017-10-09,Terengganu,12,1,11,2017
2017-10-10,Terengganu,68,39,29,2017
2017-10-11,Terengganu,9,0,9,2017
2017-10-12,Terengganu,6,0,6,2017
2017-10-13,Terengganu,81,27,54,2017
2017-10-14,Terengganu,48,3,45,2017
2017-10-15,Terengganu,7,0,7,2017
2017-10-16,Terengganu,53,20,33,2017
2017-10-17,Terengganu,83,26,57,2017
2017-10-18,Terengganu,0,0,0,2017
2017-10-19,Terengganu,37,6,31,2017
2017-10-20,Terengganu,14,0,14,2017
2017-10-21,Terengganu,68,34,34,2017
2017-10-22,Terengganu,6,0,6,2017
2017-10-23,Terengganu,10,1,9,2017
2017-10-24,Terengganu,126,53,73,2017
2017-10-25,Terengganu,149,52,97,2017
2017-10-26,Terengganu,33,16,17,2017
2017-10-27,Terengganu,0,0,0,2017
2017-10-28,Terengganu,27,5,22,2017
2017-10-29,Terengganu,13,1,12,2017
2017-10-30,Terengganu,12,5,7,2017
2017-10-31,Terengganu,26,6,20,2017
2017-11-01,Terengganu,59,23,36,2017
2017-11-02,Terengganu,58,5,53,2017
2017-11-03,Terengganu,0,0,0,2017
2017-11-04,Terengganu,48,26,22,2017
2017-11-05,Terengganu,29,2,27,2017
2017-11-06,Terengganu,64,31,33,2017
2017-11-07,Terengganu,14,2,12,2017
2017-11-08,Terengganu,29,9,20,2017
2017-11-09,Terengganu,92,18,74,2017
2017-11-10,Terengganu,21,4,17,2017
2017-11-11,Terengganu,32,13,19,2017
2017-11-12,Terengganu,10,0,10,2017
2017-11-13,Terengganu,31,9,22,2017
2017-11-14,Terengganu,99,29,70,2017
2017-11-15,Terengganu,47,28,19,2017
2017-11-16,Terengganu,40,12,28,2017
2017-11-17,Terengganu,40,18,22,2017
2017-11-18,Terengganu,21,11,10,2017
2017-11-19,Terengganu,22,1,21,2017
2017-11-20,Terengganu,81,33,48,2017
2017-11-21,Terengganu,89,46,43,2017
2017-11-22,Terengganu,96,38,58,2017
2017-11-23,Terengganu,59,27,32,2017
2017-11-24,Terengganu,0,0,0,2017
2017-11-25,Terengganu,40,12,28,2017
2017-11-26,Terengganu,10,0,10,2017
2017-11-27,Terengganu,60,18,42,2017
2017-11-28,Terengganu,13,4,9,2017
2017-11-29,Terengganu,29,6,23,2017
2017-11-30,Terengganu,45,7,38,2017
2017-12-01,Terengganu,0,0,0,2017
2017-12-02,Terengganu,22,2,20,2017
2017-12-03,Terengganu,77,10,67,2017
2017-12-04,Terengganu,46,26,20,2017
2017-12-05,Terengganu,48,13,35,2017
2017-12-06,Terengganu,136,62,74,2017
2017-12-07,Terengganu,109,44,65,2017
2017-12-08,Terengganu,0,0,0,2017
2017-12-09,Terengganu,32,25,7,2017
2017-12-10,Terengganu,29,9,20,2017
2017-12-11,Terengganu,84,29,55,2017
2017-12-12,Terengganu,92,38,54,2017
2017-12-13,Terengganu,101,40,61,2017
2017-12-14,Terengganu,7,0,7,2017
2017-12-15,Terengganu,51,9,42,2017
2017-12-16,Terengganu,0,0,0,2017
2017-12-17,Terengganu,13,1,12,2017
2017-12-18,Terengganu,34,13,21,2017
2017-12-19,Terengganu,59,23,36,2017
2017-12-20,Terengganu,74,32,42,2017
2017-12-21,Terengganu,12,0,12,2017
2017-12-22,Terengganu,20,5,15,2017
2017-12-23,Terengganu,0,0,0,2017
2017-12-24,Terengganu,38,7,31,2017
2017-12-25,Terengganu,0,0,0,2017
2017-12-26,Terengganu,32,7,25,2017
2017-12-27,Terengganu,34,11,23,2017
2017-12-28,Terengganu,46,19,27,2017
2017-12-29,Terengganu,23,6,17,2017
2017-12-30,Terengganu,53,16,37,2017
2017-12-31,Terengganu,18,0,18,2017
2018-01-01,Terengganu,34,5,29,2018
2018-01-02,Terengganu,181,99,82,2018
2018-01-03,Terengganu,158,92,66,2018
2018-01-04,Terengganu,7,0,7,2018
2018-01-05,Terengganu,0,0,0,2018
2018-01-06,Terengganu,56,16,40,2018
2018-01-07,Terengganu,10,1,9,2018
2018-01-08,Terengganu,26,9,17,2018
2018-01-09,Terengganu,82,24,58,2018
2018-01-10,Terengganu,33,14,19,2018
2018-01-11,Terengganu,34,14,20,2018
2018-01-12,Terengganu,91,20,71,2018
2018-01-13,Terengganu,28,7,21,2018
2018-01-14,Terengganu,37,5,32,2018
2018-01-15,Terengganu,47,22,25,2018
2018-01-16,Terengganu,5,0,5,2018
2018-01-17,Terengganu,114,45,69,2018
2018-01-18,Terengganu,83,34,49,2018
2018-01-19,Terengganu,43,10,33,2018
2018-01-20,Terengganu,34,10,24,2018
2018-01-21,Terengganu,90,49,41,2018
2018-01-22,Terengganu,3,0,3,2018
2018-01-23,Terengganu,5,2,3,2018
2018-01-24,Terengganu,55,22,33,2018
2018-01-25,Terengganu,37,6,31,2018
2018-01-26,Terengganu,59,27,32,2018
2018-01-27,Terengganu,54,34,20,2018
2018-01-28,Terengganu,137,71,66,2018
2018-01-29,Terengganu,6,0,6,2018
2018-01-30,Terengganu,149,76,73,2018
2018-01-31,Terengganu,140,94,46,2018
2018-02-01,Terengganu,43,29,14,2018
2018-02-02,Terengganu,38,18,20,2018
2018-02-03,Terengganu,108,46,62,2018
2018-02-04,Terengganu,92,28,64,2018
2018-02-05,Terengganu,70,34,36,2018
2018-02-06,Terengganu,106,40,66,2018
2018-02-07,Terengganu,44,30,14,2018
2018-02-08,Terengganu,13,3,10,2018
2018-02-09,Terengganu,75,22,53,2018
2018-02-10,Terengganu,47,12,35,2018
2018-02-11,Terengganu,132,30,102,2018
2018-02-12,Terengganu,13,1,12,2018
2018-02-13,Terengganu,15,1,14,2018
2018-02-14,Terengganu,90,52,38,2018
2018-02-15,Terengganu,44,13,31,2018
2018-02-16,Terengganu,0,0,0,2018
2018-02-17,Terengganu,0,0,0,2018
2018-02-18,Terengganu,0,0,0,2018
2018-02-19,Terengganu,20,1,19,2018
2018-02-20,Terengganu,60,21,39,2018
2018-02-21,Terengganu,19,4,15,2018
2018-02-22,Terengganu,5,0,5,2018
2018-02-23,Terengganu,55,49,6,2018
2018-02-24,Terengganu,59,25,34,2018
2018-02-25,Terengganu,5,0,5,2018
2018-02-26,Terengganu,68,33,35,2018
2018-02-27,Terengganu,8,0,8,2018
2018-02-28,Terengganu,54,10,44,2018
2018-03-01,Terengganu,45,8,37,2018
2018-03-02,Terengganu,77,15,62,2018
2018-03-03,Terengganu,0,0,0,2018
2018-03-04,Terengganu,0,0,0,2018
2018-03-05,Terengganu,17,0,17,2018
2018-03-06,Terengganu,94,58,36,2018
2018-03-07,Terengganu,31,9,22,2018
2018-03-08,Terengganu,80,33,47,2018
2018-03-09,Terengganu,24,11,13,2018
2018-03-10,Terengganu,54,18,36,2018
2018-03-11,Terengganu,26,7,19,2018
2018-03-12,Terengganu,18,1,17,2018
2018-03-13,Terengganu,64,48,16,2018
2018-03-14,Terengganu,42,12,30,2018
2018-03-15,Terengganu,46,15,31,2018
2018-03-16,Terengganu,0,0,0,2018
2018-03-17,Terengganu,72,7,65,2018
2018-03-18,Terengganu,41,6,35,2018
2018-03-19,Terengganu,81,39,42,2018
2018-03-20,Terengganu,162,39,123,2018
2018-03-21,Terengganu,192,63,129,2018
2018-03-22,Terengganu,26,10,16,2018
2018-03-23,Terengganu,0,0,0,2018
2018-03-24,Terengganu,36,13,23,2018
2018-03-25,Terengganu,15,0,15,2018
2018-03-26,Terengganu,6,2,4,2018
2018-03-27,Terengganu,30,9,21,2018
2018-03-28,Terengganu,81,40,41,2018
2018-03-29,Terengganu,51,21,30,2018
2018-03-30,Terengganu,7,2,5,2018
2018-03-31,Terengganu,24,8,16,2018
2018-04-01,Terengganu,3,0,3,2018
2018-04-02,Terengganu,101,76,25,2018
2018-04-03,Terengganu,35,5,30,2018
2018-04-04,Terengganu,9,1,8,2018
2018-04-05,Terengganu,26,3,23,2018
2018-04-06,Terengganu,0,0,0,2018
2018-04-07,Terengganu,32,6,26,2018
2018-04-08,Terengganu,49,21,28,2018
2018-04-09,Terengganu,64,28,36,2018
2018-04-10,Terengganu,52,22,30,2018
2018-04-11,Terengganu,101,33,68,2018
2018-04-12,Terengganu,37,5,32,2018
2018-04-13,Terengganu,0,0,0,2018
2018-04-14,Terengganu,61,15,46,2018
2018-04-15,Terengganu,50,14,36,2018
2018-04-16,Terengganu,66,12,54,2018
2018-04-17,Terengganu,45,12,33,2018
2018-04-18,Terengganu,7,0,7,2018
2018-04-19,Terengganu,50,14,36,2018
2018-04-20,Terengganu,0,0,0,2018
2018-04-21,Terengganu,35,26,9,2018
2018-04-22,Terengganu,52,14,38,2018
2018-04-23,Terengganu,77,29,48,2018
2018-04-24,Terengganu,7,0,7,2018
2018-04-25,Terengganu,71,17,54,2018
2018-04-26,Terengganu,0,0,0,2018
2018-04-27,Terengganu,22,6,16,2018
2018-04-28,Terengganu,40,14,26,2018
2018-04-29,Terengganu,70,38,32,2018
2018-04-30,Terengganu,75,27,48,2018
2018-05-01,Terengganu,107,21,86,2018
2018-05-02,Terengganu,82,25,57,2018
2018-05-03,Terengganu,185,85,100,2018
2018-05-04,Terengganu,67,27,40,2018
2018-05-05,Terengganu,34,16,18,2018
2018-05-06,Terengganu,32,18,14,2018
2018-05-07,Terengganu,90,40,50,2018
2018-05-08,Terengganu,13,0,13,2018
2018-05-09,Terengganu,0,0,0,2018
2018-05-10,Terengganu,26,4,22,2018
2018-05-11,Terengganu,117,35,82,2018
2018-05-12,Terengganu,141,51,90,2018
2018-05-13,Terengganu,12,1,11,2018
2018-05-14,Terengganu,27,2,25,2018
2018-05-15,Terengganu,84,50,34,2018
2018-05-16,Terengganu,124,34,90,2018
2018-05-17,Terengganu,5,0,5,2018
2018-05-18,Terengganu,0,0,0,2018
2018-05-19,Terengganu,49,7,42,2018
2018-05-20,Terengganu,34,7,27,2018
2018-05-21,Terengganu,40,17,23,2018
2018-05-22,Terengganu,80,16,64,2018
2018-05-23,Terengganu,28,9,19,2018
2018-05-24,Terengganu,36,13,23,2018
2018-05-25,Terengganu,50,13,37,2018
2018-05-26,Terengganu,30,6,24,2018
2018-05-27,Terengganu,78,23,55,2018
2018-05-28,Terengganu,58,8,50,2018
2018-05-29,Terengganu,62,20,42,2018
2018-05-30,Terengganu,62,22,40,2018
2018-05-31,Terengganu,44,16,28,2018
2018-06-01,Terengganu,50,10,40,2018
2018-06-02,Terengganu,49,19,30,2018
2018-06-03,Terengganu,77,23,54,2018
2018-06-04,Terengganu,24,3,21,2018
2018-06-05,Terengganu,38,5,33,2018
2018-06-06,Terengganu,13,7,6,2018
2018-06-07,Terengganu,13,7,6,2018
2018-06-08,Terengganu,84,9,75,2018
2018-06-09,Terengganu,65,11,54,2018
2018-06-10,Terengganu,25,5,20,2018
2018-06-11,Terengganu,40,10,30,2018
2018-06-12,Terengganu,39,9,30,2018
2018-06-13,Terengganu,60,2,58,2018
2018-06-14,Terengganu,1,0,1,2018
2018-06-15,Terengganu,0,0,0,2018
2018-06-16,Terengganu,0,0,0,2018
2018-06-17,Terengganu,14,4,10,2018
2018-06-18,Terengganu,4,0,4,2018
2018-06-19,Terengganu,41,10,31,2018
2018-06-20,Terengganu,16,3,13,2018
2018-06-21,Terengganu,26,9,17,2018
2018-06-22,Terengganu,96,15,81,2018
2018-06-23,Terengganu,107,71,36,2018
2018-06-24,Terengganu,34,1,33,2018
2018-06-25,Terengganu,37,24,13,2018
2018-06-26,Terengganu,23,9,14,2018
2018-06-27,Terengganu,57,31,26,2018
2018-06-28,Terengganu,73,10,63,2018
2018-06-29,Terengganu,24,9,15,2018
2018-06-30,Terengganu,7,0,7,2018
2018-07-01,Terengganu,14,0,14,2018
2018-07-02,Terengganu,26,4,22,2018
2018-07-03,Terengganu,65,35,30,2018
2018-07-04,Terengganu,46,20,26,2018
2018-07-05,Terengganu,83,35,48,2018
2018-07-06,Terengganu,0,0,0,2018
2018-07-07,Terengganu,40,13,27,2018
2018-07-08,Terengganu,10,0,10,2018
2018-07-09,Terengganu,53,24,29,2018
2018-07-10,Terengganu,30,2,28,2018
2018-07-11,Terengganu,19,2,17,2018
2018-07-12,Terengganu,216,41,175,2018
2018-07-13,Terengganu,0,0,0,2018
2018-07-14,Terengganu,0,0,0,2018
2018-07-15,Terengganu,95,45,50,2018
2018-07-16,Terengganu,86,45,41,2018
2018-07-17,Terengganu,13,3,10,2018
2018-07-18,Terengganu,161,91,70,2018
2018-07-19,Terengganu,181,107,74,2018
2018-07-20,Terengganu,147,37,110,2018
2018-07-21,Terengganu,10,3,7,2018
2018-07-22,Terengganu,15,1,14,2018
2018-07-23,Terengganu,63,20,43,2018
2018-07-24,Terengganu,53,15,38,2018
2018-07-25,Terengganu,44,13,31,2018
2018-07-26,Terengganu,51,10,41,2018
2018-07-27,Terengganu,19,5,14,2018
2018-07-28,Terengganu,6,1,5,2018
2018-07-29,Terengganu,14,0,14,2018
2018-07-30,Terengganu,69,52,17,2018
2018-07-31,Terengganu,176,110,66,2018
2018-08-01,Terengganu,151,80,71,2018
2018-08-02,Terengganu,6,1,5,2018
2018-08-03,Terengganu,0,0,0,2018
2018-08-04,Terengganu,8,1,7,2018
2018-08-05,Terengganu,94,38,56,2018
2018-08-06,Terengganu,96,57,39,2018
2018-08-07,Terengganu,43,19,24,2018
2018-08-08,Terengganu,12,2,10,2018
2018-08-09,Terengganu,81,55,26,2018
2018-08-10,Terengganu,0,0,0,2018
2018-08-11,Terengganu,107,38,69,2018
2018-08-12,Terengganu,35,19,16,2018
2018-08-13,Terengganu,107,57,50,2018
2018-08-14,Terengganu,66,34,32,2018
2018-08-15,Terengganu,11,0,11,2018
2018-08-16,Terengganu,27,5,22,2018
2018-08-17,Terengganu,0,0,0,2018
2018-08-18,Terengganu,71,23,48,2018
2018-08-19,Terengganu,19,2,17,2018
2018-08-20,Terengganu,6,0,6,2018
2018-08-21,Terengganu,39,14,25,2018
2018-08-22,Terengganu,0,0,0,2018
2018-08-23,Terengganu,0,0,0,2018
2018-08-24,Terengganu,28,5,23,2018
2018-08-25,Terengganu,1,0,1,2018
2018-08-26,Terengganu,82,54,28,2018
2018-08-27,Terengganu,43,24,19,2018
2018-08-28,Terengganu,95,56,39,2018
2018-08-29,Terengganu,13,2,11,2018
2018-08-30,Terengganu,7,1,6,2018
2018-08-31,Terengganu,0,0,0,2018
2018-09-01,Terengganu,29,5,24,2018
2018-09-02,Terengganu,142,117,25,2018
2018-09-03,Terengganu,81,39,42,2018
2018-09-04,Terengganu,78,27,51,2018
2018-09-05,Terengganu,68,24,44,2018
2018-09-06,Terengganu,16,6,10,2018
2018-09-07,Terengganu,0,0,0,2018
2018-09-08,Terengganu,26,11,15,2018
2018-09-09,Terengganu,0,0,0,2018
2018-09-10,Terengganu,47,9,38,2018
2018-09-11,Terengganu,0,0,0,2018
2018-09-12,Terengganu,118,74,44,2018
2018-09-13,Terengganu,71,19,52,2018
2018-09-14,Terengganu,26,0,26,2018
2018-09-15,Terengganu,49,12,37,2018
2018-09-16,Terengganu,72,24,48,2018
2018-09-17,Terengganu,14,3,11,2018
2018-09-18,Terengganu,14,2,12,2018
2018-09-19,Terengganu,79,35,44,2018
2018-09-20,Terengganu,125,96,29,2018
2018-09-21,Terengganu,0,0,0,2018
2018-09-22,Terengganu,0,0,0,2018
2018-09-23,Terengganu,73,24,49,2018
2018-09-24,Terengganu,12,3,9,2018
2018-09-25,Terengganu,74,23,51,2018
2018-09-26,Terengganu,142,43,99,2018
2018-09-27,Terengganu,9,0,9,2018
2018-09-28,Terengganu,0,0,0,2018
2018-09-29,Terengganu,45,18,27,2018
2018-09-30,Terengganu,0,0,0,2018
2018-10-01,Terengganu,64,19,45,2018
2018-10-02,Terengganu,99,33,66,2018
2018-10-03,Terengganu,120,58,62,2018
2018-10-04,Terengganu,31,7,24,2018
2018-10-05,Terengganu,85,13,72,2018
2018-10-06,Terengganu,47,9,38,2018
2018-10-07,Terengganu,7,0,7,2018
2018-10-08,Terengganu,43,32,11,2018
2018-10-09,Terengganu,58,23,35,2018
2018-10-10,Terengganu,62,23,39,2018
2018-10-11,Terengganu,39,7,32,2018
2018-10-12,Terengganu,0,0,0,2018
2018-10-13,Terengganu,61,7,54,2018
2018-10-14,Terengganu,14,2,12,2018
2018-10-15,Terengganu,53,9,44,2018
2018-10-16,Terengganu,15,0,15,2018
2018-10-17,Terengganu,7,0,7,2018
2018-10-18,Terengganu,94,37,57,2018
2018-10-19,Terengganu,22,3,19,2018
2018-10-20,Terengganu,33,10,23,2018
2018-10-21,Terengganu,70,35,35,2018
2018-10-22,Terengganu,116,37,79,2018
2018-10-23,Terengganu,103,34,69,2018
2018-10-24,Terengganu,39,19,20,2018
2018-10-25,Terengganu,87,24,63,2018
2018-10-26,Terengganu,28,6,22,2018
2018-10-27,Terengganu,48,12,36,2018
2018-10-28,Terengganu,0,0,0,2018
2018-10-29,Terengganu,119,65,54,2018
2018-10-30,Terengganu,120,88,32,2018
2018-10-31,Terengganu,106,51,55,2018
2018-11-01,Terengganu,54,8,46,2018
2018-11-02,Terengganu,0,0,0,2018
2018-11-03,Terengganu,1,0,1,2018
2018-11-04,Terengganu,61,18,43,2018
2018-11-05,Terengganu,13,0,13,2018
2018-11-06,Terengganu,0,0,0,2018
2018-11-07,Terengganu,39,9,30,2018
2018-11-08,Terengganu,43,6,37,2018
2018-11-09,Terengganu,0,0,0,2018
2018-11-10,Terengganu,36,4,32,2018
2018-11-11,Terengganu,43,7,36,2018
2018-11-12,Terengganu,80,23,57,2018
2018-11-13,Terengganu,73,23,50,2018
2018-11-14,Terengganu,12,0,12,2018
2018-11-15,Terengganu,43,13,30,2018
2018-11-16,Terengganu,47,18,29,2018
2018-11-17,Terengganu,84,34,50,2018
2018-11-18,Terengganu,11,1,10,2018
2018-11-19,Terengganu,41,12,29,2018
2018-11-20,Terengganu,0,0,0,2018
2018-11-21,Terengganu,98,59,39,2018
2018-11-22,Terengganu,28,3,25,2018
2018-11-23,Terengganu,0,0,0,2018
2018-11-24,Terengganu,54,29,25,2018
2018-11-25,Terengganu,23,7,16,2018
2018-11-26,Terengganu,9,1,8,2018
2018-11-27,Terengganu,46,15,31,2018
2018-11-28,Terengganu,10,2,8,2018
2018-11-29,Terengganu,4,0,4,2018
2018-11-30,Terengganu,53,9,44,2018
2018-12-01,Terengganu,0,0,0,2018
2018-12-02,Terengganu,15,0,15,2018
2018-12-03,Terengganu,43,21,22,2018
2018-12-04,Terengganu,38,13,25,2018
2018-12-05,Terengganu,64,19,45,2018
2018-12-06,Terengganu,271,63,208,2018
2018-12-07,Terengganu,39,10,29,2018
2018-12-08,Terengganu,40,14,26,2018
2018-12-09,Terengganu,16,1,15,2018
2018-12-10,Terengganu,23,1,22,2018
2018-12-11,Terengganu,50,12,38,2018
2018-12-12,Terengganu,8,1,7,2018
2018-12-13,Terengganu,86,33,53,2018
2018-12-14,Terengganu,91,30,61,2018
2018-12-15,Terengganu,60,32,28,2018
2018-12-16,Terengganu,21,5,16,2018
2018-12-17,Terengganu,54,10,44,2018
2018-12-18,Terengganu,91,33,58,2018
2018-12-19,Terengganu,155,49,106,2018
2018-12-20,Terengganu,125,53,72,2018
2018-12-21,Terengganu,76,25,51,2018
2018-12-22,Terengganu,125,37,88,2018
2018-12-23,Terengganu,57,12,45,2018
2018-12-24,Terengganu,37,12,25,2018
2018-12-25,Terengganu,0,0,0,2018
2018-12-26,Terengganu,10,1,9,2018
2018-12-27,Terengganu,96,24,72,2018
2018-12-28,Terengganu,24,10,14,2018
2018-12-29,Terengganu,45,12,33,2018
2018-12-30,Terengganu,19,3,16,2018
2018-12-31,Terengganu,101,26,75,2018
2019-01-01,Terengganu,19,6,13,2019
2019-01-02,Terengganu,30,6,24,2019
2019-01-03,Terengganu,15,2,13,2019
2019-01-04,Terengganu,23,3,20,2019
2019-01-05,Terengganu,43,8,35,2019
2019-01-06,Terengganu,16,0,16,2019
2019-01-07,Terengganu,28,5,23,2019
2019-01-08,Terengganu,9,0,9,2019
2019-01-09,Terengganu,10,0,10,2019
2019-01-10,Terengganu,32,20,12,2019
2019-01-11,Terengganu,17,4,13,2019
2019-01-12,Terengganu,5,1,4,2019
2019-01-13,Terengganu,10,0,10,2019
2019-01-14,Terengganu,34,10,24,2019
2019-01-15,Terengganu,45,13,32,2019
2019-01-16,Terengganu,42,11,31,2019
2019-01-17,Terengganu,89,36,53,2019
2019-01-18,Terengganu,0,0,0,2019
2019-01-19,Terengganu,3,0,3,2019
2019-01-20,Terengganu,111,28,83,2019
2019-01-21,Terengganu,124,75,49,2019
2019-01-22,Terengganu,9,1,8,2019
2019-01-23,Terengganu,61,39,22,2019
2019-01-24,Terengganu,167,55,112,2019
2019-01-25,Terengganu,45,13,32,2019
2019-01-26,Terengganu,57,14,43,2019
2019-01-27,Terengganu,14,0,14,2019
2019-01-28,Terengganu,48,14,34,2019
2019-01-29,Terengganu,186,71,115,2019
2019-01-30,Terengganu,44,17,27,2019
2019-01-31,Terengganu,82,52,30,2019
2019-02-01,Terengganu,46,15,31,2019
2019-02-02,Terengganu,78,22,56,2019
2019-02-03,Terengganu,70,30,40,2019
2019-02-04,Terengganu,26,2,24,2019
2019-02-05,Terengganu,0,0,0,2019
2019-02-06,Terengganu,0,0,0,2019
2019-02-07,Terengganu,58,13,45,2019
2019-02-08,Terengganu,0,0,0,2019
2019-02-09,Terengganu,34,7,27,2019
2019-02-10,Terengganu,15,0,15,2019
2019-02-11,Terengganu,114,49,65,2019
2019-02-12,Terengganu,55,18,37,2019
2019-02-13,Terengganu,14,3,11,2019
2019-02-14,Terengganu,125,56,69,2019
2019-02-15,Terengganu,13,4,9,2019
2019-02-16,Terengganu,52,20,32,2019
2019-02-17,Terengganu,114,19,95,2019
2019-02-18,Terengganu,36,11,25,2019
2019-02-19,Terengganu,66,24,42,2019
2019-02-20,Terengganu,116,53,63,2019
2019-02-21,Terengganu,22,9,13,2019
2019-02-22,Terengganu,32,14,18,2019
2019-02-23,Terengganu,15,3,12,2019
2019-02-24,Terengganu,11,0,11,2019
2019-02-25,Terengganu,98,40,58,2019
2019-02-26,Terengganu,61,22,39,2019
2019-02-27,Terengganu,158,48,110,2019
2019-02-28,Terengganu,195,61,134,2019
2019-03-01,Terengganu,15,5,10,2019
2019-03-02,Terengganu,42,4,38,2019
2019-03-03,Terengganu,11,1,10,2019
2019-03-04,Terengganu,33,14,19,2019
2019-03-05,Terengganu,55,20,35,2019
2019-03-06,Terengganu,69,47,22,2019
2019-03-07,Terengganu,107,37,70,2019
2019-03-08,Terengganu,45,24,21,2019
2019-03-09,Terengganu,2,1,1,2019
2019-03-10,Terengganu,28,3,25,2019
2019-03-11,Terengganu,36,15,21,2019
2019-03-12,Terengganu,10,0,10,2019
2019-03-13,Terengganu,70,29,41,2019
2019-03-14,Terengganu,39,3,36,2019
2019-03-15,Terengganu,0,0,0,2019
2019-03-16,Terengganu,102,24,78,2019
2019-03-17,Terengganu,12,1,11,2019
2019-03-18,Terengganu,56,39,17,2019
2019-03-19,Terengganu,22,9,13,2019
2019-03-20,Terengganu,14,1,13,2019
2019-03-21,Terengganu,80,33,47,2019
2019-03-22,Terengganu,0,0,0,2019
2019-03-23,Terengganu,8,0,8,2019
2019-03-24,Terengganu,8,1,7,2019
2019-03-25,Terengganu,7,0,7,2019
2019-03-26,Terengganu,74,34,40,2019
2019-03-27,Terengganu,116,70,46,2019
2019-03-28,Terengganu,18,4,14,2019
2019-03-29,Terengganu,18,2,16,2019
2019-03-30,Terengganu,33,3,30,2019
2019-03-31,Terengganu,11,0,11,2019
2019-04-01,Terengganu,8,0,8,2019
2019-04-02,Terengganu,36,4,32,2019
2019-04-03,Terengganu,70,19,51,2019
2019-04-04,Terengganu,15,2,13,2019
2019-04-05,Terengganu,0,0,0,2019
2019-04-06,Terengganu,43,8,35,2019
2019-04-07,Terengganu,32,9,23,2019
2019-04-08,Terengganu,43,9,34,2019
2019-04-09,Terengganu,138,59,79,2019
2019-04-10,Terengganu,56,9,47,2019
2019-04-11,Terengganu,12,1,11,2019
2019-04-12,Terengganu,0,0,0,2019
2019-04-13,Terengganu,47,11,36,2019
2019-04-14,Terengganu,67,16,51,2019
2019-04-15,Terengganu,46,9,37,2019
2019-04-16,Terengganu,30,10,20,2019
2019-04-17,Terengganu,152,89,63,2019
2019-04-18,Terengganu,88,25,63,2019
2019-04-19,Terengganu,52,15,37,2019
2019-04-20,Terengganu,131,109,22,2019
2019-04-21,Terengganu,132,50,82,2019
2019-04-22,Terengganu,68,13,55,2019
2019-04-23,Terengganu,86,31,55,2019
2019-04-24,Terengganu,107,47,60,2019
2019-04-25,Terengganu,23,8,15,2019
2019-04-26,Terengganu,72,23,49,2019
2019-04-27,Terengganu,147,51,96,2019
2019-04-28,Terengganu,163,50,113,2019
2019-04-29,Terengganu,39,6,33,2019
2019-04-30,Terengganu,83,29,54,2019
2019-05-01,Terengganu,56,5,51,2019
2019-05-02,Terengganu,7,0,7,2019
2019-05-03,Terengganu,149,25,124,2019
2019-05-04,Terengganu,28,9,19,2019
2019-05-05,Terengganu,105,54,51,2019
2019-05-06,Terengganu,6,3,3,2019
2019-05-07,Terengganu,23,3,20,2019
2019-05-08,Terengganu,31,7,24,2019
2019-05-09,Terengganu,30,5,25,2019
2019-05-10,Terengganu,51,8,43,2019
2019-05-11,Terengganu,30,5,25,2019
2019-05-12,Terengganu,25,6,19,2019
2019-05-13,Terengganu,0,0,0,2019
2019-05-14,Terengganu,27,3,24,2019
2019-05-15,Terengganu,47,15,32,2019
2019-05-16,Terengganu,111,27,84,2019
2019-05-17,Terengganu,22,3,19,2019
2019-05-18,Terengganu,35,11,24,2019
2019-05-19,Terengganu,32,6,26,2019
2019-05-20,Terengganu,32,10,22,2019
2019-05-21,Terengganu,70,14,56,2019
2019-05-22,Terengganu,54,17,37,2019
2019-05-23,Terengganu,52,12,40,2019
2019-05-24,Terengganu,67,14,53,2019
2019-05-25,Terengganu,48,9,39,2019
2019-05-26,Terengganu,27,6,21,2019
2019-05-27,Terengganu,0,0,0,2019
2019-05-28,Terengganu,24,6,18,2019
2019-05-29,Terengganu,25,12,13,2019
2019-05-30,Terengganu,39,3,36,2019
2019-05-31,Terengganu,68,11,57,2019
2019-06-01,Terengganu,33,7,26,2019
2019-06-02,Terengganu,0,0,0,2019
2019-06-03,Terengganu,31,4,27,2019
2019-06-04,Terengganu,1,0,1,2019
2019-06-05,Terengganu,0,0,0,2019
2019-06-06,Terengganu,0,0,0,2019
2019-06-07,Terengganu,15,4,11,2019
2019-06-08,Terengganu,0,0,0,2019
2019-06-09,Terengganu,27,6,21,2019
2019-06-10,Terengganu,19,2,17,2019
2019-06-11,Terengganu,43,10,33,2019
2019-06-12,Terengganu,15,6,9,2019
2019-06-13,Terengganu,26,3,23,2019
2019-06-14,Terengganu,18,3,15,2019
2019-06-15,Terengganu,0,0,0,2019
2019-06-16,Terengganu,60,6,54,2019
2019-06-17,Terengganu,16,0,16,2019
2019-06-18,Terengganu,96,23,73,2019
2019-06-19,Terengganu,105,51,54,2019
2019-06-20,Terengganu,14,1,13,2019
2019-06-21,Terengganu,40,4,36,2019
2019-06-22,Terengganu,64,18,46,2019
2019-06-23,Terengganu,66,13,53,2019
2019-06-24,Terengganu,59,36,23,2019
2019-06-25,Terengganu,84,61,23,2019
2019-06-26,Terengganu,40,16,24,2019
2019-06-27,Terengganu,12,1,11,2019
2019-06-28,Terengganu,23,9,14,2019
2019-06-29,Terengganu,13,3,10,2019
2019-06-30,Terengganu,20,2,18,2019
2019-07-01,Terengganu,45,28,17,2019
2019-07-02,Terengganu,47,21,26,2019
2019-07-03,Terengganu,39,9,30,2019
2019-07-04,Terengganu,31,13,18,2019
2019-07-05,Terengganu,0,0,0,2019
2019-07-06,Terengganu,0,0,0,2019
2019-07-07,Terengganu,75,40,35,2019
2019-07-08,Terengganu,141,59,82,2019
2019-07-09,Terengganu,134,54,80,2019
2019-07-10,Terengganu,50,11,39,2019
2019-07-11,Terengganu,73,35,38,2019
2019-07-12,Terengganu,0,0,0,2019
2019-07-13,Terengganu,1,0,1,2019
2019-07-14,Terengganu,72,16,56,2019
2019-07-15,Terengganu,44,4,40,2019
2019-07-16,Terengganu,64,45,19,2019
2019-07-17,Terengganu,79,49,30,2019
2019-07-18,Terengganu,101,41,60,2019
2019-07-19,Terengganu,0,0,0,2019
2019-07-20,Terengganu,13,5,8,2019
2019-07-21,Terengganu,39,13,26,2019
2019-07-22,Terengganu,48,34,14,2019
2019-07-23,Terengganu,130,42,88,2019
2019-07-24,Terengganu,56,37,19,2019
2019-07-25,Terengganu,10,0,10,2019
2019-07-26,Terengganu,32,6,26,2019
2019-07-27,Terengganu,68,45,23,2019
2019-07-28,Terengganu,96,30,66,2019
2019-07-29,Terengganu,37,17,20,2019
2019-07-30,Terengganu,0,0,0,2019
2019-07-31,Terengganu,50,37,13,2019
2019-08-01,Terengganu,22,8,14,2019
2019-08-02,Terengganu,30,12,18,2019
2019-08-03,Terengganu,0,0,0,2019
2019-08-04,Terengganu,40,31,9,2019
2019-08-05,Terengganu,10,2,8,2019
2019-08-06,Terengganu,108,45,63,2019
2019-08-07,Terengganu,31,13,18,2019
2019-08-08,Terengganu,5,1,4,2019
2019-08-09,Terengganu,10,3,7,2019
2019-08-10,Terengganu,26,5,21,2019
2019-08-11,Terengganu,0,0,0,2019
2019-08-12,Terengganu,0,0,0,2019
2019-08-13,Terengganu,59,8,51,2019
2019-08-14,Terengganu,8,0,8,2019
2019-08-15,Terengganu,24,8,16,2019
2019-08-16,Terengganu,0,0,0,2019
2019-08-17,Terengganu,31,7,24,2019
2019-08-18,Terengganu,6,0,6,2019
2019-08-19,Terengganu,61,27,34,2019
2019-08-20,Terengganu,11,0,11,2019
2019-08-21,Terengganu,29,10,19,2019
2019-08-22,Terengganu,8,1,7,2019
2019-08-23,Terengganu,39,6,33,2019
2019-08-24,Terengganu,52,23,29,2019
2019-08-25,Terengganu,13,2,11,2019
2019-08-26,Terengganu,102,52,50,2019
2019-08-27,Terengganu,107,62,45,2019
2019-08-28,Terengganu,31,8,23,2019
2019-08-29,Terengganu,131,22,109,2019
2019-08-30,Terengganu,43,6,37,2019
2019-08-31,Terengganu,14,5,9,2019
2019-09-01,Terengganu,0,0,0,2019
2019-09-02,Terengganu,37,18,19,2019
2019-09-03,Terengganu,11,2,9,2019
2019-09-04,Terengganu,35,4,31,2019
2019-09-05,Terengganu,25,1,24,2019
2019-09-06,Terengganu,27,7,20,2019
2019-09-07,Terengganu,42,9,33,2019
2019-09-08,Terengganu,34,7,27,2019
2019-09-09,Terengganu,0,0,0,2019
2019-09-10,Terengganu,46,10,36,2019
2019-09-11,Terengganu,17,2,15,2019
2019-09-12,Terengganu,74,44,30,2019
2019-09-13,Terengganu,36,8,28,2019
2019-09-14,Terengganu,75,54,21,2019
2019-09-15,Terengganu,21,3,18,2019
2019-09-16,Terengganu,52,10,42,2019
2019-09-17,Terengganu,7,0,7,2019
2019-09-18,Terengganu,13,4,9,2019
2019-09-19,Terengganu,23,6,17,2019
2019-09-20,Terengganu,55,11,44,2019
2019-09-21,Terengganu,100,70,30,2019
2019-09-22,Terengganu,88,38,50,2019
2019-09-23,Terengganu,18,3,15,2019
2019-09-24,Terengganu,67,32,35,2019
2019-09-25,Terengganu,118,51,67,2019
2019-09-26,Terengganu,48,12,36,2019
2019-09-27,Terengganu,31,4,27,2019
2019-09-28,Terengganu,22,6,16,2019
2019-09-29,Terengganu,10,1,9,2019
2019-09-30,Terengganu,105,38,67,2019
2019-10-01,Terengganu,47,10,37,2019
2019-10-02,Terengganu,81,24,57,2019
2019-10-03,Terengganu,75,28,47,2019
2019-10-04,Terengganu,34,7,27,2019
2019-10-05,Terengganu,23,5,18,2019
2019-10-06,Terengganu,13,0,13,2019
2019-10-07,Terengganu,30,16,14,2019
2019-10-08,Terengganu,39,6,33,2019
2019-10-09,Terengganu,88,32,56,2019
2019-10-10,Terengganu,44,9,35,2019
2019-10-11,Terengganu,23,4,19,2019
2019-10-12,Terengganu,0,0,0,2019
2019-10-13,Terengganu,18,1,17,2019
2019-10-14,Terengganu,119,34,85,2019
2019-10-15,Terengganu,37,5,32,2019
2019-10-16,Terengganu,132,50,82,2019
2019-10-17,Terengganu,18,8,10,2019
2019-10-18,Terengganu,15,4,11,2019
2019-10-19,Terengganu,54,17,37,2019
2019-10-20,Terengganu,8,0,8,2019
2019-10-21,Terengganu,12,0,12,2019
2019-10-22,Terengganu,7,0,7,2019
2019-10-23,Terengganu,68,35,33,2019
2019-10-24,Terengganu,92,32,60,2019
2019-10-25,Terengganu,0,0,0,2019
2019-10-26,Terengganu,26,5,21,2019
2019-10-27,Terengganu,0,0,0,2019
2019-10-28,Terengganu,25,5,20,2019
2019-10-29,Terengganu,18,2,16,2019
2019-10-30,Terengganu,12,2,10,2019
2019-10-31,Terengganu,9,0,9,2019
2019-11-01,Terengganu,16,13,3,2019
2019-11-02,Terengganu,20,4,16,2019
2019-11-03,Terengganu,8,0,8,2019
2019-11-04,Terengganu,2,1,1,2019
2019-11-05,Terengganu,59,26,33,2019
2019-11-06,Terengganu,74,37,37,2019
2019-11-07,Terengganu,120,70,50,2019
2019-11-08,Terengganu,22,5,17,2019
2019-11-09,Terengganu,47,9,38,2019
2019-11-10,Terengganu,0,0,0,2019
2019-11-11,Terengganu,19,2,17,2019
2019-11-12,Terengganu,61,11,50,2019
2019-11-13,Terengganu,31,7,24,2019
2019-11-14,Terengganu,61,13,48,2019
2019-11-15,Terengganu,60,16,44,2019
2019-11-16,Terengganu,114,64,50,2019
2019-11-17,Terengganu,39,13,26,2019
2019-11-18,Terengganu,66,12,54,2019
2019-11-19,Terengganu,5,0,5,2019
2019-11-20,Terengganu,7,0,7,2019
2019-11-21,Terengganu,48,20,28,2019
2019-11-22,Terengganu,27,12,15,2019
2019-11-23,Terengganu,45,8,37,2019
2019-11-24,Terengganu,7,0,7,2019
2019-11-25,Terengganu,51,22,29,2019
2019-11-26,Terengganu,72,33,39,2019
2019-11-27,Terengganu,9,1,8,2019
2019-11-28,Terengganu,6,0,6,2019
2019-11-29,Terengganu,34,10,24,2019
2019-11-30,Terengganu,47,32,15,2019
2019-12-01,Terengganu,11,3,8,2019
2019-12-02,Terengganu,30,3,27,2019
2019-12-03,Terengganu,45,13,32,2019
2019-12-04,Terengganu,56,13,43,2019
2019-12-05,Terengganu,157,30,127,2019
2019-12-06,Terengganu,40,10,30,2019
2019-12-07,Terengganu,52,12,40,2019
2019-12-08,Terengganu,65,20,45,2019
2019-12-09,Terengganu,60,39,21,2019
2019-12-10,Terengganu,43,13,30,2019
2019-12-11,Terengganu,50,7,43,2019
2019-12-12,Terengganu,33,3,30,2019
2019-12-13,Terengganu,0,0,0,2019
2019-12-14,Terengganu,28,11,17,2019
2019-12-15,Terengganu,33,4,29,2019
2019-12-16,Terengganu,115,52,63,2019
2019-12-17,Terengganu,118,56,62,2019
2019-12-18,Terengganu,49,19,30,2019
2019-12-19,Terengganu,50,10,40,2019
2019-12-20,Terengganu,21,10,11,2019
2019-12-21,Terengganu,140,80,60,2019
2019-12-22,Terengganu,19,0,19,2019
2019-12-23,Terengganu,79,16,63,2019
2019-12-24,Terengganu,36,7,29,2019
2019-12-25,Terengganu,0,0,0,2019
2019-12-26,Terengganu,45,6,39,2019
2019-12-27,Terengganu,94,66,28,2019
2019-12-28,Terengganu,32,7,25,2019
2019-12-29,Terengganu,53,11,42,2019
2019-12-30,Terengganu,52,15,37,2019
2019-12-31,Terengganu,61,12,49,2019
2020-01-01,Terengganu,12,1,11,2020
2020-01-02,Terengganu,30,5,25,2020
2020-01-03,Terengganu,28,8,20,2020
2020-01-04,Terengganu,35,12,23,2020
2020-01-05,Terengganu,12,0,12,2020
2020-01-06,Terengganu,16,2,14,2020
2020-01-07,Terengganu,34,4,30,2020
2020-01-08,Terengganu,8,0,8,2020
2020-01-09,Terengganu,24,14,10,2020
2020-01-10,Terengganu,57,11,46,2020
2020-01-11,Terengganu,0,0,0,2020
2020-01-12,Terengganu,11,0,11,2020
2020-01-13,Terengganu,87,33,54,2020
2020-01-14,Terengganu,39,10,29,2020
2020-01-15,Terengganu,35,4,31,2020
2020-01-16,Terengganu,89,35,54,2020
2020-01-17,Terengganu,29,7,22,2020
2020-01-18,Terengganu,63,21,42,2020
2020-01-19,Terengganu,89,15,74,2020
2020-01-20,Terengganu,107,55,52,2020
2020-01-21,Terengganu,163,58,105,2020
2020-01-22,Terengganu,9,1,8,2020
2020-01-23,Terengganu,26,7,19,2020
2020-01-24,Terengganu,29,6,23,2020
2020-01-25,Terengganu,3,1,2,2020
2020-01-26,Terengganu,40,12,28,2020
2020-01-27,Terengganu,0,0,0,2020
2020-01-28,Terengganu,29,6,23,2020
2020-01-29,Terengganu,11,0,11,2020
2020-01-30,Terengganu,77,51,26,2020
2020-01-31,Terengganu,0,0,0,2020
2020-02-01,Terengganu,12,2,10,2020
2020-02-02,Terengganu,42,4,38,2020
2020-02-03,Terengganu,32,9,23,2020
2020-02-04,Terengganu,50,42,8,2020
2020-02-05,Terengganu,29,9,20,2020
2020-02-06,Terengganu,23,2,21,2020
2020-02-07,Terengganu,22,5,17,2020
2020-02-08,Terengganu,40,18,22,2020
2020-02-09,Terengganu,13,0,13,2020
2020-02-10,Terengganu,68,16,52,2020
2020-02-11,Terengganu,95,44,51,2020
2020-02-12,Terengganu,58,18,40,2020
2020-02-13,Terengganu,24,6,18,2020
2020-02-14,Terengganu,35,9,26,2020
2020-02-15,Terengganu,4,0,4,2020
2020-02-16,Terengganu,35,8,27,2020
2020-02-17,Terengganu,161,41,120,2020
2020-02-18,Terengganu,134,40,94,2020
2020-02-19,Terengganu,40,14,26,2020
2020-02-20,Terengganu,30,7,23,2020
2020-02-21,Terengganu,28,16,12,2020
2020-02-22,Terengganu,42,13,29,2020
2020-02-23,Terengganu,21,3,18,2020
2020-02-24,Terengganu,91,43,48,2020
2020-02-25,Terengganu,62,36,26,2020
2020-02-26,Terengganu,91,36,55,2020
2020-02-27,Terengganu,20,14,6,2020
2020-02-28,Terengganu,50,9,41,2020
2020-02-29,Terengganu,0,0,0,2020
2020-03-01,Terengganu,67,28,39,2020
2020-03-02,Terengganu,7,0,7,2020
2020-03-03,Terengganu,78,51,27,2020
2020-03-04,Terengganu,35,20,15,2020
2020-03-05,Terengganu,31,3,28,2020
2020-03-06,Terengganu,57,20,37,2020
2020-03-07,Terengganu,42,9,33,2020
2020-03-08,Terengganu,13,0,13,2020
2020-03-09,Terengganu,38,17,21,2020
2020-03-10,Terengganu,98,19,79,2020
2020-03-11,Terengganu,11,0,11,2020
2020-03-12,Terengganu,218,78,140,2020
2020-03-13,Terengganu,0,0,0,2020
2020-03-14,Terengganu,55,24,31,2020
2020-03-15,Terengganu,29,5,24,2020
2020-03-16,Terengganu,78,39,39,2020
2020-03-17,Terengganu,5,1,4,2020
2020-03-18,Terengganu,7,0,7,2020
2020-03-19,Terengganu,98,35,63,2020
2020-03-20,Terengganu,0,0,0,2020
2020-03-21,Terengganu,12,1,11,2020
2020-03-22,Terengganu,0,0,0,2020
2020-03-23,Terengganu,9,1,8,2020
2020-03-24,Terengganu,7,1,6,2020
2020-03-25,Terengganu,5,0,5,2020
2020-03-26,Terengganu,5,0,5,2020
2020-03-27,Terengganu,0,0,0,2020
2020-03-28,Terengganu,14,1,13,2020
2020-03-29,Terengganu,27,5,22,2020
2020-03-30,Terengganu,35,17,18,2020
2020-03-31,Terengganu,8,0,8,2020
2020-04-01,Terengganu,7,0,7,2020
2020-04-02,Terengganu,9,1,8,2020
2020-04-03,Terengganu,0,0,0,2020
2020-04-04,Terengganu,14,3,11,2020
2020-04-05,Terengganu,35,2,33,2020
2020-04-06,Terengganu,28,0,28,2020
2020-04-07,Terengganu,36,7,29,2020
2020-04-08,Terengganu,23,3,20,2020
2020-04-09,Terengganu,30,9,21,2020
2020-04-10,Terengganu,0,0,0,2020
2020-04-11,Terengganu,23,2,21,2020
2020-04-12,Terengganu,31,6,25,2020
2020-04-13,Terengganu,31,3,28,2020
2020-04-14,Terengganu,65,27,38,2020
2020-04-15,Terengganu,141,45,96,2020
2020-04-16,Terengganu,94,13,81,2020
2020-04-17,Terengganu,85,33,52,2020
2020-04-18,Terengganu,76,21,55,2020
2020-04-19,Terengganu,134,38,96,2020
2020-04-20,Terengganu,116,43,73,2020
2020-04-21,Terengganu,103,36,67,2020
2020-04-22,Terengganu,98,50,48,2020
2020-04-23,Terengganu,25,4,21,2020
2020-04-24,Terengganu,0,0,0,2020
2020-04-25,Terengganu,0,0,0,2020
2020-04-26,Terengganu,3,0,3,2020
2020-04-27,Terengganu,4,0,4,2020
2020-04-28,Terengganu,4,0,4,2020
2020-04-29,Terengganu,6,0,6,2020
2020-04-30,Terengganu,25,3,22,2020
2020-05-01,Terengganu,17,2,15,2020
2020-05-02,Terengganu,21,2,19,2020
2020-05-03,Terengganu,27,3,24,2020
2020-05-04,Terengganu,17,4,13,2020
2020-05-05,Terengganu,26,6,20,2020
2020-05-06,Terengganu,34,8,26,2020
2020-05-07,Terengganu,2,0,2,2020
2020-05-08,Terengganu,18,1,17,2020
2020-05-09,Terengganu,13,1,12,2020
2020-05-10,Terengganu,35,9,26,2020
2020-05-11,Terengganu,61,12,49,2020
2020-05-12,Terengganu,73,13,60,2020
2020-05-13,Terengganu,64,16,48,2020
2020-05-14,Terengganu,67,19,48,2020
2020-05-15,Terengganu,90,25,65,2020
2020-05-16,Terengganu,0,0,0,2020
2020-05-17,Terengganu,81,18,63,2020
2020-05-18,Terengganu,72,19,53,2020
2020-05-19,Terengganu,88,30,58,2020
2020-05-20,Terengganu,66,19,47,2020
2020-05-21,Terengganu,27,4,23,2020
2020-05-22,Terengganu,40,13,27,2020
2020-05-23,Terengganu,31,13,18,2020
2020-05-24,Terengganu,0,0,0,2020
2020-05-25,Terengganu,0,0,0,2020
2020-05-26,Terengganu,76,15,61,2020
2020-05-27,Terengganu,77,26,51,2020
2020-05-28,Terengganu,7,0,7,2020
2020-05-29,Terengganu,114,53,61,2020
2020-05-30,Terengganu,194,108,86,2020
2020-05-31,Terengganu,26,5,21,2020
2020-06-01,Terengganu,74,25,49,2020
2020-06-02,Terengganu,11,2,9,2020
2020-06-03,Terengganu,58,11,47,2020
2020-06-04,Terengganu,23,2,21,2020
2020-06-05,Terengganu,0,0,0,2020
2020-06-06,Terengganu,37,12,25,2020
2020-06-07,Terengganu,11,1,10,2020
2020-06-08,Terengganu,0,0,0,2020
2020-06-09,Terengganu,28,3,25,2020
2020-06-10,Terengganu,30,2,28,2020
2020-06-11,Terengganu,15,2,13,2020
2020-06-12,Terengganu,47,11,36,2020
2020-06-13,Terengganu,131,106,25,2020
2020-06-14,Terengganu,15,0,15,2020
2020-06-15,Terengganu,21,1,20,2020
2020-06-16,Terengganu,18,2,16,2020
2020-06-17,Terengganu,93,11,82,2020
2020-06-18,Terengganu,95,20,75,2020
2020-06-19,Terengganu,47,10,37,2020
2020-06-20,Terengganu,69,33,36,2020
2020-06-21,Terengganu,23,4,19,2020
2020-06-22,Terengganu,11,3,8,2020
2020-06-23,Terengganu,35,7,28,2020
2020-06-24,Terengganu,13,1,12,2020
2020-06-25,Terengganu,91,31,60,2020
2020-06-26,Terengganu,48,16,32,2020
2020-06-27,Terengganu,81,27,54,2020
2020-06-28,Terengganu,10,1,9,2020
2020-06-29,Terengganu,73,15,58,2020
2020-06-30,Terengganu,14,1,13,2020
2020-07-01,Terengganu,31,6,25,2020
2020-07-02,Terengganu,14,0,14,2020
2020-07-03,Terengganu,43,17,26,2020
2020-07-04,Terengganu,50,8,42,2020
2020-07-05,Terengganu,43,15,28,2020
2020-07-06,Terengganu,32,3,29,2020
2020-07-07,Terengganu,14,3,11,2020
2020-07-08,Terengganu,52,11,41,2020
2020-07-09,Terengganu,45,9,36,2020
2020-07-10,Terengganu,38,28,10,2020
2020-07-11,Terengganu,32,6,26,2020
2020-07-12,Terengganu,37,5,32,2020
2020-07-13,Terengganu,31,7,24,2020
2020-07-14,Terengganu,104,31,73,2020
2020-07-15,Terengganu,43,6,37,2020
2020-07-16,Terengganu,45,8,37,2020
2020-07-17,Terengganu,30,7,23,2020
2020-07-18,Terengganu,38,8,30,2020
2020-07-19,Terengganu,29,10,19,2020
2020-07-20,Terengganu,40,6,34,2020
2020-07-21,Terengganu,51,9,42,2020
2020-07-22,Terengganu,44,7,37,2020
2020-07-23,Terengganu,8,1,7,2020
2020-07-24,Terengganu,85,33,52,2020
2020-07-25,Terengganu,0,0,0,2020
2020-07-26,Terengganu,36,14,22,2020
2020-07-27,Terengganu,18,3,15,2020
2020-07-28,Terengganu,19,3,16,2020
2020-07-29,Terengganu,43,11,32,2020
2020-07-30,Terengganu,64,18,46,2020
2020-07-31,Terengganu,0,0,0,2020
2020-08-01,Terengganu,0,0,0,2020
2020-08-02,Terengganu,41,14,27,2020
2020-08-03,Terengganu,12,0,12,2020
2020-08-04,Terengganu,38,12,26,2020
2020-08-05,Terengganu,47,15,32,2020
2020-08-06,Terengganu,36,6,30,2020
2020-08-07,Terengganu,96,35,61,2020
2020-08-08,Terengganu,44,10,34,2020
2020-08-09,Terengganu,129,44,85,2020
2020-08-10,Terengganu,40,10,30,2020
2020-08-11,Terengganu,104,20,84,2020
2020-08-12,Terengganu,79,25,54,2020
2020-08-13,Terengganu,39,15,24,2020
2020-08-14,Terengganu,65,26,39,2020
2020-08-15,Terengganu,88,34,54,2020
2020-08-16,Terengganu,18,3,15,2020
2020-08-17,Terengganu,60,10,50,2020
2020-08-18,Terengganu,83,32,51,2020
2020-08-19,Terengganu,13,2,11,2020
2020-08-20,Terengganu,0,0,0,2020
2020-08-21,Terengganu,42,13,29,2020
2020-08-22,Terengganu,22,5,17,2020
2020-08-23,Terengganu,41,8,33,2020
2020-08-24,Terengganu,47,16,31,2020
2020-08-25,Terengganu,29,9,20,2020
2020-08-26,Terengganu,39,12,27,2020
2020-08-27,Terengganu,10,2,8,2020
2020-08-28,Terengganu,38,6,32,2020
2020-08-29,Terengganu,40,5,35,2020
2020-08-30,Terengganu,57,11,46,2020
2020-08-31,Terengganu,0,0,0,2020
2020-09-01,Terengganu,25,5,20,2020
2020-09-02,Terengganu,13,0,13,2020
2020-09-03,Terengganu,52,15,37,2020
2020-09-04,Terengganu,23,12,11,2020
2020-09-05,Terengganu,34,6,28,2020
2020-09-06,Terengganu,29,9,20,2020
2020-09-07,Terengganu,52,14,38,2020
2020-09-08,Terengganu,38,6,32,2020
2020-09-09,Terengganu,39,7,32,2020
2020-09-10,Terengganu,49,28,21,2020
2020-09-11,Terengganu,37,7,30,2020
2020-09-12,Terengganu,54,26,28,2020
2020-09-13,Terengganu,11,0,11,2020
2020-09-14,Terengganu,177,43,134,2020
2020-09-15,Terengganu,35,9,26,2020
2020-09-16,Terengganu,86,22,64,2020
2020-09-17,Terengganu,35,8,27,2020
2020-09-18,Terengganu,51,17,34,2020
2020-09-19,Terengganu,37,16,21,2020
2020-09-20,Terengganu,16,1,15,2020
2020-09-21,Terengganu,34,4,30,2020
2020-09-22,Terengganu,12,2,10,2020
2020-09-23,Terengganu,33,9,24,2020
2020-09-24,Terengganu,15,1,14,2020
2020-09-25,Terengganu,52,14,38,2020
2020-09-26,Terengganu,38,7,31,2020
2020-09-27,Terengganu,54,11,43,2020
2020-09-28,Terengganu,32,7,25,2020
2020-09-29,Terengganu,34,6,28,2020
2020-09-30,Terengganu,71,16,55,2020
2020-10-01,Terengganu,53,10,43,2020
2020-10-02,Terengganu,35,6,29,2020
2020-10-03,Terengganu,59,10,49,2020
2020-10-04,Terengganu,42,12,30,2020
2020-10-05,Terengganu,8,2,6,2020
2020-10-06,Terengganu,34,9,25,2020
2020-10-07,Terengganu,33,7,26,2020
2020-10-08,Terengganu,114,42,72,2020
2020-10-09,Terengganu,29,4,25,2020
2020-10-10,Terengganu,50,10,40,2020
2020-10-11,Terengganu,26,5,21,2020
2020-10-12,Terengganu,30,8,22,2020
2020-10-13,Terengganu,89,35,54,2020
2020-10-14,Terengganu,105,63,42,2020
2020-10-15,Terengganu,3,0,3,2020
2020-10-16,Terengganu,28,8,20,2020
2020-10-17,Terengganu,49,13,36,2020
2020-10-18,Terengganu,31,5,26,2020
2020-10-19,Terengganu,13,1,12,2020
2020-10-20,Terengganu,45,7,38,2020
2020-10-21,Terengganu,54,12,42,2020
2020-10-22,Terengganu,47,10,37,2020
2020-10-23,Terengganu,38,9,29,2020
2020-10-24,Terengganu,56,18,38,2020
2020-10-25,Terengganu,42,10,32,2020
2020-10-26,Terengganu,45,10,35,2020
2020-10-27,Terengganu,4,0,4,2020
2020-10-28,Terengganu,40,8,32,2020
2020-10-29,Terengganu,32,12,20,2020
2020-10-30,Terengganu,21,9,12,2020
2020-10-31,Terengganu,42,7,35,2020
2020-11-01,Terengganu,8,0,8,2020
2020-11-02,Terengganu,29,10,19,2020
2020-11-03,Terengganu,27,3,24,2020
2020-11-04,Terengganu,65,35,30,2020
2020-11-05,Terengganu,22,5,17,2020
2020-11-06,Terengganu,26,7,19,2020
2020-11-07,Terengganu,23,7,16,2020
2020-11-08,Terengganu,7,2,5,2020
2020-11-09,Terengganu,52,19,33,2020
2020-11-10,Terengganu,11,1,10,2020
2020-11-11,Terengganu,19,2,17,2020
2020-11-12,Terengganu,68,20,48,2020
2020-11-13,Terengganu,49,7,42,2020
2020-11-14,Terengganu,140,37,103,2020
2020-11-15,Terengganu,87,17,70,2020
2020-11-16,Terengganu,15,1,14,2020
2020-11-17,Terengganu,72,16,56,2020
2020-11-18,Terengganu,36,5,31,2020
2020-11-19,Terengganu,165,40,125,2020
2020-11-20,Terengganu,65,20,45,2020
2020-11-21,Terengganu,94,70,24,2020
2020-11-22,Terengganu,4,1,3,2020
2020-11-23,Terengganu,52,18,34,2020
2020-11-24,Terengganu,50,14,36,2020
2020-11-25,Terengganu,5,0,5,2020
2020-11-26,Terengganu,18,1,17,2020
2020-11-27,Terengganu,67,16,51,2020
2020-11-28,Terengganu,58,19,39,2020
2020-11-29,Terengganu,58,19,39,2020
2020-11-30,Terengganu,97,31,66,2020
2020-12-01,Terengganu,10,0,10,2020
2020-12-02,Terengganu,25,7,18,2020
2020-12-03,Terengganu,33,13,20,2020
2020-12-04,Terengganu,54,12,42,2020
2020-12-05,Terengganu,19,7,12,2020
2020-12-06,Terengganu,12,0,12,2020
2020-12-07,Terengganu,11,1,10,2020
2020-12-08,Terengganu,20,4,16,2020
2020-12-09,Terengganu,23,7,16,2020
2020-12-10,Terengganu,54,12,42,2020
2020-12-11,Terengganu,31,10,21,2020
2020-12-12,Terengganu,64,18,46,2020
2020-12-13,Terengganu,10,0,10,2020
2020-12-14,Terengganu,27,7,20,2020
2020-12-15,Terengganu,16,2,14,2020
2020-12-16,Terengganu,47,8,39,2020
2020-12-17,Terengganu,12,0,12,2020
2020-12-18,Terengganu,43,14,29,2020
2020-12-19,Terengganu,14,5,9,2020
2020-12-20,Terengganu,21,0,21,2020
2020-12-21,Terengganu,61,13,48,2020
2020-12-22,Terengganu,31,5,26,2020
2020-12-23,Terengganu,12,0,12,2020
2020-12-24,Terengganu,140,36,104,2020
2020-12-25,Terengganu,36,8,28,2020
2020-12-26,Terengganu,58,13,45,2020
2020-12-27,Terengganu,13,1,12,2020
2020-12-28,Terengganu,8,1,7,2020
2020-12-29,Terengganu,52,13,39,2020
2020-12-30,Terengganu,172,43,129,2020
2020-12-31,Terengganu,57,9,48,2020
2021-01-01,Terengganu,41,11,30,2021
2021-01-02,Terengganu,30,3,27,2021
2021-01-03,Terengganu,10,1,9,2021
2021-01-04,Terengganu,4,1,3,2021
2021-01-05,Terengganu,32,4,28,2021
2021-01-06,Terengganu,7,3,4,2021
2021-01-07,Terengganu,59,13,46,2021
2021-01-08,Terengganu,86,25,61,2021
2021-01-09,Terengganu,59,18,41,2021
2021-01-10,Terengganu,14,2,12,2021
2021-01-11,Terengganu,10,0,10,2021
2021-01-12,Terengganu,21,7,14,2021
2021-01-13,Terengganu,35,8,27,2021
2021-01-14,Terengganu,29,9,20,2021
2021-01-15,Terengganu,67,26,41,2021
2021-01-16,Terengganu,24,4,20,2021
2021-01-17,Terengganu,33,7,26,2021
2021-01-18,Terengganu,16,1,15,2021
2021-01-19,Terengganu,33,13,20,2021
2021-01-20,Terengganu,7,0,7,2021
2021-01-21,Terengganu,50,11,39,2021
2021-01-22,Terengganu,16,2,14,2021
2021-01-23,Terengganu,123,27,96,2021
2021-01-24,Terengganu,13,1,12,2021
2021-01-25,Terengganu,157,44,113,2021
2021-01-26,Terengganu,35,5,30,2021
2021-01-27,Terengganu,10,1,9,2021
2021-01-28,Terengganu,10,0,10,2021
2021-01-29,Terengganu,0,0,0,2021
2021-01-30,Terengganu,0,0,0,2021
2021-01-31,Terengganu,10,0,10,2021
2021-02-01,Terengganu,13,2,11,2021
2021-02-02,Terengganu,51,5,46,2021
2021-02-03,Terengganu,14,0,14,2021
2021-02-04,Terengganu,94,24,70,2021
2021-02-05,Terengganu,37,11,26,2021
2021-02-06,Terengganu,0,0,0,2021
2021-02-07,Terengganu,101,25,76,2021
2021-02-08,Terengganu,37,3,34,2021
2021-02-09,Terengganu,48,14,34,2021
2021-02-10,Terengganu,53,24,29,2021
2021-02-11,Terengganu,27,4,23,2021
2021-02-12,Terengganu,55,14,41,2021
2021-02-13,Terengganu,47,19,28,2021
2021-02-14,Terengganu,0,0,0,2021
2021-02-15,Terengganu,59,9,50,2021
2021-02-16,Terengganu,37,8,29,2021
2021-02-17,Terengganu,12,3,9,2021
2021-02-18,Terengganu,43,2,41,2021
2021-02-19,Terengganu,59,20,39,2021
2021-02-20,Terengganu,47,6,41,2021
2021-02-21,Terengganu,21,2,19,2021
2021-02-22,Terengganu,11,0,11,2021
2021-02-23,Terengganu,140,66,74,2021
2021-02-24,Terengganu,23,0,23,2021
2021-02-25,Terengganu,58,12,46,2021
2021-02-26,Terengganu,27,6,21,2021
2021-02-27,Terengganu,52,15,37,2021
2021-02-28,Terengganu,37,5,32,2021
2021-03-01,Terengganu,11,3,8,2021
2021-03-02,Terengganu,14,1,13,2021
2021-03-03,Terengganu,89,30,59,2021
2021-03-04,Terengganu,30,4,26,2021
2021-03-05,Terengganu,0,0,0,2021
2021-03-06,Terengganu,23,0,23,2021
2021-03-07,Terengganu,12,1,11,2021
2021-03-08,Terengganu,9,0,9,2021
2021-03-09,Terengganu,51,28,23,2021
2021-03-10,Terengganu,188,68,120,2021
2021-03-11,Terengganu,38,4,34,2021
2021-03-12,Terengganu,74,27,47,2021
2021-03-13,Terengganu,28,5,23,2021
2021-03-14,Terengganu,54,4,50,2021
2021-03-15,Terengganu,50,24,26,2021
2021-03-16,Terengganu,70,30,40,2021
2021-03-17,Terengganu,13,1,12,2021
2021-03-18,Terengganu,27,4,23,2021
2021-03-19,Terengganu,49,15,34,2021
2021-03-20,Terengganu,37,6,31,2021
2021-03-21,Terengganu,83,9,74,2021
2021-03-22,Terengganu,19,2,17,2021
2021-03-23,Terengganu,73,32,41,2021
2021-03-24,Terengganu,51,17,34,2021
2021-03-25,Terengganu,154,35,119,2021
2021-03-26,Terengganu,57,10,47,2021
2021-03-27,Terengganu,59,13,46,2021
2021-03-28,Terengganu,21,4,17,2021
2021-03-29,Terengganu,25,3,22,2021
2021-03-30,Terengganu,78,23,55,2021
2021-03-31,Terengganu,29,8,21,2021
2021-04-01,Terengganu,11,2,9,2021
2021-04-02,Terengganu,39,4,35,2021
2021-04-03,Terengganu,17,4,13,2021
2021-04-04,Terengganu,65,17,48,2021
2021-04-05,Terengganu,81,29,52,2021
2021-04-06,Terengganu,69,41,28,2021
2021-04-07,Terengganu,50,21,29,2021
2021-04-08,Terengganu,75,53,22,2021
2021-04-09,Terengganu,44,5,39,2021
2021-04-10,Terengganu,20,5,15,2021
2021-04-11,Terengganu,118,27,91,2021
2021-04-12,Terengganu,68,16,52,2021
2021-04-13,Terengganu,1,0,1,2021
2021-04-14,Terengganu,1,0,1,2021
2021-04-15,Terengganu,40,9,31,2021
2021-04-16,Terengganu,106,18,88,2021
2021-04-17,Terengganu,55,16,39,2021
2021-04-18,Terengganu,31,2,29,2021
2021-04-19,Terengganu,29,9,20,2021
2021-04-20,Terengganu,33,5,28,2021
2021-04-21,Terengganu,52,12,40,2021
2021-04-22,Terengganu,50,11,39,2021
2021-04-23,Terengganu,63,12,51,2021
2021-04-24,Terengganu,51,6,45,2021
2021-04-25,Terengganu,57,15,42,2021
2021-04-26,Terengganu,43,13,30,2021
2021-04-27,Terengganu,59,38,21,2021
2021-04-28,Terengganu,4,1,3,2021
2021-04-29,Terengganu,44,11,33,2021
2021-04-30,Terengganu,58,8,50,2021
2021-05-01,Terengganu,78,18,60,2021
2021-05-02,Terengganu,73,22,51,2021
2021-05-03,Terengganu,59,27,32,2021
2021-05-04,Terengganu,49,32,17,2021
2021-05-05,Terengganu,26,6,20,2021
2021-05-06,Terengganu,24,4,20,2021
2021-05-07,Terengganu,37,9,28,2021
2021-05-08,Terengganu,35,8,27,2021
2021-05-09,Terengganu,29,7,22,2021
2021-05-10,Terengganu,48,12,36,2021
2021-05-11,Terengganu,40,5,35,2021
2021-05-12,Terengganu,2,0,2,2021
2021-05-13,Terengganu,0,0,0,2021
2021-05-14,Terengganu,0,0,0,2021
2021-05-15,Terengganu,69,16,53,2021
2021-05-16,Terengganu,15,0,15,2021
2021-05-17,Terengganu,76,12,64,2021
2021-05-18,Terengganu,14,1,13,2021
2021-05-19,Terengganu,43,4,39,2021
2021-05-20,Terengganu,34,12,22,2021
2021-05-21,Terengganu,44,4,40,2021
2021-05-22,Terengganu,33,6,27,2021
2021-05-23,Terengganu,48,3,45,2021
2021-05-24,Terengganu,12,0,12,2021
2021-05-25,Terengganu,12,0,12,2021
2021-05-26,Terengganu,12,1,11,2021
2021-05-27,Terengganu,19,2,17,2021
2021-05-28,Terengganu,23,1,22,2021
2021-05-29,Terengganu,27,2,25,2021
2021-05-30,Terengganu,14,0,14,2021
2021-05-31,Terengganu,22,3,19,2021
2021-06-01,Terengganu,34,4,30,2021
2021-06-02,Terengganu,40,5,35,2021
2021-06-03,Terengganu,38,4,34,2021
2021-06-04,Terengganu,24,4,20,2021
2021-06-05,Terengganu,38,6,32,2021
2021-06-06,Terengganu,43,8,35,2021
2021-06-07,Terengganu,42,9,33,2021
2021-06-08,Terengganu,44,2,42,2021
2021-06-09,Terengganu,26,2,24,2021
2021-06-10,Terengganu,123,21,102,2021
2021-06-11,Terengganu,112,27,85,2021
2021-06-12,Terengganu,113,31,82,2021
2021-06-13,Terengganu,38,6,32,2021
2021-06-14,Terengganu,33,10,23,2021
2021-06-15,Terengganu,81,14,67,2021
2021-06-16,Terengganu,73,15,58,2021
2021-06-17,Terengganu,76,20,56,2021
2021-06-18,Terengganu,58,18,40,2021
2021-06-19,Terengganu,44,6,38,2021
2021-06-20,Terengganu,65,11,54,2021
2021-06-21,Terengganu,57,9,48,2021
2021-06-22,Terengganu,12,0,12,2021
2021-06-23,Terengganu,15,4,11,2021
2021-06-24,Terengganu,11,0,11,2021
2021-06-25,Terengganu,107,17,90,2021
2021-06-26,Terengganu,79,18,61,2021
2021-06-27,Terengganu,54,9,45,2021
2021-06-28,Terengganu,7,0,7,2021
2021-06-29,Terengganu,83,14,69,2021
2021-06-30,Terengganu,109,24,85,2021
2021-07-01,Terengganu,13,0,13,2021
2021-07-02,Terengganu,66,14,52,2021
2021-07-03,Terengganu,79,17,62,2021
2021-07-04,Terengganu,77,23,54,2021
2021-07-05,Terengganu,14,0,14,2021
2021-07-06,Terengganu,18,0,18,2021
2021-07-07,Terengganu,28,7,21,2021
2021-07-08,Terengganu,11,1,10,2021
2021-07-09,Terengganu,24,7,17,2021
2021-07-10,Terengganu,61,16,45,2021
2021-07-11,Terengganu,43,8,35,2021
2021-07-12,Terengganu,25,4,21,2021
2021-07-13,Terengganu,20,1,19,2021
2021-07-14,Terengganu,24,2,22,2021
2021-07-15,Terengganu,19,3,16,2021
2021-07-16,Terengganu,92,46,46,2021
2021-07-17,Terengganu,123,23,100,2021
2021-07-18,Terengganu,11,2,9,2021
2021-07-19,Terengganu,10,0,10,2021
2021-07-20,Terengganu,0,0,0,2021
2021-07-21,Terengganu,0,0,0,2021
2021-07-22,Terengganu,57,11,46,2021
2021-07-23,Terengganu,19,0,19,2021
2021-07-24,Terengganu,32,11,21,2021
2021-07-25,Terengganu,29,4,25,2021
2021-07-26,Terengganu,80,28,52,2021
2021-07-27,Terengganu,107,45,62,2021
2021-07-28,Terengganu,10,1,9,2021
2021-07-29,Terengganu,12,1,11,2021
2021-07-30,Terengganu,52,8,44,2021
2021-07-31,Terengganu,42,10,32,2021
2021-08-01,Terengganu,10,0,10,2021
2021-08-02,Terengganu,45,6,39,2021
2021-08-03,Terengganu,40,4,36,2021
2021-08-04,Terengganu,24,3,21,2021
2021-08-05,Terengganu,84,25,59,2021
2021-08-06,Terengganu,49,12,37,2021
2021-08-07,Terengganu,35,12,23,2021
2021-08-08,Terengganu,13,1,12,2021
2021-08-09,Terengganu,11,0,11,2021
2021-08-10,Terengganu,67,16,51,2021
2021-08-11,Terengganu,37,6,31,2021
2021-08-12,Terengganu,5,0,5,2021
2021-08-13,Terengganu,52,18,34,2021
2021-08-14,Terengganu,58,6,52,2021
2021-08-15,Terengganu,30,9,21,2021
2021-08-16,Terengganu,18,0,18,2021
2021-08-17,Terengganu,68,20,48,2021
2021-08-18,Terengganu,54,11,43,2021
2021-08-19,Terengganu,122,29,93,2021
2021-08-20,Terengganu,46,18,28,2021
2021-08-21,Terengganu,51,7,44,2021
2021-08-22,Terengganu,34,7,27,2021
2021-08-23,Terengganu,57,13,44,2021
2021-08-24,Terengganu,11,0,11,2021
2021-08-25,Terengganu,7,0,7,2021
2021-08-26,Terengganu,37,15,22,2021
2021-08-27,Terengganu,42,19,23,2021
2021-08-28,Terengganu,9,1,8,2021
2021-08-29,Terengganu,11,0,11,2021
2021-08-30,Terengganu,165,27,138,2021
2021-08-31,Terengganu,30,8,22,2021
2021-09-01,Terengganu,2,0,2,2021
2021-09-02,Terengganu,31,4,27,2021
2021-09-03,Terengganu,62,15,47,2021
2021-09-04,Terengganu,58,9,49,2021
2021-09-05,Terengganu,28,2,26,2021
2021-09-06,Terengganu,42,2,40,2021
2021-09-07,Terengganu,37,9,28,2021
2021-09-08,Terengganu,29,3,26,2021
2021-09-09,Terengganu,28,0,28,2021
2021-09-10,Terengganu,35,9,26,2021
2021-09-11,Terengganu,46,28,18,2021
2021-09-12,Terengganu,22,4,18,2021
2021-09-13,Terengganu,11,0,11,2021
2021-09-14,Terengganu,22,0,22,2021
2021-09-15,Terengganu,203,48,155,2021
2021-09-16,Terengganu,2,0,2,2021
2021-09-17,Terengganu,33,8,25,2021
2021-09-18,Terengganu,53,7,46,2021
2021-09-19,Terengganu,28,3,25,2021
2021-09-20,Terengganu,44,10,34,2021
2021-09-21,Terengganu,38,14,24,2021
2021-09-22,Terengganu,18,1,17,2021
2021-09-23,Terengganu,21,2,19,2021
2021-09-24,Terengganu,51,17,34,2021
2021-09-25,Terengganu,87,14,73,2021
2021-09-26,Terengganu,36,2,34,2021
2021-09-27,Terengganu,65,15,50,2021
2021-09-28,Terengganu,11,0,11,2021
2021-09-29,Terengganu,39,3,36,2021
2021-09-30,Terengganu,49,9,40,2021
2021-10-01,Terengganu,82,28,54,2021
2021-10-02,Terengganu,27,2,25,2021
2021-10-03,Terengganu,13,0,13,2021
2021-10-04,Terengganu,35,4,31,2021
2021-10-05,Terengganu,54,6,48,2021
2021-10-06,Terengganu,37,2,35,2021
2021-10-07,Terengganu,43,6,37,2021
2021-10-08,Terengganu,65,6,59,2021
2021-10-09,Terengganu,106,22,84,2021
2021-10-10,Terengganu,32,8,24,2021
2021-10-11,Terengganu,12,1,11,2021
2021-10-12,Terengganu,24,5,19,2021
2021-10-13,Terengganu,55,10,45,2021
2021-10-14,Terengganu,41,5,36,2021
2021-10-15,Terengganu,112,18,94,2021
2021-10-16,Terengganu,88,17,71,2021
2021-10-17,Terengganu,12,0,12,2021
2021-10-18,Terengganu,26,3,23,2021
2021-10-19,Terengganu,132,26,106,2021
2021-10-20,Terengganu,6,0,6,2021
2021-10-21,Terengganu,41,16,25,2021
2021-10-22,Terengganu,77,8,69,2021
2021-10-23,Terengganu,30,7,23,2021
2021-10-24,Terengganu,43,5,38,2021
2021-10-25,Terengganu,10,0,10,2021
2021-10-26,Terengganu,18,2,16,2021
2021-10-27,Terengganu,45,9,36,2021
2021-10-28,Terengganu,19,3,16,2021
2021-10-29,Terengganu,57,20,37,2021
2021-10-30,Terengganu,89,19,70,2021
2021-10-31,Terengganu,10,1,9,2021
2021-11-01,Terengganu,5,0,5,2021
2021-11-02,Terengganu,24,3,21,2021
2021-11-03,Terengganu,44,3,41,2021
2021-11-04,Terengganu,67,5,62,2021
2021-11-05,Terengganu,106,16,90,2021
2021-11-06,Terengganu,86,14,72,2021
2021-11-07,Terengganu,27,4,23,2021
2021-11-08,Terengganu,26,6,20,2021
2021-11-09,Terengganu,48,10,38,2021
2021-11-10,Terengganu,21,3,18,2021
2021-11-11,Terengganu,19,2,17,2021
2021-11-12,Terengganu,9,3,6,2021
2021-11-13,Terengganu,56,19,37,2021
2021-11-14,Terengganu,16,0,16,2021
2021-11-15,Terengganu,32,4,28,2021
2021-11-16,Terengganu,48,7,41,2021
2021-11-17,Terengganu,15,1,14,2021
2021-11-18,Terengganu,93,19,74,2021
2021-11-19,Terengganu,77,18,59,2021
2021-11-20,Terengganu,28,5,23,2021
2021-11-21,Terengganu,71,4,67,2021
2021-11-22,Terengganu,57,12,45,2021
2021-11-23,Terengganu,21,5,16,2021
2021-11-24,Terengganu,21,4,17,2021
2021-11-25,Terengganu,39,4,35,2021
2021-11-26,Terengganu,68,11,57,2021
2021-11-27,Terengganu,34,11,23,2021
2021-11-28,Terengganu,51,14,37,2021
2021-11-29,Terengganu,41,5,36,2021
2021-11-30,Terengganu,34,4,30,2021
2021-12-01,Terengganu,11,0,11,2021
2021-12-02,Terengganu,24,6,18,2021
2021-12-03,Terengganu,31,8,23,2021
2021-12-04,Terengganu,39,4,35,2021
2021-12-05,Terengganu,39,4,35,2021
2021-12-06,Terengganu,102,42,60,2021
2021-12-07,Terengganu,79,44,35,2021
2021-12-08,Terengganu,10,1,9,2021
2021-12-09,Terengganu,30,6,24,2021
2021-12-10,Terengganu,27,5,22,2021
2021-12-11,Terengganu,45,6,39,2021
2021-12-12,Terengganu,19,3,16,2021
2021-12-13,Terengganu,57,22,35,2021
2021-12-14,Terengganu,95,25,70,2021
2021-12-15,Terengganu,58,13,45,2021
2021-12-16,Terengganu,75,26,49,2021
2021-12-17,Terengganu,10,0,10,2021
2021-12-18,Terengganu,20,1,19,2021
2021-12-19,Terengganu,84,53,31,2021
2021-12-20,Terengganu,91,36,55,2021
2021-12-21,Terengganu,103,44,59,2021
2021-12-22,Terengganu,33,5,28,2021
2021-12-23,Terengganu,27,4,23,2021
2021-12-24,Terengganu,67,17,50,2021
2021-12-25,Terengganu,75,21,54,2021
2021-12-26,Terengganu,0,0,0,2021
2021-12-27,Terengganu,206,42,164,2021
2021-12-28,Terengganu,13,0,13,2021
2021-12-29,Terengganu,288,54,234,2021
2021-12-30,Terengganu,20,2,18,2021
2021-12-31,Terengganu,36,2,34,2021
2022-01-01,Terengganu,39,7,32,2022
2022-01-02,Terengganu,24,3,21,2022
2022-01-03,Terengganu,26,2,24,2022
2022-01-04,Terengganu,18,1,17,2022
2022-01-05,Terengganu,91,58,33,2022
2022-01-06,Terengganu,7,0,7,2022
2022-01-07,Terengganu,38,10,28,2022
2022-01-08,Terengganu,49,11,38,2022
2022-01-09,Terengganu,9,1,8,2022
2022-01-10,Terengganu,58,7,51,2022
2022-01-11,Terengganu,6,0,6,2022
2022-01-12,Terengganu,17,3,14,2022
2022-01-13,Terengganu,160,111,49,2022
2022-01-14,Terengganu,48,4,44,2022
2022-01-15,Terengganu,88,10,78,2022
2022-01-16,Terengganu,34,4,30,2022
2022-01-17,Terengganu,6,0,6,2022
2022-01-18,Terengganu,62,18,44,2022
2022-01-19,Terengganu,47,18,29,2022
2022-01-20,Terengganu,34,14,20,2022
2022-01-21,Terengganu,120,47,73,2022
2022-01-22,Terengganu,120,79,41,2022
2022-01-23,Terengganu,7,0,7,2022
2022-01-24,Terengganu,6,0,6,2022
2022-01-25,Terengganu,38,5,33,2022
2022-01-26,Terengganu,34,11,23,2022
2022-01-27,Terengganu,66,14,52,2022
2022-01-28,Terengganu,22,2,20,2022
2022-01-29,Terengganu,62,9,53,2022
2022-01-30,Terengganu,44,4,40,2022
2022-01-31,Terengganu,47,8,39,2022
2022-02-01,Terengganu,0,0,0,2022
2022-02-02,Terengganu,43,3,40,2022
2022-02-03,Terengganu,18,1,17,2022
2022-02-04,Terengganu,18,1,17,2022
2022-02-05,Terengganu,44,5,39,2022
2022-02-06,Terengganu,9,0,9,2022
2022-02-07,Terengganu,76,14,62,2022
2022-02-08,Terengganu,12,0,12,2022
2022-02-09,Terengganu,78,7,71,2022
2022-02-10,Terengganu,33,6,27,2022
2022-02-11,Terengganu,36,12,24,2022
2022-02-12,Terengganu,49,11,38,2022
2022-02-13,Terengganu,25,0,25,2022
2022-02-14,Terengganu,71,19,52,2022
2022-02-15,Terengganu,83,52,31,2022
2022-02-16,Terengganu,7,0,7,2022
2022-02-17,Terengganu,44,3,41,2022
2022-02-18,Terengganu,37,4,33,2022
2022-02-19,Terengganu,72,18,54,2022
2022-02-20,Terengganu,8,0,8,2022
2022-02-21,Terengganu,39,17,22,2022
2022-02-22,Terengganu,30,9,21,2022
2022-02-23,Terengganu,46,9,37,2022
2022-02-24,Terengganu,60,14,46,2022
2022-02-25,Terengganu,29,3,26,2022
2022-02-26,Terengganu,73,11,62,2022
2022-02-27,Terengganu,22,2,20,2022
2022-02-28,Terengganu,6,1,5,2022
2022-03-01,Terengganu,24,3,21,2022
2022-03-02,Terengganu,23,1,22,2022
2022-03-03,Terengganu,27,4,23,2022
2022-03-04,Terengganu,57,9,48,2022
2022-03-05,Terengganu,13,1,12,2022
2022-03-06,Terengganu,32,3,29,2022
2022-03-07,Terengganu,29,3,26,2022
2022-03-08,Terengganu,8,1,7,2022
2022-03-09,Terengganu,20,5,15,2022
2022-03-10,Terengganu,125,31,94,2022
2022-03-11,Terengganu,28,4,24,2022
2022-03-12,Terengganu,57,14,43,2022
2022-03-13,Terengganu,38,3,35,2022
2022-03-14,Terengganu,113,36,77,2022
2022-03-15,Terengganu,100,54,46,2022
2022-03-16,Terengganu,9,0,9,2022
2022-03-17,Terengganu,32,5,27,2022
2022-03-18,Terengganu,26,6,20,2022
2022-03-19,Terengganu,71,37,34,2022
2022-03-20,Terengganu,57,24,33,2022
2022-03-21,Terengganu,6,0,6,2022
2022-03-22,Terengganu,11,1,10,2022
2022-03-23,Terengganu,64,16,48,2022
2022-03-24,Terengganu,22,3,19,2022
2022-03-25,Terengganu,91,20,71,2022
2022-03-26,Terengganu,102,26,76,2022
2022-03-27,Terengganu,47,18,29,2022
2022-03-28,Terengganu,40,7,33,2022
2022-03-29,Terengganu,201,33,168,2022
2022-03-30,Terengganu,20,1,19,2022
2022-03-31,Terengganu,250,51,199,2022
2022-04-01,Terengganu,92,20,72,2022
2022-04-02,Terengganu,28,4,24,2022
2022-04-03,Terengganu,1,0,1,2022
2022-04-04,Terengganu,40,7,33,2022
2022-04-05,Terengganu,26,4,22,2022
2022-04-06,Terengganu,51,5,46,2022
2022-04-07,Terengganu,62,21,41,2022
2022-04-08,Terengganu,59,15,44,2022
2022-04-09,Terengganu,40,8,32,2022
2022-04-10,Terengganu,39,4,35,2022
2022-04-11,Terengganu,25,4,21,2022
2022-04-12,Terengganu,46,4,42,2022
2022-04-13,Terengganu,48,7,41,2022
2022-04-14,Terengganu,55,27,28,2022
2022-04-15,Terengganu,55,6,49,2022
2022-04-16,Terengganu,37,7,30,2022
2022-04-17,Terengganu,54,12,42,2022
2022-04-18,Terengganu,35,9,26,2022
2022-04-19,Terengganu,139,56,83,2022
2022-04-20,Terengganu,152,80,72,2022
2022-04-21,Terengganu,39,3,36,2022
2022-04-22,Terengganu,88,17,71,2022
2022-04-23,Terengganu,45,6,39,2022
2022-04-24,Terengganu,51,2,49,2022
2022-04-25,Terengganu,41,4,37,2022
2022-04-26,Terengganu,50,7,43,2022
2022-04-27,Terengganu,18,7,11,2022
2022-04-28,Terengganu,37,10,27,2022
2022-04-29,Terengganu,60,8,52,2022
2022-04-30,Terengganu,36,9,27,2022
2022-05-01,Terengganu,24,2,22,2022
2022-05-02,Terengganu,0,0,0,2022
2022-05-03,Terengganu,0,0,0,2022
2022-05-04,Terengganu,0,0,0,2022
2022-05-05,Terengganu,13,0,13,2022
2022-05-06,Terengganu,44,15,29,2022
2022-05-07,Terengganu,60,17,43,2022
2022-05-08,Terengganu,38,5,33,2022
2022-05-09,Terengganu,33,3,30,2022
2022-05-10,Terengganu,21,2,19,2022
2022-05-11,Terengganu,24,4,20,2022
2022-05-12,Terengganu,101,36,65,2022
2022-05-13,Terengganu,60,14,46,2022
2022-05-14,Terengganu,70,13,57,2022
2022-05-15,Terengganu,47,8,39,2022
2022-05-16,Terengganu,104,62,42,2022
2022-05-17,Terengganu,112,63,49,2022
2022-05-18,Terengganu,42,6,36,2022
2022-05-19,Terengganu,8,0,8,2022
2022-05-20,Terengganu,48,6,42,2022
2022-05-21,Terengganu,46,7,39,2022
2022-05-22,Terengganu,52,14,38,2022
2022-05-23,Terengganu,39,14,25,2022
2022-05-24,Terengganu,48,27,21,2022
2022-05-25,Terengganu,8,0,8,2022
2022-05-26,Terengganu,57,8,49,2022
2022-05-27,Terengganu,14,2,12,2022
2022-05-28,Terengganu,51,6,45,2022
2022-05-29,Terengganu,37,2,35,2022
2022-05-30,Terengganu,11,0,11,2022
2022-05-31,Terengganu,49,11,38,2022
2022-06-01,Terengganu,10,0,10,2022
2022-06-02,Terengganu,11,0,11,2022
2022-06-03,Terengganu,61,11,50,2022
2022-06-04,Terengganu,36,9,27,2022
2022-06-05,Terengganu,34,3,31,2022
2022-06-06,Terengganu,51,12,39,2022
2022-06-07,Terengganu,88,44,44,2022
2022-06-08,Terengganu,83,42,41,2022
2022-06-09,Terengganu,17,0,17,2022
2022-06-10,Terengganu,29,4,25,2022
2022-06-11,Terengganu,66,8,58,2022
2022-06-12,Terengganu,43,18,25,2022
2022-06-13,Terengganu,83,58,25,2022
2022-06-14,Terengganu,152,74,78,2022
2022-06-15,Terengganu,11,1,10,2022
2022-06-16,Terengganu,9,1,8,2022
2022-06-17,Terengganu,0,0,0,2022
2022-06-18,Terengganu,193,25,168,2022
2022-06-19,Terengganu,10,1,9,2022
2022-06-20,Terengganu,15,3,12,2022
2022-06-21,Terengganu,104,50,54,2022
2022-06-22,Terengganu,55,10,45,2022
2022-06-23,Terengganu,102,36,66,2022
2022-06-24,Terengganu,55,18,37,2022
2022-06-25,Terengganu,52,13,39,2022
2022-06-26,Terengganu,76,17,59,2022
2022-06-27,Terengganu,21,1,20,2022
2022-06-28,Terengganu,64,9,55,2022
2022-06-29,Terengganu,82,29,53,2022
2022-06-30,Terengganu,57,9,48,2022
2022-07-01,Terengganu,0,0,0,2022
2022-07-02,Terengganu,52,12,40,2022
2022-07-03,Terengganu,69,35,34,2022
2022-07-04,Terengganu,6,1,5,2022
2022-07-05,Terengganu,105,40,65,2022
2022-07-06,Terengganu,54,6,48,2022
2022-07-07,Terengganu,31,5,26,2022
2022-07-08,Terengganu,44,8,36,2022
2022-07-09,Terengganu,0,0,0,2022
2022-07-10,Terengganu,0,0,0,2022
2022-07-11,Terengganu,0,0,0,2022
2022-07-12,Terengganu,43,10,33,2022
2022-07-13,Terengganu,68,17,51,2022
2022-07-14,Terengganu,47,7,40,2022
2022-07-15,Terengganu,76,19,57,2022
2022-07-16,Terengganu,36,12,24,2022
2022-07-17,Terengganu,32,13,19,2022
2022-07-18,Terengganu,34,1,33,2022
2022-07-19,Terengganu,36,5,31,2022
2022-07-20,Terengganu,35,18,17,2022
2022-07-21,Terengganu,16,0,16,2022
2022-07-22,Terengganu,23,6,17,2022
2022-07-23,Terengganu,73,18,55,2022
2022-07-24,Terengganu,14,0,14,2022
2022-07-25,Terengganu,6,1,5,2022
2022-07-26,Terengganu,61,39,22,2022
2022-07-27,Terengganu,23,8,15,2022
2022-07-28,Terengganu,37,8,29,2022
2022-07-29,Terengganu,51,9,42,2022
2022-07-30,Terengganu,14,4,10,2022
2022-07-31,Terengganu,66,23,43,2022
2022-08-01,Terengganu,9,0,9,2022
2022-08-02,Terengganu,44,9,35,2022
2022-08-03,Terengganu,32,8,24,2022
2022-08-04,Terengganu,8,0,8,2022
2022-08-05,Terengganu,35,8,27,2022
2022-08-06,Terengganu,91,15,76,2022
2022-08-07,Terengganu,35,9,26,2022
2022-08-08,Terengganu,43,14,29,2022
2022-08-09,Terengganu,73,8,65,2022
2022-08-10,Terengganu,53,13,40,2022
2022-08-11,Terengganu,74,10,64,2022
2022-08-12,Terengganu,49,7,42,2022
2022-08-13,Terengganu,103,86,17,2022
2022-08-14,Terengganu,12,0,12,2022
2022-08-15,Terengganu,78,16,62,2022
2022-08-16,Terengganu,58,16,42,2022
2022-08-17,Terengganu,95,24,71,2022
2022-08-18,Terengganu,45,7,38,2022
2022-08-19,Terengganu,101,17,84,2022
2022-08-20,Terengganu,105,26,79,2022
2022-08-21,Terengganu,48,8,40,2022
2022-08-22,Terengganu,42,19,23,2022
2022-08-23,Terengganu,57,41,16,2022
2022-08-24,Terengganu,127,46,81,2022
2022-08-25,Terengganu,67,25,42,2022
2022-08-26,Terengganu,42,11,31,2022
2022-08-27,Terengganu,89,16,73,2022
2022-08-28,Terengganu,61,24,37,2022
2022-08-29,Terengganu,182,27,155,2022
2022-08-30,Terengganu,5,0,5,2022
2022-08-31,Terengganu,157,27,130,2022
2022-09-01,Terengganu,63,14,49,2022
2022-09-02,Terengganu,45,8,37,2022
2022-09-03,Terengganu,0,0,0,2022
2022-09-04,Terengganu,32,10,22,2022
2022-09-05,Terengganu,13,0,13,2022
2022-09-06,Terengganu,124,68,56,2022
2022-09-07,Terengganu,14,0,14,2022
2022-09-08,Terengganu,31,6,25,2022
2022-09-09,Terengganu,56,10,46,2022
2022-09-10,Terengganu,50,10,40,2022
2022-09-11,Terengganu,0,0,0,2022
2022-09-12,Terengganu,66,25,41,2022
2022-09-13,Terengganu,107,92,15,2022
2022-09-14,Terengganu,0,0,0,2022
2022-09-15,Terengganu,150,116,34,2022
2022-09-16,Terengganu,0,0,0,2022
2022-09-17,Terengganu,100,20,80,2022
2022-09-18,Terengganu,98,43,55,2022
2022-09-19,Terengganu,9,1,8,2022
2022-09-20,Terengganu,24,4,20,2022
2022-09-21,Terengganu,11,0,11,2022
2022-09-22,Terengganu,109,14,95,2022
2022-09-23,Terengganu,86,15,71,2022
2022-09-24,Terengganu,26,7,19,2022
2022-09-25,Terengganu,14,0,14,2022
2022-09-26,Terengganu,55,21,34,2022
2022-09-27,Terengganu,4,0,4,2022
2022-09-28,Terengganu,10,0,10,2022
2022-09-29,Terengganu,44,6,38,2022
2022-09-30,Terengganu,109,11,98,2022
2022-10-01,Terengganu,86,24,62,2022
2022-10-02,Terengganu,54,9,45,2022
2022-10-03,Terengganu,16,1,15,2022
2022-10-04,Terengganu,92,50,42,2022
2022-10-05,Terengganu,17,2,15,2022
2022-10-06,Terengganu,51,31,20,2022
2022-10-07,Terengganu,81,18,63,2022
2022-10-08,Terengganu,110,37,73,2022
2022-10-09,Terengganu,36,3,33,2022
2022-10-10,Terengganu,66,32,34,2022
2022-10-11,Terengganu,55,7,48,2022
2022-10-12,Terengganu,169,38,131,2022
2022-10-13,Terengganu,7,1,6,2022
2022-10-14,Terengganu,70,6,64,2022
2022-10-15,Terengganu,0,0,0,2022
2022-10-16,Terengganu,27,2,25,2022
2022-10-17,Terengganu,85,59,26,2022
2022-10-18,Terengganu,36,15,21,2022
2022-10-19,Terengganu,8,0,8,2022
2022-10-20,Terengganu,208,68,140,2022
2022-10-21,Terengganu,0,0,0,2022
2022-10-22,Terengganu,112,16,96,2022
2022-10-23,Terengganu,15,0,15,2022
2022-10-24,Terengganu,64,15,49,2022
2022-10-25,Terengganu,9,1,8,2022
2022-10-26,Terengganu,102,59,43,2022
2022-10-27,Terengganu,48,15,33,2022
2022-10-28,Terengganu,71,16,55,2022
2022-10-29,Terengganu,26,4,22,2022
2022-10-30,Terengganu,12,0,12,2022
2022-10-31,Terengganu,4,0,4,2022
2022-11-01,Terengganu,149,69,80,2022
2022-11-02,Terengganu,186,100,86,2022
2022-11-03,Terengganu,37,16,21,2022
2022-11-04,Terengganu,91,43,48,2022
2022-11-05,Terengganu,53,9,44,2022
2022-11-06,Terengganu,9,1,8,2022
2022-11-07,Terengganu,37,9,28,2022
2022-11-08,Terengganu,26,10,16,2022
2022-11-09,Terengganu,95,44,51,2022
2022-11-10,Terengganu,7,0,7,2022
2022-11-11,Terengganu,33,6,27,2022
2022-11-12,Terengganu,26,3,23,2022
2022-11-13,Terengganu,7,0,7,2022
2022-11-14,Terengganu,83,40,43,2022
2022-11-15,Terengganu,65,34,31,2022
2022-11-16,Terengganu,11,0,11,2022
2022-11-17,Terengganu,23,0,23,2022
2022-11-18,Terengganu,65,13,52,2022
2022-11-19,Terengganu,0,0,0,2022
2022-11-20,Terengganu,0,0,0,2022
2022-11-21,Terengganu,50,6,44,2022
2022-11-22,Terengganu,49,5,44,2022
2022-11-23,Terengganu,110,48,62,2022
2022-11-24,Terengganu,6,0,6,2022
2022-11-25,Terengganu,68,17,51,2022
2022-11-26,Terengganu,58,10,48,2022
2022-11-27,Terengganu,66,10,56,2022
2022-11-28,Terengganu,44,4,40,2022
2022-11-29,Terengganu,88,58,30,2022
2022-11-30,Terengganu,7,1,6,2022
2022-12-01,Terengganu,7,0,7,2022
2022-12-02,Terengganu,70,10,60,2022
2022-12-03,Terengganu,43,7,36,2022
2022-12-04,Terengganu,36,24,12,2022
2022-12-05,Terengganu,79,15,64,2022
2022-12-06,Terengganu,56,20,36,2022
2022-12-07,Terengganu,69,38,31,2022
2022-12-08,Terengganu,41,3,38,2022
2022-12-09,Terengganu,57,5,52,2022
2022-12-10,Terengganu,32,1,31,2022
2022-12-11,Terengganu,114,78,36,2022
2022-12-12,Terengganu,31,6,25,2022
2022-12-13,Terengganu,106,58,48,2022
2022-12-14,Terengganu,56,10,46,2022
2022-12-15,Terengganu,24,5,19,2022
2022-12-16,Terengganu,24,4,20,2022
2022-12-17,Terengganu,39,4,35,2022
2022-12-18,Terengganu,55,9,46,2022
2022-12-19,Terengganu,7,1,6,2022
2022-12-20,Terengganu,42,2,40,2022
2022-12-21,Terengganu,34,5,29,2022
2022-12-22,Terengganu,36,6,30,2022
2022-12-23,Terengganu,46,5,41,2022
2022-12-24,Terengganu,38,9,29,2022
2022-12-25,Terengganu,73,17,56,2022
2022-12-26,Terengganu,21,2,19,2022
2022-12-27,Terengganu,90,28,62,2022
2022-12-28,Terengganu,91,26,65,2022
2022-12-29,Terengganu,35,5,30,2022
2022-12-30,Terengganu,58,16,42,2022
2022-12-31,Terengganu,90,10,80,2022
2023-01-01,Terengganu,24,0,24,2023
2023-01-02,Terengganu,36,5,31,2023
2023-01-03,Terengganu,42,2,40,2023
2023-01-04,Terengganu,49,9,40,2023
2023-01-05,Terengganu,53,10,43,2023
2023-01-06,Terengganu,20,4,16,2023
2023-01-07,Terengganu,59,4,55,2023
2023-01-08,Terengganu,48,35,13,2023
2023-01-09,Terengganu,100,56,44,2023
2023-01-10,Terengganu,11,0,11,2023
2023-01-11,Terengganu,105,56,49,2023
2023-01-12,Terengganu,84,49,35,2023
2023-01-13,Terengganu,0,0,0,2023
2023-01-14,Terengganu,70,11,59,2023
2023-01-15,Terengganu,57,6,51,2023
2023-01-16,Terengganu,38,14,24,2023
2023-01-17,Terengganu,25,3,22,2023
2023-01-18,Terengganu,140,70,70,2023
2023-01-19,Terengganu,18,1,17,2023
2023-01-20,Terengganu,17,9,8,2023
2023-01-21,Terengganu,94,14,80,2023
2023-01-22,Terengganu,34,6,28,2023
2023-01-23,Terengganu,62,15,47,2023
2023-01-24,Terengganu,10,0,10,2023
2023-01-25,Terengganu,66,32,34,2023
2023-01-26,Terengganu,12,0,12,2023
2023-01-27,Terengganu,58,5,53,2023
2023-01-28,Terengganu,43,3,40,2023
2023-01-29,Terengganu,21,2,19,2023
2023-01-30,Terengganu,41,7,34,2023
2023-01-31,Terengganu,55,4,51,2023
2023-02-01,Terengganu,273,43,230,2023
2023-02-02,Terengganu,1,0,1,2023
2023-02-03,Terengganu,38,11,27,2023
2023-02-04,Terengganu,27,4,23,2023
2023-02-05,Terengganu,46,2,44,2023
2023-02-06,Terengganu,52,29,23,2023
2023-02-07,Terengganu,50,9,41,2023
2023-02-08,Terengganu,8,0,8,2023
2023-02-09,Terengganu,11,0,11,2023
2023-02-10,Terengganu,0,0,0,2023
2023-02-11,Terengganu,45,6,39,2023
2023-02-12,Terengganu,31,2,29,2023
2023-02-13,Terengganu,28,14,14,2023
2023-02-14,Terengganu,41,25,16,2023
2023-02-15,Terengganu,47,2,45,2023
2023-02-16,Terengganu,40,4,36,2023
2023-02-17,Terengganu,58,6,52,2023
2023-02-18,Terengganu,17,3,14,2023
2023-02-19,Terengganu,41,8,33,2023
2023-02-20,Terengganu,76,24,52,2023
2023-02-21,Terengganu,22,12,10,2023
2023-02-22,Terengganu,45,19,26,2023
2023-02-23,Terengganu,67,42,25,2023
2023-02-24,Terengganu,22,2,20,2023
2023-02-25,Terengganu,38,16,22,2023
2023-02-26,Terengganu,63,49,14,2023
2023-02-27,Terengganu,66,21,45,2023
2023-02-28,Terengganu,131,61,70,2023
2023-03-01,Terengganu,13,2,11,2023
2023-03-02,Terengganu,52,23,29,2023
2023-03-03,Terengganu,88,3,85,2023
2023-03-04,Terengganu,69,18,51,2023
2023-03-05,Terengganu,45,5,40,2023
2023-03-06,Terengganu,77,20,57,2023
2023-03-07,Terengganu,54,15,39,2023
2023-03-08,Terengganu,81,29,52,2023
2023-03-09,Terengganu,37,5,32,2023
2023-03-10,Terengganu,93,14,79,2023
2023-03-11,Terengganu,97,11,86,2023
2023-03-12,Terengganu,6,0,6,2023
2023-03-13,Terengganu,97,20,77,2023
2023-03-14,Terengganu,117,55,62,2023
2023-03-15,Terengganu,32,4,28,2023
2023-03-16,Terengganu,95,26,69,2023
2023-03-17,Terengganu,63,12,51,2023
2023-03-18,Terengganu,132,106,26,2023
2023-03-19,Terengganu,48,19,29,2023
2023-03-20,Terengganu,124,19,105,2023
2023-03-21,Terengganu,43,9,34,2023
2023-03-22,Terengganu,21,0,21,2023
2023-03-23,Terengganu,0,0,0,2023
2023-03-24,Terengganu,0,0,0,2023
2023-03-25,Terengganu,119,32,87,2023
2023-03-26,Terengganu,32,7,25,2023
2023-03-27,Terengganu,46,3,43,2023
2023-03-28,Terengganu,39,8,31,2023
2023-03-29,Terengganu,37,10,27,2023
2023-03-30,Terengganu,62,31,31,2023
2023-03-31,Terengganu,70,16,54,2023
2023-04-01,Terengganu,73,12,61,2023
2023-04-02,Terengganu,44,13,31,2023
2023-04-03,Terengganu,48,9,39,2023
2023-04-04,Terengganu,27,1,26,2023
2023-04-05,Terengganu,92,38,54,2023
2023-04-06,Terengganu,91,44,47,2023
2023-04-07,Terengganu,86,25,61,2023
2023-04-08,Terengganu,64,13,51,2023
2023-04-09,Terengganu,48,16,32,2023
2023-04-10,Terengganu,36,9,27,2023
2023-04-11,Terengganu,56,7,49,2023
2023-04-12,Terengganu,50,13,37,2023
2023-04-13,Terengganu,50,17,33,2023
2023-04-14,Terengganu,76,11,65,2023
2023-04-15,Terengganu,64,16,48,2023
2023-04-16,Terengganu,59,4,55,2023
2023-04-17,Terengganu,81,15,66,2023
2023-04-18,Terengganu,70,13,57,2023
2023-04-19,Terengganu,21,3,18,2023
2023-04-20,Terengganu,4,0,4,2023
2023-04-21,Terengganu,0,0,0,2023
2023-04-22,Terengganu,0,0,0,2023
2023-04-23,Terengganu,0,0,0,2023
2023-04-24,Terengganu,40,11,29,2023
2023-04-25,Terengganu,60,7,53,2023
2023-04-26,Terengganu,60,18,42,2023
2023-04-27,Terengganu,38,5,33,2023
2023-04-28,Terengganu,72,12,60,2023
2023-04-29,Terengganu,48,5,43,2023
2023-04-30,Terengganu,32,3,29,2023
2023-05-01,Terengganu,87,13,74,2023
2023-05-02,Terengganu,11,0,11,2023
2023-05-03,Terengganu,8,1,7,2023
2023-05-04,Terengganu,65,10,55,2023
2023-05-05,Terengganu,41,7,34,2023
2023-05-06,Terengganu,45,14,31,2023
2023-05-07,Terengganu,22,4,18,2023
2023-05-08,Terengganu,4,0,4,2023
2023-05-09,Terengganu,5,0,5,2023
2023-05-10,Terengganu,38,3,35,2023
2023-05-11,Terengganu,8,0,8,2023
2023-05-12,Terengganu,116,49,67,2023
2023-05-13,Terengganu,103,49,54,2023
2023-05-14,Terengganu,13,1,12,2023
2023-05-15,Terengganu,46,1,45,2023
2023-05-16,Terengganu,8,0,8,2023
2023-05-17,Terengganu,87,27,60,2023
2023-05-18,Terengganu,19,4,15,2023
2023-05-19,Terengganu,58,6,52,2023
2023-05-20,Terengganu,90,35,55,2023
2023-05-21,Terengganu,153,55,98,2023
2023-05-22,Terengganu,13,1,12,2023
2023-05-23,Terengganu,26,5,21,2023
2023-05-24,Terengganu,9,1,8,2023
2023-05-25,Terengganu,59,20,39,2023
2023-05-26,Terengganu,60,6,54,2023
2023-05-27,Terengganu,53,12,41,2023
2023-05-28,Terengganu,92,11,81,2023
2023-05-29,Terengganu,43,6,37,2023
2023-05-30,Terengganu,14,0,14,2023
2023-05-31,Terengganu,46,9,37,2023
2023-06-01,Terengganu,31,8,23,2023
2023-06-02,Terengganu,48,6,42,2023
2023-06-03,Terengganu,62,17,45,2023
2023-06-04,Terengganu,13,0,13,2023
2023-06-05,Terengganu,75,9,66,2023
2023-06-06,Terengganu,83,47,36,2023
2023-06-07,Terengganu,6,0,6,2023
2023-06-08,Terengganu,50,16,34,2023
2023-06-09,Terengganu,70,9,61,2023
2023-06-10,Terengganu,82,22,60,2023
2023-06-11,Terengganu,60,4,56,2023
2023-06-12,Terengganu,98,42,56,2023
2023-06-13,Terengganu,91,22,69,2023
2023-06-14,Terengganu,56,5,51,2023
2023-06-15,Terengganu,10,0,10,2023
2023-06-16,Terengganu,37,9,28,2023
2023-06-17,Terengganu,46,20,26,2023
2023-06-18,Terengganu,53,5,48,2023
2023-06-19,Terengganu,84,21,63,2023
2023-06-20,Terengganu,91,38,53,2023
2023-06-21,Terengganu,103,38,65,2023
2023-06-22,Terengganu,66,37,29,2023
2023-06-23,Terengganu,68,11,57,2023
2023-06-24,Terengganu,90,13,77,2023
2023-06-25,Terengganu,13,0,13,2023
2023-06-26,Terengganu,35,6,29,2023
2023-06-27,Terengganu,41,12,29,2023
2023-06-28,Terengganu,42,10,32,2023
2023-06-29,Terengganu,0,0,0,2023
2023-06-30,Terengganu,0,0,0,2023
2023-07-01,Terengganu,40,4,36,2023
2023-07-02,Terengganu,13,1,12,2023
2023-07-03,Terengganu,35,3,32,2023
2023-07-04,Terengganu,61,51,10,2023
2023-07-05,Terengganu,13,1,12,2023
2023-07-06,Terengganu,78,18,60,2023
2023-07-07,Terengganu,70,17,53,2023
2023-07-08,Terengganu,51,12,39,2023
2023-07-09,Terengganu,71,31,40,2023
2023-07-10,Terengganu,7,0,7,2023
2023-07-11,Terengganu,73,15,58,2023
2023-07-12,Terengganu,13,2,11,2023
2023-07-13,Terengganu,52,43,9,2023
2023-07-14,Terengganu,82,12,70,2023
2023-07-15,Terengganu,46,16,30,2023
2023-07-16,Terengganu,8,0,8,2023
2023-07-17,Terengganu,43,9,34,2023
2023-07-18,Terengganu,103,18,85,2023
2023-07-19,Terengganu,41,6,35,2023
2023-07-20,Terengganu,4,0,4,2023
2023-07-21,Terengganu,0,0,0,2023
2023-07-22,Terengganu,269,35,234,2023
2023-07-23,Terengganu,5,1,4,2023
2023-07-24,Terengganu,9,1,8,2023
2023-07-25,Terengganu,11,1,10,2023
2023-07-26,Terengganu,39,17,22,2023
2023-07-27,Terengganu,35,6,29,2023
2023-07-28,Terengganu,32,10,22,2023
2023-07-29,Terengganu,35,10,25,2023
2023-07-30,Terengganu,80,16,64,2023
2023-07-31,Terengganu,42,2,40,2023
2023-08-01,Terengganu,9,0,9,2023
2023-08-02,Terengganu,89,36,53,2023
2023-08-03,Terengganu,44,6,38,2023
2023-08-04,Terengganu,88,16,72,2023
2023-08-05,Terengganu,24,3,21,2023
2023-08-06,Terengganu,51,20,31,2023
2023-08-07,Terengganu,136,20,116,2023
2023-08-08,Terengganu,8,0,8,2023
2023-08-09,Terengganu,109,37,72,2023
2023-08-10,Terengganu,55,9,46,2023
2023-08-11,Terengganu,99,12,87,2023
2023-08-12,Terengganu,0,0,0,2023
2023-08-13,Terengganu,36,5,31,2023
2023-08-14,Terengganu,28,1,27,2023
2023-08-15,Terengganu,8,0,8,2023
2023-08-16,Terengganu,59,5,54,2023
2023-08-17,Terengganu,51,24,27,2023
2023-08-18,Terengganu,60,4,56,2023
2023-08-19,Terengganu,149,119,30,2023
2023-08-20,Terengganu,43,14,29,2023
2023-08-21,Terengganu,97,51,46,2023
2023-08-22,Terengganu,8,1,7,2023
2023-08-23,Terengganu,109,74,35,2023
2023-08-24,Terengganu,46,3,43,2023
2023-08-25,Terengganu,46,9,37,2023
2023-08-26,Terengganu,35,5,30,2023
2023-08-27,Terengganu,67,14,53,2023
2023-08-28,Terengganu,101,40,61,2023
2023-08-29,Terengganu,27,4,23,2023
2023-08-30,Terengganu,30,3,27,2023
2023-08-31,Terengganu,66,10,56,2023
2023-09-01,Terengganu,69,10,59,2023
2023-09-02,Terengganu,54,11,43,2023
2023-09-03,Terengganu,9,0,9,2023
2023-09-04,Terengganu,91,29,62,2023
2023-09-05,Terengganu,36,0,36,2023
2023-09-06,Terengganu,114,32,82,2023
2023-09-07,Terengganu,9,1,8,2023
2023-09-08,Terengganu,0,0,0,2023
2023-09-09,Terengganu,45,7,38,2023
2023-09-10,Terengganu,34,15,19,2023
2023-09-11,Terengganu,30,3,27,2023
2023-09-12,Terengganu,112,35,77,2023
2023-09-13,Terengganu,11,0,11,2023
2023-09-14,Terengganu,40,4,36,2023
2023-09-15,Terengganu,44,16,28,2023
2023-09-16,Terengganu,33,10,23,2023
2023-09-17,Terengganu,25,3,22,2023
2023-09-18,Terengganu,50,21,29,2023
2023-09-19,Terengganu,118,48,70,2023
2023-09-20,Terengganu,40,4,36,2023
2023-09-21,Terengganu,47,10,37,2023
2023-09-22,Terengganu,35,5,30,2023
2023-09-23,Terengganu,108,19,89,2023
2023-09-24,Terengganu,65,5,60,2023
2023-09-25,Terengganu,120,79,41,2023
2023-09-26,Terengganu,5,0,5,2023
2023-09-27,Terengganu,35,3,32,2023
2023-09-28,Terengganu,17,2,15,2023
2023-09-29,Terengganu,51,8,43,2023
2023-09-30,Terengganu,82,13,69,2023
2023-10-01,Terengganu,18,2,16,2023
2023-10-02,Terengganu,77,28,49,2023
2023-10-03,Terengganu,100,50,50,2023
2023-10-04,Terengganu,86,60,26,2023
2023-10-05,Terengganu,11,4,7,2023
2023-10-06,Terengganu,45,6,39,2023
2023-10-07,Terengganu,35,8,27,2023
2023-10-08,Terengganu,89,76,13,2023
2023-10-09,Terengganu,7,0,7,2023
2023-10-10,Terengganu,36,4,32,2023
2023-10-11,Terengganu,66,13,53,2023
2023-10-12,Terengganu,5,0,5,2023
2023-10-13,Terengganu,140,79,61,2023
2023-10-14,Terengganu,127,71,56,2023
2023-10-15,Terengganu,42,7,35,2023
2023-10-16,Terengganu,39,18,21,2023
2023-10-17,Terengganu,40,14,26,2023
2023-10-18,Terengganu,110,53,57,2023
2023-10-19,Terengganu,92,13,79,2023
2023-10-20,Terengganu,51,27,24,2023
2023-10-21,Terengganu,61,38,23,2023
2023-10-22,Terengganu,44,7,37,2023
2023-10-23,Terengganu,88,45,43,2023
2023-10-24,Terengganu,114,36,78,2023
2023-10-25,Terengganu,78,45,33,2023
2023-10-26,Terengganu,26,0,26,2023
2023-10-27,Terengganu,32,4,28,2023
2023-10-28,Terengganu,62,10,52,2023
2023-10-29,Terengganu,39,5,34,2023
2023-10-30,Terengganu,5,0,5,2023
2023-10-31,Terengganu,54,20,34,2023
2023-11-01,Terengganu,147,74,73,2023
2023-11-02,Terengganu,142,68,74,2023
2023-11-03,Terengganu,42,7,35,2023
2023-11-04,Terengganu,43,12,31,2023
2023-11-05,Terengganu,5,1,4,2023
2023-11-06,Terengganu,6,0,6,2023
2023-11-07,Terengganu,32,5,27,2023
2023-11-08,Terengganu,45,12,33,2023
2023-11-09,Terengganu,45,10,35,2023
2023-11-10,Terengganu,0,0,0,2023
2023-11-11,Terengganu,34,5,29,2023
2023-11-12,Terengganu,51,2,49,2023
2023-11-13,Terengganu,37,12,25,2023
2023-11-14,Terengganu,62,36,26,2023
2023-11-15,Terengganu,7,0,7,2023
2023-11-16,Terengganu,40,23,17,2023
2023-11-17,Terengganu,62,15,47,2023
2023-11-18,Terengganu,41,18,23,2023
2023-11-19,Terengganu,46,12,34,2023
2023-11-20,Terengganu,68,12,56,2023
2023-11-21,Terengganu,77,41,36,2023
2023-11-22,Terengganu,106,27,79,2023
2023-11-23,Terengganu,42,5,37,2023
2023-11-24,Terengganu,85,13,72,2023
2023-11-25,Terengganu,65,11,54,2023
2023-11-26,Terengganu,30,5,25,2023
2023-11-27,Terengganu,186,113,73,2023
2023-11-28,Terengganu,36,3,33,2023
2023-11-29,Terengganu,10,0,10,2023
2023-11-30,Terengganu,73,34,39,2023
2023-12-01,Terengganu,17,1,16,2023
2023-12-02,Terengganu,50,3,47,2023
2023-12-03,Terengganu,43,37,6,2023
2023-12-04,Terengganu,61,16,45,2023
2023-12-05,Terengganu,35,7,28,2023
2023-12-06,Terengganu,52,6,46,2023
2023-12-07,Terengganu,124,61,63,2023
2023-12-08,Terengganu,80,6,74,2023
2023-12-09,Terengganu,41,6,35,2023
2023-12-10,Terengganu,54,6,48,2023
2023-12-11,Terengganu,34,14,20,2023
2023-12-12,Terengganu,68,11,57,2023
2023-12-13,Terengganu,63,31,32,2023
2023-12-14,Terengganu,69,31,38,2023
2023-12-15,Terengganu,79,36,43,2023
2023-12-16,Terengganu,67,19,48,2023
2023-12-17,Terengganu,114,44,70,2023
2023-12-18,Terengganu,71,21,50,2023
2023-12-19,Terengganu,53,17,36,2023
2023-12-20,Terengganu,43,3,40,2023
2023-12-21,Terengganu,42,21,21,2023
2023-12-22,Terengganu,94,29,65,2023
2023-12-23,Terengganu,19,4,15,2023
2023-12-24,Terengganu,10,0,10,2023
2023-12-25,Terengganu,58,4,54,2023
2023-12-26,Terengganu,46,3,43,2023
2023-12-27,Terengganu,40,4,36,2023
2023-12-28,Terengganu,43,15,28,2023
2023-12-29,Terengganu,66,7,59,2023
2023-12-30,Terengganu,154,57,97,2023
2023-12-31,Terengganu,17,0,17,2023
2024-01-01,Terengganu,32,2,30,2024
2024-01-02,Terengganu,69,6,63,2024
2024-01-03,Terengganu,49,7,42,2024
2024-01-04,Terengganu,26,5,21,2024
2024-01-05,Terengganu,114,16,98,2024
2024-01-06,Terengganu,40,6,34,2024
2024-01-07,Terengganu,80,18,62,2024
2024-01-08,Terengganu,55,10,45,2024
2024-01-09,Terengganu,122,57,65,2024
2024-01-10,Terengganu,7,1,6,2024
2024-01-11,Terengganu,48,2,46,2024
2024-01-12,Terengganu,32,8,24,2024
2024-01-13,Terengganu,30,5,25,2024
2024-01-14,Terengganu,95,68,27,2024
2024-01-15,Terengganu,112,45,67,2024
2024-01-16,Terengganu,61,19,42,2024
2024-01-17,Terengganu,132,54,78,2024
2024-01-18,Terengganu,23,2,21,2024
2024-01-19,Terengganu,88,14,74,2024
2024-01-20,Terengganu,93,22,71,2024
2024-01-21,Terengganu,52,10,42,2024
2024-01-22,Terengganu,10,1,9,2024
2024-01-23,Terengganu,46,13,33,2024
2024-01-24,Terengganu,35,4,31,2024
2024-01-25,Terengganu,113,43,70,2024
2024-01-26,Terengganu,42,7,35,2024
2024-01-27,Terengganu,154,40,114,2024
2024-01-28,Terengganu,57,8,49,2024
2024-01-29,Terengganu,64,9,55,2024
2024-01-30,Terengganu,7,0,7,2024
2024-01-31,Terengganu,60,22,38,2024
2024-02-01,Terengganu,13,3,10,2024
2024-02-02,Terengganu,62,20,42,2024
2006-01-01,W.P. Kuala Lumpur,218,203,15,2006
2006-01-02,W.P. Kuala Lumpur,89,69,20,2006
2006-01-03,W.P. Kuala Lumpur,51,6,45,2006
2006-01-04,W.P. Kuala Lumpur,290,250,40,2006
2006-01-05,W.P. Kuala Lumpur,271,217,54,2006
2006-01-06,W.P. Kuala Lumpur,201,159,42,2006
2006-01-07,W.P. Kuala Lumpur,113,49,64,2006
2006-01-08,W.P. Kuala Lumpur,480,308,172,2006
2006-01-09,W.P. Kuala Lumpur,301,239,62,2006
2006-01-10,W.P. Kuala Lumpur,0,0,0,2006
2006-01-11,W.P. Kuala Lumpur,426,376,50,2006
2006-01-12,W.P. Kuala Lumpur,721,671,50,2006
2006-01-13,W.P. Kuala Lumpur,185,134,51,2006
2006-01-14,W.P. Kuala Lumpur,299,226,73,2006
2006-01-15,W.P. Kuala Lumpur,321,309,12,2006
2006-01-16,W.P. Kuala Lumpur,389,338,51,2006
2006-01-17,W.P. Kuala Lumpur,771,731,40,2006
2006-01-18,W.P. Kuala Lumpur,711,654,57,2006
2006-01-19,W.P. Kuala Lumpur,733,668,65,2006
2006-01-20,W.P. Kuala Lumpur,504,453,51,2006
2006-01-21,W.P. Kuala Lumpur,304,230,74,2006
2006-01-22,W.P. Kuala Lumpur,373,366,7,2006
2006-01-23,W.P. Kuala Lumpur,284,224,60,2006
2006-01-24,W.P. Kuala Lumpur,333,279,54,2006
2006-01-25,W.P. Kuala Lumpur,618,575,43,2006
2006-01-26,W.P. Kuala Lumpur,538,483,55,2006
2006-01-27,W.P. Kuala Lumpur,72,20,52,2006
2006-01-28,W.P. Kuala Lumpur,62,16,46,2006
2006-01-29,W.P. Kuala Lumpur,0,0,0,2006
2006-01-30,W.P. Kuala Lumpur,40,30,10,2006
2006-01-31,W.P. Kuala Lumpur,77,58,19,2006
2006-02-01,W.P. Kuala Lumpur,116,89,27,2006
2006-02-02,W.P. Kuala Lumpur,121,75,46,2006
2006-02-03,W.P. Kuala Lumpur,162,94,68,2006
2006-02-04,W.P. Kuala Lumpur,178,120,58,2006
2006-02-05,W.P. Kuala Lumpur,0,0,0,2006
2006-02-06,W.P. Kuala Lumpur,420,362,58,2006
2006-02-07,W.P. Kuala Lumpur,497,445,52,2006
2006-02-08,W.P. Kuala Lumpur,1015,941,74,2006
2006-02-09,W.P. Kuala Lumpur,490,437,53,2006
2006-02-10,W.P. Kuala Lumpur,743,663,80,2006
2006-02-11,W.P. Kuala Lumpur,1822,1674,148,2006
2006-02-12,W.P. Kuala Lumpur,146,142,4,2006
2006-02-13,W.P. Kuala Lumpur,55,13,42,2006
2006-02-14,W.P. Kuala Lumpur,188,141,47,2006
2006-02-15,W.P. Kuala Lumpur,557,497,60,2006
2006-02-16,W.P. Kuala Lumpur,429,360,69,2006
2006-02-17,W.P. Kuala Lumpur,76,25,51,2006
2006-02-18,W.P. Kuala Lumpur,802,701,101,2006
2006-02-19,W.P. Kuala Lumpur,23,21,2,2006
2006-02-20,W.P. Kuala Lumpur,269,219,50,2006
2006-02-21,W.P. Kuala Lumpur,856,775,81,2006
2006-02-22,W.P. Kuala Lumpur,669,618,51,2006
2006-02-23,W.P. Kuala Lumpur,416,367,49,2006
2006-02-24,W.P. Kuala Lumpur,477,395,82,2006
2006-02-25,W.P. Kuala Lumpur,261,180,81,2006
2006-02-26,W.P. Kuala Lumpur,92,89,3,2006
2006-02-27,W.P. Kuala Lumpur,488,443,45,2006
2006-02-28,W.P. Kuala Lumpur,457,401,56,2006
2006-03-01,W.P. Kuala Lumpur,537,483,54,2006
2006-03-02,W.P. Kuala Lumpur,762,672,90,2006
2006-03-03,W.P. Kuala Lumpur,411,349,62,2006
2006-03-04,W.P. Kuala Lumpur,220,144,76,2006
2006-03-05,W.P. Kuala Lumpur,743,695,48,2006
2006-03-06,W.P. Kuala Lumpur,291,231,60,2006
2006-03-07,W.P. Kuala Lumpur,405,347,58,2006
2006-03-08,W.P. Kuala Lumpur,709,649,60,2006
2006-03-09,W.P. Kuala Lumpur,451,403,48,2006
2006-03-10,W.P. Kuala Lumpur,294,211,83,2006
2006-03-11,W.P. Kuala Lumpur,198,129,69,2006
2006-03-12,W.P. Kuala Lumpur,201,183,18,2006
2006-03-13,W.P. Kuala Lumpur,198,128,70,2006
2006-03-14,W.P. Kuala Lumpur,335,239,96,2006
2006-03-15,W.P. Kuala Lumpur,281,181,100,2006
2006-03-16,W.P. Kuala Lumpur,694,536,158,2006
2006-03-17,W.P. Kuala Lumpur,255,147,108,2006
2006-03-18,W.P. Kuala Lumpur,196,112,84,2006
2006-03-19,W.P. Kuala Lumpur,590,531,59,2006
2006-03-20,W.P. Kuala Lumpur,181,126,55,2006
2006-03-21,W.P. Kuala Lumpur,596,457,139,2006
2006-03-22,W.P. Kuala Lumpur,503,393,110,2006
2006-03-23,W.P. Kuala Lumpur,336,247,89,2006
2006-03-24,W.P. Kuala Lumpur,261,176,85,2006
2006-03-25,W.P. Kuala Lumpur,554,470,84,2006
2006-03-26,W.P. Kuala Lumpur,148,127,21,2006
2006-03-27,W.P. Kuala Lumpur,485,436,49,2006
2006-03-28,W.P. Kuala Lumpur,688,627,61,2006
2006-03-29,W.P. Kuala Lumpur,1086,1009,77,2006
2006-03-30,W.P. Kuala Lumpur,925,843,82,2006
2006-03-31,W.P. Kuala Lumpur,411,351,60,2006
2006-04-01,W.P. Kuala Lumpur,377,283,94,2006
2006-04-02,W.P. Kuala Lumpur,266,244,22,2006
2006-04-03,W.P. Kuala Lumpur,100,53,47,2006
2006-04-04,W.P. Kuala Lumpur,594,508,86,2006
2006-04-05,W.P. Kuala Lumpur,236,177,59,2006
2006-04-06,W.P. Kuala Lumpur,155,115,40,2006
2006-04-07,W.P. Kuala Lumpur,83,37,46,2006
2006-04-08,W.P. Kuala Lumpur,259,176,83,2006
2006-04-09,W.P. Kuala Lumpur,731,661,70,2006
2006-04-10,W.P. Kuala Lumpur,141,87,54,2006
2006-04-11,W.P. Kuala Lumpur,317,271,46,2006
2006-04-12,W.P. Kuala Lumpur,264,174,90,2006
2006-04-13,W.P. Kuala Lumpur,418,334,84,2006
2006-04-14,W.P. Kuala Lumpur,423,348,75,2006
2006-04-15,W.P. Kuala Lumpur,53,2,51,2006
2006-04-16,W.P. Kuala Lumpur,93,75,18,2006
2006-04-17,W.P. Kuala Lumpur,177,124,53,2006
2006-04-18,W.P. Kuala Lumpur,214,178,36,2006
2006-04-19,W.P. Kuala Lumpur,494,400,94,2006
2006-04-20,W.P. Kuala Lumpur,454,382,72,2006
2006-04-21,W.P. Kuala Lumpur,161,106,55,2006
2006-04-22,W.P. Kuala Lumpur,441,346,95,2006
2006-04-23,W.P. Kuala Lumpur,432,405,27,2006
2006-04-24,W.P. Kuala Lumpur,81,45,36,2006
2006-04-25,W.P. Kuala Lumpur,106,64,42,2006
2006-04-26,W.P. Kuala Lumpur,579,487,92,2006
2006-04-27,W.P. Kuala Lumpur,409,349,60,2006
2006-04-28,W.P. Kuala Lumpur,203,151,52,2006
2006-04-29,W.P. Kuala Lumpur,263,201,62,2006
2006-04-30,W.P. Kuala Lumpur,71,68,3,2006
2006-05-01,W.P. Kuala Lumpur,1537,1357,180,2006
2006-05-02,W.P. Kuala Lumpur,97,34,63,2006
2006-05-03,W.P. Kuala Lumpur,305,215,90,2006
2006-05-04,W.P. Kuala Lumpur,204,128,76,2006
2006-05-05,W.P. Kuala Lumpur,100,59,41,2006
2006-05-06,W.P. Kuala Lumpur,587,499,88,2006
2006-05-07,W.P. Kuala Lumpur,712,631,81,2006
2006-05-08,W.P. Kuala Lumpur,164,119,45,2006
2006-05-09,W.P. Kuala Lumpur,158,78,80,2006
2006-05-10,W.P. Kuala Lumpur,275,236,39,2006
2006-05-11,W.P. Kuala Lumpur,489,430,59,2006
2006-05-12,W.P. Kuala Lumpur,1085,967,118,2006
2006-05-13,W.P. Kuala Lumpur,272,195,77,2006
2006-05-14,W.P. Kuala Lumpur,823,724,99,2006
2006-05-15,W.P. Kuala Lumpur,190,103,87,2006
2006-05-16,W.P. Kuala Lumpur,304,231,73,2006
2006-05-17,W.P. Kuala Lumpur,614,449,165,2006
2006-05-18,W.P. Kuala Lumpur,250,203,47,2006
2006-05-19,W.P. Kuala Lumpur,80,24,56,2006
2006-05-20,W.P. Kuala Lumpur,612,512,100,2006
2006-05-21,W.P. Kuala Lumpur,705,606,99,2006
2006-05-22,W.P. Kuala Lumpur,156,106,50,2006
2006-05-23,W.P. Kuala Lumpur,517,403,114,2006
2006-05-24,W.P. Kuala Lumpur,503,364,139,2006
2006-05-25,W.P. Kuala Lumpur,615,465,150,2006
2006-05-26,W.P. Kuala Lumpur,269,211,58,2006
2006-05-27,W.P. Kuala Lumpur,194,123,71,2006
2006-05-28,W.P. Kuala Lumpur,549,499,50,2006
2006-05-29,W.P. Kuala Lumpur,185,135,50,2006
2006-05-30,W.P. Kuala Lumpur,190,118,72,2006
2006-05-31,W.P. Kuala Lumpur,155,74,81,2006
2006-06-01,W.P. Kuala Lumpur,378,230,148,2006
2006-06-02,W.P. Kuala Lumpur,151,74,77,2006
2006-06-03,W.P. Kuala Lumpur,203,166,37,2006
2006-06-04,W.P. Kuala Lumpur,339,287,52,2006
2006-06-05,W.P. Kuala Lumpur,91,37,54,2006
2006-06-06,W.P. Kuala Lumpur,124,65,59,2006
2006-06-07,W.P. Kuala Lumpur,383,241,142,2006
2006-06-08,W.P. Kuala Lumpur,153,90,63,2006
2006-06-09,W.P. Kuala Lumpur,167,108,59,2006
2006-06-10,W.P. Kuala Lumpur,207,136,71,2006
2006-06-11,W.P. Kuala Lumpur,405,323,82,2006
2006-06-12,W.P. Kuala Lumpur,220,174,46,2006
2006-06-13,W.P. Kuala Lumpur,96,65,31,2006
2006-06-14,W.P. Kuala Lumpur,143,31,112,2006
2006-06-15,W.P. Kuala Lumpur,316,261,55,2006
2006-06-16,W.P. Kuala Lumpur,523,440,83,2006
2006-06-17,W.P. Kuala Lumpur,462,338,124,2006
2006-06-18,W.P. Kuala Lumpur,535,384,151,2006
2006-06-19,W.P. Kuala Lumpur,117,79,38,2006
2006-06-20,W.P. Kuala Lumpur,280,182,98,2006
2006-06-21,W.P. Kuala Lumpur,385,306,79,2006
2006-06-22,W.P. Kuala Lumpur,398,329,69,2006
2006-06-23,W.P. Kuala Lumpur,154,97,57,2006
2006-06-24,W.P. Kuala Lumpur,858,781,77,2006
2006-06-25,W.P. Kuala Lumpur,461,377,84,2006
2006-06-26,W.P. Kuala Lumpur,124,58,66,2006
2006-06-27,W.P. Kuala Lumpur,595,489,106,2006
2006-06-28,W.P. Kuala Lumpur,270,187,83,2006
2006-06-29,W.P. Kuala Lumpur,200,119,81,2006
2006-06-30,W.P. Kuala Lumpur,107,53,54,2006
2006-07-01,W.P. Kuala Lumpur,62,6,56,2006
2006-07-02,W.P. Kuala Lumpur,410,287,123,2006
2006-07-03,W.P. Kuala Lumpur,101,51,50,2006
2006-07-04,W.P. Kuala Lumpur,254,195,59,2006
2006-07-05,W.P. Kuala Lumpur,47,4,43,2006
2006-07-06,W.P. Kuala Lumpur,150,98,52,2006
2006-07-07,W.P. Kuala Lumpur,269,207,62,2006
2006-07-08,W.P. Kuala Lumpur,306,218,88,2006
2006-07-09,W.P. Kuala Lumpur,191,152,39,2006
2006-07-10,W.P. Kuala Lumpur,207,118,89,2006
2006-07-11,W.P. Kuala Lumpur,618,402,216,2006
2006-07-12,W.P. Kuala Lumpur,725,478,247,2006
2006-07-13,W.P. Kuala Lumpur,804,494,310,2006
2006-07-14,W.P. Kuala Lumpur,773,493,280,2006
2006-07-15,W.P. Kuala Lumpur,594,313,281,2006
2006-07-16,W.P. Kuala Lumpur,356,299,57,2006
2006-07-17,W.P. Kuala Lumpur,159,71,88,2006
2006-07-18,W.P. Kuala Lumpur,338,187,151,2006
2006-07-19,W.P. Kuala Lumpur,470,332,138,2006
2006-07-20,W.P. Kuala Lumpur,596,484,112,2006
2006-07-21,W.P. Kuala Lumpur,442,331,111,2006
2006-07-22,W.P. Kuala Lumpur,255,174,81,2006
2006-07-23,W.P. Kuala Lumpur,634,551,83,2006
2006-07-24,W.P. Kuala Lumpur,233,150,83,2006
2006-07-25,W.P. Kuala Lumpur,732,535,197,2006
2006-07-26,W.P. Kuala Lumpur,794,510,284,2006
2006-07-27,W.P. Kuala Lumpur,661,481,180,2006
2006-07-28,W.P. Kuala Lumpur,327,263,64,2006
2006-07-29,W.P. Kuala Lumpur,345,248,97,2006
2006-07-30,W.P. Kuala Lumpur,484,389,95,2006
2006-07-31,W.P. Kuala Lumpur,62,17,45,2006
2006-08-01,W.P. Kuala Lumpur,318,234,84,2006
2006-08-02,W.P. Kuala Lumpur,349,230,119,2006
2006-08-03,W.P. Kuala Lumpur,489,388,101,2006
2006-08-04,W.P. Kuala Lumpur,198,107,91,2006
2006-08-05,W.P. Kuala Lumpur,79,16,63,2006
2006-08-06,W.P. Kuala Lumpur,679,521,158,2006
2006-08-07,W.P. Kuala Lumpur,362,250,112,2006
2006-08-08,W.P. Kuala Lumpur,286,192,94,2006
2006-08-09,W.P. Kuala Lumpur,348,282,66,2006
2006-08-10,W.P. Kuala Lumpur,122,78,44,2006
2006-08-11,W.P. Kuala Lumpur,140,64,76,2006
2006-08-12,W.P. Kuala Lumpur,640,533,107,2006
2006-08-13,W.P. Kuala Lumpur,638,470,168,2006
2006-08-14,W.P. Kuala Lumpur,298,196,102,2006
2006-08-15,W.P. Kuala Lumpur,725,549,176,2006
2006-08-16,W.P. Kuala Lumpur,531,401,130,2006
2006-08-17,W.P. Kuala Lumpur,612,508,104,2006
2006-08-18,W.P. Kuala Lumpur,639,534,105,2006
2006-08-19,W.P. Kuala Lumpur,382,286,96,2006
2006-08-20,W.P. Kuala Lumpur,703,542,161,2006
2006-08-21,W.P. Kuala Lumpur,226,111,115,2006
2006-08-22,W.P. Kuala Lumpur,649,413,236,2006
2006-08-23,W.P. Kuala Lumpur,817,572,245,2006
2006-08-24,W.P. Kuala Lumpur,767,535,232,2006
2006-08-25,W.P. Kuala Lumpur,418,262,156,2006
2006-08-26,W.P. Kuala Lumpur,148,76,72,2006
2006-08-27,W.P. Kuala Lumpur,507,372,135,2006
2006-08-28,W.P. Kuala Lumpur,234,178,56,2006
2006-08-29,W.P. Kuala Lumpur,569,508,61,2006
2006-08-30,W.P. Kuala Lumpur,363,295,68,2006
2006-08-31,W.P. Kuala Lumpur,337,261,76,2006
2006-09-01,W.P. Kuala Lumpur,73,11,62,2006
2006-09-02,W.P. Kuala Lumpur,264,196,68,2006
2006-09-03,W.P. Kuala Lumpur,1601,1367,234,2006
2006-09-04,W.P. Kuala Lumpur,193,76,117,2006
2006-09-05,W.P. Kuala Lumpur,339,249,90,2006
2006-09-06,W.P. Kuala Lumpur,630,458,172,2006
2006-09-07,W.P. Kuala Lumpur,667,450,217,2006
2006-09-08,W.P. Kuala Lumpur,427,306,121,2006
2006-09-09,W.P. Kuala Lumpur,279,189,90,2006
2006-09-10,W.P. Kuala Lumpur,397,268,129,2006
2006-09-11,W.P. Kuala Lumpur,338,252,86,2006
2006-09-12,W.P. Kuala Lumpur,704,500,204,2006
2006-09-13,W.P. Kuala Lumpur,523,411,112,2006
2006-09-14,W.P. Kuala Lumpur,512,359,153,2006
2006-09-15,W.P. Kuala Lumpur,417,322,95,2006
2006-09-16,W.P. Kuala Lumpur,649,528,121,2006
2006-09-17,W.P. Kuala Lumpur,515,366,149,2006
2006-09-18,W.P. Kuala Lumpur,282,163,119,2006
2006-09-19,W.P. Kuala Lumpur,641,361,280,2006
2006-09-20,W.P. Kuala Lumpur,680,526,154,2006
2006-09-21,W.P. Kuala Lumpur,835,669,166,2006
2006-09-22,W.P. Kuala Lumpur,731,532,199,2006
2006-09-23,W.P. Kuala Lumpur,204,106,98,2006
2006-09-24,W.P. Kuala Lumpur,163,127,36,2006
2006-09-25,W.P. Kuala Lumpur,31,2,29,2006
2006-09-26,W.P. Kuala Lumpur,12,1,11,2006
2006-09-27,W.P. Kuala Lumpur,89,48,41,2006
2006-09-28,W.P. Kuala Lumpur,77,33,44,2006
2006-09-29,W.P. Kuala Lumpur,93,36,57,2006
2006-09-30,W.P. Kuala Lumpur,98,18,80,2006
2006-10-01,W.P. Kuala Lumpur,468,312,156,2006
2006-10-02,W.P. Kuala Lumpur,74,27,47,2006
2006-10-03,W.P. Kuala Lumpur,98,41,57,2006
2006-10-04,W.P. Kuala Lumpur,68,16,52,2006
2006-10-05,W.P. Kuala Lumpur,93,29,64,2006
2006-10-06,W.P. Kuala Lumpur,385,256,129,2006
2006-10-07,W.P. Kuala Lumpur,34,3,31,2006
2006-10-08,W.P. Kuala Lumpur,579,367,212,2006
2006-10-09,W.P. Kuala Lumpur,26,4,22,2006
2006-10-10,W.P. Kuala Lumpur,121,71,50,2006
2006-10-11,W.P. Kuala Lumpur,48,20,28,2006
2006-10-12,W.P. Kuala Lumpur,202,131,71,2006
2006-10-13,W.P. Kuala Lumpur,69,34,35,2006
2006-10-14,W.P. Kuala Lumpur,232,177,55,2006
2006-10-15,W.P. Kuala Lumpur,1121,778,343,2006
2006-10-16,W.P. Kuala Lumpur,179,145,34,2006
2006-10-17,W.P. Kuala Lumpur,256,192,64,2006
2006-10-18,W.P. Kuala Lumpur,149,88,61,2006
2006-10-19,W.P. Kuala Lumpur,668,229,439,2006
2006-10-20,W.P. Kuala Lumpur,206,135,71,2006
2006-10-21,W.P. Kuala Lumpur,28,10,18,2006
2006-10-22,W.P. Kuala Lumpur,155,111,44,2006
2006-10-23,W.P. Kuala Lumpur,37,6,31,2006
2006-10-24,W.P. Kuala Lumpur,0,0,0,2006
2006-10-25,W.P. Kuala Lumpur,0,0,0,2006
2006-10-26,W.P. Kuala Lumpur,52,5,47,2006
2006-10-27,W.P. Kuala Lumpur,143,60,83,2006
2006-10-28,W.P. Kuala Lumpur,254,167,87,2006
2006-10-29,W.P. Kuala Lumpur,503,403,100,2006
2006-10-30,W.P. Kuala Lumpur,112,40,72,2006
2006-10-31,W.P. Kuala Lumpur,74,14,60,2006
2006-11-01,W.P. Kuala Lumpur,243,149,94,2006
2006-11-02,W.P. Kuala Lumpur,260,183,77,2006
2006-11-03,W.P. Kuala Lumpur,510,416,94,2006
2006-11-04,W.P. Kuala Lumpur,232,126,106,2006
2006-11-05,W.P. Kuala Lumpur,326,273,53,2006
2006-11-06,W.P. Kuala Lumpur,258,138,120,2006
2006-11-07,W.P. Kuala Lumpur,392,165,227,2006
2006-11-08,W.P. Kuala Lumpur,424,215,209,2006
2006-11-09,W.P. Kuala Lumpur,586,389,197,2006
2006-11-10,W.P. Kuala Lumpur,234,186,48,2006
2006-11-11,W.P. Kuala Lumpur,235,126,109,2006
2006-11-12,W.P. Kuala Lumpur,684,414,270,2006
2006-11-13,W.P. Kuala Lumpur,116,50,66,2006
2006-11-14,W.P. Kuala Lumpur,648,383,265,2006
2006-11-15,W.P. Kuala Lumpur,347,233,114,2006
2006-11-16,W.P. Kuala Lumpur,510,349,161,2006
2006-11-17,W.P. Kuala Lumpur,462,316,146,2006
2006-11-18,W.P. Kuala Lumpur,189,100,89,2006
2006-11-19,W.P. Kuala Lumpur,499,313,186,2006
2006-11-20,W.P. Kuala Lumpur,700,370,330,2006
2006-11-21,W.P. Kuala Lumpur,667,319,348,2006
2006-11-22,W.P. Kuala Lumpur,826,458,368,2006
2006-11-23,W.P. Kuala Lumpur,1129,723,406,2006
2006-11-24,W.P. Kuala Lumpur,785,416,369,2006
2006-11-25,W.P. Kuala Lumpur,129,59,70,2006
2006-11-26,W.P. Kuala Lumpur,351,275,76,2006
2006-11-27,W.P. Kuala Lumpur,135,65,70,2006
2006-11-28,W.P. Kuala Lumpur,154,80,74,2006
2006-11-29,W.P. Kuala Lumpur,224,143,81,2006
2006-11-30,W.P. Kuala Lumpur,490,324,166,2006
2006-12-01,W.P. Kuala Lumpur,556,398,158,2006
2006-12-02,W.P. Kuala Lumpur,327,203,124,2006
2006-12-03,W.P. Kuala Lumpur,917,532,385,2006
2006-12-04,W.P. Kuala Lumpur,51,10,41,2006
2006-12-05,W.P. Kuala Lumpur,236,98,138,2006
2006-12-06,W.P. Kuala Lumpur,318,200,118,2006
2006-12-07,W.P. Kuala Lumpur,273,119,154,2006
2006-12-08,W.P. Kuala Lumpur,240,126,114,2006
2006-12-09,W.P. Kuala Lumpur,285,185,100,2006
2006-12-10,W.P. Kuala Lumpur,304,185,119,2006
2006-12-11,W.P. Kuala Lumpur,215,94,121,2006
2006-12-12,W.P. Kuala Lumpur,522,283,239,2006
2006-12-13,W.P. Kuala Lumpur,462,265,197,2006
2006-12-14,W.P. Kuala Lumpur,632,371,261,2006
2006-12-15,W.P. Kuala Lumpur,225,131,94,2006
2006-12-16,W.P. Kuala Lumpur,158,91,67,2006
2006-12-17,W.P. Kuala Lumpur,347,228,119,2006
2006-12-18,W.P. Kuala Lumpur,85,28,57,2006
2006-12-19,W.P. Kuala Lumpur,188,78,110,2006
2006-12-20,W.P. Kuala Lumpur,609,387,222,2006
2006-12-21,W.P. Kuala Lumpur,508,308,200,2006
2006-12-22,W.P. Kuala Lumpur,288,192,96,2006
2006-12-23,W.P. Kuala Lumpur,127,59,68,2006
2006-12-24,W.P. Kuala Lumpur,269,212,57,2006
2006-12-25,W.P. Kuala Lumpur,73,38,35,2006
2006-12-26,W.P. Kuala Lumpur,209,81,128,2006
2006-12-27,W.P. Kuala Lumpur,294,158,136,2006
2006-12-28,W.P. Kuala Lumpur,251,97,154,2006
2006-12-29,W.P. Kuala Lumpur,724,299,425,2006
2006-12-30,W.P. Kuala Lumpur,241,142,99,2006
2006-12-31,W.P. Kuala Lumpur,44,26,18,2006
2007-01-01,W.P. Kuala Lumpur,54,30,24,2007
2007-01-02,W.P. Kuala Lumpur,75,37,38,2007
2007-01-03,W.P. Kuala Lumpur,108,48,60,2007
2007-01-04,W.P. Kuala Lumpur,406,322,84,2007
2007-01-05,W.P. Kuala Lumpur,71,14,57,2007
2007-01-06,W.P. Kuala Lumpur,164,81,83,2007
2007-01-07,W.P. Kuala Lumpur,669,468,201,2007
2007-01-08,W.P. Kuala Lumpur,580,340,240,2007
2007-01-09,W.P. Kuala Lumpur,830,440,390,2007
2007-01-10,W.P. Kuala Lumpur,1158,642,516,2007
2007-01-11,W.P. Kuala Lumpur,663,344,319,2007
2007-01-12,W.P. Kuala Lumpur,157,49,108,2007
2007-01-13,W.P. Kuala Lumpur,279,174,105,2007
2007-01-14,W.P. Kuala Lumpur,185,108,77,2007
2007-01-15,W.P. Kuala Lumpur,431,221,210,2007
2007-01-16,W.P. Kuala Lumpur,521,280,241,2007
2007-01-17,W.P. Kuala Lumpur,670,328,342,2007
2007-01-18,W.P. Kuala Lumpur,566,386,180,2007
2007-01-19,W.P. Kuala Lumpur,167,61,106,2007
2007-01-20,W.P. Kuala Lumpur,165,96,69,2007
2007-01-21,W.P. Kuala Lumpur,350,220,130,2007
2007-01-22,W.P. Kuala Lumpur,486,287,199,2007
2007-01-23,W.P. Kuala Lumpur,528,325,203,2007
2007-01-24,W.P. Kuala Lumpur,647,466,181,2007
2007-01-25,W.P. Kuala Lumpur,662,451,211,2007
2007-01-26,W.P. Kuala Lumpur,590,351,239,2007
2007-01-27,W.P. Kuala Lumpur,293,144,149,2007
2007-01-28,W.P. Kuala Lumpur,476,281,195,2007
2007-01-29,W.P. Kuala Lumpur,122,54,68,2007
2007-01-30,W.P. Kuala Lumpur,459,291,168,2007
2007-01-31,W.P. Kuala Lumpur,653,444,209,2007
2007-02-01,W.P. Kuala Lumpur,1910,1391,519,2007
2007-02-02,W.P. Kuala Lumpur,118,31,87,2007
2007-02-03,W.P. Kuala Lumpur,316,188,128,2007
2007-02-04,W.P. Kuala Lumpur,237,159,78,2007
2007-02-05,W.P. Kuala Lumpur,300,175,125,2007
2007-02-06,W.P. Kuala Lumpur,682,400,282,2007
2007-02-07,W.P. Kuala Lumpur,604,359,245,2007
2007-02-08,W.P. Kuala Lumpur,531,323,208,2007
2007-02-09,W.P. Kuala Lumpur,973,874,99,2007
2007-02-10,W.P. Kuala Lumpur,1565,1415,150,2007
2007-02-11,W.P. Kuala Lumpur,2667,2506,161,2007
2007-02-12,W.P. Kuala Lumpur,437,281,156,2007
2007-02-13,W.P. Kuala Lumpur,344,172,172,2007
2007-02-14,W.P. Kuala Lumpur,866,538,328,2007
2007-02-15,W.P. Kuala Lumpur,465,325,140,2007
2007-02-16,W.P. Kuala Lumpur,189,96,93,2007
2007-02-17,W.P. Kuala Lumpur,160,79,81,2007
2007-02-18,W.P. Kuala Lumpur,67,52,15,2007
2007-02-19,W.P. Kuala Lumpur,136,113,23,2007
2007-02-20,W.P. Kuala Lumpur,76,58,18,2007
2007-02-21,W.P. Kuala Lumpur,234,119,115,2007
2007-02-22,W.P. Kuala Lumpur,85,10,75,2007
2007-02-23,W.P. Kuala Lumpur,206,100,106,2007
2007-02-24,W.P. Kuala Lumpur,551,453,98,2007
2007-02-25,W.P. Kuala Lumpur,164,109,55,2007
2007-02-26,W.P. Kuala Lumpur,358,201,157,2007
2007-02-27,W.P. Kuala Lumpur,324,203,121,2007
2007-02-28,W.P. Kuala Lumpur,1001,723,278,2007
2007-03-01,W.P. Kuala Lumpur,298,131,167,2007
2007-03-02,W.P. Kuala Lumpur,228,122,106,2007
2007-03-03,W.P. Kuala Lumpur,118,28,90,2007
2007-03-04,W.P. Kuala Lumpur,50,29,21,2007
2007-03-05,W.P. Kuala Lumpur,387,205,182,2007
2007-03-06,W.P. Kuala Lumpur,519,232,287,2007
2007-03-07,W.P. Kuala Lumpur,493,266,227,2007
2007-03-08,W.P. Kuala Lumpur,682,356,326,2007
2007-03-09,W.P. Kuala Lumpur,459,310,149,2007
2007-03-10,W.P. Kuala Lumpur,218,108,110,2007
2007-03-11,W.P. Kuala Lumpur,223,150,73,2007
2007-03-12,W.P. Kuala Lumpur,310,156,154,2007
2007-03-13,W.P. Kuala Lumpur,356,142,214,2007
2007-03-14,W.P. Kuala Lumpur,313,186,127,2007
2007-03-15,W.P. Kuala Lumpur,284,123,161,2007
2007-03-16,W.P. Kuala Lumpur,66,6,60,2007
2007-03-17,W.P. Kuala Lumpur,105,31,74,2007
2007-03-18,W.P. Kuala Lumpur,241,150,91,2007
2007-03-19,W.P. Kuala Lumpur,67,6,61,2007
2007-03-20,W.P. Kuala Lumpur,154,108,46,2007
2007-03-21,W.P. Kuala Lumpur,402,223,179,2007
2007-03-22,W.P. Kuala Lumpur,526,359,167,2007
2007-03-23,W.P. Kuala Lumpur,250,158,92,2007
2007-03-24,W.P. Kuala Lumpur,652,397,255,2007
2007-03-25,W.P. Kuala Lumpur,549,329,220,2007
2007-03-26,W.P. Kuala Lumpur,354,120,234,2007
2007-03-27,W.P. Kuala Lumpur,584,272,312,2007
2007-03-28,W.P. Kuala Lumpur,851,274,577,2007
2007-03-29,W.P. Kuala Lumpur,1011,435,576,2007
2007-03-30,W.P. Kuala Lumpur,570,235,335,2007
2007-03-31,W.P. Kuala Lumpur,80,33,47,2007
2007-04-01,W.P. Kuala Lumpur,227,178,49,2007
2007-04-02,W.P. Kuala Lumpur,92,34,58,2007
2007-04-03,W.P. Kuala Lumpur,559,271,288,2007
2007-04-04,W.P. Kuala Lumpur,564,290,274,2007
2007-04-05,W.P. Kuala Lumpur,630,311,319,2007
2007-04-06,W.P. Kuala Lumpur,405,249,156,2007
2007-04-07,W.P. Kuala Lumpur,675,528,147,2007
2007-04-08,W.P. Kuala Lumpur,752,422,330,2007
2007-04-09,W.P. Kuala Lumpur,62,6,56,2007
2007-04-10,W.P. Kuala Lumpur,318,255,63,2007
2007-04-11,W.P. Kuala Lumpur,161,85,76,2007
2007-04-12,W.P. Kuala Lumpur,300,141,159,2007
2007-04-13,W.P. Kuala Lumpur,212,134,78,2007
2007-04-14,W.P. Kuala Lumpur,351,160,191,2007
2007-04-15,W.P. Kuala Lumpur,627,355,272,2007
2007-04-16,W.P. Kuala Lumpur,198,74,124,2007
2007-04-17,W.P. Kuala Lumpur,300,184,116,2007
2007-04-18,W.P. Kuala Lumpur,469,206,263,2007
2007-04-19,W.P. Kuala Lumpur,630,386,244,2007
2007-04-20,W.P. Kuala Lumpur,227,145,82,2007
2007-04-21,W.P. Kuala Lumpur,382,212,170,2007
2007-04-22,W.P. Kuala Lumpur,1053,636,417,2007
2007-04-23,W.P. Kuala Lumpur,248,154,94,2007
2007-04-24,W.P. Kuala Lumpur,237,171,66,2007
2007-04-25,W.P. Kuala Lumpur,522,365,157,2007
2007-04-26,W.P. Kuala Lumpur,0,0,0,2007
2007-04-27,W.P. Kuala Lumpur,55,10,45,2007
2007-04-28,W.P. Kuala Lumpur,277,154,123,2007
2007-04-29,W.P. Kuala Lumpur,1149,735,414,2007
2007-04-30,W.P. Kuala Lumpur,322,185,137,2007
2007-05-01,W.P. Kuala Lumpur,1094,576,518,2007
2007-05-02,W.P. Kuala Lumpur,0,0,0,2007
2007-05-03,W.P. Kuala Lumpur,90,31,59,2007
2007-05-04,W.P. Kuala Lumpur,51,9,42,2007
2007-05-05,W.P. Kuala Lumpur,268,150,118,2007
2007-05-06,W.P. Kuala Lumpur,525,352,173,2007
2007-05-07,W.P. Kuala Lumpur,210,95,115,2007
2007-05-08,W.P. Kuala Lumpur,299,174,125,2007
2007-05-09,W.P. Kuala Lumpur,756,488,268,2007
2007-05-10,W.P. Kuala Lumpur,568,335,233,2007
2007-05-11,W.P. Kuala Lumpur,51,10,41,2007
2007-05-12,W.P. Kuala Lumpur,268,197,71,2007
2007-05-13,W.P. Kuala Lumpur,1234,532,702,2007
2007-05-14,W.P. Kuala Lumpur,275,161,114,2007
2007-05-15,W.P. Kuala Lumpur,483,332,151,2007
2007-05-16,W.P. Kuala Lumpur,273,161,112,2007
2007-05-17,W.P. Kuala Lumpur,145,50,95,2007
2007-05-18,W.P. Kuala Lumpur,195,108,87,2007
2007-05-19,W.P. Kuala Lumpur,288,175,113,2007
2007-05-20,W.P. Kuala Lumpur,392,198,194,2007
2007-05-21,W.P. Kuala Lumpur,257,169,88,2007
2007-05-22,W.P. Kuala Lumpur,57,7,50,2007
2007-05-23,W.P. Kuala Lumpur,116,44,72,2007
2007-05-24,W.P. Kuala Lumpur,309,214,95,2007
2007-05-25,W.P. Kuala Lumpur,624,436,188,2007
2007-05-26,W.P. Kuala Lumpur,159,95,64,2007
2007-05-27,W.P. Kuala Lumpur,320,199,121,2007
2007-05-28,W.P. Kuala Lumpur,200,77,123,2007
2007-05-29,W.P. Kuala Lumpur,344,177,167,2007
2007-05-30,W.P. Kuala Lumpur,221,66,155,2007
2007-05-31,W.P. Kuala Lumpur,284,123,161,2007
2007-06-01,W.P. Kuala Lumpur,126,64,62,2007
2007-06-02,W.P. Kuala Lumpur,186,98,88,2007
2007-06-03,W.P. Kuala Lumpur,208,97,111,2007
2007-06-04,W.P. Kuala Lumpur,146,51,95,2007
2007-06-05,W.P. Kuala Lumpur,368,199,169,2007
2007-06-06,W.P. Kuala Lumpur,457,213,244,2007
2007-06-07,W.P. Kuala Lumpur,651,312,339,2007
2007-06-08,W.P. Kuala Lumpur,435,286,149,2007
2007-06-09,W.P. Kuala Lumpur,414,263,151,2007
2007-06-10,W.P. Kuala Lumpur,567,335,232,2007
2007-06-11,W.P. Kuala Lumpur,330,180,150,2007
2007-06-12,W.P. Kuala Lumpur,377,262,115,2007
2007-06-13,W.P. Kuala Lumpur,540,240,300,2007
2007-06-14,W.P. Kuala Lumpur,278,114,164,2007
2007-06-15,W.P. Kuala Lumpur,427,195,232,2007
2007-06-16,W.P. Kuala Lumpur,340,179,161,2007
2007-06-17,W.P. Kuala Lumpur,550,285,265,2007
2007-06-18,W.P. Kuala Lumpur,178,116,62,2007
2007-06-19,W.P. Kuala Lumpur,215,113,102,2007
2007-06-20,W.P. Kuala Lumpur,452,209,243,2007
2007-06-21,W.P. Kuala Lumpur,396,230,166,2007
2007-06-22,W.P. Kuala Lumpur,439,213,226,2007
2007-06-23,W.P. Kuala Lumpur,582,369,213,2007
2007-06-24,W.P. Kuala Lumpur,505,274,231,2007
2007-06-25,W.P. Kuala Lumpur,220,104,116,2007
2007-06-26,W.P. Kuala Lumpur,388,203,185,2007
2007-06-27,W.P. Kuala Lumpur,390,246,144,2007
2007-06-28,W.P. Kuala Lumpur,192,77,115,2007
2007-06-29,W.P. Kuala Lumpur,181,117,64,2007
2007-06-30,W.P. Kuala Lumpur,211,96,115,2007
2007-07-01,W.P. Kuala Lumpur,537,281,256,2007
2007-07-02,W.P. Kuala Lumpur,81,21,60,2007
2007-07-03,W.P. Kuala Lumpur,165,70,95,2007
2007-07-04,W.P. Kuala Lumpur,188,88,100,2007
2007-07-05,W.P. Kuala Lumpur,315,192,123,2007
2007-07-06,W.P. Kuala Lumpur,457,311,146,2007
2007-07-07,W.P. Kuala Lumpur,664,417,247,2007
2007-07-08,W.P. Kuala Lumpur,638,437,201,2007
2007-07-09,W.P. Kuala Lumpur,392,161,231,2007
2007-07-10,W.P. Kuala Lumpur,837,356,481,2007
2007-07-11,W.P. Kuala Lumpur,988,343,645,2007
2007-07-12,W.P. Kuala Lumpur,863,263,600,2007
2007-07-13,W.P. Kuala Lumpur,781,350,431,2007
2007-07-14,W.P. Kuala Lumpur,423,259,164,2007
2007-07-15,W.P. Kuala Lumpur,620,272,348,2007
2007-07-16,W.P. Kuala Lumpur,101,47,54,2007
2007-07-17,W.P. Kuala Lumpur,825,535,290,2007
2007-07-18,W.P. Kuala Lumpur,285,147,138,2007
2007-07-19,W.P. Kuala Lumpur,563,318,245,2007
2007-07-20,W.P. Kuala Lumpur,386,211,175,2007
2007-07-21,W.P. Kuala Lumpur,590,401,189,2007
2007-07-22,W.P. Kuala Lumpur,491,273,218,2007
2007-07-23,W.P. Kuala Lumpur,341,131,210,2007
2007-07-24,W.P. Kuala Lumpur,506,263,243,2007
2007-07-25,W.P. Kuala Lumpur,525,350,175,2007
2007-07-26,W.P. Kuala Lumpur,661,386,275,2007
2007-07-27,W.P. Kuala Lumpur,356,191,165,2007
2007-07-28,W.P. Kuala Lumpur,467,347,120,2007
2007-07-29,W.P. Kuala Lumpur,316,203,113,2007
2007-07-30,W.P. Kuala Lumpur,229,113,116,2007
2007-07-31,W.P. Kuala Lumpur,260,129,131,2007
2007-08-01,W.P. Kuala Lumpur,530,381,149,2007
2007-08-02,W.P. Kuala Lumpur,184,113,71,2007
2007-08-03,W.P. Kuala Lumpur,217,114,103,2007
2007-08-04,W.P. Kuala Lumpur,417,213,204,2007
2007-08-05,W.P. Kuala Lumpur,604,328,276,2007
2007-08-06,W.P. Kuala Lumpur,205,91,114,2007
2007-08-07,W.P. Kuala Lumpur,647,382,265,2007
2007-08-08,W.P. Kuala Lumpur,315,193,122,2007
2007-08-09,W.P. Kuala Lumpur,327,164,163,2007
2007-08-10,W.P. Kuala Lumpur,268,146,122,2007
2007-08-11,W.P. Kuala Lumpur,433,213,220,2007
2007-08-12,W.P. Kuala Lumpur,552,301,251,2007
2007-08-13,W.P. Kuala Lumpur,254,121,133,2007
2007-08-14,W.P. Kuala Lumpur,296,154,142,2007
2007-08-15,W.P. Kuala Lumpur,685,478,207,2007
2007-08-16,W.P. Kuala Lumpur,693,440,253,2007
2007-08-17,W.P. Kuala Lumpur,421,240,181,2007
2007-08-18,W.P. Kuala Lumpur,625,438,187,2007
2007-08-19,W.P. Kuala Lumpur,481,329,152,2007
2007-08-20,W.P. Kuala Lumpur,290,163,127,2007
2007-08-21,W.P. Kuala Lumpur,592,305,287,2007
2007-08-22,W.P. Kuala Lumpur,625,343,282,2007
2007-08-23,W.P. Kuala Lumpur,409,207,202,2007
2007-08-24,W.P. Kuala Lumpur,368,192,176,2007
2007-08-25,W.P. Kuala Lumpur,255,141,114,2007
2007-08-26,W.P. Kuala Lumpur,654,397,257,2007
2007-08-27,W.P. Kuala Lumpur,162,65,97,2007
2007-08-28,W.P. Kuala Lumpur,423,278,145,2007
2007-08-29,W.P. Kuala Lumpur,334,198,136,2007
2007-08-30,W.P. Kuala Lumpur,135,70,65,2007
2007-08-31,W.P. Kuala Lumpur,44,40,4,2007
2007-09-01,W.P. Kuala Lumpur,170,111,59,2007
2007-09-02,W.P. Kuala Lumpur,594,301,293,2007
2007-09-03,W.P. Kuala Lumpur,314,157,157,2007
2007-09-04,W.P. Kuala Lumpur,757,439,318,2007
2007-09-05,W.P. Kuala Lumpur,806,421,385,2007
2007-09-06,W.P. Kuala Lumpur,676,332,344,2007
2007-09-07,W.P. Kuala Lumpur,673,361,312,2007
2007-09-08,W.P. Kuala Lumpur,537,314,223,2007
2007-09-09,W.P. Kuala Lumpur,895,462,433,2007
2007-09-10,W.P. Kuala Lumpur,407,164,243,2007
2007-09-11,W.P. Kuala Lumpur,658,351,307,2007
2007-09-12,W.P. Kuala Lumpur,397,135,262,2007
2007-09-13,W.P. Kuala Lumpur,109,44,65,2007
2007-09-14,W.P. Kuala Lumpur,30,4,26,2007
2007-09-15,W.P. Kuala Lumpur,150,59,91,2007
2007-09-16,W.P. Kuala Lumpur,634,400,234,2007
2007-09-17,W.P. Kuala Lumpur,63,18,45,2007
2007-09-18,W.P. Kuala Lumpur,139,56,83,2007
2007-09-19,W.P. Kuala Lumpur,196,88,108,2007
2007-09-20,W.P. Kuala Lumpur,139,57,82,2007
2007-09-21,W.P. Kuala Lumpur,141,68,73,2007
2007-09-22,W.P. Kuala Lumpur,91,9,82,2007
2007-09-23,W.P. Kuala Lumpur,945,335,610,2007
2007-09-24,W.P. Kuala Lumpur,29,1,28,2007
2007-09-25,W.P. Kuala Lumpur,134,67,67,2007
2007-09-26,W.P. Kuala Lumpur,304,177,127,2007
2007-09-27,W.P. Kuala Lumpur,362,275,87,2007
2007-09-28,W.P. Kuala Lumpur,109,51,58,2007
2007-09-29,W.P. Kuala Lumpur,92,35,57,2007
2007-09-30,W.P. Kuala Lumpur,800,421,379,2007
2007-10-01,W.P. Kuala Lumpur,40,19,21,2007
2007-10-02,W.P. Kuala Lumpur,91,46,45,2007
2007-10-03,W.P. Kuala Lumpur,92,24,68,2007
2007-10-04,W.P. Kuala Lumpur,209,103,106,2007
2007-10-05,W.P. Kuala Lumpur,351,199,152,2007
2007-10-06,W.P. Kuala Lumpur,195,94,101,2007
2007-10-07,W.P. Kuala Lumpur,649,391,258,2007
2007-10-08,W.P. Kuala Lumpur,186,113,73,2007
2007-10-09,W.P. Kuala Lumpur,266,116,150,2007
2007-10-10,W.P. Kuala Lumpur,233,103,130,2007
2007-10-11,W.P. Kuala Lumpur,168,59,109,2007
2007-10-12,W.P. Kuala Lumpur,86,20,66,2007
2007-10-13,W.P. Kuala Lumpur,0,0,0,2007
2007-10-14,W.P. Kuala Lumpur,0,0,0,2007
2007-10-15,W.P. Kuala Lumpur,48,7,41,2007
2007-10-16,W.P. Kuala Lumpur,52,9,43,2007
2007-10-17,W.P. Kuala Lumpur,147,66,81,2007
2007-10-18,W.P. Kuala Lumpur,113,26,87,2007
2007-10-19,W.P. Kuala Lumpur,102,27,75,2007
2007-10-20,W.P. Kuala Lumpur,291,141,150,2007
2007-10-21,W.P. Kuala Lumpur,570,287,283,2007
2007-10-22,W.P. Kuala Lumpur,273,102,171,2007
2007-10-23,W.P. Kuala Lumpur,556,223,333,2007
2007-10-24,W.P. Kuala Lumpur,617,277,340,2007
2007-10-25,W.P. Kuala Lumpur,933,558,375,2007
2007-10-26,W.P. Kuala Lumpur,332,188,144,2007
2007-10-27,W.P. Kuala Lumpur,474,286,188,2007
2007-10-28,W.P. Kuala Lumpur,937,517,420,2007
2007-10-29,W.P. Kuala Lumpur,182,85,97,2007
2007-10-30,W.P. Kuala Lumpur,445,249,196,2007
2007-10-31,W.P. Kuala Lumpur,226,112,114,2007
2007-11-01,W.P. Kuala Lumpur,227,138,89,2007
2007-11-02,W.P. Kuala Lumpur,267,112,155,2007
2007-11-03,W.P. Kuala Lumpur,307,170,137,2007
2007-11-04,W.P. Kuala Lumpur,574,317,257,2007
2007-11-05,W.P. Kuala Lumpur,241,99,142,2007
2007-11-06,W.P. Kuala Lumpur,286,146,140,2007
2007-11-07,W.P. Kuala Lumpur,538,382,156,2007
2007-11-08,W.P. Kuala Lumpur,174,88,86,2007
2007-11-09,W.P. Kuala Lumpur,258,130,128,2007
2007-11-10,W.P. Kuala Lumpur,148,83,65,2007
2007-11-11,W.P. Kuala Lumpur,569,260,309,2007
2007-11-12,W.P. Kuala Lumpur,195,87,108,2007
2007-11-13,W.P. Kuala Lumpur,251,109,142,2007
2007-11-14,W.P. Kuala Lumpur,242,95,147,2007
2007-11-15,W.P. Kuala Lumpur,649,381,268,2007
2007-11-16,W.P. Kuala Lumpur,279,143,136,2007
2007-11-17,W.P. Kuala Lumpur,352,196,156,2007
2007-11-18,W.P. Kuala Lumpur,696,336,360,2007
2007-11-19,W.P. Kuala Lumpur,516,191,325,2007
2007-11-20,W.P. Kuala Lumpur,908,356,552,2007
2007-11-21,W.P. Kuala Lumpur,848,352,496,2007
2007-11-22,W.P. Kuala Lumpur,1186,664,522,2007
2007-11-23,W.P. Kuala Lumpur,966,482,484,2007
2007-11-24,W.P. Kuala Lumpur,541,287,254,2007
2007-11-25,W.P. Kuala Lumpur,682,342,340,2007
2007-11-26,W.P. Kuala Lumpur,280,130,150,2007
2007-11-27,W.P. Kuala Lumpur,185,86,99,2007
2007-11-28,W.P. Kuala Lumpur,477,304,173,2007
2007-11-29,W.P. Kuala Lumpur,475,255,220,2007
2007-11-30,W.P. Kuala Lumpur,152,64,88,2007
2007-12-01,W.P. Kuala Lumpur,934,767,167,2007
2007-12-02,W.P. Kuala Lumpur,671,310,361,2007
2007-12-03,W.P. Kuala Lumpur,236,136,100,2007
2007-12-04,W.P. Kuala Lumpur,468,300,168,2007
2007-12-05,W.P. Kuala Lumpur,424,277,147,2007
2007-12-06,W.P. Kuala Lumpur,740,398,342,2007
2007-12-07,W.P. Kuala Lumpur,158,112,46,2007
2007-12-08,W.P. Kuala Lumpur,200,95,105,2007
2007-12-09,W.P. Kuala Lumpur,496,242,254,2007
2007-12-10,W.P. Kuala Lumpur,259,105,154,2007
2007-12-11,W.P. Kuala Lumpur,224,85,139,2007
2007-12-12,W.P. Kuala Lumpur,535,261,274,2007
2007-12-13,W.P. Kuala Lumpur,765,325,440,2007
2007-12-14,W.P. Kuala Lumpur,488,292,196,2007
2007-12-15,W.P. Kuala Lumpur,342,161,181,2007
2007-12-16,W.P. Kuala Lumpur,307,163,144,2007
2007-12-17,W.P. Kuala Lumpur,340,202,138,2007
2007-12-18,W.P. Kuala Lumpur,244,114,130,2007
2007-12-19,W.P. Kuala Lumpur,138,52,86,2007
2007-12-20,W.P. Kuala Lumpur,0,0,0,2007
2007-12-21,W.P. Kuala Lumpur,79,11,68,2007
2007-12-22,W.P. Kuala Lumpur,152,82,70,2007
2007-12-23,W.P. Kuala Lumpur,690,281,409,2007
2007-12-24,W.P. Kuala Lumpur,83,12,71,2007
2007-12-25,W.P. Kuala Lumpur,148,93,55,2007
2007-12-26,W.P. Kuala Lumpur,155,50,105,2007
2007-12-27,W.P. Kuala Lumpur,558,332,226,2007
2007-12-28,W.P. Kuala Lumpur,420,185,235,2007
2007-12-29,W.P. Kuala Lumpur,419,220,199,2007
2007-12-30,W.P. Kuala Lumpur,535,272,263,2007
2007-12-31,W.P. Kuala Lumpur,152,34,118,2007
2008-01-01,W.P. Kuala Lumpur,89,32,57,2008
2008-01-02,W.P. Kuala Lumpur,304,140,164,2008
2008-01-03,W.P. Kuala Lumpur,413,190,223,2008
2008-01-04,W.P. Kuala Lumpur,188,77,111,2008
2008-01-05,W.P. Kuala Lumpur,133,38,95,2008
2008-01-06,W.P. Kuala Lumpur,362,179,183,2008
2008-01-07,W.P. Kuala Lumpur,268,93,175,2008
2008-01-08,W.P. Kuala Lumpur,376,159,217,2008
2008-01-09,W.P. Kuala Lumpur,398,170,228,2008
2008-01-10,W.P. Kuala Lumpur,191,92,99,2008
2008-01-11,W.P. Kuala Lumpur,300,133,167,2008
2008-01-12,W.P. Kuala Lumpur,491,188,303,2008
2008-01-13,W.P. Kuala Lumpur,815,420,395,2008
2008-01-14,W.P. Kuala Lumpur,577,246,331,2008
2008-01-15,W.P. Kuala Lumpur,665,314,351,2008
2008-01-16,W.P. Kuala Lumpur,978,518,460,2008
2008-01-17,W.P. Kuala Lumpur,829,432,397,2008
2008-01-18,W.P. Kuala Lumpur,442,211,231,2008
2008-01-19,W.P. Kuala Lumpur,419,278,141,2008
2008-01-20,W.P. Kuala Lumpur,379,223,156,2008
2008-01-21,W.P. Kuala Lumpur,662,331,331,2008
2008-01-22,W.P. Kuala Lumpur,413,185,228,2008
2008-01-23,W.P. Kuala Lumpur,854,451,403,2008
2008-01-24,W.P. Kuala Lumpur,722,295,427,2008
2008-01-25,W.P. Kuala Lumpur,283,135,148,2008
2008-01-26,W.P. Kuala Lumpur,306,145,161,2008
2008-01-27,W.P. Kuala Lumpur,223,120,103,2008
2008-01-28,W.P. Kuala Lumpur,383,206,177,2008
2008-01-29,W.P. Kuala Lumpur,669,310,359,2008
2008-01-30,W.P. Kuala Lumpur,742,348,394,2008
2008-01-31,W.P. Kuala Lumpur,879,551,328,2008
2008-02-01,W.P. Kuala Lumpur,151,95,56,2008
2008-02-02,W.P. Kuala Lumpur,243,116,127,2008
2008-02-03,W.P. Kuala Lumpur,100,68,32,2008
2008-02-04,W.P. Kuala Lumpur,110,30,80,2008
2008-02-05,W.P. Kuala Lumpur,185,85,100,2008
2008-02-06,W.P. Kuala Lumpur,89,4,85,2008
2008-02-07,W.P. Kuala Lumpur,140,74,66,2008
2008-02-08,W.P. Kuala Lumpur,183,111,72,2008
2008-02-09,W.P. Kuala Lumpur,906,831,75,2008
2008-02-10,W.P. Kuala Lumpur,210,124,86,2008
2008-02-11,W.P. Kuala Lumpur,158,43,115,2008
2008-02-12,W.P. Kuala Lumpur,420,154,266,2008
2008-02-13,W.P. Kuala Lumpur,698,368,330,2008
2008-02-14,W.P. Kuala Lumpur,424,216,208,2008
2008-02-15,W.P. Kuala Lumpur,281,126,155,2008
2008-02-16,W.P. Kuala Lumpur,476,241,235,2008
2008-02-17,W.P. Kuala Lumpur,382,222,160,2008
2008-02-18,W.P. Kuala Lumpur,189,73,116,2008
2008-02-19,W.P. Kuala Lumpur,386,185,201,2008
2008-02-20,W.P. Kuala Lumpur,645,305,340,2008
2008-02-21,W.P. Kuala Lumpur,864,513,351,2008
2008-02-22,W.P. Kuala Lumpur,568,394,174,2008
2008-02-23,W.P. Kuala Lumpur,809,677,132,2008
2008-02-24,W.P. Kuala Lumpur,196,109,87,2008
2008-02-25,W.P. Kuala Lumpur,191,103,88,2008
2008-02-26,W.P. Kuala Lumpur,449,226,223,2008
2008-02-27,W.P. Kuala Lumpur,615,277,338,2008
2008-02-28,W.P. Kuala Lumpur,629,305,324,2008
2008-02-29,W.P. Kuala Lumpur,303,182,121,2008
2008-03-01,W.P. Kuala Lumpur,280,158,122,2008
2008-03-02,W.P. Kuala Lumpur,651,293,358,2008
2008-03-03,W.P. Kuala Lumpur,145,63,82,2008
2008-03-04,W.P. Kuala Lumpur,441,234,207,2008
2008-03-05,W.P. Kuala Lumpur,299,157,142,2008
2008-03-06,W.P. Kuala Lumpur,291,132,159,2008
2008-03-07,W.P. Kuala Lumpur,164,92,72,2008
2008-03-08,W.P. Kuala Lumpur,34,5,29,2008
2008-03-09,W.P. Kuala Lumpur,147,74,73,2008
2008-03-10,W.P. Kuala Lumpur,94,36,58,2008
2008-03-11,W.P. Kuala Lumpur,362,182,180,2008
2008-03-12,W.P. Kuala Lumpur,514,278,236,2008
2008-03-13,W.P. Kuala Lumpur,455,242,213,2008
2008-03-14,W.P. Kuala Lumpur,176,62,114,2008
2008-03-15,W.P. Kuala Lumpur,251,81,170,2008
2008-03-16,W.P. Kuala Lumpur,647,236,411,2008
2008-03-17,W.P. Kuala Lumpur,574,268,306,2008
2008-03-18,W.P. Kuala Lumpur,766,393,373,2008
2008-03-19,W.P. Kuala Lumpur,215,143,72,2008
2008-03-20,W.P. Kuala Lumpur,98,68,30,2008
2008-03-21,W.P. Kuala Lumpur,186,69,117,2008
2008-03-22,W.P. Kuala Lumpur,313,157,156,2008
2008-03-23,W.P. Kuala Lumpur,678,295,383,2008
2008-03-24,W.P. Kuala Lumpur,460,153,307,2008
2008-03-25,W.P. Kuala Lumpur,866,401,465,2008
2008-03-26,W.P. Kuala Lumpur,743,301,442,2008
2008-03-27,W.P. Kuala Lumpur,784,303,481,2008
2008-03-28,W.P. Kuala Lumpur,704,286,418,2008
2008-03-29,W.P. Kuala Lumpur,519,272,247,2008
2008-03-30,W.P. Kuala Lumpur,428,265,163,2008
2008-03-31,W.P. Kuala Lumpur,248,131,117,2008
2008-04-01,W.P. Kuala Lumpur,464,266,198,2008
2008-04-02,W.P. Kuala Lumpur,1105,660,445,2008
2008-04-03,W.P. Kuala Lumpur,769,346,423,2008
2008-04-04,W.P. Kuala Lumpur,169,69,100,2008
2008-04-05,W.P. Kuala Lumpur,219,77,142,2008
2008-04-06,W.P. Kuala Lumpur,548,282,266,2008
2008-04-07,W.P. Kuala Lumpur,461,288,173,2008
2008-04-08,W.P. Kuala Lumpur,708,424,284,2008
2008-04-09,W.P. Kuala Lumpur,259,112,147,2008
2008-04-10,W.P. Kuala Lumpur,282,117,165,2008
2008-04-11,W.P. Kuala Lumpur,311,121,190,2008
2008-04-12,W.P. Kuala Lumpur,194,85,109,2008
2008-04-13,W.P. Kuala Lumpur,654,396,258,2008
2008-04-14,W.P. Kuala Lumpur,343,164,179,2008
2008-04-15,W.P. Kuala Lumpur,306,148,158,2008
2008-04-16,W.P. Kuala Lumpur,844,408,436,2008
2008-04-17,W.P. Kuala Lumpur,622,289,333,2008
2008-04-18,W.P. Kuala Lumpur,491,237,254,2008
2008-04-19,W.P. Kuala Lumpur,340,140,200,2008
2008-04-20,W.P. Kuala Lumpur,878,386,492,2008
2008-04-21,W.P. Kuala Lumpur,426,198,228,2008
2008-04-22,W.P. Kuala Lumpur,581,338,243,2008
2008-04-23,W.P. Kuala Lumpur,399,262,137,2008
2008-04-24,W.P. Kuala Lumpur,129,42,87,2008
2008-04-25,W.P. Kuala Lumpur,286,143,143,2008
2008-04-26,W.P. Kuala Lumpur,286,116,170,2008
2008-04-27,W.P. Kuala Lumpur,742,380,362,2008
2008-04-28,W.P. Kuala Lumpur,242,116,126,2008
2008-04-29,W.P. Kuala Lumpur,296,137,159,2008
2008-04-30,W.P. Kuala Lumpur,406,222,184,2008
2008-05-01,W.P. Kuala Lumpur,1291,372,919,2008
2008-05-02,W.P. Kuala Lumpur,91,9,82,2008
2008-05-03,W.P. Kuala Lumpur,256,99,157,2008
2008-05-04,W.P. Kuala Lumpur,743,318,425,2008
2008-05-05,W.P. Kuala Lumpur,231,145,86,2008
2008-05-06,W.P. Kuala Lumpur,245,120,125,2008
2008-05-07,W.P. Kuala Lumpur,418,188,230,2008
2008-05-08,W.P. Kuala Lumpur,591,279,312,2008
2008-05-09,W.P. Kuala Lumpur,488,262,226,2008
2008-05-10,W.P. Kuala Lumpur,383,178,205,2008
2008-05-11,W.P. Kuala Lumpur,263,160,103,2008
2008-05-12,W.P. Kuala Lumpur,150,44,106,2008
2008-05-13,W.P. Kuala Lumpur,253,110,143,2008
2008-05-14,W.P. Kuala Lumpur,436,228,208,2008
2008-05-15,W.P. Kuala Lumpur,579,265,314,2008
2008-05-16,W.P. Kuala Lumpur,503,255,248,2008
2008-05-17,W.P. Kuala Lumpur,768,641,127,2008
2008-05-18,W.P. Kuala Lumpur,842,410,432,2008
2008-05-19,W.P. Kuala Lumpur,1300,573,727,2008
2008-05-20,W.P. Kuala Lumpur,202,74,128,2008
2008-05-21,W.P. Kuala Lumpur,563,271,292,2008
2008-05-22,W.P. Kuala Lumpur,364,224,140,2008
2008-05-23,W.P. Kuala Lumpur,276,152,124,2008
2008-05-24,W.P. Kuala Lumpur,115,41,74,2008
2008-05-25,W.P. Kuala Lumpur,498,291,207,2008
2008-05-26,W.P. Kuala Lumpur,122,35,87,2008
2008-05-27,W.P. Kuala Lumpur,126,48,78,2008
2008-05-28,W.P. Kuala Lumpur,740,398,342,2008
2008-05-29,W.P. Kuala Lumpur,339,166,173,2008
2008-05-30,W.P. Kuala Lumpur,221,56,165,2008
2008-05-31,W.P. Kuala Lumpur,201,69,132,2008
2008-06-01,W.P. Kuala Lumpur,114,43,71,2008
2008-06-02,W.P. Kuala Lumpur,91,24,67,2008
2008-06-03,W.P. Kuala Lumpur,330,153,177,2008
2008-06-04,W.P. Kuala Lumpur,145,69,76,2008
2008-06-05,W.P. Kuala Lumpur,224,61,163,2008
2008-06-06,W.P. Kuala Lumpur,213,84,129,2008
2008-06-07,W.P. Kuala Lumpur,214,92,122,2008
2008-06-08,W.P. Kuala Lumpur,481,263,218,2008
2008-06-09,W.P. Kuala Lumpur,184,63,121,2008
2008-06-10,W.P. Kuala Lumpur,389,225,164,2008
2008-06-11,W.P. Kuala Lumpur,428,217,211,2008
2008-06-12,W.P. Kuala Lumpur,323,161,162,2008
2008-06-13,W.P. Kuala Lumpur,132,58,74,2008
2008-06-14,W.P. Kuala Lumpur,675,512,163,2008
2008-06-15,W.P. Kuala Lumpur,979,389,590,2008
2008-06-16,W.P. Kuala Lumpur,307,168,139,2008
2008-06-17,W.P. Kuala Lumpur,111,39,72,2008
2008-06-18,W.P. Kuala Lumpur,296,179,117,2008
2008-06-19,W.P. Kuala Lumpur,437,255,182,2008
2008-06-20,W.P. Kuala Lumpur,410,227,183,2008
2008-06-21,W.P. Kuala Lumpur,707,338,369,2008
2008-06-22,W.P. Kuala Lumpur,941,362,579,2008
2008-06-23,W.P. Kuala Lumpur,113,30,83,2008
2008-06-24,W.P. Kuala Lumpur,422,147,275,2008
2008-06-25,W.P. Kuala Lumpur,483,217,266,2008
2008-06-26,W.P. Kuala Lumpur,476,254,222,2008
2008-06-27,W.P. Kuala Lumpur,299,137,162,2008
2008-06-28,W.P. Kuala Lumpur,500,258,242,2008
2008-06-29,W.P. Kuala Lumpur,548,292,256,2008
2008-06-30,W.P. Kuala Lumpur,418,255,163,2008
2008-07-01,W.P. Kuala Lumpur,201,46,155,2008
2008-07-02,W.P. Kuala Lumpur,232,116,116,2008
2008-07-03,W.P. Kuala Lumpur,232,100,132,2008
2008-07-04,W.P. Kuala Lumpur,440,191,249,2008
2008-07-05,W.P. Kuala Lumpur,336,130,206,2008
2008-07-06,W.P. Kuala Lumpur,679,319,360,2008
2008-07-07,W.P. Kuala Lumpur,176,73,103,2008
2008-07-08,W.P. Kuala Lumpur,427,257,170,2008
2008-07-09,W.P. Kuala Lumpur,230,120,110,2008
2008-07-10,W.P. Kuala Lumpur,431,189,242,2008
2008-07-11,W.P. Kuala Lumpur,263,132,131,2008
2008-07-12,W.P. Kuala Lumpur,410,259,151,2008
2008-07-13,W.P. Kuala Lumpur,584,248,336,2008
2008-07-14,W.P. Kuala Lumpur,227,105,122,2008
2008-07-15,W.P. Kuala Lumpur,565,290,275,2008
2008-07-16,W.P. Kuala Lumpur,661,317,344,2008
2008-07-17,W.P. Kuala Lumpur,819,361,458,2008
2008-07-18,W.P. Kuala Lumpur,519,212,307,2008
2008-07-19,W.P. Kuala Lumpur,314,162,152,2008
2008-07-20,W.P. Kuala Lumpur,455,214,241,2008
2008-07-21,W.P. Kuala Lumpur,383,223,160,2008
2008-07-22,W.P. Kuala Lumpur,506,260,246,2008
2008-07-23,W.P. Kuala Lumpur,465,232,233,2008
2008-07-24,W.P. Kuala Lumpur,830,437,393,2008
2008-07-25,W.P. Kuala Lumpur,554,245,309,2008
2008-07-26,W.P. Kuala Lumpur,743,411,332,2008
2008-07-27,W.P. Kuala Lumpur,632,395,237,2008
2008-07-28,W.P. Kuala Lumpur,360,141,219,2008
2008-07-29,W.P. Kuala Lumpur,774,318,456,2008
2008-07-30,W.P. Kuala Lumpur,909,355,554,2008
2008-07-31,W.P. Kuala Lumpur,755,320,435,2008
2008-08-01,W.P. Kuala Lumpur,703,285,418,2008
2008-08-02,W.P. Kuala Lumpur,353,155,198,2008
2008-08-03,W.P. Kuala Lumpur,780,318,462,2008
2008-08-04,W.P. Kuala Lumpur,509,267,242,2008
2008-08-05,W.P. Kuala Lumpur,593,287,306,2008
2008-08-06,W.P. Kuala Lumpur,773,470,303,2008
2008-08-07,W.P. Kuala Lumpur,675,348,327,2008
2008-08-08,W.P. Kuala Lumpur,321,145,176,2008
2008-08-09,W.P. Kuala Lumpur,499,283,216,2008
2008-08-10,W.P. Kuala Lumpur,952,473,479,2008
2008-08-11,W.P. Kuala Lumpur,364,179,185,2008
2008-08-12,W.P. Kuala Lumpur,726,379,347,2008
2008-08-13,W.P. Kuala Lumpur,1011,400,611,2008
2008-08-14,W.P. Kuala Lumpur,818,440,378,2008
2008-08-15,W.P. Kuala Lumpur,184,79,105,2008
2008-08-16,W.P. Kuala Lumpur,816,692,124,2008
2008-08-17,W.P. Kuala Lumpur,524,256,268,2008
2008-08-18,W.P. Kuala Lumpur,86,28,58,2008
2008-08-19,W.P. Kuala Lumpur,506,298,208,2008
2008-08-20,W.P. Kuala Lumpur,674,320,354,2008
2008-08-21,W.P. Kuala Lumpur,1029,601,428,2008
2008-08-22,W.P. Kuala Lumpur,592,318,274,2008
2008-08-23,W.P. Kuala Lumpur,392,303,89,2008
2008-08-24,W.P. Kuala Lumpur,620,318,302,2008
2008-08-25,W.P. Kuala Lumpur,566,302,264,2008
2008-08-26,W.P. Kuala Lumpur,533,216,317,2008
2008-08-27,W.P. Kuala Lumpur,941,472,469,2008
2008-08-28,W.P. Kuala Lumpur,593,273,320,2008
2008-08-29,W.P. Kuala Lumpur,577,291,286,2008
2008-08-30,W.P. Kuala Lumpur,729,352,377,2008
2008-08-31,W.P. Kuala Lumpur,831,446,385,2008
2008-09-01,W.P. Kuala Lumpur,492,227,265,2008
2008-09-02,W.P. Kuala Lumpur,38,6,32,2008
2008-09-03,W.P. Kuala Lumpur,54,12,42,2008
2008-09-04,W.P. Kuala Lumpur,74,31,43,2008
2008-09-05,W.P. Kuala Lumpur,51,6,45,2008
2008-09-06,W.P. Kuala Lumpur,190,66,124,2008
2008-09-07,W.P. Kuala Lumpur,672,271,401,2008
2008-09-08,W.P. Kuala Lumpur,56,4,52,2008
2008-09-09,W.P. Kuala Lumpur,93,23,70,2008
2008-09-10,W.P. Kuala Lumpur,101,33,68,2008
2008-09-11,W.P. Kuala Lumpur,49,2,47,2008
2008-09-12,W.P. Kuala Lumpur,126,32,94,2008
2008-09-13,W.P. Kuala Lumpur,173,110,63,2008
2008-09-14,W.P. Kuala Lumpur,308,201,107,2008
2008-09-15,W.P. Kuala Lumpur,47,2,45,2008
2008-09-16,W.P. Kuala Lumpur,80,24,56,2008
2008-09-17,W.P. Kuala Lumpur,142,42,100,2008
2008-09-18,W.P. Kuala Lumpur,547,360,187,2008
2008-09-19,W.P. Kuala Lumpur,136,53,83,2008
2008-09-20,W.P. Kuala Lumpur,213,103,110,2008
2008-09-21,W.P. Kuala Lumpur,1129,382,747,2008
2008-09-22,W.P. Kuala Lumpur,59,13,46,2008
2008-09-23,W.P. Kuala Lumpur,356,198,158,2008
2008-09-24,W.P. Kuala Lumpur,174,93,81,2008
2008-09-25,W.P. Kuala Lumpur,235,103,132,2008
2008-09-26,W.P. Kuala Lumpur,135,42,93,2008
2008-09-27,W.P. Kuala Lumpur,321,123,198,2008
2008-09-28,W.P. Kuala Lumpur,873,383,490,2008
2008-09-29,W.P. Kuala Lumpur,51,5,46,2008
2008-09-30,W.P. Kuala Lumpur,37,0,37,2008
2008-10-01,W.P. Kuala Lumpur,0,0,0,2008
2008-10-02,W.P. Kuala Lumpur,15,2,13,2008
2008-10-03,W.P. Kuala Lumpur,82,10,72,2008
2008-10-04,W.P. Kuala Lumpur,105,33,72,2008
2008-10-05,W.P. Kuala Lumpur,342,147,195,2008
2008-10-06,W.P. Kuala Lumpur,105,17,88,2008
2008-10-07,W.P. Kuala Lumpur,273,99,174,2008
2008-10-08,W.P. Kuala Lumpur,353,127,226,2008
2008-10-09,W.P. Kuala Lumpur,330,158,172,2008
2008-10-10,W.P. Kuala Lumpur,230,73,157,2008
2008-10-11,W.P. Kuala Lumpur,614,397,217,2008
2008-10-12,W.P. Kuala Lumpur,894,475,419,2008
2008-10-13,W.P. Kuala Lumpur,162,61,101,2008
2008-10-14,W.P. Kuala Lumpur,266,127,139,2008
2008-10-15,W.P. Kuala Lumpur,1091,742,349,2008
2008-10-16,W.P. Kuala Lumpur,645,315,330,2008
2008-10-17,W.P. Kuala Lumpur,171,53,118,2008
2008-10-18,W.P. Kuala Lumpur,839,724,115,2008
2008-10-19,W.P. Kuala Lumpur,566,241,325,2008
2008-10-20,W.P. Kuala Lumpur,469,243,226,2008
2008-10-21,W.P. Kuala Lumpur,305,110,195,2008
2008-10-22,W.P. Kuala Lumpur,698,312,386,2008
2008-10-23,W.P. Kuala Lumpur,739,244,495,2008
2008-10-24,W.P. Kuala Lumpur,161,53,108,2008
2008-10-25,W.P. Kuala Lumpur,159,50,109,2008
2008-10-26,W.P. Kuala Lumpur,609,247,362,2008
2008-10-27,W.P. Kuala Lumpur,26,4,22,2008
2008-10-28,W.P. Kuala Lumpur,265,103,162,2008
2008-10-29,W.P. Kuala Lumpur,216,102,114,2008
2008-10-30,W.P. Kuala Lumpur,238,122,116,2008
2008-10-31,W.P. Kuala Lumpur,322,111,211,2008
2008-11-01,W.P. Kuala Lumpur,320,139,181,2008
2008-11-02,W.P. Kuala Lumpur,917,518,399,2008
2008-11-03,W.P. Kuala Lumpur,138,42,96,2008
2008-11-04,W.P. Kuala Lumpur,425,138,287,2008
2008-11-05,W.P. Kuala Lumpur,425,210,215,2008
2008-11-06,W.P. Kuala Lumpur,437,155,282,2008
2008-11-07,W.P. Kuala Lumpur,468,225,243,2008
2008-11-08,W.P. Kuala Lumpur,358,160,198,2008
2008-11-09,W.P. Kuala Lumpur,739,324,415,2008
2008-11-10,W.P. Kuala Lumpur,202,57,145,2008
2008-11-11,W.P. Kuala Lumpur,539,231,308,2008
2008-11-12,W.P. Kuala Lumpur,204,70,134,2008
2008-11-13,W.P. Kuala Lumpur,465,182,283,2008
2008-11-14,W.P. Kuala Lumpur,265,89,176,2008
2008-11-15,W.P. Kuala Lumpur,358,166,192,2008
2008-11-16,W.P. Kuala Lumpur,820,371,449,2008
2008-11-17,W.P. Kuala Lumpur,108,33,75,2008
2008-11-18,W.P. Kuala Lumpur,350,187,163,2008
2008-11-19,W.P. Kuala Lumpur,531,319,212,2008
2008-11-20,W.P. Kuala Lumpur,506,255,251,2008
2008-11-21,W.P. Kuala Lumpur,394,216,178,2008
2008-11-22,W.P. Kuala Lumpur,528,236,292,2008
2008-11-23,W.P. Kuala Lumpur,428,240,188,2008
2008-11-24,W.P. Kuala Lumpur,270,58,212,2008
2008-11-25,W.P. Kuala Lumpur,666,243,423,2008
2008-11-26,W.P. Kuala Lumpur,739,237,502,2008
2008-11-27,W.P. Kuala Lumpur,879,350,529,2008
2008-11-28,W.P. Kuala Lumpur,971,476,495,2008
2008-11-29,W.P. Kuala Lumpur,350,195,155,2008
2008-11-30,W.P. Kuala Lumpur,435,185,250,2008
2008-12-01,W.P. Kuala Lumpur,213,82,131,2008
2008-12-02,W.P. Kuala Lumpur,211,76,135,2008
2008-12-03,W.P. Kuala Lumpur,460,230,230,2008
2008-12-04,W.P. Kuala Lumpur,964,374,590,2008
2008-12-05,W.P. Kuala Lumpur,423,196,227,2008
2008-12-06,W.P. Kuala Lumpur,256,127,129,2008
2008-12-07,W.P. Kuala Lumpur,920,320,600,2008
2008-12-08,W.P. Kuala Lumpur,16,8,8,2008
2008-12-09,W.P. Kuala Lumpur,183,63,120,2008
2008-12-10,W.P. Kuala Lumpur,88,28,60,2008
2008-12-11,W.P. Kuala Lumpur,354,124,230,2008
2008-12-12,W.P. Kuala Lumpur,279,130,149,2008
2008-12-13,W.P. Kuala Lumpur,414,228,186,2008
2008-12-14,W.P. Kuala Lumpur,613,270,343,2008
2008-12-15,W.P. Kuala Lumpur,187,70,117,2008
2008-12-16,W.P. Kuala Lumpur,454,180,274,2008
2008-12-17,W.P. Kuala Lumpur,569,228,341,2008
2008-12-18,W.P. Kuala Lumpur,895,376,519,2008
2008-12-19,W.P. Kuala Lumpur,368,184,184,2008
2008-12-20,W.P. Kuala Lumpur,310,152,158,2008
2008-12-21,W.P. Kuala Lumpur,362,57,305,2008
2008-12-22,W.P. Kuala Lumpur,444,216,228,2008
2008-12-23,W.P. Kuala Lumpur,593,276,317,2008
2008-12-24,W.P. Kuala Lumpur,218,73,145,2008
2008-12-25,W.P. Kuala Lumpur,113,34,79,2008
2008-12-26,W.P. Kuala Lumpur,173,70,103,2008
2008-12-27,W.P. Kuala Lumpur,367,171,196,2008
2008-12-28,W.P. Kuala Lumpur,486,224,262,2008
2008-12-29,W.P. Kuala Lumpur,16,1,15,2008
2008-12-30,W.P. Kuala Lumpur,168,26,142,2008
2008-12-31,W.P. Kuala Lumpur,335,95,240,2008
2009-01-01,W.P. Kuala Lumpur,26,4,22,2009
2009-01-02,W.P. Kuala Lumpur,101,19,82,2009
2009-01-03,W.P. Kuala Lumpur,153,44,109,2009
2009-01-04,W.P. Kuala Lumpur,164,58,106,2009
2009-01-05,W.P. Kuala Lumpur,292,93,199,2009
2009-01-06,W.P. Kuala Lumpur,299,71,228,2009
2009-01-07,W.P. Kuala Lumpur,552,209,343,2009
2009-01-08,W.P. Kuala Lumpur,502,233,269,2009
2009-01-09,W.P. Kuala Lumpur,806,425,381,2009
2009-01-10,W.P. Kuala Lumpur,412,197,215,2009
2009-01-11,W.P. Kuala Lumpur,570,301,269,2009
2009-01-12,W.P. Kuala Lumpur,393,192,201,2009
2009-01-13,W.P. Kuala Lumpur,724,280,444,2009
2009-01-14,W.P. Kuala Lumpur,892,383,509,2009
2009-01-15,W.P. Kuala Lumpur,633,270,363,2009
2009-01-16,W.P. Kuala Lumpur,490,275,215,2009
2009-01-17,W.P. Kuala Lumpur,407,161,246,2009
2009-01-18,W.P. Kuala Lumpur,294,163,131,2009
2009-01-19,W.P. Kuala Lumpur,223,107,116,2009
2009-01-20,W.P. Kuala Lumpur,678,287,391,2009
2009-01-21,W.P. Kuala Lumpur,912,449,463,2009
2009-01-22,W.P. Kuala Lumpur,731,414,317,2009
2009-01-23,W.P. Kuala Lumpur,377,194,183,2009
2009-01-24,W.P. Kuala Lumpur,273,116,157,2009
2009-01-25,W.P. Kuala Lumpur,188,106,82,2009
2009-01-26,W.P. Kuala Lumpur,242,138,104,2009
2009-01-27,W.P. Kuala Lumpur,206,114,92,2009
2009-01-28,W.P. Kuala Lumpur,258,86,172,2009
2009-01-29,W.P. Kuala Lumpur,607,296,311,2009
2009-01-30,W.P. Kuala Lumpur,463,184,279,2009
2009-01-31,W.P. Kuala Lumpur,472,219,253,2009
2009-02-01,W.P. Kuala Lumpur,379,189,190,2009
2009-02-02,W.P. Kuala Lumpur,250,131,119,2009
2009-02-03,W.P. Kuala Lumpur,205,61,144,2009
2009-02-04,W.P. Kuala Lumpur,750,384,366,2009
2009-02-05,W.P. Kuala Lumpur,635,270,365,2009
2009-02-06,W.P. Kuala Lumpur,183,64,119,2009
2009-02-07,W.P. Kuala Lumpur,1149,910,239,2009
2009-02-08,W.P. Kuala Lumpur,840,403,437,2009
2009-02-09,W.P. Kuala Lumpur,221,134,87,2009
2009-02-10,W.P. Kuala Lumpur,303,127,176,2009
2009-02-11,W.P. Kuala Lumpur,493,330,163,2009
2009-02-12,W.P. Kuala Lumpur,575,270,305,2009
2009-02-13,W.P. Kuala Lumpur,560,266,294,2009
2009-02-14,W.P. Kuala Lumpur,705,369,336,2009
2009-02-15,W.P. Kuala Lumpur,388,222,166,2009
2009-02-16,W.P. Kuala Lumpur,198,46,152,2009
2009-02-17,W.P. Kuala Lumpur,563,200,363,2009
2009-02-18,W.P. Kuala Lumpur,702,210,492,2009
2009-02-19,W.P. Kuala Lumpur,674,295,379,2009
2009-02-20,W.P. Kuala Lumpur,643,284,359,2009
2009-02-21,W.P. Kuala Lumpur,903,644,259,2009
2009-02-22,W.P. Kuala Lumpur,456,254,202,2009
2009-02-23,W.P. Kuala Lumpur,119,43,76,2009
2009-02-24,W.P. Kuala Lumpur,489,274,215,2009
2009-02-25,W.P. Kuala Lumpur,669,304,365,2009
2009-02-26,W.P. Kuala Lumpur,585,266,319,2009
2009-02-27,W.P. Kuala Lumpur,317,157,160,2009
2009-02-28,W.P. Kuala Lumpur,387,181,206,2009
2009-03-01,W.P. Kuala Lumpur,993,393,600,2009
2009-03-02,W.P. Kuala Lumpur,229,110,119,2009
2009-03-03,W.P. Kuala Lumpur,423,210,213,2009
2009-03-04,W.P. Kuala Lumpur,323,126,197,2009
2009-03-05,W.P. Kuala Lumpur,606,307,299,2009
2009-03-06,W.P. Kuala Lumpur,266,91,175,2009
2009-03-07,W.P. Kuala Lumpur,956,247,709,2009
2009-03-08,W.P. Kuala Lumpur,338,163,175,2009
2009-03-09,W.P. Kuala Lumpur,0,0,0,2009
2009-03-10,W.P. Kuala Lumpur,443,208,235,2009
2009-03-11,W.P. Kuala Lumpur,366,200,166,2009
2009-03-12,W.P. Kuala Lumpur,611,309,302,2009
2009-03-13,W.P. Kuala Lumpur,456,197,259,2009
2009-03-14,W.P. Kuala Lumpur,244,86,158,2009
2009-03-15,W.P. Kuala Lumpur,580,228,352,2009
2009-03-16,W.P. Kuala Lumpur,393,109,284,2009
2009-03-17,W.P. Kuala Lumpur,606,178,428,2009
2009-03-18,W.P. Kuala Lumpur,658,232,426,2009
2009-03-19,W.P. Kuala Lumpur,772,328,444,2009
2009-03-20,W.P. Kuala Lumpur,424,151,273,2009
2009-03-21,W.P. Kuala Lumpur,416,191,225,2009
2009-03-22,W.P. Kuala Lumpur,443,230,213,2009
2009-03-23,W.P. Kuala Lumpur,245,135,110,2009
2009-03-24,W.P. Kuala Lumpur,447,236,211,2009
2009-03-25,W.P. Kuala Lumpur,552,270,282,2009
2009-03-26,W.P. Kuala Lumpur,721,286,435,2009
2009-03-27,W.P. Kuala Lumpur,384,168,216,2009
2009-03-28,W.P. Kuala Lumpur,352,170,182,2009
2009-03-29,W.P. Kuala Lumpur,673,238,435,2009
2009-03-30,W.P. Kuala Lumpur,341,165,176,2009
2009-03-31,W.P. Kuala Lumpur,522,275,247,2009
2009-04-01,W.P. Kuala Lumpur,687,260,427,2009
2009-04-02,W.P. Kuala Lumpur,411,278,133,2009
2009-04-03,W.P. Kuala Lumpur,327,158,169,2009
2009-04-04,W.P. Kuala Lumpur,239,93,146,2009
2009-04-05,W.P. Kuala Lumpur,628,289,339,2009
2009-04-06,W.P. Kuala Lumpur,240,78,162,2009
2009-04-07,W.P. Kuala Lumpur,696,327,369,2009
2009-04-08,W.P. Kuala Lumpur,672,390,282,2009
2009-04-09,W.P. Kuala Lumpur,867,445,422,2009
2009-04-10,W.P. Kuala Lumpur,243,130,113,2009
2009-04-11,W.P. Kuala Lumpur,554,296,258,2009
2009-04-12,W.P. Kuala Lumpur,408,139,269,2009
2009-04-13,W.P. Kuala Lumpur,342,116,226,2009
2009-04-14,W.P. Kuala Lumpur,877,324,553,2009
2009-04-15,W.P. Kuala Lumpur,639,279,360,2009
2009-04-16,W.P. Kuala Lumpur,479,217,262,2009
2009-04-17,W.P. Kuala Lumpur,554,264,290,2009
2009-04-18,W.P. Kuala Lumpur,359,170,189,2009
2009-04-19,W.P. Kuala Lumpur,556,189,367,2009
2009-04-20,W.P. Kuala Lumpur,454,200,254,2009
2009-04-21,W.P. Kuala Lumpur,376,155,221,2009
2009-04-22,W.P. Kuala Lumpur,602,259,343,2009
2009-04-23,W.P. Kuala Lumpur,303,133,170,2009
2009-04-24,W.P. Kuala Lumpur,421,170,251,2009
2009-04-25,W.P. Kuala Lumpur,184,58,126,2009
2009-04-26,W.P. Kuala Lumpur,297,136,161,2009
2009-04-27,W.P. Kuala Lumpur,213,72,141,2009
2009-04-28,W.P. Kuala Lumpur,363,174,189,2009
2009-04-29,W.P. Kuala Lumpur,192,78,114,2009
2009-04-30,W.P. Kuala Lumpur,404,186,218,2009
2009-05-01,W.P. Kuala Lumpur,1362,343,1019,2009
2009-05-02,W.P. Kuala Lumpur,182,52,130,2009
2009-05-03,W.P. Kuala Lumpur,328,139,189,2009
2009-05-04,W.P. Kuala Lumpur,69,9,60,2009
2009-05-05,W.P. Kuala Lumpur,312,117,195,2009
2009-05-06,W.P. Kuala Lumpur,338,120,218,2009
2009-05-07,W.P. Kuala Lumpur,379,146,233,2009
2009-05-08,W.P. Kuala Lumpur,349,115,234,2009
2009-05-09,W.P. Kuala Lumpur,1433,516,917,2009
2009-05-10,W.P. Kuala Lumpur,482,237,245,2009
2009-05-11,W.P. Kuala Lumpur,252,91,161,2009
2009-05-12,W.P. Kuala Lumpur,452,182,270,2009
2009-05-13,W.P. Kuala Lumpur,533,207,326,2009
2009-05-14,W.P. Kuala Lumpur,428,231,197,2009
2009-05-15,W.P. Kuala Lumpur,735,353,382,2009
2009-05-16,W.P. Kuala Lumpur,612,344,268,2009
2009-05-17,W.P. Kuala Lumpur,698,250,448,2009
2009-05-18,W.P. Kuala Lumpur,110,17,93,2009
2009-05-19,W.P. Kuala Lumpur,465,231,234,2009
2009-05-20,W.P. Kuala Lumpur,287,97,190,2009
2009-05-21,W.P. Kuala Lumpur,317,87,230,2009
2009-05-22,W.P. Kuala Lumpur,256,115,141,2009
2009-05-23,W.P. Kuala Lumpur,566,379,187,2009
2009-05-24,W.P. Kuala Lumpur,838,355,483,2009
2009-05-25,W.P. Kuala Lumpur,322,144,178,2009
2009-05-26,W.P. Kuala Lumpur,221,72,149,2009
2009-05-27,W.P. Kuala Lumpur,477,230,247,2009
2009-05-28,W.P. Kuala Lumpur,791,323,468,2009
2009-05-29,W.P. Kuala Lumpur,444,205,239,2009
2009-05-30,W.P. Kuala Lumpur,403,208,195,2009
2009-05-31,W.P. Kuala Lumpur,799,345,454,2009
2009-06-01,W.P. Kuala Lumpur,140,48,92,2009
2009-06-02,W.P. Kuala Lumpur,135,46,89,2009
2009-06-03,W.P. Kuala Lumpur,520,267,253,2009
2009-06-04,W.P. Kuala Lumpur,301,106,195,2009
2009-06-05,W.P. Kuala Lumpur,154,55,99,2009
2009-06-06,W.P. Kuala Lumpur,303,126,177,2009
2009-06-07,W.P. Kuala Lumpur,703,296,407,2009
2009-06-08,W.P. Kuala Lumpur,289,132,157,2009
2009-06-09,W.P. Kuala Lumpur,223,96,127,2009
2009-06-10,W.P. Kuala Lumpur,138,59,79,2009
2009-06-11,W.P. Kuala Lumpur,242,79,163,2009
2009-06-12,W.P. Kuala Lumpur,262,80,182,2009
2009-06-13,W.P. Kuala Lumpur,174,31,143,2009
2009-06-14,W.P. Kuala Lumpur,923,268,655,2009
2009-06-15,W.P. Kuala Lumpur,318,173,145,2009
2009-06-16,W.P. Kuala Lumpur,465,230,235,2009
2009-06-17,W.P. Kuala Lumpur,687,379,308,2009
2009-06-18,W.P. Kuala Lumpur,718,388,330,2009
2009-06-19,W.P. Kuala Lumpur,306,153,153,2009
2009-06-20,W.P. Kuala Lumpur,469,237,232,2009
2009-06-21,W.P. Kuala Lumpur,678,353,325,2009
2009-06-22,W.P. Kuala Lumpur,156,59,97,2009
2009-06-23,W.P. Kuala Lumpur,528,312,216,2009
2009-06-24,W.P. Kuala Lumpur,335,152,183,2009
2009-06-25,W.P. Kuala Lumpur,530,279,251,2009
2009-06-26,W.P. Kuala Lumpur,280,139,141,2009
2009-06-27,W.P. Kuala Lumpur,950,477,473,2009
2009-06-28,W.P. Kuala Lumpur,528,245,283,2009
2009-06-29,W.P. Kuala Lumpur,110,26,84,2009
2009-06-30,W.P. Kuala Lumpur,387,226,161,2009
2009-07-01,W.P. Kuala Lumpur,442,234,208,2009
2009-07-02,W.P. Kuala Lumpur,448,242,206,2009
2009-07-03,W.P. Kuala Lumpur,350,166,184,2009
2009-07-04,W.P. Kuala Lumpur,358,128,230,2009
2009-07-05,W.P. Kuala Lumpur,570,198,372,2009
2009-07-06,W.P. Kuala Lumpur,278,171,107,2009
2009-07-07,W.P. Kuala Lumpur,563,317,246,2009
2009-07-08,W.P. Kuala Lumpur,326,256,70,2009
2009-07-09,W.P. Kuala Lumpur,482,255,227,2009
2009-07-10,W.P. Kuala Lumpur,215,125,90,2009
2009-07-11,W.P. Kuala Lumpur,413,166,247,2009
2009-07-12,W.P. Kuala Lumpur,842,346,496,2009
2009-07-13,W.P. Kuala Lumpur,346,153,193,2009
2009-07-14,W.P. Kuala Lumpur,400,189,211,2009
2009-07-15,W.P. Kuala Lumpur,797,417,380,2009
2009-07-16,W.P. Kuala Lumpur,568,216,352,2009
2009-07-17,W.P. Kuala Lumpur,486,246,240,2009
2009-07-18,W.P. Kuala Lumpur,277,102,175,2009
2009-07-19,W.P. Kuala Lumpur,495,230,265,2009
2009-07-20,W.P. Kuala Lumpur,433,177,256,2009
2009-07-21,W.P. Kuala Lumpur,510,181,329,2009
2009-07-22,W.P. Kuala Lumpur,816,335,481,2009
2009-07-23,W.P. Kuala Lumpur,698,317,381,2009
2009-07-24,W.P. Kuala Lumpur,931,736,195,2009
2009-07-25,W.P. Kuala Lumpur,527,216,311,2009
2009-07-26,W.P. Kuala Lumpur,698,292,406,2009
2009-07-27,W.P. Kuala Lumpur,608,344,264,2009
2009-07-28,W.P. Kuala Lumpur,415,200,215,2009
2009-07-29,W.P. Kuala Lumpur,317,125,192,2009
2009-07-30,W.P. Kuala Lumpur,265,97,168,2009
2009-07-31,W.P. Kuala Lumpur,435,156,279,2009
2009-08-01,W.P. Kuala Lumpur,225,125,100,2009
2009-08-02,W.P. Kuala Lumpur,944,368,576,2009
2009-08-03,W.P. Kuala Lumpur,562,197,365,2009
2009-08-04,W.P. Kuala Lumpur,826,256,570,2009
2009-08-05,W.P. Kuala Lumpur,1214,554,660,2009
2009-08-06,W.P. Kuala Lumpur,836,331,505,2009
2009-08-07,W.P. Kuala Lumpur,940,456,484,2009
2009-08-08,W.P. Kuala Lumpur,766,273,493,2009
2009-08-09,W.P. Kuala Lumpur,535,275,260,2009
2009-08-10,W.P. Kuala Lumpur,401,204,197,2009
2009-08-11,W.P. Kuala Lumpur,630,298,332,2009
2009-08-12,W.P. Kuala Lumpur,689,282,407,2009
2009-08-13,W.P. Kuala Lumpur,647,326,321,2009
2009-08-14,W.P. Kuala Lumpur,681,344,337,2009
2009-08-15,W.P. Kuala Lumpur,830,351,479,2009
2009-08-16,W.P. Kuala Lumpur,797,388,409,2009
2009-08-17,W.P. Kuala Lumpur,641,282,359,2009
2009-08-18,W.P. Kuala Lumpur,781,280,501,2009
2009-08-19,W.P. Kuala Lumpur,555,224,331,2009
2009-08-20,W.P. Kuala Lumpur,746,361,385,2009
2009-08-21,W.P. Kuala Lumpur,347,161,186,2009
2009-08-22,W.P. Kuala Lumpur,125,40,85,2009
2009-08-23,W.P. Kuala Lumpur,636,253,383,2009
2009-08-24,W.P. Kuala Lumpur,39,3,36,2009
2009-08-25,W.P. Kuala Lumpur,193,71,122,2009
2009-08-26,W.P. Kuala Lumpur,53,10,43,2009
2009-08-27,W.P. Kuala Lumpur,293,97,196,2009
2009-08-28,W.P. Kuala Lumpur,90,30,60,2009
2009-08-29,W.P. Kuala Lumpur,232,119,113,2009
2009-08-30,W.P. Kuala Lumpur,217,86,131,2009
2009-08-31,W.P. Kuala Lumpur,0,0,0,2009
2009-09-01,W.P. Kuala Lumpur,90,21,69,2009
2009-09-02,W.P. Kuala Lumpur,85,23,62,2009
2009-09-03,W.P. Kuala Lumpur,160,78,82,2009
2009-09-04,W.P. Kuala Lumpur,128,38,90,2009
2009-09-05,W.P. Kuala Lumpur,250,79,171,2009
2009-09-06,W.P. Kuala Lumpur,707,175,532,2009
2009-09-07,W.P. Kuala Lumpur,95,14,81,2009
2009-09-08,W.P. Kuala Lumpur,260,113,147,2009
2009-09-09,W.P. Kuala Lumpur,151,76,75,2009
2009-09-10,W.P. Kuala Lumpur,197,48,149,2009
2009-09-11,W.P. Kuala Lumpur,177,84,93,2009
2009-09-12,W.P. Kuala Lumpur,299,133,166,2009
2009-09-13,W.P. Kuala Lumpur,1235,394,841,2009
2009-09-14,W.P. Kuala Lumpur,81,13,68,2009
2009-09-15,W.P. Kuala Lumpur,138,35,103,2009
2009-09-16,W.P. Kuala Lumpur,301,144,157,2009
2009-09-17,W.P. Kuala Lumpur,187,54,133,2009
2009-09-18,W.P. Kuala Lumpur,87,24,63,2009
2009-09-19,W.P. Kuala Lumpur,58,8,50,2009
2009-09-20,W.P. Kuala Lumpur,0,0,0,2009
2009-09-21,W.P. Kuala Lumpur,22,2,20,2009
2009-09-22,W.P. Kuala Lumpur,66,18,48,2009
2009-09-23,W.P. Kuala Lumpur,113,30,83,2009
2009-09-24,W.P. Kuala Lumpur,212,72,140,2009
2009-09-25,W.P. Kuala Lumpur,293,104,189,2009
2009-09-26,W.P. Kuala Lumpur,516,200,316,2009
2009-09-27,W.P. Kuala Lumpur,657,261,396,2009
2009-09-28,W.P. Kuala Lumpur,331,147,184,2009
2009-09-29,W.P. Kuala Lumpur,305,127,178,2009
2009-09-30,W.P. Kuala Lumpur,595,253,342,2009
2009-10-01,W.P. Kuala Lumpur,555,242,313,2009
2009-10-02,W.P. Kuala Lumpur,469,292,177,2009
2009-10-03,W.P. Kuala Lumpur,531,427,104,2009
2009-10-04,W.P. Kuala Lumpur,655,267,388,2009
2009-10-05,W.P. Kuala Lumpur,159,41,118,2009
2009-10-06,W.P. Kuala Lumpur,393,155,238,2009
2009-10-07,W.P. Kuala Lumpur,675,336,339,2009
2009-10-08,W.P. Kuala Lumpur,471,207,264,2009
2009-10-09,W.P. Kuala Lumpur,535,314,221,2009
2009-10-10,W.P. Kuala Lumpur,394,161,233,2009
2009-10-11,W.P. Kuala Lumpur,418,182,236,2009
2009-10-12,W.P. Kuala Lumpur,165,48,117,2009
2009-10-13,W.P. Kuala Lumpur,442,175,267,2009
2009-10-14,W.P. Kuala Lumpur,510,174,336,2009
2009-10-15,W.P. Kuala Lumpur,436,177,259,2009
2009-10-16,W.P. Kuala Lumpur,296,140,156,2009
2009-10-17,W.P. Kuala Lumpur,277,124,153,2009
2009-10-18,W.P. Kuala Lumpur,839,316,523,2009
2009-10-19,W.P. Kuala Lumpur,209,39,170,2009
2009-10-20,W.P. Kuala Lumpur,335,91,244,2009
2009-10-21,W.P. Kuala Lumpur,768,327,441,2009
2009-10-22,W.P. Kuala Lumpur,782,338,444,2009
2009-10-23,W.P. Kuala Lumpur,225,75,150,2009
2009-10-24,W.P. Kuala Lumpur,281,113,168,2009
2009-10-25,W.P. Kuala Lumpur,516,244,272,2009
2009-10-26,W.P. Kuala Lumpur,259,62,197,2009
2009-10-27,W.P. Kuala Lumpur,510,208,302,2009
2009-10-28,W.P. Kuala Lumpur,663,377,286,2009
2009-10-29,W.P. Kuala Lumpur,688,249,439,2009
2009-10-30,W.P. Kuala Lumpur,346,140,206,2009
2009-10-31,W.P. Kuala Lumpur,382,164,218,2009
2009-11-01,W.P. Kuala Lumpur,345,138,207,2009
2009-11-02,W.P. Kuala Lumpur,146,49,97,2009
2009-11-03,W.P. Kuala Lumpur,542,214,328,2009
2009-11-04,W.P. Kuala Lumpur,344,145,199,2009
2009-11-05,W.P. Kuala Lumpur,349,92,257,2009
2009-11-06,W.P. Kuala Lumpur,191,52,139,2009
2009-11-07,W.P. Kuala Lumpur,353,129,224,2009
2009-11-08,W.P. Kuala Lumpur,578,288,290,2009
2009-11-09,W.P. Kuala Lumpur,183,52,131,2009
2009-11-10,W.P. Kuala Lumpur,212,90,122,2009
2009-11-11,W.P. Kuala Lumpur,376,133,243,2009
2009-11-12,W.P. Kuala Lumpur,467,217,250,2009
2009-11-13,W.P. Kuala Lumpur,450,171,279,2009
2009-11-14,W.P. Kuala Lumpur,937,748,189,2009
2009-11-15,W.P. Kuala Lumpur,749,287,462,2009
2009-11-16,W.P. Kuala Lumpur,456,179,277,2009
2009-11-17,W.P. Kuala Lumpur,878,341,537,2009
2009-11-18,W.P. Kuala Lumpur,672,310,362,2009
2009-11-19,W.P. Kuala Lumpur,775,319,456,2009
2009-11-20,W.P. Kuala Lumpur,524,215,309,2009
2009-11-21,W.P. Kuala Lumpur,471,252,219,2009
2009-11-22,W.P. Kuala Lumpur,483,202,281,2009
2009-11-23,W.P. Kuala Lumpur,702,258,444,2009
2009-11-24,W.P. Kuala Lumpur,861,367,494,2009
2009-11-25,W.P. Kuala Lumpur,865,274,591,2009
2009-11-26,W.P. Kuala Lumpur,733,214,519,2009
2009-11-27,W.P. Kuala Lumpur,0,0,0,2009
2009-11-28,W.P. Kuala Lumpur,145,69,76,2009
2009-11-29,W.P. Kuala Lumpur,277,109,168,2009
2009-11-30,W.P. Kuala Lumpur,147,31,116,2009
2009-12-01,W.P. Kuala Lumpur,540,202,338,2009
2009-12-02,W.P. Kuala Lumpur,504,219,285,2009
2009-12-03,W.P. Kuala Lumpur,615,228,387,2009
2009-12-04,W.P. Kuala Lumpur,268,77,191,2009
2009-12-05,W.P. Kuala Lumpur,290,106,184,2009
2009-12-06,W.P. Kuala Lumpur,475,136,339,2009
2009-12-07,W.P. Kuala Lumpur,68,3,65,2009
2009-12-08,W.P. Kuala Lumpur,132,40,92,2009
2009-12-09,W.P. Kuala Lumpur,324,132,192,2009
2009-12-10,W.P. Kuala Lumpur,574,241,333,2009
2009-12-11,W.P. Kuala Lumpur,338,128,210,2009
2009-12-12,W.P. Kuala Lumpur,222,92,130,2009
2009-12-13,W.P. Kuala Lumpur,436,151,285,2009
2009-12-14,W.P. Kuala Lumpur,181,82,99,2009
2009-12-15,W.P. Kuala Lumpur,364,144,220,2009
2009-12-16,W.P. Kuala Lumpur,549,232,317,2009
2009-12-17,W.P. Kuala Lumpur,449,145,304,2009
2009-12-18,W.P. Kuala Lumpur,178,57,121,2009
2009-12-19,W.P. Kuala Lumpur,287,90,197,2009
2009-12-20,W.P. Kuala Lumpur,520,211,309,2009
2009-12-21,W.P. Kuala Lumpur,169,64,105,2009
2009-12-22,W.P. Kuala Lumpur,223,72,151,2009
2009-12-23,W.P. Kuala Lumpur,549,260,289,2009
2009-12-24,W.P. Kuala Lumpur,231,64,167,2009
2009-12-25,W.P. Kuala Lumpur,246,95,151,2009
2009-12-26,W.P. Kuala Lumpur,502,185,317,2009
2009-12-27,W.P. Kuala Lumpur,828,221,607,2009
2009-12-28,W.P. Kuala Lumpur,166,41,125,2009
2009-12-29,W.P. Kuala Lumpur,370,111,259,2009
2009-12-30,W.P. Kuala Lumpur,282,69,213,2009
2009-12-31,W.P. Kuala Lumpur,598,171,427,2009
2010-01-01,W.P. Kuala Lumpur,241,103,138,2010
2010-01-02,W.P. Kuala Lumpur,335,131,204,2010
2010-01-03,W.P. Kuala Lumpur,246,102,144,2010
2010-01-04,W.P. Kuala Lumpur,152,41,111,2010
2010-01-05,W.P. Kuala Lumpur,489,182,307,2010
2010-01-06,W.P. Kuala Lumpur,511,206,305,2010
2010-01-07,W.P. Kuala Lumpur,521,198,323,2010
2010-01-08,W.P. Kuala Lumpur,412,192,220,2010
2010-01-09,W.P. Kuala Lumpur,529,219,310,2010
2010-01-10,W.P. Kuala Lumpur,518,223,295,2010
2010-01-11,W.P. Kuala Lumpur,935,516,419,2010
2010-01-12,W.P. Kuala Lumpur,587,275,312,2010
2010-01-13,W.P. Kuala Lumpur,706,285,421,2010
2010-01-14,W.P. Kuala Lumpur,616,242,374,2010
2010-01-15,W.P. Kuala Lumpur,342,163,179,2010
2010-01-16,W.P. Kuala Lumpur,594,241,353,2010
2010-01-17,W.P. Kuala Lumpur,330,90,240,2010
2010-01-18,W.P. Kuala Lumpur,291,149,142,2010
2010-01-19,W.P. Kuala Lumpur,475,230,245,2010
2010-01-20,W.P. Kuala Lumpur,675,247,428,2010
2010-01-21,W.P. Kuala Lumpur,1149,583,566,2010
2010-01-22,W.P. Kuala Lumpur,870,453,417,2010
2010-01-23,W.P. Kuala Lumpur,593,248,345,2010
2010-01-24,W.P. Kuala Lumpur,574,221,353,2010
2010-01-25,W.P. Kuala Lumpur,364,151,213,2010
2010-01-26,W.P. Kuala Lumpur,328,98,230,2010
2010-01-27,W.P. Kuala Lumpur,653,269,384,2010
2010-01-28,W.P. Kuala Lumpur,321,135,186,2010
2010-01-29,W.P. Kuala Lumpur,486,222,264,2010
2010-01-30,W.P. Kuala Lumpur,1215,440,775,2010
2010-01-31,W.P. Kuala Lumpur,244,125,119,2010
2010-02-01,W.P. Kuala Lumpur,47,6,41,2010
2010-02-02,W.P. Kuala Lumpur,285,101,184,2010
2010-02-03,W.P. Kuala Lumpur,526,239,287,2010
2010-02-04,W.P. Kuala Lumpur,900,408,492,2010
2010-02-05,W.P. Kuala Lumpur,207,52,155,2010
2010-02-06,W.P. Kuala Lumpur,551,219,332,2010
2010-02-07,W.P. Kuala Lumpur,308,171,137,2010
2010-02-08,W.P. Kuala Lumpur,685,377,308,2010
2010-02-09,W.P. Kuala Lumpur,430,186,244,2010
2010-02-10,W.P. Kuala Lumpur,548,248,300,2010
2010-02-11,W.P. Kuala Lumpur,581,296,285,2010
2010-02-12,W.P. Kuala Lumpur,230,83,147,2010
2010-02-13,W.P. Kuala Lumpur,218,77,141,2010
2010-02-14,W.P. Kuala Lumpur,126,70,56,2010
2010-02-15,W.P. Kuala Lumpur,147,65,82,2010
2010-02-16,W.P. Kuala Lumpur,150,61,89,2010
2010-02-17,W.P. Kuala Lumpur,218,79,139,2010
2010-02-18,W.P. Kuala Lumpur,405,169,236,2010
2010-02-19,W.P. Kuala Lumpur,224,68,156,2010
2010-02-20,W.P. Kuala Lumpur,352,145,207,2010
2010-02-21,W.P. Kuala Lumpur,184,93,91,2010
2010-02-22,W.P. Kuala Lumpur,325,136,189,2010
2010-02-23,W.P. Kuala Lumpur,530,170,360,2010
2010-02-24,W.P. Kuala Lumpur,572,208,364,2010
2010-02-25,W.P. Kuala Lumpur,594,209,385,2010
2010-02-26,W.P. Kuala Lumpur,311,191,120,2010
2010-02-27,W.P. Kuala Lumpur,964,755,209,2010
2010-02-28,W.P. Kuala Lumpur,480,239,241,2010
2010-03-01,W.P. Kuala Lumpur,403,177,226,2010
2010-03-02,W.P. Kuala Lumpur,550,258,292,2010
2010-03-03,W.P. Kuala Lumpur,229,89,140,2010
2010-03-04,W.P. Kuala Lumpur,436,196,240,2010
2010-03-05,W.P. Kuala Lumpur,231,69,162,2010
2010-03-06,W.P. Kuala Lumpur,557,291,266,2010
2010-03-07,W.P. Kuala Lumpur,591,283,308,2010
2010-03-08,W.P. Kuala Lumpur,578,208,370,2010
2010-03-09,W.P. Kuala Lumpur,772,273,499,2010
2010-03-10,W.P. Kuala Lumpur,709,252,457,2010
2010-03-11,W.P. Kuala Lumpur,680,228,452,2010
2010-03-12,W.P. Kuala Lumpur,363,100,263,2010
2010-03-13,W.P. Kuala Lumpur,322,109,213,2010
2010-03-14,W.P. Kuala Lumpur,443,144,299,2010
2010-03-15,W.P. Kuala Lumpur,394,207,187,2010
2010-03-16,W.P. Kuala Lumpur,563,235,328,2010
2010-03-17,W.P. Kuala Lumpur,741,287,454,2010
2010-03-18,W.P. Kuala Lumpur,452,221,231,2010
2010-03-19,W.P. Kuala Lumpur,201,61,140,2010
2010-03-20,W.P. Kuala Lumpur,357,157,200,2010
2010-03-21,W.P. Kuala Lumpur,552,225,327,2010
2010-03-22,W.P. Kuala Lumpur,175,49,126,2010
2010-03-23,W.P. Kuala Lumpur,270,103,167,2010
2010-03-24,W.P. Kuala Lumpur,867,329,538,2010
2010-03-25,W.P. Kuala Lumpur,658,224,434,2010
2010-03-26,W.P. Kuala Lumpur,496,213,283,2010
2010-03-27,W.P. Kuala Lumpur,323,122,201,2010
2010-03-28,W.P. Kuala Lumpur,696,233,463,2010
2010-03-29,W.P. Kuala Lumpur,468,178,290,2010
2010-03-30,W.P. Kuala Lumpur,454,126,328,2010
2010-03-31,W.P. Kuala Lumpur,552,165,387,2010
2010-04-01,W.P. Kuala Lumpur,651,243,408,2010
2010-04-02,W.P. Kuala Lumpur,377,153,224,2010
2010-04-03,W.P. Kuala Lumpur,248,89,159,2010
2010-04-04,W.P. Kuala Lumpur,304,141,163,2010
2010-04-05,W.P. Kuala Lumpur,224,88,136,2010
2010-04-06,W.P. Kuala Lumpur,319,141,178,2010
2010-04-07,W.P. Kuala Lumpur,477,162,315,2010
2010-04-08,W.P. Kuala Lumpur,700,334,366,2010
2010-04-09,W.P. Kuala Lumpur,119,30,89,2010
2010-04-10,W.P. Kuala Lumpur,356,143,213,2010
2010-04-11,W.P. Kuala Lumpur,781,326,455,2010
2010-04-12,W.P. Kuala Lumpur,73,8,65,2010
2010-04-13,W.P. Kuala Lumpur,264,80,184,2010
2010-04-14,W.P. Kuala Lumpur,483,200,283,2010
2010-04-15,W.P. Kuala Lumpur,564,186,378,2010
2010-04-16,W.P. Kuala Lumpur,262,116,146,2010
2010-04-17,W.P. Kuala Lumpur,555,208,347,2010
2010-04-18,W.P. Kuala Lumpur,732,202,530,2010
2010-04-19,W.P. Kuala Lumpur,265,95,170,2010
2010-04-20,W.P. Kuala Lumpur,485,175,310,2010
2010-04-21,W.P. Kuala Lumpur,294,110,184,2010
2010-04-22,W.P. Kuala Lumpur,693,238,455,2010
2010-04-23,W.P. Kuala Lumpur,375,176,199,2010
2010-04-24,W.P. Kuala Lumpur,268,104,164,2010
2010-04-25,W.P. Kuala Lumpur,758,256,502,2010
2010-04-26,W.P. Kuala Lumpur,134,36,98,2010
2010-04-27,W.P. Kuala Lumpur,344,115,229,2010
2010-04-28,W.P. Kuala Lumpur,315,95,220,2010
2010-04-29,W.P. Kuala Lumpur,550,301,249,2010
2010-04-30,W.P. Kuala Lumpur,198,100,98,2010
2010-05-01,W.P. Kuala Lumpur,1150,257,893,2010
2010-05-02,W.P. Kuala Lumpur,150,67,83,2010
2010-05-03,W.P. Kuala Lumpur,143,68,75,2010
2010-05-04,W.P. Kuala Lumpur,360,139,221,2010
2010-05-05,W.P. Kuala Lumpur,365,134,231,2010
2010-05-06,W.P. Kuala Lumpur,575,307,268,2010
2010-05-07,W.P. Kuala Lumpur,269,113,156,2010
2010-05-08,W.P. Kuala Lumpur,708,524,184,2010
2010-05-09,W.P. Kuala Lumpur,397,158,239,2010
2010-05-10,W.P. Kuala Lumpur,131,60,71,2010
2010-05-11,W.P. Kuala Lumpur,231,67,164,2010
2010-05-12,W.P. Kuala Lumpur,346,99,247,2010
2010-05-13,W.P. Kuala Lumpur,401,148,253,2010
2010-05-14,W.P. Kuala Lumpur,386,180,206,2010
2010-05-15,W.P. Kuala Lumpur,408,186,222,2010
2010-05-16,W.P. Kuala Lumpur,419,196,223,2010
2010-05-17,W.P. Kuala Lumpur,195,50,145,2010
2010-05-18,W.P. Kuala Lumpur,321,135,186,2010
2010-05-19,W.P. Kuala Lumpur,547,230,317,2010
2010-05-20,W.P. Kuala Lumpur,546,214,332,2010
2010-05-21,W.P. Kuala Lumpur,482,181,301,2010
2010-05-22,W.P. Kuala Lumpur,1018,780,238,2010
2010-05-23,W.P. Kuala Lumpur,417,146,271,2010
2010-05-24,W.P. Kuala Lumpur,1027,523,504,2010
2010-05-25,W.P. Kuala Lumpur,563,209,354,2010
2010-05-26,W.P. Kuala Lumpur,270,85,185,2010
2010-05-27,W.P. Kuala Lumpur,413,119,294,2010
2010-05-28,W.P. Kuala Lumpur,1142,323,819,2010
2010-05-29,W.P. Kuala Lumpur,307,127,180,2010
2010-05-30,W.P. Kuala Lumpur,304,107,197,2010
2010-05-31,W.P. Kuala Lumpur,233,97,136,2010
2010-06-01,W.P. Kuala Lumpur,132,42,90,2010
2010-06-02,W.P. Kuala Lumpur,463,175,288,2010
2010-06-03,W.P. Kuala Lumpur,585,287,298,2010
2010-06-04,W.P. Kuala Lumpur,440,184,256,2010
2010-06-05,W.P. Kuala Lumpur,340,157,183,2010
2010-06-06,W.P. Kuala Lumpur,410,155,255,2010
2010-06-07,W.P. Kuala Lumpur,87,16,71,2010
2010-06-08,W.P. Kuala Lumpur,434,221,213,2010
2010-06-09,W.P. Kuala Lumpur,280,122,158,2010
2010-06-10,W.P. Kuala Lumpur,372,186,186,2010
2010-06-11,W.P. Kuala Lumpur,373,178,195,2010
2010-06-12,W.P. Kuala Lumpur,529,224,305,2010
2010-06-13,W.P. Kuala Lumpur,754,224,530,2010
2010-06-14,W.P. Kuala Lumpur,416,148,268,2010
2010-06-15,W.P. Kuala Lumpur,352,114,238,2010
2010-06-16,W.P. Kuala Lumpur,513,240,273,2010
2010-06-17,W.P. Kuala Lumpur,435,212,223,2010
2010-06-18,W.P. Kuala Lumpur,219,91,128,2010
2010-06-19,W.P. Kuala Lumpur,445,158,287,2010
2010-06-20,W.P. Kuala Lumpur,747,335,412,2010
2010-06-21,W.P. Kuala Lumpur,203,49,154,2010
2010-06-22,W.P. Kuala Lumpur,168,45,123,2010
2010-06-23,W.P. Kuala Lumpur,407,183,224,2010
2010-06-24,W.P. Kuala Lumpur,377,170,207,2010
2010-06-25,W.P. Kuala Lumpur,535,190,345,2010
2010-06-26,W.P. Kuala Lumpur,485,172,313,2010
2010-06-27,W.P. Kuala Lumpur,699,233,466,2010
2010-06-28,W.P. Kuala Lumpur,352,151,201,2010
2010-06-29,W.P. Kuala Lumpur,471,201,270,2010
2010-06-30,W.P. Kuala Lumpur,527,182,345,2010
2010-07-01,W.P. Kuala Lumpur,279,137,142,2010
2010-07-02,W.P. Kuala Lumpur,80,13,67,2010
2010-07-03,W.P. Kuala Lumpur,702,298,404,2010
2010-07-04,W.P. Kuala Lumpur,323,160,163,2010
2010-07-05,W.P. Kuala Lumpur,259,112,147,2010
2010-07-06,W.P. Kuala Lumpur,496,199,297,2010
2010-07-07,W.P. Kuala Lumpur,178,82,96,2010
2010-07-08,W.P. Kuala Lumpur,123,37,86,2010
2010-07-09,W.P. Kuala Lumpur,141,48,93,2010
2010-07-10,W.P. Kuala Lumpur,312,118,194,2010
2010-07-11,W.P. Kuala Lumpur,571,189,382,2010
2010-07-12,W.P. Kuala Lumpur,143,34,109,2010
2010-07-13,W.P. Kuala Lumpur,301,77,224,2010
2010-07-14,W.P. Kuala Lumpur,566,205,361,2010
2010-07-15,W.P. Kuala Lumpur,657,262,395,2010
2010-07-16,W.P. Kuala Lumpur,328,147,181,2010
2010-07-17,W.P. Kuala Lumpur,337,115,222,2010
2010-07-18,W.P. Kuala Lumpur,194,75,119,2010
2010-07-19,W.P. Kuala Lumpur,385,151,234,2010
2010-07-20,W.P. Kuala Lumpur,455,140,315,2010
2010-07-21,W.P. Kuala Lumpur,741,319,422,2010
2010-07-22,W.P. Kuala Lumpur,586,273,313,2010
2010-07-23,W.P. Kuala Lumpur,365,174,191,2010
2010-07-24,W.P. Kuala Lumpur,374,198,176,2010
2010-07-25,W.P. Kuala Lumpur,477,154,323,2010
2010-07-26,W.P. Kuala Lumpur,797,300,497,2010
2010-07-27,W.P. Kuala Lumpur,770,273,497,2010
2010-07-28,W.P. Kuala Lumpur,882,360,522,2010
2010-07-29,W.P. Kuala Lumpur,962,351,611,2010
2010-07-30,W.P. Kuala Lumpur,971,372,599,2010
2010-07-31,W.P. Kuala Lumpur,626,317,309,2010
2010-08-01,W.P. Kuala Lumpur,583,212,371,2010
2010-08-02,W.P. Kuala Lumpur,711,356,355,2010
2010-08-03,W.P. Kuala Lumpur,553,223,330,2010
2010-08-04,W.P. Kuala Lumpur,624,196,428,2010
2010-08-05,W.P. Kuala Lumpur,583,187,396,2010
2010-08-06,W.P. Kuala Lumpur,492,227,265,2010
2010-08-07,W.P. Kuala Lumpur,783,320,463,2010
2010-08-08,W.P. Kuala Lumpur,982,444,538,2010
2010-08-09,W.P. Kuala Lumpur,658,263,395,2010
2010-08-10,W.P. Kuala Lumpur,424,125,299,2010
2010-08-11,W.P. Kuala Lumpur,139,36,103,2010
2010-08-12,W.P. Kuala Lumpur,61,17,44,2010
2010-08-13,W.P. Kuala Lumpur,70,20,50,2010
2010-08-14,W.P. Kuala Lumpur,115,19,96,2010
2010-08-15,W.P. Kuala Lumpur,572,196,376,2010
2010-08-16,W.P. Kuala Lumpur,40,2,38,2010
2010-08-17,W.P. Kuala Lumpur,99,20,79,2010
2010-08-18,W.P. Kuala Lumpur,130,71,59,2010
2010-08-19,W.P. Kuala Lumpur,77,7,70,2010
2010-08-20,W.P. Kuala Lumpur,141,64,77,2010
2010-08-21,W.P. Kuala Lumpur,179,51,128,2010
2010-08-22,W.P. Kuala Lumpur,616,195,421,2010
2010-08-23,W.P. Kuala Lumpur,60,16,44,2010
2010-08-24,W.P. Kuala Lumpur,274,121,153,2010
2010-08-25,W.P. Kuala Lumpur,327,164,163,2010
2010-08-26,W.P. Kuala Lumpur,295,123,172,2010
2010-08-27,W.P. Kuala Lumpur,163,74,89,2010
2010-08-28,W.P. Kuala Lumpur,309,118,191,2010
2010-08-29,W.P. Kuala Lumpur,929,209,720,2010
2010-08-30,W.P. Kuala Lumpur,248,92,156,2010
2010-08-31,W.P. Kuala Lumpur,205,93,112,2010
2010-09-01,W.P. Kuala Lumpur,97,41,56,2010
2010-09-02,W.P. Kuala Lumpur,49,2,47,2010
2010-09-03,W.P. Kuala Lumpur,64,3,61,2010
2010-09-04,W.P. Kuala Lumpur,238,91,147,2010
2010-09-05,W.P. Kuala Lumpur,700,213,487,2010
2010-09-06,W.P. Kuala Lumpur,35,2,33,2010
2010-09-07,W.P. Kuala Lumpur,108,25,83,2010
2010-09-08,W.P. Kuala Lumpur,66,11,55,2010
2010-09-09,W.P. Kuala Lumpur,53,3,50,2010
2010-09-10,W.P. Kuala Lumpur,0,0,0,2010
2010-09-11,W.P. Kuala Lumpur,0,0,0,2010
2010-09-12,W.P. Kuala Lumpur,354,132,222,2010
2010-09-13,W.P. Kuala Lumpur,82,7,75,2010
2010-09-14,W.P. Kuala Lumpur,170,61,109,2010
2010-09-15,W.P. Kuala Lumpur,234,52,182,2010
2010-09-16,W.P. Kuala Lumpur,253,100,153,2010
2010-09-17,W.P. Kuala Lumpur,139,16,123,2010
2010-09-18,W.P. Kuala Lumpur,959,789,170,2010
2010-09-19,W.P. Kuala Lumpur,433,135,298,2010
2010-09-20,W.P. Kuala Lumpur,174,56,118,2010
2010-09-21,W.P. Kuala Lumpur,239,118,121,2010
2010-09-22,W.P. Kuala Lumpur,307,143,164,2010
2010-09-23,W.P. Kuala Lumpur,291,122,169,2010
2010-09-24,W.P. Kuala Lumpur,487,233,254,2010
2010-09-25,W.P. Kuala Lumpur,491,182,309,2010
2010-09-26,W.P. Kuala Lumpur,640,201,439,2010
2010-09-27,W.P. Kuala Lumpur,168,44,124,2010
2010-09-28,W.P. Kuala Lumpur,505,126,379,2010
2010-09-29,W.P. Kuala Lumpur,369,142,227,2010
2010-09-30,W.P. Kuala Lumpur,518,205,313,2010
2010-10-01,W.P. Kuala Lumpur,528,178,350,2010
2010-10-02,W.P. Kuala Lumpur,546,210,336,2010
2010-10-03,W.P. Kuala Lumpur,472,216,256,2010
2010-10-04,W.P. Kuala Lumpur,402,90,312,2010
2010-10-05,W.P. Kuala Lumpur,413,130,283,2010
2010-10-06,W.P. Kuala Lumpur,534,198,336,2010
2010-10-07,W.P. Kuala Lumpur,433,166,267,2010
2010-10-08,W.P. Kuala Lumpur,376,120,256,2010
2010-10-09,W.P. Kuala Lumpur,439,131,308,2010
2010-10-10,W.P. Kuala Lumpur,562,174,388,2010
2010-10-11,W.P. Kuala Lumpur,416,178,238,2010
2010-10-12,W.P. Kuala Lumpur,595,213,382,2010
2010-10-13,W.P. Kuala Lumpur,619,319,300,2010
2010-10-14,W.P. Kuala Lumpur,475,158,317,2010
2010-10-15,W.P. Kuala Lumpur,239,105,134,2010
2010-10-16,W.P. Kuala Lumpur,340,103,237,2010
2010-10-17,W.P. Kuala Lumpur,593,232,361,2010
2010-10-18,W.P. Kuala Lumpur,382,131,251,2010
2010-10-19,W.P. Kuala Lumpur,533,172,361,2010
2010-10-20,W.P. Kuala Lumpur,785,324,461,2010
2010-10-21,W.P. Kuala Lumpur,518,191,327,2010
2010-10-22,W.P. Kuala Lumpur,183,46,137,2010
2010-10-23,W.P. Kuala Lumpur,426,184,242,2010
2010-10-24,W.P. Kuala Lumpur,479,132,347,2010
2010-10-25,W.P. Kuala Lumpur,343,81,262,2010
2010-10-26,W.P. Kuala Lumpur,594,173,421,2010
2010-10-27,W.P. Kuala Lumpur,906,284,622,2010
2010-10-28,W.P. Kuala Lumpur,730,244,486,2010
2010-10-29,W.P. Kuala Lumpur,657,230,427,2010
2010-10-30,W.P. Kuala Lumpur,365,111,254,2010
2010-10-31,W.P. Kuala Lumpur,638,240,398,2010
2010-11-01,W.P. Kuala Lumpur,539,183,356,2010
2010-11-02,W.P. Kuala Lumpur,330,90,240,2010
2010-11-03,W.P. Kuala Lumpur,448,157,291,2010
2010-11-04,W.P. Kuala Lumpur,282,71,211,2010
2010-11-05,W.P. Kuala Lumpur,274,98,176,2010
2010-11-06,W.P. Kuala Lumpur,320,108,212,2010
2010-11-07,W.P. Kuala Lumpur,453,149,304,2010
2010-11-08,W.P. Kuala Lumpur,263,88,175,2010
2010-11-09,W.P. Kuala Lumpur,553,171,382,2010
2010-11-10,W.P. Kuala Lumpur,690,227,463,2010
2010-11-11,W.P. Kuala Lumpur,842,367,475,2010
2010-11-12,W.P. Kuala Lumpur,324,165,159,2010
2010-11-13,W.P. Kuala Lumpur,254,76,178,2010
2010-11-14,W.P. Kuala Lumpur,769,315,454,2010
2010-11-15,W.P. Kuala Lumpur,147,35,112,2010
2010-11-16,W.P. Kuala Lumpur,189,61,128,2010
2010-11-17,W.P. Kuala Lumpur,26,7,19,2010
2010-11-18,W.P. Kuala Lumpur,102,38,64,2010
2010-11-19,W.P. Kuala Lumpur,214,70,144,2010
2010-11-20,W.P. Kuala Lumpur,450,185,265,2010
2010-11-21,W.P. Kuala Lumpur,392,145,247,2010
2010-11-22,W.P. Kuala Lumpur,55,7,48,2010
2010-11-23,W.P. Kuala Lumpur,259,78,181,2010
2010-11-24,W.P. Kuala Lumpur,318,106,212,2010
2010-11-25,W.P. Kuala Lumpur,587,231,356,2010
2010-11-26,W.P. Kuala Lumpur,464,183,281,2010
2010-11-27,W.P. Kuala Lumpur,275,107,168,2010
2010-11-28,W.P. Kuala Lumpur,320,89,231,2010
2010-11-29,W.P. Kuala Lumpur,210,39,171,2010
2010-11-30,W.P. Kuala Lumpur,352,157,195,2010
2010-12-01,W.P. Kuala Lumpur,666,229,437,2010
2010-12-02,W.P. Kuala Lumpur,789,276,513,2010
2010-12-03,W.P. Kuala Lumpur,215,92,123,2010
2010-12-04,W.P. Kuala Lumpur,355,119,236,2010
2010-12-05,W.P. Kuala Lumpur,685,179,506,2010
2010-12-06,W.P. Kuala Lumpur,147,36,111,2010
2010-12-07,W.P. Kuala Lumpur,207,92,115,2010
2010-12-08,W.P. Kuala Lumpur,193,63,130,2010
2010-12-09,W.P. Kuala Lumpur,261,114,147,2010
2010-12-10,W.P. Kuala Lumpur,187,57,130,2010
2010-12-11,W.P. Kuala Lumpur,272,86,186,2010
2010-12-12,W.P. Kuala Lumpur,628,260,368,2010
2010-12-13,W.P. Kuala Lumpur,244,109,135,2010
2010-12-14,W.P. Kuala Lumpur,607,237,370,2010
2010-12-15,W.P. Kuala Lumpur,549,226,323,2010
2010-12-16,W.P. Kuala Lumpur,573,186,387,2010
2010-12-17,W.P. Kuala Lumpur,250,61,189,2010
2010-12-18,W.P. Kuala Lumpur,248,86,162,2010
2010-12-19,W.P. Kuala Lumpur,546,137,409,2010
2010-12-20,W.P. Kuala Lumpur,333,155,178,2010
2010-12-21,W.P. Kuala Lumpur,300,100,200,2010
2010-12-22,W.P. Kuala Lumpur,454,146,308,2010
2010-12-23,W.P. Kuala Lumpur,401,97,304,2010
2010-12-24,W.P. Kuala Lumpur,188,53,135,2010
2010-12-25,W.P. Kuala Lumpur,326,112,214,2010
2010-12-26,W.P. Kuala Lumpur,377,131,246,2010
2010-12-27,W.P. Kuala Lumpur,190,44,146,2010
2010-12-28,W.P. Kuala Lumpur,255,80,175,2010
2010-12-29,W.P. Kuala Lumpur,324,89,235,2010
2010-12-30,W.P. Kuala Lumpur,302,88,214,2010
2010-12-31,W.P. Kuala Lumpur,181,48,133,2010
2011-01-01,W.P. Kuala Lumpur,267,93,174,2011
2011-01-02,W.P. Kuala Lumpur,221,81,140,2011
2011-01-03,W.P. Kuala Lumpur,160,50,110,2011
2011-01-04,W.P. Kuala Lumpur,239,69,170,2011
2011-01-05,W.P. Kuala Lumpur,333,119,214,2011
2011-01-06,W.P. Kuala Lumpur,440,133,307,2011
2011-01-07,W.P. Kuala Lumpur,402,120,282,2011
2011-01-08,W.P. Kuala Lumpur,536,167,369,2011
2011-01-09,W.P. Kuala Lumpur,563,176,387,2011
2011-01-10,W.P. Kuala Lumpur,94,17,77,2011
2011-01-11,W.P. Kuala Lumpur,668,196,472,2011
2011-01-12,W.P. Kuala Lumpur,693,312,381,2011
2011-01-13,W.P. Kuala Lumpur,547,218,329,2011
2011-01-14,W.P. Kuala Lumpur,368,122,246,2011
2011-01-15,W.P. Kuala Lumpur,413,125,288,2011
2011-01-16,W.P. Kuala Lumpur,466,191,275,2011
2011-01-17,W.P. Kuala Lumpur,185,63,122,2011
2011-01-18,W.P. Kuala Lumpur,791,277,514,2011
2011-01-19,W.P. Kuala Lumpur,512,182,330,2011
2011-01-20,W.P. Kuala Lumpur,1058,383,675,2011
2011-01-21,W.P. Kuala Lumpur,142,40,102,2011
2011-01-22,W.P. Kuala Lumpur,349,99,250,2011
2011-01-23,W.P. Kuala Lumpur,331,90,241,2011
2011-01-24,W.P. Kuala Lumpur,253,74,179,2011
2011-01-25,W.P. Kuala Lumpur,749,298,451,2011
2011-01-26,W.P. Kuala Lumpur,702,311,391,2011
2011-01-27,W.P. Kuala Lumpur,1004,598,406,2011
2011-01-28,W.P. Kuala Lumpur,170,38,132,2011
2011-01-29,W.P. Kuala Lumpur,176,41,135,2011
2011-01-30,W.P. Kuala Lumpur,145,48,97,2011
2011-01-31,W.P. Kuala Lumpur,97,17,80,2011
2011-02-01,W.P. Kuala Lumpur,203,59,144,2011
2011-02-02,W.P. Kuala Lumpur,182,52,130,2011
2011-02-03,W.P. Kuala Lumpur,222,80,142,2011
2011-02-04,W.P. Kuala Lumpur,274,121,153,2011
2011-02-05,W.P. Kuala Lumpur,408,154,254,2011
2011-02-06,W.P. Kuala Lumpur,332,139,193,2011
2011-02-07,W.P. Kuala Lumpur,211,48,163,2011
2011-02-08,W.P. Kuala Lumpur,262,87,175,2011
2011-02-09,W.P. Kuala Lumpur,539,230,309,2011
2011-02-10,W.P. Kuala Lumpur,440,158,282,2011
2011-02-11,W.P. Kuala Lumpur,156,42,114,2011
2011-02-12,W.P. Kuala Lumpur,744,493,251,2011
2011-02-13,W.P. Kuala Lumpur,296,122,174,2011
2011-02-14,W.P. Kuala Lumpur,282,93,189,2011
2011-02-15,W.P. Kuala Lumpur,358,131,227,2011
2011-02-16,W.P. Kuala Lumpur,794,288,506,2011
2011-02-17,W.P. Kuala Lumpur,669,240,429,2011
2011-02-18,W.P. Kuala Lumpur,386,123,263,2011
2011-02-19,W.P. Kuala Lumpur,369,130,239,2011
2011-02-20,W.P. Kuala Lumpur,481,179,302,2011
2011-02-21,W.P. Kuala Lumpur,324,114,210,2011
2011-02-22,W.P. Kuala Lumpur,385,133,252,2011
2011-02-23,W.P. Kuala Lumpur,654,192,462,2011
2011-02-24,W.P. Kuala Lumpur,885,392,493,2011
2011-02-25,W.P. Kuala Lumpur,689,302,387,2011
2011-02-26,W.P. Kuala Lumpur,655,336,319,2011
2011-02-27,W.P. Kuala Lumpur,301,108,193,2011
2011-02-28,W.P. Kuala Lumpur,304,143,161,2011
2011-03-01,W.P. Kuala Lumpur,408,170,238,2011
2011-03-02,W.P. Kuala Lumpur,285,107,178,2011
2011-03-03,W.P. Kuala Lumpur,370,171,199,2011
2011-03-04,W.P. Kuala Lumpur,263,91,172,2011
2011-03-05,W.P. Kuala Lumpur,767,559,208,2011
2011-03-06,W.P. Kuala Lumpur,326,142,184,2011
2011-03-07,W.P. Kuala Lumpur,627,204,423,2011
2011-03-08,W.P. Kuala Lumpur,735,226,509,2011
2011-03-09,W.P. Kuala Lumpur,853,289,564,2011
2011-03-10,W.P. Kuala Lumpur,786,251,535,2011
2011-03-11,W.P. Kuala Lumpur,526,179,347,2011
2011-03-12,W.P. Kuala Lumpur,557,260,297,2011
2011-03-13,W.P. Kuala Lumpur,263,123,140,2011
2011-03-14,W.P. Kuala Lumpur,237,86,151,2011
2011-03-15,W.P. Kuala Lumpur,643,270,373,2011
2011-03-16,W.P. Kuala Lumpur,604,281,323,2011
2011-03-17,W.P. Kuala Lumpur,496,187,309,2011
2011-03-18,W.P. Kuala Lumpur,201,55,146,2011
2011-03-19,W.P. Kuala Lumpur,458,152,306,2011
2011-03-20,W.P. Kuala Lumpur,722,226,496,2011
2011-03-21,W.P. Kuala Lumpur,276,116,160,2011
2011-03-22,W.P. Kuala Lumpur,412,109,303,2011
2011-03-23,W.P. Kuala Lumpur,514,138,376,2011
2011-03-24,W.P. Kuala Lumpur,609,177,432,2011
2011-03-25,W.P. Kuala Lumpur,315,99,216,2011
2011-03-26,W.P. Kuala Lumpur,533,202,331,2011
2011-03-27,W.P. Kuala Lumpur,931,394,537,2011
2011-03-28,W.P. Kuala Lumpur,144,49,95,2011
2011-03-29,W.P. Kuala Lumpur,396,112,284,2011
2011-03-30,W.P. Kuala Lumpur,560,226,334,2011
2011-03-31,W.P. Kuala Lumpur,543,232,311,2011
2011-04-01,W.P. Kuala Lumpur,547,205,342,2011
2011-04-02,W.P. Kuala Lumpur,214,57,157,2011
2011-04-03,W.P. Kuala Lumpur,564,252,312,2011
2011-04-04,W.P. Kuala Lumpur,275,99,176,2011
2011-04-05,W.P. Kuala Lumpur,565,185,380,2011
2011-04-06,W.P. Kuala Lumpur,491,150,341,2011
2011-04-07,W.P. Kuala Lumpur,595,185,410,2011
2011-04-08,W.P. Kuala Lumpur,170,40,130,2011
2011-04-09,W.P. Kuala Lumpur,584,265,319,2011
2011-04-10,W.P. Kuala Lumpur,781,178,603,2011
2011-04-11,W.P. Kuala Lumpur,506,105,401,2011
2011-04-12,W.P. Kuala Lumpur,537,194,343,2011
2011-04-13,W.P. Kuala Lumpur,623,199,424,2011
2011-04-14,W.P. Kuala Lumpur,420,149,271,2011
2011-04-15,W.P. Kuala Lumpur,179,41,138,2011
2011-04-16,W.P. Kuala Lumpur,606,232,374,2011
2011-04-17,W.P. Kuala Lumpur,605,137,468,2011
2011-04-18,W.P. Kuala Lumpur,281,92,189,2011
2011-04-19,W.P. Kuala Lumpur,273,108,165,2011
2011-04-20,W.P. Kuala Lumpur,380,135,245,2011
2011-04-21,W.P. Kuala Lumpur,438,182,256,2011
2011-04-22,W.P. Kuala Lumpur,168,39,129,2011
2011-04-23,W.P. Kuala Lumpur,244,95,149,2011
2011-04-24,W.P. Kuala Lumpur,888,252,636,2011
2011-04-25,W.P. Kuala Lumpur,96,16,80,2011
2011-04-26,W.P. Kuala Lumpur,337,122,215,2011
2011-04-27,W.P. Kuala Lumpur,373,156,217,2011
2011-04-28,W.P. Kuala Lumpur,453,141,312,2011
2011-04-29,W.P. Kuala Lumpur,233,52,181,2011
2011-04-30,W.P. Kuala Lumpur,133,29,104,2011
2011-05-01,W.P. Kuala Lumpur,984,156,828,2011
2011-05-02,W.P. Kuala Lumpur,228,78,150,2011
2011-05-03,W.P. Kuala Lumpur,124,23,101,2011
2011-05-04,W.P. Kuala Lumpur,191,50,141,2011
2011-05-05,W.P. Kuala Lumpur,177,36,141,2011
2011-05-06,W.P. Kuala Lumpur,242,86,156,2011
2011-05-07,W.P. Kuala Lumpur,463,172,291,2011
2011-05-08,W.P. Kuala Lumpur,354,144,210,2011
2011-05-09,W.P. Kuala Lumpur,172,45,127,2011
2011-05-10,W.P. Kuala Lumpur,513,177,336,2011
2011-05-11,W.P. Kuala Lumpur,471,161,310,2011
2011-05-12,W.P. Kuala Lumpur,230,83,147,2011
2011-05-13,W.P. Kuala Lumpur,342,110,232,2011
2011-05-14,W.P. Kuala Lumpur,283,77,206,2011
2011-05-15,W.P. Kuala Lumpur,446,172,274,2011
2011-05-16,W.P. Kuala Lumpur,235,44,191,2011
2011-05-17,W.P. Kuala Lumpur,1070,283,787,2011
2011-05-18,W.P. Kuala Lumpur,403,116,287,2011
2011-05-19,W.P. Kuala Lumpur,496,205,291,2011
2011-05-20,W.P. Kuala Lumpur,109,19,90,2011
2011-05-21,W.P. Kuala Lumpur,519,207,312,2011
2011-05-22,W.P. Kuala Lumpur,443,157,286,2011
2011-05-23,W.P. Kuala Lumpur,138,39,99,2011
2011-05-24,W.P. Kuala Lumpur,385,109,276,2011
2011-05-25,W.P. Kuala Lumpur,538,224,314,2011
2011-05-26,W.P. Kuala Lumpur,527,185,342,2011
2011-05-27,W.P. Kuala Lumpur,199,67,132,2011
2011-05-28,W.P. Kuala Lumpur,588,157,431,2011
2011-05-29,W.P. Kuala Lumpur,311,166,145,2011
2011-05-30,W.P. Kuala Lumpur,177,58,119,2011
2011-05-31,W.P. Kuala Lumpur,487,208,279,2011
2011-06-01,W.P. Kuala Lumpur,213,71,142,2011
2011-06-02,W.P. Kuala Lumpur,318,120,198,2011
2011-06-03,W.P. Kuala Lumpur,351,102,249,2011
2011-06-04,W.P. Kuala Lumpur,792,602,190,2011
2011-06-05,W.P. Kuala Lumpur,218,87,131,2011
2011-06-06,W.P. Kuala Lumpur,221,66,155,2011
2011-06-07,W.P. Kuala Lumpur,496,173,323,2011
2011-06-08,W.P. Kuala Lumpur,438,164,274,2011
2011-06-09,W.P. Kuala Lumpur,376,156,220,2011
2011-06-10,W.P. Kuala Lumpur,255,86,169,2011
2011-06-11,W.P. Kuala Lumpur,521,145,376,2011
2011-06-12,W.P. Kuala Lumpur,914,248,666,2011
2011-06-13,W.P. Kuala Lumpur,304,129,175,2011
2011-06-14,W.P. Kuala Lumpur,830,277,553,2011
2011-06-15,W.P. Kuala Lumpur,584,194,390,2011
2011-06-16,W.P. Kuala Lumpur,622,249,373,2011
2011-06-17,W.P. Kuala Lumpur,433,167,266,2011
2011-06-18,W.P. Kuala Lumpur,618,196,422,2011
2011-06-19,W.P. Kuala Lumpur,443,180,263,2011
2011-06-20,W.P. Kuala Lumpur,360,144,216,2011
2011-06-21,W.P. Kuala Lumpur,354,150,204,2011
2011-06-22,W.P. Kuala Lumpur,722,247,475,2011
2011-06-23,W.P. Kuala Lumpur,626,213,413,2011
2011-06-24,W.P. Kuala Lumpur,574,293,281,2011
2011-06-25,W.P. Kuala Lumpur,778,315,463,2011
2011-06-26,W.P. Kuala Lumpur,800,231,569,2011
2011-06-27,W.P. Kuala Lumpur,348,123,225,2011
2011-06-28,W.P. Kuala Lumpur,556,206,350,2011
2011-06-29,W.P. Kuala Lumpur,464,180,284,2011
2011-06-30,W.P. Kuala Lumpur,581,302,279,2011
2011-07-01,W.P. Kuala Lumpur,498,216,282,2011
2011-07-02,W.P. Kuala Lumpur,461,148,313,2011
2011-07-03,W.P. Kuala Lumpur,348,120,228,2011
2011-07-04,W.P. Kuala Lumpur,253,62,191,2011
2011-07-05,W.P. Kuala Lumpur,593,265,328,2011
2011-07-06,W.P. Kuala Lumpur,681,354,327,2011
2011-07-07,W.P. Kuala Lumpur,589,347,242,2011
2011-07-08,W.P. Kuala Lumpur,187,59,128,2011
2011-07-09,W.P. Kuala Lumpur,686,521,165,2011
2011-07-10,W.P. Kuala Lumpur,605,225,380,2011
2011-07-11,W.P. Kuala Lumpur,475,165,310,2011
2011-07-12,W.P. Kuala Lumpur,522,151,371,2011
2011-07-13,W.P. Kuala Lumpur,374,176,198,2011
2011-07-14,W.P. Kuala Lumpur,413,148,265,2011
2011-07-15,W.P. Kuala Lumpur,338,141,197,2011
2011-07-16,W.P. Kuala Lumpur,343,96,247,2011
2011-07-17,W.P. Kuala Lumpur,728,219,509,2011
2011-07-18,W.P. Kuala Lumpur,300,122,178,2011
2011-07-19,W.P. Kuala Lumpur,674,229,445,2011
2011-07-20,W.P. Kuala Lumpur,873,369,504,2011
2011-07-21,W.P. Kuala Lumpur,674,318,356,2011
2011-07-22,W.P. Kuala Lumpur,558,245,313,2011
2011-07-23,W.P. Kuala Lumpur,571,238,333,2011
2011-07-24,W.P. Kuala Lumpur,739,276,463,2011
2011-07-25,W.P. Kuala Lumpur,483,197,286,2011
2011-07-26,W.P. Kuala Lumpur,567,266,301,2011
2011-07-27,W.P. Kuala Lumpur,724,389,335,2011
2011-07-28,W.P. Kuala Lumpur,786,394,392,2011
2011-07-29,W.P. Kuala Lumpur,512,179,333,2011
2011-07-30,W.P. Kuala Lumpur,665,251,414,2011
2011-07-31,W.P. Kuala Lumpur,851,344,507,2011
2011-08-01,W.P. Kuala Lumpur,404,140,264,2011
2011-08-02,W.P. Kuala Lumpur,531,169,362,2011
2011-08-03,W.P. Kuala Lumpur,552,211,341,2011
2011-08-04,W.P. Kuala Lumpur,508,195,313,2011
2011-08-05,W.P. Kuala Lumpur,458,170,288,2011
2011-08-06,W.P. Kuala Lumpur,185,55,130,2011
2011-08-07,W.P. Kuala Lumpur,1002,258,744,2011
2011-08-08,W.P. Kuala Lumpur,64,16,48,2011
2011-08-09,W.P. Kuala Lumpur,109,32,77,2011
2011-08-10,W.P. Kuala Lumpur,99,49,50,2011
2011-08-11,W.P. Kuala Lumpur,72,4,68,2011
2011-08-12,W.P. Kuala Lumpur,272,84,188,2011
2011-08-13,W.P. Kuala Lumpur,287,101,186,2011
2011-08-14,W.P. Kuala Lumpur,586,193,393,2011
2011-08-15,W.P. Kuala Lumpur,66,8,58,2011
2011-08-16,W.P. Kuala Lumpur,212,73,139,2011
2011-08-17,W.P. Kuala Lumpur,270,114,156,2011
2011-08-18,W.P. Kuala Lumpur,222,100,122,2011
2011-08-19,W.P. Kuala Lumpur,335,193,142,2011
2011-08-20,W.P. Kuala Lumpur,538,283,255,2011
2011-08-21,W.P. Kuala Lumpur,605,151,454,2011
2011-08-22,W.P. Kuala Lumpur,111,31,80,2011
2011-08-23,W.P. Kuala Lumpur,198,67,131,2011
2011-08-24,W.P. Kuala Lumpur,145,44,101,2011
2011-08-25,W.P. Kuala Lumpur,147,50,97,2011
2011-08-26,W.P. Kuala Lumpur,450,226,224,2011
2011-08-27,W.P. Kuala Lumpur,419,208,211,2011
2011-08-28,W.P. Kuala Lumpur,512,205,307,2011
2011-08-29,W.P. Kuala Lumpur,53,1,52,2011
2011-08-30,W.P. Kuala Lumpur,0,0,0,2011
2011-08-31,W.P. Kuala Lumpur,0,0,0,2011
2011-09-01,W.P. Kuala Lumpur,217,82,135,2011
2011-09-02,W.P. Kuala Lumpur,210,51,159,2011
2011-09-03,W.P. Kuala Lumpur,472,178,294,2011
2011-09-04,W.P. Kuala Lumpur,748,260,488,2011
2011-09-05,W.P. Kuala Lumpur,193,37,156,2011
2011-09-06,W.P. Kuala Lumpur,252,66,186,2011
2011-09-07,W.P. Kuala Lumpur,481,187,294,2011
2011-09-08,W.P. Kuala Lumpur,616,286,330,2011
2011-09-09,W.P. Kuala Lumpur,341,157,184,2011
2011-09-10,W.P. Kuala Lumpur,342,120,222,2011
2011-09-11,W.P. Kuala Lumpur,562,269,293,2011
2011-09-12,W.P. Kuala Lumpur,163,31,132,2011
2011-09-13,W.P. Kuala Lumpur,306,83,223,2011
2011-09-14,W.P. Kuala Lumpur,425,137,288,2011
2011-09-15,W.P. Kuala Lumpur,363,158,205,2011
2011-09-16,W.P. Kuala Lumpur,277,89,188,2011
2011-09-17,W.P. Kuala Lumpur,298,85,213,2011
2011-09-18,W.P. Kuala Lumpur,679,236,443,2011
2011-09-19,W.P. Kuala Lumpur,149,28,121,2011
2011-09-20,W.P. Kuala Lumpur,617,205,412,2011
2011-09-21,W.P. Kuala Lumpur,709,312,397,2011
2011-09-22,W.P. Kuala Lumpur,399,152,247,2011
2011-09-23,W.P. Kuala Lumpur,222,37,185,2011
2011-09-24,W.P. Kuala Lumpur,266,67,199,2011
2011-09-25,W.P. Kuala Lumpur,679,205,474,2011
2011-09-26,W.P. Kuala Lumpur,272,119,153,2011
2011-09-27,W.P. Kuala Lumpur,347,118,229,2011
2011-09-28,W.P. Kuala Lumpur,531,210,321,2011
2011-09-29,W.P. Kuala Lumpur,623,285,338,2011
2011-09-30,W.P. Kuala Lumpur,433,148,285,2011
2011-10-01,W.P. Kuala Lumpur,490,156,334,2011
2011-10-02,W.P. Kuala Lumpur,532,190,342,2011
2011-10-03,W.P. Kuala Lumpur,451,139,312,2011
2011-10-04,W.P. Kuala Lumpur,630,210,420,2011
2011-10-05,W.P. Kuala Lumpur,612,245,367,2011
2011-10-06,W.P. Kuala Lumpur,504,142,362,2011
2011-10-07,W.P. Kuala Lumpur,390,157,233,2011
2011-10-08,W.P. Kuala Lumpur,465,165,300,2011
2011-10-09,W.P. Kuala Lumpur,908,317,591,2011
2011-10-10,W.P. Kuala Lumpur,416,135,281,2011
2011-10-11,W.P. Kuala Lumpur,586,161,425,2011
2011-10-12,W.P. Kuala Lumpur,741,227,514,2011
2011-10-13,W.P. Kuala Lumpur,750,243,507,2011
2011-10-14,W.P. Kuala Lumpur,553,196,357,2011
2011-10-15,W.P. Kuala Lumpur,452,160,292,2011
2011-10-16,W.P. Kuala Lumpur,481,140,341,2011
2011-10-17,W.P. Kuala Lumpur,524,173,351,2011
2011-10-18,W.P. Kuala Lumpur,569,146,423,2011
2011-10-19,W.P. Kuala Lumpur,1063,461,602,2011
2011-10-20,W.P. Kuala Lumpur,834,265,569,2011
2011-10-21,W.P. Kuala Lumpur,697,208,489,2011
2011-10-22,W.P. Kuala Lumpur,433,139,294,2011
2011-10-23,W.P. Kuala Lumpur,519,164,355,2011
2011-10-24,W.P. Kuala Lumpur,330,78,252,2011
2011-10-25,W.P. Kuala Lumpur,470,155,315,2011
2011-10-26,W.P. Kuala Lumpur,235,88,147,2011
2011-10-27,W.P. Kuala Lumpur,568,217,351,2011
2011-10-28,W.P. Kuala Lumpur,215,44,171,2011
2011-10-29,W.P. Kuala Lumpur,393,124,269,2011
2011-10-30,W.P. Kuala Lumpur,608,197,411,2011
2011-10-31,W.P. Kuala Lumpur,153,42,111,2011
2011-11-01,W.P. Kuala Lumpur,142,42,100,2011
2011-11-02,W.P. Kuala Lumpur,423,149,274,2011
2011-11-03,W.P. Kuala Lumpur,283,66,217,2011
2011-11-04,W.P. Kuala Lumpur,204,53,151,2011
2011-11-05,W.P. Kuala Lumpur,228,61,167,2011
2011-11-06,W.P. Kuala Lumpur,100,41,59,2011
2011-11-07,W.P. Kuala Lumpur,183,48,135,2011
2011-11-08,W.P. Kuala Lumpur,143,43,100,2011
2011-11-09,W.P. Kuala Lumpur,411,123,288,2011
2011-11-10,W.P. Kuala Lumpur,1035,279,756,2011
2011-11-11,W.P. Kuala Lumpur,376,112,264,2011
2011-11-12,W.P. Kuala Lumpur,649,371,278,2011
2011-11-13,W.P. Kuala Lumpur,529,147,382,2011
2011-11-14,W.P. Kuala Lumpur,256,96,160,2011
2011-11-15,W.P. Kuala Lumpur,494,166,328,2011
2011-11-16,W.P. Kuala Lumpur,620,210,410,2011
2011-11-17,W.P. Kuala Lumpur,856,298,558,2011
2011-11-18,W.P. Kuala Lumpur,510,229,281,2011
2011-11-19,W.P. Kuala Lumpur,496,222,274,2011
2011-11-20,W.P. Kuala Lumpur,732,227,505,2011
2011-11-21,W.P. Kuala Lumpur,327,122,205,2011
2011-11-22,W.P. Kuala Lumpur,468,175,293,2011
2011-11-23,W.P. Kuala Lumpur,634,245,389,2011
2011-11-24,W.P. Kuala Lumpur,384,141,243,2011
2011-11-25,W.P. Kuala Lumpur,371,140,231,2011
2011-11-26,W.P. Kuala Lumpur,373,179,194,2011
2011-11-27,W.P. Kuala Lumpur,586,193,393,2011
2011-11-28,W.P. Kuala Lumpur,217,81,136,2011
2011-11-29,W.P. Kuala Lumpur,390,141,249,2011
2011-11-30,W.P. Kuala Lumpur,620,275,345,2011
2011-12-01,W.P. Kuala Lumpur,514,165,349,2011
2011-12-02,W.P. Kuala Lumpur,671,225,446,2011
2011-12-03,W.P. Kuala Lumpur,286,70,216,2011
2011-12-04,W.P. Kuala Lumpur,675,175,500,2011
2011-12-05,W.P. Kuala Lumpur,179,47,132,2011
2011-12-06,W.P. Kuala Lumpur,412,122,290,2011
2011-12-07,W.P. Kuala Lumpur,360,112,248,2011
2011-12-08,W.P. Kuala Lumpur,733,368,365,2011
2011-12-09,W.P. Kuala Lumpur,264,84,180,2011
2011-12-10,W.P. Kuala Lumpur,373,135,238,2011
2011-12-11,W.P. Kuala Lumpur,385,149,236,2011
2011-12-12,W.P. Kuala Lumpur,301,76,225,2011
2011-12-13,W.P. Kuala Lumpur,508,190,318,2011
2011-12-14,W.P. Kuala Lumpur,520,196,324,2011
2011-12-15,W.P. Kuala Lumpur,704,231,473,2011
2011-12-16,W.P. Kuala Lumpur,388,123,265,2011
2011-12-17,W.P. Kuala Lumpur,403,166,237,2011
2011-12-18,W.P. Kuala Lumpur,793,173,620,2011
2011-12-19,W.P. Kuala Lumpur,203,58,145,2011
2011-12-20,W.P. Kuala Lumpur,337,103,234,2011
2011-12-21,W.P. Kuala Lumpur,392,122,270,2011
2011-12-22,W.P. Kuala Lumpur,329,118,211,2011
2011-12-23,W.P. Kuala Lumpur,202,43,159,2011
2011-12-24,W.P. Kuala Lumpur,376,102,274,2011
2011-12-25,W.P. Kuala Lumpur,384,107,277,2011
2011-12-26,W.P. Kuala Lumpur,467,115,352,2011
2011-12-27,W.P. Kuala Lumpur,222,54,168,2011
2011-12-28,W.P. Kuala Lumpur,266,60,206,2011
2011-12-29,W.P. Kuala Lumpur,230,54,176,2011
2011-12-30,W.P. Kuala Lumpur,297,50,247,2011
2011-12-31,W.P. Kuala Lumpur,337,99,238,2011
2012-01-01,W.P. Kuala Lumpur,310,108,202,2012
2012-01-02,W.P. Kuala Lumpur,337,117,220,2012
2012-01-03,W.P. Kuala Lumpur,243,72,171,2012
2012-01-04,W.P. Kuala Lumpur,312,115,197,2012
2012-01-05,W.P. Kuala Lumpur,564,229,335,2012
2012-01-06,W.P. Kuala Lumpur,291,113,178,2012
2012-01-07,W.P. Kuala Lumpur,196,42,154,2012
2012-01-08,W.P. Kuala Lumpur,538,185,353,2012
2012-01-09,W.P. Kuala Lumpur,121,24,97,2012
2012-01-10,W.P. Kuala Lumpur,382,148,234,2012
2012-01-11,W.P. Kuala Lumpur,754,229,525,2012
2012-01-12,W.P. Kuala Lumpur,841,373,468,2012
2012-01-13,W.P. Kuala Lumpur,435,182,253,2012
2012-01-14,W.P. Kuala Lumpur,590,201,389,2012
2012-01-15,W.P. Kuala Lumpur,297,80,217,2012
2012-01-16,W.P. Kuala Lumpur,227,74,153,2012
2012-01-17,W.P. Kuala Lumpur,495,138,357,2012
2012-01-18,W.P. Kuala Lumpur,877,352,525,2012
2012-01-19,W.P. Kuala Lumpur,721,343,378,2012
2012-01-20,W.P. Kuala Lumpur,205,62,143,2012
2012-01-21,W.P. Kuala Lumpur,417,114,303,2012
2012-01-22,W.P. Kuala Lumpur,297,116,181,2012
2012-01-23,W.P. Kuala Lumpur,297,120,177,2012
2012-01-24,W.P. Kuala Lumpur,298,115,183,2012
2012-01-25,W.P. Kuala Lumpur,188,39,149,2012
2012-01-26,W.P. Kuala Lumpur,358,82,276,2012
2012-01-27,W.P. Kuala Lumpur,1324,1193,131,2012
2012-01-28,W.P. Kuala Lumpur,950,513,437,2012
2012-01-29,W.P. Kuala Lumpur,303,101,202,2012
2012-01-30,W.P. Kuala Lumpur,180,56,124,2012
2012-01-31,W.P. Kuala Lumpur,497,206,291,2012
2012-02-01,W.P. Kuala Lumpur,237,72,165,2012
2012-02-02,W.P. Kuala Lumpur,190,50,140,2012
2012-02-03,W.P. Kuala Lumpur,184,42,142,2012
2012-02-04,W.P. Kuala Lumpur,396,120,276,2012
2012-02-05,W.P. Kuala Lumpur,539,191,348,2012
2012-02-06,W.P. Kuala Lumpur,404,143,261,2012
2012-02-07,W.P. Kuala Lumpur,1038,349,689,2012
2012-02-08,W.P. Kuala Lumpur,194,30,164,2012
2012-02-09,W.P. Kuala Lumpur,228,65,163,2012
2012-02-10,W.P. Kuala Lumpur,206,44,162,2012
2012-02-11,W.P. Kuala Lumpur,497,177,320,2012
2012-02-12,W.P. Kuala Lumpur,396,146,250,2012
2012-02-13,W.P. Kuala Lumpur,223,83,140,2012
2012-02-14,W.P. Kuala Lumpur,233,44,189,2012
2012-02-15,W.P. Kuala Lumpur,342,108,234,2012
2012-02-16,W.P. Kuala Lumpur,709,268,441,2012
2012-02-17,W.P. Kuala Lumpur,554,179,375,2012
2012-02-18,W.P. Kuala Lumpur,408,125,283,2012
2012-02-19,W.P. Kuala Lumpur,669,256,413,2012
2012-02-20,W.P. Kuala Lumpur,391,122,269,2012
2012-02-21,W.P. Kuala Lumpur,624,270,354,2012
2012-02-22,W.P. Kuala Lumpur,539,211,328,2012
2012-02-23,W.P. Kuala Lumpur,509,218,291,2012
2012-02-24,W.P. Kuala Lumpur,218,56,162,2012
2012-02-25,W.P. Kuala Lumpur,826,611,215,2012
2012-02-26,W.P. Kuala Lumpur,783,340,443,2012
2012-02-27,W.P. Kuala Lumpur,458,120,338,2012
2012-02-28,W.P. Kuala Lumpur,793,291,502,2012
2012-02-29,W.P. Kuala Lumpur,621,127,494,2012
2012-03-01,W.P. Kuala Lumpur,722,195,527,2012
2012-03-02,W.P. Kuala Lumpur,516,143,373,2012
2012-03-03,W.P. Kuala Lumpur,230,58,172,2012
2012-03-04,W.P. Kuala Lumpur,474,156,318,2012
2012-03-05,W.P. Kuala Lumpur,311,89,222,2012
2012-03-06,W.P. Kuala Lumpur,550,156,394,2012
2012-03-07,W.P. Kuala Lumpur,755,254,501,2012
2012-03-08,W.P. Kuala Lumpur,637,237,400,2012
2012-03-09,W.P. Kuala Lumpur,251,56,195,2012
2012-03-10,W.P. Kuala Lumpur,353,111,242,2012
2012-03-11,W.P. Kuala Lumpur,540,213,327,2012
2012-03-12,W.P. Kuala Lumpur,365,136,229,2012
2012-03-13,W.P. Kuala Lumpur,669,287,382,2012
2012-03-14,W.P. Kuala Lumpur,457,194,263,2012
2012-03-15,W.P. Kuala Lumpur,450,146,304,2012
2012-03-16,W.P. Kuala Lumpur,263,77,186,2012
2012-03-17,W.P. Kuala Lumpur,374,84,290,2012
2012-03-18,W.P. Kuala Lumpur,459,115,344,2012
2012-03-19,W.P. Kuala Lumpur,189,62,127,2012
2012-03-20,W.P. Kuala Lumpur,547,137,410,2012
2012-03-21,W.P. Kuala Lumpur,589,203,386,2012
2012-03-22,W.P. Kuala Lumpur,767,195,572,2012
2012-03-23,W.P. Kuala Lumpur,215,49,166,2012
2012-03-24,W.P. Kuala Lumpur,282,63,219,2012
2012-03-25,W.P. Kuala Lumpur,643,152,491,2012
2012-03-26,W.P. Kuala Lumpur,409,93,316,2012
2012-03-27,W.P. Kuala Lumpur,436,152,284,2012
2012-03-28,W.P. Kuala Lumpur,931,337,594,2012
2012-03-29,W.P. Kuala Lumpur,471,133,338,2012
2012-03-30,W.P. Kuala Lumpur,267,56,211,2012
2012-03-31,W.P. Kuala Lumpur,230,53,177,2012
2012-04-01,W.P. Kuala Lumpur,361,99,262,2012
2012-04-02,W.P. Kuala Lumpur,428,165,263,2012
2012-04-03,W.P. Kuala Lumpur,199,62,137,2012
2012-04-04,W.P. Kuala Lumpur,367,138,229,2012
2012-04-05,W.P. Kuala Lumpur,651,241,410,2012
2012-04-06,W.P. Kuala Lumpur,320,89,231,2012
2012-04-07,W.P. Kuala Lumpur,219,34,185,2012
2012-04-08,W.P. Kuala Lumpur,782,227,555,2012
2012-04-09,W.P. Kuala Lumpur,463,165,298,2012
2012-04-10,W.P. Kuala Lumpur,694,256,438,2012
2012-04-11,W.P. Kuala Lumpur,0,0,0,2012
2012-04-12,W.P. Kuala Lumpur,412,122,290,2012
2012-04-13,W.P. Kuala Lumpur,367,119,248,2012
2012-04-14,W.P. Kuala Lumpur,679,180,499,2012
2012-04-15,W.P. Kuala Lumpur,776,194,582,2012
2012-04-16,W.P. Kuala Lumpur,523,147,376,2012
2012-04-17,W.P. Kuala Lumpur,642,328,314,2012
2012-04-18,W.P. Kuala Lumpur,462,138,324,2012
2012-04-19,W.P. Kuala Lumpur,507,145,362,2012
2012-04-20,W.P. Kuala Lumpur,398,131,267,2012
2012-04-21,W.P. Kuala Lumpur,344,86,258,2012
2012-04-22,W.P. Kuala Lumpur,923,210,713,2012
2012-04-23,W.P. Kuala Lumpur,456,128,328,2012
2012-04-24,W.P. Kuala Lumpur,469,133,336,2012
2012-04-25,W.P. Kuala Lumpur,473,164,309,2012
2012-04-26,W.P. Kuala Lumpur,456,110,346,2012
2012-04-27,W.P. Kuala Lumpur,367,127,240,2012
2012-04-28,W.P. Kuala Lumpur,241,58,183,2012
2012-04-29,W.P. Kuala Lumpur,484,152,332,2012
2012-04-30,W.P. Kuala Lumpur,198,56,142,2012
2012-05-01,W.P. Kuala Lumpur,1401,280,1121,2012
2012-05-02,W.P. Kuala Lumpur,366,108,258,2012
2012-05-03,W.P. Kuala Lumpur,681,236,445,2012
2012-05-04,W.P. Kuala Lumpur,356,106,250,2012
2012-05-05,W.P. Kuala Lumpur,1043,190,853,2012
2012-05-06,W.P. Kuala Lumpur,372,146,226,2012
2012-05-07,W.P. Kuala Lumpur,240,66,174,2012
2012-05-08,W.P. Kuala Lumpur,390,88,302,2012
2012-05-09,W.P. Kuala Lumpur,435,133,302,2012
2012-05-10,W.P. Kuala Lumpur,442,193,249,2012
2012-05-11,W.P. Kuala Lumpur,305,140,165,2012
2012-05-12,W.P. Kuala Lumpur,392,67,325,2012
2012-05-13,W.P. Kuala Lumpur,630,174,456,2012
2012-05-14,W.P. Kuala Lumpur,384,119,265,2012
2012-05-15,W.P. Kuala Lumpur,582,224,358,2012
2012-05-16,W.P. Kuala Lumpur,334,104,230,2012
2012-05-17,W.P. Kuala Lumpur,592,192,400,2012
2012-05-18,W.P. Kuala Lumpur,410,126,284,2012
2012-05-19,W.P. Kuala Lumpur,236,48,188,2012
2012-05-20,W.P. Kuala Lumpur,687,231,456,2012
2012-05-21,W.P. Kuala Lumpur,219,46,173,2012
2012-05-22,W.P. Kuala Lumpur,432,187,245,2012
2012-05-23,W.P. Kuala Lumpur,477,131,346,2012
2012-05-24,W.P. Kuala Lumpur,432,122,310,2012
2012-05-25,W.P. Kuala Lumpur,393,108,285,2012
2012-05-26,W.P. Kuala Lumpur,397,115,282,2012
2012-05-27,W.P. Kuala Lumpur,637,161,476,2012
2012-05-28,W.P. Kuala Lumpur,117,29,88,2012
2012-05-29,W.P. Kuala Lumpur,313,104,209,2012
2012-05-30,W.P. Kuala Lumpur,278,117,161,2012
2012-05-31,W.P. Kuala Lumpur,186,31,155,2012
2012-06-01,W.P. Kuala Lumpur,143,28,115,2012
2012-06-02,W.P. Kuala Lumpur,269,71,198,2012
2012-06-03,W.P. Kuala Lumpur,535,217,318,2012
2012-06-04,W.P. Kuala Lumpur,287,108,179,2012
2012-06-05,W.P. Kuala Lumpur,575,217,358,2012
2012-06-06,W.P. Kuala Lumpur,607,196,411,2012
2012-06-07,W.P. Kuala Lumpur,320,72,248,2012
2012-06-08,W.P. Kuala Lumpur,368,147,221,2012
2012-06-09,W.P. Kuala Lumpur,469,176,293,2012
2012-06-10,W.P. Kuala Lumpur,657,118,539,2012
2012-06-11,W.P. Kuala Lumpur,193,35,158,2012
2012-06-12,W.P. Kuala Lumpur,397,156,241,2012
2012-06-13,W.P. Kuala Lumpur,970,709,261,2012
2012-06-14,W.P. Kuala Lumpur,894,263,631,2012
2012-06-15,W.P. Kuala Lumpur,421,132,289,2012
2012-06-16,W.P. Kuala Lumpur,542,221,321,2012
2012-06-17,W.P. Kuala Lumpur,609,156,453,2012
2012-06-18,W.P. Kuala Lumpur,392,166,226,2012
2012-06-19,W.P. Kuala Lumpur,370,165,205,2012
2012-06-20,W.P. Kuala Lumpur,519,200,319,2012
2012-06-21,W.P. Kuala Lumpur,713,239,474,2012
2012-06-22,W.P. Kuala Lumpur,405,126,279,2012
2012-06-23,W.P. Kuala Lumpur,810,310,500,2012
2012-06-24,W.P. Kuala Lumpur,378,148,230,2012
2012-06-25,W.P. Kuala Lumpur,478,164,314,2012
2012-06-26,W.P. Kuala Lumpur,548,191,357,2012
2012-06-27,W.P. Kuala Lumpur,639,228,411,2012
2012-06-28,W.P. Kuala Lumpur,537,198,339,2012
2012-06-29,W.P. Kuala Lumpur,427,166,261,2012
2012-06-30,W.P. Kuala Lumpur,510,223,287,2012
2012-07-01,W.P. Kuala Lumpur,372,125,247,2012
2012-07-02,W.P. Kuala Lumpur,278,94,184,2012
2012-07-03,W.P. Kuala Lumpur,294,67,227,2012
2012-07-04,W.P. Kuala Lumpur,440,182,258,2012
2012-07-05,W.P. Kuala Lumpur,478,141,337,2012
2012-07-06,W.P. Kuala Lumpur,569,188,381,2012
2012-07-07,W.P. Kuala Lumpur,498,171,327,2012
2012-07-08,W.P. Kuala Lumpur,684,186,498,2012
2012-07-09,W.P. Kuala Lumpur,545,198,347,2012
2012-07-10,W.P. Kuala Lumpur,907,301,606,2012
2012-07-11,W.P. Kuala Lumpur,750,228,522,2012
2012-07-12,W.P. Kuala Lumpur,983,348,635,2012
2012-07-13,W.P. Kuala Lumpur,783,315,468,2012
2012-07-14,W.P. Kuala Lumpur,747,229,518,2012
2012-07-15,W.P. Kuala Lumpur,1109,418,691,2012
2012-07-16,W.P. Kuala Lumpur,493,175,318,2012
2012-07-17,W.P. Kuala Lumpur,631,208,423,2012
2012-07-18,W.P. Kuala Lumpur,744,287,457,2012
2012-07-19,W.P. Kuala Lumpur,308,115,193,2012
2012-07-20,W.P. Kuala Lumpur,391,102,289,2012
2012-07-21,W.P. Kuala Lumpur,153,34,119,2012
2012-07-22,W.P. Kuala Lumpur,606,189,417,2012
2012-07-23,W.P. Kuala Lumpur,61,19,42,2012
2012-07-24,W.P. Kuala Lumpur,128,57,71,2012
2012-07-25,W.P. Kuala Lumpur,60,0,60,2012
2012-07-26,W.P. Kuala Lumpur,54,2,52,2012
2012-07-27,W.P. Kuala Lumpur,92,15,77,2012
2012-07-28,W.P. Kuala Lumpur,137,37,100,2012
2012-07-29,W.P. Kuala Lumpur,1203,258,945,2012
2012-07-30,W.P. Kuala Lumpur,50,3,47,2012
2012-07-31,W.P. Kuala Lumpur,61,1,60,2012
2012-08-01,W.P. Kuala Lumpur,65,4,61,2012
2012-08-02,W.P. Kuala Lumpur,87,19,68,2012
2012-08-03,W.P. Kuala Lumpur,184,43,141,2012
2012-08-04,W.P. Kuala Lumpur,416,115,301,2012
2012-08-05,W.P. Kuala Lumpur,740,198,542,2012
2012-08-06,W.P. Kuala Lumpur,98,23,75,2012
2012-08-07,W.P. Kuala Lumpur,82,15,67,2012
2012-08-08,W.P. Kuala Lumpur,273,89,184,2012
2012-08-09,W.P. Kuala Lumpur,225,38,187,2012
2012-08-10,W.P. Kuala Lumpur,130,21,109,2012
2012-08-11,W.P. Kuala Lumpur,603,145,458,2012
2012-08-12,W.P. Kuala Lumpur,768,168,600,2012
2012-08-13,W.P. Kuala Lumpur,349,71,278,2012
2012-08-14,W.P. Kuala Lumpur,202,85,117,2012
2012-08-15,W.P. Kuala Lumpur,93,22,71,2012
2012-08-16,W.P. Kuala Lumpur,128,18,110,2012
2012-08-17,W.P. Kuala Lumpur,123,16,107,2012
2012-08-18,W.P. Kuala Lumpur,56,2,54,2012
2012-08-19,W.P. Kuala Lumpur,0,0,0,2012
2012-08-20,W.P. Kuala Lumpur,0,0,0,2012
2012-08-21,W.P. Kuala Lumpur,219,53,166,2012
2012-08-22,W.P. Kuala Lumpur,188,43,145,2012
2012-08-23,W.P. Kuala Lumpur,163,31,132,2012
2012-08-24,W.P. Kuala Lumpur,180,27,153,2012
2012-08-25,W.P. Kuala Lumpur,526,142,384,2012
2012-08-26,W.P. Kuala Lumpur,993,432,561,2012
2012-08-27,W.P. Kuala Lumpur,177,56,121,2012
2012-08-28,W.P. Kuala Lumpur,450,145,305,2012
2012-08-29,W.P. Kuala Lumpur,315,59,256,2012
2012-08-30,W.P. Kuala Lumpur,373,128,245,2012
2012-08-31,W.P. Kuala Lumpur,546,173,373,2012
2012-09-01,W.P. Kuala Lumpur,455,104,351,2012
2012-09-02,W.P. Kuala Lumpur,844,332,512,2012
2012-09-03,W.P. Kuala Lumpur,241,58,183,2012
2012-09-04,W.P. Kuala Lumpur,340,134,206,2012
2012-09-05,W.P. Kuala Lumpur,376,150,226,2012
2012-09-06,W.P. Kuala Lumpur,469,173,296,2012
2012-09-07,W.P. Kuala Lumpur,334,115,219,2012
2012-09-08,W.P. Kuala Lumpur,789,604,185,2012
2012-09-09,W.P. Kuala Lumpur,482,133,349,2012
2012-09-10,W.P. Kuala Lumpur,406,99,307,2012
2012-09-11,W.P. Kuala Lumpur,952,577,375,2012
2012-09-12,W.P. Kuala Lumpur,601,221,380,2012
2012-09-13,W.P. Kuala Lumpur,745,201,544,2012
2012-09-14,W.P. Kuala Lumpur,306,106,200,2012
2012-09-15,W.P. Kuala Lumpur,410,110,300,2012
2012-09-16,W.P. Kuala Lumpur,600,161,439,2012
2012-09-17,W.P. Kuala Lumpur,223,60,163,2012
2012-09-18,W.P. Kuala Lumpur,464,156,308,2012
2012-09-19,W.P. Kuala Lumpur,640,178,462,2012
2012-09-20,W.P. Kuala Lumpur,662,224,438,2012
2012-09-21,W.P. Kuala Lumpur,327,107,220,2012
2012-09-22,W.P. Kuala Lumpur,538,185,353,2012
2012-09-23,W.P. Kuala Lumpur,697,196,501,2012
2012-09-24,W.P. Kuala Lumpur,82,4,78,2012
2012-09-25,W.P. Kuala Lumpur,357,111,246,2012
2012-09-26,W.P. Kuala Lumpur,463,216,247,2012
2012-09-27,W.P. Kuala Lumpur,701,241,460,2012
2012-09-28,W.P. Kuala Lumpur,363,123,240,2012
2012-09-29,W.P. Kuala Lumpur,580,177,403,2012
2012-09-30,W.P. Kuala Lumpur,491,189,302,2012
2012-10-01,W.P. Kuala Lumpur,211,34,177,2012
2012-10-02,W.P. Kuala Lumpur,479,214,265,2012
2012-10-03,W.P. Kuala Lumpur,469,197,272,2012
2012-10-04,W.P. Kuala Lumpur,534,197,337,2012
2012-10-05,W.P. Kuala Lumpur,213,42,171,2012
2012-10-06,W.P. Kuala Lumpur,478,156,322,2012
2012-10-07,W.P. Kuala Lumpur,618,186,432,2012
2012-10-08,W.P. Kuala Lumpur,212,53,159,2012
2012-10-09,W.P. Kuala Lumpur,391,74,317,2012
2012-10-10,W.P. Kuala Lumpur,560,187,373,2012
2012-10-11,W.P. Kuala Lumpur,436,124,312,2012
2012-10-12,W.P. Kuala Lumpur,387,142,245,2012
2012-10-13,W.P. Kuala Lumpur,227,55,172,2012
2012-10-14,W.P. Kuala Lumpur,492,153,339,2012
2012-10-15,W.P. Kuala Lumpur,420,150,270,2012
2012-10-16,W.P. Kuala Lumpur,492,148,344,2012
2012-10-17,W.P. Kuala Lumpur,535,237,298,2012
2012-10-18,W.P. Kuala Lumpur,563,243,320,2012
2012-10-19,W.P. Kuala Lumpur,421,163,258,2012
2012-10-20,W.P. Kuala Lumpur,420,150,270,2012
2012-10-21,W.P. Kuala Lumpur,713,249,464,2012
2012-10-22,W.P. Kuala Lumpur,259,47,212,2012
2012-10-23,W.P. Kuala Lumpur,499,171,328,2012
2012-10-24,W.P. Kuala Lumpur,495,202,293,2012
2012-10-25,W.P. Kuala Lumpur,155,32,123,2012
2012-10-26,W.P. Kuala Lumpur,65,22,43,2012
2012-10-27,W.P. Kuala Lumpur,157,40,117,2012
2012-10-28,W.P. Kuala Lumpur,636,183,453,2012
2012-10-29,W.P. Kuala Lumpur,139,30,109,2012
2012-10-30,W.P. Kuala Lumpur,246,75,171,2012
2012-10-31,W.P. Kuala Lumpur,536,233,303,2012
2012-11-01,W.P. Kuala Lumpur,417,132,285,2012
2012-11-02,W.P. Kuala Lumpur,552,139,413,2012
2012-11-03,W.P. Kuala Lumpur,405,124,281,2012
2012-11-04,W.P. Kuala Lumpur,1090,387,703,2012
2012-11-05,W.P. Kuala Lumpur,504,117,387,2012
2012-11-06,W.P. Kuala Lumpur,559,137,422,2012
2012-11-07,W.P. Kuala Lumpur,521,124,397,2012
2012-11-08,W.P. Kuala Lumpur,710,158,552,2012
2012-11-09,W.P. Kuala Lumpur,513,142,371,2012
2012-11-10,W.P. Kuala Lumpur,404,190,214,2012
2012-11-11,W.P. Kuala Lumpur,478,133,345,2012
2012-11-12,W.P. Kuala Lumpur,238,68,170,2012
2012-11-13,W.P. Kuala Lumpur,192,50,142,2012
2012-11-14,W.P. Kuala Lumpur,133,24,109,2012
2012-11-15,W.P. Kuala Lumpur,235,59,176,2012
2012-11-16,W.P. Kuala Lumpur,351,89,262,2012
2012-11-17,W.P. Kuala Lumpur,453,151,302,2012
2012-11-18,W.P. Kuala Lumpur,960,260,700,2012
2012-11-19,W.P. Kuala Lumpur,402,111,291,2012
2012-11-20,W.P. Kuala Lumpur,530,174,356,2012
2012-11-21,W.P. Kuala Lumpur,504,133,371,2012
2012-11-22,W.P. Kuala Lumpur,619,220,399,2012
2012-11-23,W.P. Kuala Lumpur,519,167,352,2012
2012-11-24,W.P. Kuala Lumpur,524,196,328,2012
2012-11-25,W.P. Kuala Lumpur,480,172,308,2012
2012-11-26,W.P. Kuala Lumpur,263,87,176,2012
2012-11-27,W.P. Kuala Lumpur,476,219,257,2012
2012-11-28,W.P. Kuala Lumpur,348,109,239,2012
2012-11-29,W.P. Kuala Lumpur,684,212,472,2012
2012-11-30,W.P. Kuala Lumpur,426,142,284,2012
2012-12-01,W.P. Kuala Lumpur,268,85,183,2012
2012-12-02,W.P. Kuala Lumpur,505,112,393,2012
2012-12-03,W.P. Kuala Lumpur,153,34,119,2012
2012-12-04,W.P. Kuala Lumpur,373,114,259,2012
2012-12-05,W.P. Kuala Lumpur,625,258,367,2012
2012-12-06,W.P. Kuala Lumpur,707,242,465,2012
2012-12-07,W.P. Kuala Lumpur,205,47,158,2012
2012-12-08,W.P. Kuala Lumpur,393,118,275,2012
2012-12-09,W.P. Kuala Lumpur,576,181,395,2012
2012-12-10,W.P. Kuala Lumpur,449,210,239,2012
2012-12-11,W.P. Kuala Lumpur,467,130,337,2012
2012-12-12,W.P. Kuala Lumpur,522,175,347,2012
2012-12-13,W.P. Kuala Lumpur,405,142,263,2012
2012-12-14,W.P. Kuala Lumpur,410,139,271,2012
2012-12-15,W.P. Kuala Lumpur,292,63,229,2012
2012-12-16,W.P. Kuala Lumpur,895,162,733,2012
2012-12-17,W.P. Kuala Lumpur,393,105,288,2012
2012-12-18,W.P. Kuala Lumpur,557,203,354,2012
2012-12-19,W.P. Kuala Lumpur,461,121,340,2012
2012-12-20,W.P. Kuala Lumpur,469,173,296,2012
2012-12-21,W.P. Kuala Lumpur,249,83,166,2012
2012-12-22,W.P. Kuala Lumpur,397,100,297,2012
2012-12-23,W.P. Kuala Lumpur,363,93,270,2012
2012-12-24,W.P. Kuala Lumpur,225,60,165,2012
2012-12-25,W.P. Kuala Lumpur,341,87,254,2012
2012-12-26,W.P. Kuala Lumpur,147,18,129,2012
2012-12-27,W.P. Kuala Lumpur,294,67,227,2012
2012-12-28,W.P. Kuala Lumpur,350,63,287,2012
2012-12-29,W.P. Kuala Lumpur,346,102,244,2012
2012-12-30,W.P. Kuala Lumpur,401,129,272,2012
2012-12-31,W.P. Kuala Lumpur,134,17,117,2012
2013-01-01,W.P. Kuala Lumpur,206,45,161,2013
2013-01-02,W.P. Kuala Lumpur,153,30,123,2013
2013-01-03,W.P. Kuala Lumpur,373,164,209,2013
2013-01-04,W.P. Kuala Lumpur,141,31,110,2013
2013-01-05,W.P. Kuala Lumpur,471,135,336,2013
2013-01-06,W.P. Kuala Lumpur,622,183,439,2013
2013-01-07,W.P. Kuala Lumpur,133,44,89,2013
2013-01-08,W.P. Kuala Lumpur,344,89,255,2013
2013-01-09,W.P. Kuala Lumpur,464,172,292,2013
2013-01-10,W.P. Kuala Lumpur,366,135,231,2013
2013-01-11,W.P. Kuala Lumpur,123,19,104,2013
2013-01-12,W.P. Kuala Lumpur,513,160,353,2013
2013-01-13,W.P. Kuala Lumpur,594,186,408,2013
2013-01-14,W.P. Kuala Lumpur,198,56,142,2013
2013-01-15,W.P. Kuala Lumpur,535,232,303,2013
2013-01-16,W.P. Kuala Lumpur,712,218,494,2013
2013-01-17,W.P. Kuala Lumpur,480,153,327,2013
2013-01-18,W.P. Kuala Lumpur,405,102,303,2013
2013-01-19,W.P. Kuala Lumpur,663,240,423,2013
2013-01-20,W.P. Kuala Lumpur,705,169,536,2013
2013-01-21,W.P. Kuala Lumpur,371,187,184,2013
2013-01-22,W.P. Kuala Lumpur,637,243,394,2013
2013-01-23,W.P. Kuala Lumpur,635,225,410,2013
2013-01-24,W.P. Kuala Lumpur,258,87,171,2013
2013-01-25,W.P. Kuala Lumpur,185,55,130,2013
2013-01-26,W.P. Kuala Lumpur,683,263,420,2013
2013-01-27,W.P. Kuala Lumpur,1417,522,895,2013
2013-01-28,W.P. Kuala Lumpur,490,241,249,2013
2013-01-29,W.P. Kuala Lumpur,171,33,138,2013
2013-01-30,W.P. Kuala Lumpur,540,217,323,2013
2013-01-31,W.P. Kuala Lumpur,499,183,316,2013
2013-02-01,W.P. Kuala Lumpur,152,39,113,2013
2013-02-02,W.P. Kuala Lumpur,360,112,248,2013
2013-02-03,W.P. Kuala Lumpur,442,167,275,2013
2013-02-04,W.P. Kuala Lumpur,162,39,123,2013
2013-02-05,W.P. Kuala Lumpur,352,113,239,2013
2013-02-06,W.P. Kuala Lumpur,484,148,336,2013
2013-02-07,W.P. Kuala Lumpur,244,79,165,2013
2013-02-08,W.P. Kuala Lumpur,229,48,181,2013
2013-02-09,W.P. Kuala Lumpur,459,131,328,2013
2013-02-10,W.P. Kuala Lumpur,267,113,154,2013
2013-02-11,W.P. Kuala Lumpur,321,121,200,2013
2013-02-12,W.P. Kuala Lumpur,276,78,198,2013
2013-02-13,W.P. Kuala Lumpur,221,48,173,2013
2013-02-14,W.P. Kuala Lumpur,572,140,432,2013
2013-02-15,W.P. Kuala Lumpur,347,111,236,2013
2013-02-16,W.P. Kuala Lumpur,699,256,443,2013
2013-02-17,W.P. Kuala Lumpur,471,129,342,2013
2013-02-18,W.P. Kuala Lumpur,323,157,166,2013
2013-02-19,W.P. Kuala Lumpur,282,68,214,2013
2013-02-20,W.P. Kuala Lumpur,372,126,246,2013
2013-02-21,W.P. Kuala Lumpur,372,139,233,2013
2013-02-22,W.P. Kuala Lumpur,335,98,237,2013
2013-02-23,W.P. Kuala Lumpur,460,131,329,2013
2013-02-24,W.P. Kuala Lumpur,631,225,406,2013
2013-02-25,W.P. Kuala Lumpur,217,56,161,2013
2013-02-26,W.P. Kuala Lumpur,404,118,286,2013
2013-02-27,W.P. Kuala Lumpur,379,124,255,2013
2013-02-28,W.P. Kuala Lumpur,629,196,433,2013
2013-03-01,W.P. Kuala Lumpur,219,66,153,2013
2013-03-02,W.P. Kuala Lumpur,618,417,201,2013
2013-03-03,W.P. Kuala Lumpur,546,153,393,2013
2013-03-04,W.P. Kuala Lumpur,157,32,125,2013
2013-03-05,W.P. Kuala Lumpur,550,191,359,2013
2013-03-06,W.P. Kuala Lumpur,1043,347,696,2013
2013-03-07,W.P. Kuala Lumpur,607,277,330,2013
2013-03-08,W.P. Kuala Lumpur,441,173,268,2013
2013-03-09,W.P. Kuala Lumpur,496,131,365,2013
2013-03-10,W.P. Kuala Lumpur,931,229,702,2013
2013-03-11,W.P. Kuala Lumpur,335,107,228,2013
2013-03-12,W.P. Kuala Lumpur,757,241,516,2013
2013-03-13,W.P. Kuala Lumpur,700,176,524,2013
2013-03-14,W.P. Kuala Lumpur,855,214,641,2013
2013-03-15,W.P. Kuala Lumpur,574,163,411,2013
2013-03-16,W.P. Kuala Lumpur,380,87,293,2013
2013-03-17,W.P. Kuala Lumpur,696,180,516,2013
2013-03-18,W.P. Kuala Lumpur,414,118,296,2013
2013-03-19,W.P. Kuala Lumpur,478,157,321,2013
2013-03-20,W.P. Kuala Lumpur,538,194,344,2013
2013-03-21,W.P. Kuala Lumpur,506,157,349,2013
2013-03-22,W.P. Kuala Lumpur,313,74,239,2013
2013-03-23,W.P. Kuala Lumpur,393,130,263,2013
2013-03-24,W.P. Kuala Lumpur,597,169,428,2013
2013-03-25,W.P. Kuala Lumpur,492,200,292,2013
2013-03-26,W.P. Kuala Lumpur,572,145,427,2013
2013-03-27,W.P. Kuala Lumpur,537,163,374,2013
2013-03-28,W.P. Kuala Lumpur,524,170,354,2013
2013-03-29,W.P. Kuala Lumpur,338,98,240,2013
2013-03-30,W.P. Kuala Lumpur,351,103,248,2013
2013-03-31,W.P. Kuala Lumpur,231,58,173,2013
2013-04-01,W.P. Kuala Lumpur,208,66,142,2013
2013-04-02,W.P. Kuala Lumpur,479,135,344,2013
2013-04-03,W.P. Kuala Lumpur,412,164,248,2013
2013-04-04,W.P. Kuala Lumpur,758,254,504,2013
2013-04-05,W.P. Kuala Lumpur,504,185,319,2013
2013-04-06,W.P. Kuala Lumpur,511,156,355,2013
2013-04-07,W.P. Kuala Lumpur,666,198,468,2013
2013-04-08,W.P. Kuala Lumpur,315,111,204,2013
2013-04-09,W.P. Kuala Lumpur,506,166,340,2013
2013-04-10,W.P. Kuala Lumpur,554,227,327,2013
2013-04-11,W.P. Kuala Lumpur,453,128,325,2013
2013-04-12,W.P. Kuala Lumpur,307,116,191,2013
2013-04-13,W.P. Kuala Lumpur,454,126,328,2013
2013-04-14,W.P. Kuala Lumpur,535,137,398,2013
2013-04-15,W.P. Kuala Lumpur,326,139,187,2013
2013-04-16,W.P. Kuala Lumpur,564,199,365,2013
2013-04-17,W.P. Kuala Lumpur,384,139,245,2013
2013-04-18,W.P. Kuala Lumpur,475,158,317,2013
2013-04-19,W.P. Kuala Lumpur,459,158,301,2013
2013-04-20,W.P. Kuala Lumpur,462,129,333,2013
2013-04-21,W.P. Kuala Lumpur,1015,258,757,2013
2013-04-22,W.P. Kuala Lumpur,309,114,195,2013
2013-04-23,W.P. Kuala Lumpur,327,118,209,2013
2013-04-24,W.P. Kuala Lumpur,469,179,290,2013
2013-04-25,W.P. Kuala Lumpur,659,219,440,2013
2013-04-26,W.P. Kuala Lumpur,399,81,318,2013
2013-04-27,W.P. Kuala Lumpur,292,88,204,2013
2013-04-28,W.P. Kuala Lumpur,929,277,652,2013
2013-04-29,W.P. Kuala Lumpur,395,158,237,2013
2013-04-30,W.P. Kuala Lumpur,374,130,244,2013
2013-05-01,W.P. Kuala Lumpur,1695,331,1364,2013
2013-05-02,W.P. Kuala Lumpur,104,11,93,2013
2013-05-03,W.P. Kuala Lumpur,94,13,81,2013
2013-05-04,W.P. Kuala Lumpur,140,21,119,2013
2013-05-05,W.P. Kuala Lumpur,0,0,0,2013
2013-05-06,W.P. Kuala Lumpur,83,12,71,2013
2013-05-07,W.P. Kuala Lumpur,51,3,48,2013
2013-05-08,W.P. Kuala Lumpur,503,168,335,2013
2013-05-09,W.P. Kuala Lumpur,500,145,355,2013
2013-05-10,W.P. Kuala Lumpur,165,53,112,2013
2013-05-11,W.P. Kuala Lumpur,382,119,263,2013
2013-05-12,W.P. Kuala Lumpur,505,167,338,2013
2013-05-13,W.P. Kuala Lumpur,312,110,202,2013
2013-05-14,W.P. Kuala Lumpur,639,265,374,2013
2013-05-15,W.P. Kuala Lumpur,422,143,279,2013
2013-05-16,W.P. Kuala Lumpur,351,128,223,2013
2013-05-17,W.P. Kuala Lumpur,471,146,325,2013
2013-05-18,W.P. Kuala Lumpur,630,165,465,2013
2013-05-19,W.P. Kuala Lumpur,702,189,513,2013
2013-05-20,W.P. Kuala Lumpur,229,52,177,2013
2013-05-21,W.P. Kuala Lumpur,847,232,615,2013
2013-05-22,W.P. Kuala Lumpur,394,103,291,2013
2013-05-23,W.P. Kuala Lumpur,375,91,284,2013
2013-05-24,W.P. Kuala Lumpur,1251,282,969,2013
2013-05-25,W.P. Kuala Lumpur,585,154,431,2013
2013-05-26,W.P. Kuala Lumpur,416,125,291,2013
2013-05-27,W.P. Kuala Lumpur,313,120,193,2013
2013-05-28,W.P. Kuala Lumpur,429,210,219,2013
2013-05-29,W.P. Kuala Lumpur,562,187,375,2013
2013-05-30,W.P. Kuala Lumpur,761,274,487,2013
2013-05-31,W.P. Kuala Lumpur,178,34,144,2013
2013-06-01,W.P. Kuala Lumpur,545,197,348,2013
2013-06-02,W.P. Kuala Lumpur,482,116,366,2013
2013-06-03,W.P. Kuala Lumpur,320,133,187,2013
2013-06-04,W.P. Kuala Lumpur,560,214,346,2013
2013-06-05,W.P. Kuala Lumpur,827,395,432,2013
2013-06-06,W.P. Kuala Lumpur,740,308,432,2013
2013-06-07,W.P. Kuala Lumpur,282,98,184,2013
2013-06-08,W.P. Kuala Lumpur,155,28,127,2013
2013-06-09,W.P. Kuala Lumpur,618,105,513,2013
2013-06-10,W.P. Kuala Lumpur,456,127,329,2013
2013-06-11,W.P. Kuala Lumpur,531,198,333,2013
2013-06-12,W.P. Kuala Lumpur,589,150,439,2013
2013-06-13,W.P. Kuala Lumpur,594,205,389,2013
2013-06-14,W.P. Kuala Lumpur,664,165,499,2013
2013-06-15,W.P. Kuala Lumpur,595,245,350,2013
2013-06-16,W.P. Kuala Lumpur,641,165,476,2013
2013-06-17,W.P. Kuala Lumpur,582,169,413,2013
2013-06-18,W.P. Kuala Lumpur,607,196,411,2013
2013-06-19,W.P. Kuala Lumpur,672,239,433,2013
2013-06-20,W.P. Kuala Lumpur,622,201,421,2013
2013-06-21,W.P. Kuala Lumpur,436,161,275,2013
2013-06-22,W.P. Kuala Lumpur,954,363,591,2013
2013-06-23,W.P. Kuala Lumpur,623,180,443,2013
2013-06-24,W.P. Kuala Lumpur,317,122,195,2013
2013-06-25,W.P. Kuala Lumpur,553,204,349,2013
2013-06-26,W.P. Kuala Lumpur,346,92,254,2013
2013-06-27,W.P. Kuala Lumpur,459,183,276,2013
2013-06-28,W.P. Kuala Lumpur,437,96,341,2013
2013-06-29,W.P. Kuala Lumpur,527,142,385,2013
2013-06-30,W.P. Kuala Lumpur,668,203,465,2013
2013-07-01,W.P. Kuala Lumpur,760,382,378,2013
2013-07-02,W.P. Kuala Lumpur,626,261,365,2013
2013-07-03,W.P. Kuala Lumpur,757,220,537,2013
2013-07-04,W.P. Kuala Lumpur,630,181,449,2013
2013-07-05,W.P. Kuala Lumpur,478,189,289,2013
2013-07-06,W.P. Kuala Lumpur,1019,311,708,2013
2013-07-07,W.P. Kuala Lumpur,1076,338,738,2013
2013-07-08,W.P. Kuala Lumpur,489,206,283,2013
2013-07-09,W.P. Kuala Lumpur,549,190,359,2013
2013-07-10,W.P. Kuala Lumpur,30,1,29,2013
2013-07-11,W.P. Kuala Lumpur,58,5,53,2013
2013-07-12,W.P. Kuala Lumpur,63,8,55,2013
2013-07-13,W.P. Kuala Lumpur,203,61,142,2013
2013-07-14,W.P. Kuala Lumpur,833,241,592,2013
2013-07-15,W.P. Kuala Lumpur,301,108,193,2013
2013-07-16,W.P. Kuala Lumpur,502,163,339,2013
2013-07-17,W.P. Kuala Lumpur,616,236,380,2013
2013-07-18,W.P. Kuala Lumpur,513,198,315,2013
2013-07-19,W.P. Kuala Lumpur,464,202,262,2013
2013-07-20,W.P. Kuala Lumpur,372,112,260,2013
2013-07-21,W.P. Kuala Lumpur,790,227,563,2013
2013-07-22,W.P. Kuala Lumpur,40,3,37,2013
2013-07-23,W.P. Kuala Lumpur,194,77,117,2013
2013-07-24,W.P. Kuala Lumpur,408,114,294,2013
2013-07-25,W.P. Kuala Lumpur,114,44,70,2013
2013-07-26,W.P. Kuala Lumpur,132,38,94,2013
2013-07-27,W.P. Kuala Lumpur,572,170,402,2013
2013-07-28,W.P. Kuala Lumpur,1275,260,1015,2013
2013-07-29,W.P. Kuala Lumpur,40,3,37,2013
2013-07-30,W.P. Kuala Lumpur,87,13,74,2013
2013-07-31,W.P. Kuala Lumpur,187,89,98,2013
2013-08-01,W.P. Kuala Lumpur,141,41,100,2013
2013-08-02,W.P. Kuala Lumpur,97,17,80,2013
2013-08-03,W.P. Kuala Lumpur,167,28,139,2013
2013-08-04,W.P. Kuala Lumpur,1089,307,782,2013
2013-08-05,W.P. Kuala Lumpur,101,17,84,2013
2013-08-06,W.P. Kuala Lumpur,94,19,75,2013
2013-08-07,W.P. Kuala Lumpur,83,12,71,2013
2013-08-08,W.P. Kuala Lumpur,0,0,0,2013
2013-08-09,W.P. Kuala Lumpur,0,0,0,2013
2013-08-10,W.P. Kuala Lumpur,312,77,235,2013
2013-08-11,W.P. Kuala Lumpur,530,143,387,2013
2013-08-12,W.P. Kuala Lumpur,147,25,122,2013
2013-08-13,W.P. Kuala Lumpur,282,84,198,2013
2013-08-14,W.P. Kuala Lumpur,310,78,232,2013
2013-08-15,W.P. Kuala Lumpur,229,54,175,2013
2013-08-16,W.P. Kuala Lumpur,231,41,190,2013
2013-08-17,W.P. Kuala Lumpur,312,103,209,2013
2013-08-18,W.P. Kuala Lumpur,904,232,672,2013
2013-08-19,W.P. Kuala Lumpur,189,71,118,2013
2013-08-20,W.P. Kuala Lumpur,719,167,552,2013
2013-08-21,W.P. Kuala Lumpur,764,192,572,2013
2013-08-22,W.P. Kuala Lumpur,340,98,242,2013
2013-08-23,W.P. Kuala Lumpur,481,179,302,2013
2013-08-24,W.P. Kuala Lumpur,507,196,311,2013
2013-08-25,W.P. Kuala Lumpur,704,187,517,2013
2013-08-26,W.P. Kuala Lumpur,219,52,167,2013
2013-08-27,W.P. Kuala Lumpur,534,198,336,2013
2013-08-28,W.P. Kuala Lumpur,508,196,312,2013
2013-08-29,W.P. Kuala Lumpur,754,231,523,2013
2013-08-30,W.P. Kuala Lumpur,516,126,390,2013
2013-08-31,W.P. Kuala Lumpur,573,170,403,2013
2013-09-01,W.P. Kuala Lumpur,581,181,400,2013
2013-09-02,W.P. Kuala Lumpur,283,76,207,2013
2013-09-03,W.P. Kuala Lumpur,468,161,307,2013
2013-09-04,W.P. Kuala Lumpur,591,201,390,2013
2013-09-05,W.P. Kuala Lumpur,384,155,229,2013
2013-09-06,W.P. Kuala Lumpur,278,83,195,2013
2013-09-07,W.P. Kuala Lumpur,479,116,363,2013
2013-09-08,W.P. Kuala Lumpur,781,190,591,2013
2013-09-09,W.P. Kuala Lumpur,204,78,126,2013
2013-09-10,W.P. Kuala Lumpur,571,231,340,2013
2013-09-11,W.P. Kuala Lumpur,592,218,374,2013
2013-09-12,W.P. Kuala Lumpur,597,245,352,2013
2013-09-13,W.P. Kuala Lumpur,480,120,360,2013
2013-09-14,W.P. Kuala Lumpur,405,98,307,2013
2013-09-15,W.P. Kuala Lumpur,405,134,271,2013
2013-09-16,W.P. Kuala Lumpur,299,95,204,2013
2013-09-17,W.P. Kuala Lumpur,330,85,245,2013
2013-09-18,W.P. Kuala Lumpur,565,275,290,2013
2013-09-19,W.P. Kuala Lumpur,412,98,314,2013
2013-09-20,W.P. Kuala Lumpur,392,114,278,2013
2013-09-21,W.P. Kuala Lumpur,533,188,345,2013
2013-09-22,W.P. Kuala Lumpur,773,214,559,2013
2013-09-23,W.P. Kuala Lumpur,412,105,307,2013
2013-09-24,W.P. Kuala Lumpur,847,223,624,2013
2013-09-25,W.P. Kuala Lumpur,582,219,363,2013
2013-09-26,W.P. Kuala Lumpur,365,92,273,2013
2013-09-27,W.P. Kuala Lumpur,272,83,189,2013
2013-09-28,W.P. Kuala Lumpur,508,150,358,2013
2013-09-29,W.P. Kuala Lumpur,848,225,623,2013
2013-09-30,W.P. Kuala Lumpur,209,103,106,2013
2013-10-01,W.P. Kuala Lumpur,629,223,406,2013
2013-10-02,W.P. Kuala Lumpur,429,126,303,2013
2013-10-03,W.P. Kuala Lumpur,501,136,365,2013
2013-10-04,W.P. Kuala Lumpur,182,53,129,2013
2013-10-05,W.P. Kuala Lumpur,589,177,412,2013
2013-10-06,W.P. Kuala Lumpur,356,55,301,2013
2013-10-07,W.P. Kuala Lumpur,266,39,227,2013
2013-10-08,W.P. Kuala Lumpur,327,104,223,2013
2013-10-09,W.P. Kuala Lumpur,581,152,429,2013
2013-10-10,W.P. Kuala Lumpur,528,160,368,2013
2013-10-11,W.P. Kuala Lumpur,521,176,345,2013
2013-10-12,W.P. Kuala Lumpur,446,219,227,2013
2013-10-13,W.P. Kuala Lumpur,315,82,233,2013
2013-10-14,W.P. Kuala Lumpur,179,36,143,2013
2013-10-15,W.P. Kuala Lumpur,73,3,70,2013
2013-10-16,W.P. Kuala Lumpur,70,9,61,2013
2013-10-17,W.P. Kuala Lumpur,466,140,326,2013
2013-10-18,W.P. Kuala Lumpur,120,35,85,2013
2013-10-19,W.P. Kuala Lumpur,612,198,414,2013
2013-10-20,W.P. Kuala Lumpur,720,137,583,2013
2013-10-21,W.P. Kuala Lumpur,552,197,355,2013
2013-10-22,W.P. Kuala Lumpur,549,221,328,2013
2013-10-23,W.P. Kuala Lumpur,640,281,359,2013
2013-10-24,W.P. Kuala Lumpur,631,282,349,2013
2013-10-25,W.P. Kuala Lumpur,599,212,387,2013
2013-10-26,W.P. Kuala Lumpur,476,157,319,2013
2013-10-27,W.P. Kuala Lumpur,748,213,535,2013
2013-10-28,W.P. Kuala Lumpur,477,129,348,2013
2013-10-29,W.P. Kuala Lumpur,463,142,321,2013
2013-10-30,W.P. Kuala Lumpur,448,221,227,2013
2013-10-31,W.P. Kuala Lumpur,489,132,357,2013
2013-11-01,W.P. Kuala Lumpur,156,31,125,2013
2013-11-02,W.P. Kuala Lumpur,362,128,234,2013
2013-11-03,W.P. Kuala Lumpur,565,144,421,2013
2013-11-04,W.P. Kuala Lumpur,90,8,82,2013
2013-11-05,W.P. Kuala Lumpur,164,39,125,2013
2013-11-06,W.P. Kuala Lumpur,231,57,174,2013
2013-11-07,W.P. Kuala Lumpur,582,161,421,2013
2013-11-08,W.P. Kuala Lumpur,384,144,240,2013
2013-11-09,W.P. Kuala Lumpur,429,116,313,2013
2013-11-10,W.P. Kuala Lumpur,745,175,570,2013
2013-11-11,W.P. Kuala Lumpur,298,72,226,2013
2013-11-12,W.P. Kuala Lumpur,544,168,376,2013
2013-11-13,W.P. Kuala Lumpur,651,172,479,2013
2013-11-14,W.P. Kuala Lumpur,700,179,521,2013
2013-11-15,W.P. Kuala Lumpur,613,157,456,2013
2013-11-16,W.P. Kuala Lumpur,290,63,227,2013
2013-11-17,W.P. Kuala Lumpur,350,93,257,2013
2013-11-18,W.P. Kuala Lumpur,118,13,105,2013
2013-11-19,W.P. Kuala Lumpur,187,63,124,2013
2013-11-20,W.P. Kuala Lumpur,616,179,437,2013
2013-11-21,W.P. Kuala Lumpur,488,119,369,2013
2013-11-22,W.P. Kuala Lumpur,246,81,165,2013
2013-11-23,W.P. Kuala Lumpur,512,143,369,2013
2013-11-24,W.P. Kuala Lumpur,725,175,550,2013
2013-11-25,W.P. Kuala Lumpur,300,92,208,2013
2013-11-26,W.P. Kuala Lumpur,493,133,360,2013
2013-11-27,W.P. Kuala Lumpur,513,150,363,2013
2013-11-28,W.P. Kuala Lumpur,514,140,374,2013
2013-11-29,W.P. Kuala Lumpur,529,208,321,2013
2013-11-30,W.P. Kuala Lumpur,323,107,216,2013
2013-12-01,W.P. Kuala Lumpur,1318,269,1049,2013
2013-12-02,W.P. Kuala Lumpur,168,34,134,2013
2013-12-03,W.P. Kuala Lumpur,376,121,255,2013
2013-12-04,W.P. Kuala Lumpur,1018,362,656,2013
2013-12-05,W.P. Kuala Lumpur,691,173,518,2013
2013-12-06,W.P. Kuala Lumpur,411,148,263,2013
2013-12-07,W.P. Kuala Lumpur,620,177,443,2013
2013-12-08,W.P. Kuala Lumpur,524,159,365,2013
2013-12-09,W.P. Kuala Lumpur,221,66,155,2013
2013-12-10,W.P. Kuala Lumpur,590,225,365,2013
2013-12-11,W.P. Kuala Lumpur,540,175,365,2013
2013-12-12,W.P. Kuala Lumpur,664,240,424,2013
2013-12-13,W.P. Kuala Lumpur,342,121,221,2013
2013-12-14,W.P. Kuala Lumpur,460,149,311,2013
2013-12-15,W.P. Kuala Lumpur,704,142,562,2013
2013-12-16,W.P. Kuala Lumpur,132,19,113,2013
2013-12-17,W.P. Kuala Lumpur,418,128,290,2013
2013-12-18,W.P. Kuala Lumpur,427,140,287,2013
2013-12-19,W.P. Kuala Lumpur,339,100,239,2013
2013-12-20,W.P. Kuala Lumpur,266,77,189,2013
2013-12-21,W.P. Kuala Lumpur,355,113,242,2013
2013-12-22,W.P. Kuala Lumpur,630,186,444,2013
2013-12-23,W.P. Kuala Lumpur,193,69,124,2013
2013-12-24,W.P. Kuala Lumpur,268,56,212,2013
2013-12-25,W.P. Kuala Lumpur,354,85,269,2013
2013-12-26,W.P. Kuala Lumpur,106,6,100,2013
2013-12-27,W.P. Kuala Lumpur,354,67,287,2013
2013-12-28,W.P. Kuala Lumpur,558,114,444,2013
2013-12-29,W.P. Kuala Lumpur,507,148,359,2013
2013-12-30,W.P. Kuala Lumpur,173,35,138,2013
2013-12-31,W.P. Kuala Lumpur,206,34,172,2013
2014-01-01,W.P. Kuala Lumpur,498,114,384,2014
2014-01-02,W.P. Kuala Lumpur,187,47,140,2014
2014-01-03,W.P. Kuala Lumpur,288,93,195,2014
2014-01-04,W.P. Kuala Lumpur,444,156,288,2014
2014-01-05,W.P. Kuala Lumpur,371,92,279,2014
2014-01-06,W.P. Kuala Lumpur,210,35,175,2014
2014-01-07,W.P. Kuala Lumpur,500,107,393,2014
2014-01-08,W.P. Kuala Lumpur,346,97,249,2014
2014-01-09,W.P. Kuala Lumpur,536,193,343,2014
2014-01-10,W.P. Kuala Lumpur,151,29,122,2014
2014-01-11,W.P. Kuala Lumpur,486,132,354,2014
2014-01-12,W.P. Kuala Lumpur,486,120,366,2014
2014-01-13,W.P. Kuala Lumpur,116,20,96,2014
2014-01-14,W.P. Kuala Lumpur,339,99,240,2014
2014-01-15,W.P. Kuala Lumpur,626,259,367,2014
2014-01-16,W.P. Kuala Lumpur,558,170,388,2014
2014-01-17,W.P. Kuala Lumpur,1736,589,1147,2014
2014-01-18,W.P. Kuala Lumpur,568,209,359,2014
2014-01-19,W.P. Kuala Lumpur,331,98,233,2014
2014-01-20,W.P. Kuala Lumpur,110,20,90,2014
2014-01-21,W.P. Kuala Lumpur,546,136,410,2014
2014-01-22,W.P. Kuala Lumpur,939,302,637,2014
2014-01-23,W.P. Kuala Lumpur,611,234,377,2014
2014-01-24,W.P. Kuala Lumpur,266,64,202,2014
2014-01-25,W.P. Kuala Lumpur,574,167,407,2014
2014-01-26,W.P. Kuala Lumpur,564,183,381,2014
2014-01-27,W.P. Kuala Lumpur,317,93,224,2014
2014-01-28,W.P. Kuala Lumpur,490,222,268,2014
2014-01-29,W.P. Kuala Lumpur,448,124,324,2014
2014-01-30,W.P. Kuala Lumpur,457,117,340,2014
2014-01-31,W.P. Kuala Lumpur,175,59,116,2014
2014-02-01,W.P. Kuala Lumpur,268,78,190,2014
2014-02-02,W.P. Kuala Lumpur,320,99,221,2014
2014-02-03,W.P. Kuala Lumpur,328,95,233,2014
2014-02-04,W.P. Kuala Lumpur,238,52,186,2014
2014-02-05,W.P. Kuala Lumpur,364,85,279,2014
2014-02-06,W.P. Kuala Lumpur,356,101,255,2014
2014-02-07,W.P. Kuala Lumpur,387,112,275,2014
2014-02-08,W.P. Kuala Lumpur,375,76,299,2014
2014-02-09,W.P. Kuala Lumpur,707,247,460,2014
2014-02-10,W.P. Kuala Lumpur,253,60,193,2014
2014-02-11,W.P. Kuala Lumpur,483,174,309,2014
2014-02-12,W.P. Kuala Lumpur,421,134,287,2014
2014-02-13,W.P. Kuala Lumpur,791,274,517,2014
2014-02-14,W.P. Kuala Lumpur,235,70,165,2014
2014-02-15,W.P. Kuala Lumpur,306,73,233,2014
2014-02-16,W.P. Kuala Lumpur,554,189,365,2014
2014-02-17,W.P. Kuala Lumpur,219,59,160,2014
2014-02-18,W.P. Kuala Lumpur,713,266,447,2014
2014-02-19,W.P. Kuala Lumpur,871,312,559,2014
2014-02-20,W.P. Kuala Lumpur,759,293,466,2014
2014-02-21,W.P. Kuala Lumpur,274,97,177,2014
2014-02-22,W.P. Kuala Lumpur,559,243,316,2014
2014-02-23,W.P. Kuala Lumpur,745,222,523,2014
2014-02-24,W.P. Kuala Lumpur,323,128,195,2014
2014-02-25,W.P. Kuala Lumpur,707,254,453,2014
2014-02-26,W.P. Kuala Lumpur,895,300,595,2014
2014-02-27,W.P. Kuala Lumpur,462,167,295,2014
2014-02-28,W.P. Kuala Lumpur,252,77,175,2014
2014-03-01,W.P. Kuala Lumpur,155,35,120,2014
2014-03-02,W.P. Kuala Lumpur,1770,1417,353,2014
2014-03-03,W.P. Kuala Lumpur,262,54,208,2014
2014-03-04,W.P. Kuala Lumpur,329,59,270,2014
2014-03-05,W.P. Kuala Lumpur,759,235,524,2014
2014-03-06,W.P. Kuala Lumpur,473,146,327,2014
2014-03-07,W.P. Kuala Lumpur,842,246,596,2014
2014-03-08,W.P. Kuala Lumpur,684,402,282,2014
2014-03-09,W.P. Kuala Lumpur,642,176,466,2014
2014-03-10,W.P. Kuala Lumpur,159,26,133,2014
2014-03-11,W.P. Kuala Lumpur,278,82,196,2014
2014-03-12,W.P. Kuala Lumpur,736,221,515,2014
2014-03-13,W.P. Kuala Lumpur,635,183,452,2014
2014-03-14,W.P. Kuala Lumpur,346,87,259,2014
2014-03-15,W.P. Kuala Lumpur,545,144,401,2014
2014-03-16,W.P. Kuala Lumpur,406,74,332,2014
2014-03-17,W.P. Kuala Lumpur,311,129,182,2014
2014-03-18,W.P. Kuala Lumpur,319,144,175,2014
2014-03-19,W.P. Kuala Lumpur,576,192,384,2014
2014-03-20,W.P. Kuala Lumpur,307,99,208,2014
2014-03-21,W.P. Kuala Lumpur,309,73,236,2014
2014-03-22,W.P. Kuala Lumpur,470,102,368,2014
2014-03-23,W.P. Kuala Lumpur,535,125,410,2014
2014-03-24,W.P. Kuala Lumpur,211,74,137,2014
2014-03-25,W.P. Kuala Lumpur,437,166,271,2014
2014-03-26,W.P. Kuala Lumpur,331,171,160,2014
2014-03-27,W.P. Kuala Lumpur,614,216,398,2014
2014-03-28,W.P. Kuala Lumpur,345,118,227,2014
2014-03-29,W.P. Kuala Lumpur,469,135,334,2014
2014-03-30,W.P. Kuala Lumpur,550,158,392,2014
2014-03-31,W.P. Kuala Lumpur,155,21,134,2014
2014-04-01,W.P. Kuala Lumpur,456,174,282,2014
2014-04-02,W.P. Kuala Lumpur,617,261,356,2014
2014-04-03,W.P. Kuala Lumpur,832,267,565,2014
2014-04-04,W.P. Kuala Lumpur,377,87,290,2014
2014-04-05,W.P. Kuala Lumpur,348,79,269,2014
2014-04-06,W.P. Kuala Lumpur,775,196,579,2014
2014-04-07,W.P. Kuala Lumpur,412,135,277,2014
2014-04-08,W.P. Kuala Lumpur,516,168,348,2014
2014-04-09,W.P. Kuala Lumpur,398,135,263,2014
2014-04-10,W.P. Kuala Lumpur,531,171,360,2014
2014-04-11,W.P. Kuala Lumpur,341,88,253,2014
2014-04-12,W.P. Kuala Lumpur,386,109,277,2014
2014-04-13,W.P. Kuala Lumpur,864,216,648,2014
2014-04-14,W.P. Kuala Lumpur,338,107,231,2014
2014-04-15,W.P. Kuala Lumpur,306,112,194,2014
2014-04-16,W.P. Kuala Lumpur,554,180,374,2014
2014-04-17,W.P. Kuala Lumpur,735,211,524,2014
2014-04-18,W.P. Kuala Lumpur,492,215,277,2014
2014-04-19,W.P. Kuala Lumpur,768,267,501,2014
2014-04-20,W.P. Kuala Lumpur,1466,372,1094,2014
2014-04-21,W.P. Kuala Lumpur,175,62,113,2014
2014-04-22,W.P. Kuala Lumpur,817,301,516,2014
2014-04-23,W.P. Kuala Lumpur,316,81,235,2014
2014-04-24,W.P. Kuala Lumpur,511,124,387,2014
2014-04-25,W.P. Kuala Lumpur,428,96,332,2014
2014-04-26,W.P. Kuala Lumpur,510,133,377,2014
2014-04-27,W.P. Kuala Lumpur,804,182,622,2014
2014-04-28,W.P. Kuala Lumpur,472,180,292,2014
2014-04-29,W.P. Kuala Lumpur,754,261,493,2014
2014-04-30,W.P. Kuala Lumpur,79,9,70,2014
2014-05-01,W.P. Kuala Lumpur,1999,435,1564,2014
2014-05-02,W.P. Kuala Lumpur,83,13,70,2014
2014-05-03,W.P. Kuala Lumpur,336,74,262,2014
2014-05-04,W.P. Kuala Lumpur,513,138,375,2014
2014-05-05,W.P. Kuala Lumpur,232,122,110,2014
2014-05-06,W.P. Kuala Lumpur,368,125,243,2014
2014-05-07,W.P. Kuala Lumpur,435,133,302,2014
2014-05-08,W.P. Kuala Lumpur,677,245,432,2014
2014-05-09,W.P. Kuala Lumpur,128,16,112,2014
2014-05-10,W.P. Kuala Lumpur,314,81,233,2014
2014-05-11,W.P. Kuala Lumpur,580,171,409,2014
2014-05-12,W.P. Kuala Lumpur,236,37,199,2014
2014-05-13,W.P. Kuala Lumpur,1553,361,1192,2014
2014-05-14,W.P. Kuala Lumpur,307,95,212,2014
2014-05-15,W.P. Kuala Lumpur,766,253,513,2014
2014-05-16,W.P. Kuala Lumpur,319,88,231,2014
2014-05-17,W.P. Kuala Lumpur,628,291,337,2014
2014-05-18,W.P. Kuala Lumpur,1533,551,982,2014
2014-05-19,W.P. Kuala Lumpur,248,66,182,2014
2014-05-20,W.P. Kuala Lumpur,511,160,351,2014
2014-05-21,W.P. Kuala Lumpur,569,159,410,2014
2014-05-22,W.P. Kuala Lumpur,569,163,406,2014
2014-05-23,W.P. Kuala Lumpur,266,70,196,2014
2014-05-24,W.P. Kuala Lumpur,976,605,371,2014
2014-05-25,W.P. Kuala Lumpur,863,272,591,2014
2014-05-26,W.P. Kuala Lumpur,255,60,195,2014
2014-05-27,W.P. Kuala Lumpur,571,220,351,2014
2014-05-28,W.P. Kuala Lumpur,386,145,241,2014
2014-05-29,W.P. Kuala Lumpur,416,113,303,2014
2014-05-30,W.P. Kuala Lumpur,169,41,128,2014
2014-05-31,W.P. Kuala Lumpur,365,114,251,2014
2014-06-01,W.P. Kuala Lumpur,802,245,557,2014
2014-06-02,W.P. Kuala Lumpur,101,8,93,2014
2014-06-03,W.P. Kuala Lumpur,290,69,221,2014
2014-06-04,W.P. Kuala Lumpur,494,133,361,2014
2014-06-05,W.P. Kuala Lumpur,601,156,445,2014
2014-06-06,W.P. Kuala Lumpur,169,28,141,2014
2014-06-07,W.P. Kuala Lumpur,453,197,256,2014
2014-06-08,W.P. Kuala Lumpur,648,144,504,2014
2014-06-09,W.P. Kuala Lumpur,212,92,120,2014
2014-06-10,W.P. Kuala Lumpur,465,129,336,2014
2014-06-11,W.P. Kuala Lumpur,584,183,401,2014
2014-06-12,W.P. Kuala Lumpur,812,270,542,2014
2014-06-13,W.P. Kuala Lumpur,544,179,365,2014
2014-06-14,W.P. Kuala Lumpur,416,70,346,2014
2014-06-15,W.P. Kuala Lumpur,713,154,559,2014
2014-06-16,W.P. Kuala Lumpur,460,112,348,2014
2014-06-17,W.P. Kuala Lumpur,595,196,399,2014
2014-06-18,W.P. Kuala Lumpur,573,223,350,2014
2014-06-19,W.P. Kuala Lumpur,742,255,487,2014
2014-06-20,W.P. Kuala Lumpur,440,135,305,2014
2014-06-21,W.P. Kuala Lumpur,874,213,661,2014
2014-06-22,W.P. Kuala Lumpur,1006,289,717,2014
2014-06-23,W.P. Kuala Lumpur,548,124,424,2014
2014-06-24,W.P. Kuala Lumpur,614,229,385,2014
2014-06-25,W.P. Kuala Lumpur,523,148,375,2014
2014-06-26,W.P. Kuala Lumpur,641,167,474,2014
2014-06-27,W.P. Kuala Lumpur,377,100,277,2014
2014-06-28,W.P. Kuala Lumpur,1042,336,706,2014
2014-06-29,W.P. Kuala Lumpur,516,123,393,2014
2014-06-30,W.P. Kuala Lumpur,124,46,78,2014
2014-07-01,W.P. Kuala Lumpur,167,56,111,2014
2014-07-02,W.P. Kuala Lumpur,84,18,66,2014
2014-07-03,W.P. Kuala Lumpur,96,31,65,2014
2014-07-04,W.P. Kuala Lumpur,44,3,41,2014
2014-07-05,W.P. Kuala Lumpur,364,112,252,2014
2014-07-06,W.P. Kuala Lumpur,903,268,635,2014
2014-07-07,W.P. Kuala Lumpur,91,13,78,2014
2014-07-08,W.P. Kuala Lumpur,84,6,78,2014
2014-07-09,W.P. Kuala Lumpur,159,83,76,2014
2014-07-10,W.P. Kuala Lumpur,177,91,86,2014
2014-07-11,W.P. Kuala Lumpur,171,71,100,2014
2014-07-12,W.P. Kuala Lumpur,251,57,194,2014
2014-07-13,W.P. Kuala Lumpur,923,234,689,2014
2014-07-14,W.P. Kuala Lumpur,47,1,46,2014
2014-07-15,W.P. Kuala Lumpur,71,2,69,2014
2014-07-16,W.P. Kuala Lumpur,247,99,148,2014
2014-07-17,W.P. Kuala Lumpur,119,29,90,2014
2014-07-18,W.P. Kuala Lumpur,103,20,83,2014
2014-07-19,W.P. Kuala Lumpur,366,106,260,2014
2014-07-20,W.P. Kuala Lumpur,1122,206,916,2014
2014-07-21,W.P. Kuala Lumpur,168,43,125,2014
2014-07-22,W.P. Kuala Lumpur,354,104,250,2014
2014-07-23,W.P. Kuala Lumpur,490,167,323,2014
2014-07-24,W.P. Kuala Lumpur,483,187,296,2014
2014-07-25,W.P. Kuala Lumpur,409,118,291,2014
2014-07-26,W.P. Kuala Lumpur,223,34,189,2014
2014-07-27,W.P. Kuala Lumpur,161,29,132,2014
2014-07-28,W.P. Kuala Lumpur,0,0,0,2014
2014-07-29,W.P. Kuala Lumpur,0,0,0,2014
2014-07-30,W.P. Kuala Lumpur,149,17,132,2014
2014-07-31,W.P. Kuala Lumpur,176,25,151,2014
2014-08-01,W.P. Kuala Lumpur,206,40,166,2014
2014-08-02,W.P. Kuala Lumpur,533,137,396,2014
2014-08-03,W.P. Kuala Lumpur,687,209,478,2014
2014-08-04,W.P. Kuala Lumpur,175,35,140,2014
2014-08-05,W.P. Kuala Lumpur,610,185,425,2014
2014-08-06,W.P. Kuala Lumpur,635,183,452,2014
2014-08-07,W.P. Kuala Lumpur,454,144,310,2014
2014-08-08,W.P. Kuala Lumpur,498,128,370,2014
2014-08-09,W.P. Kuala Lumpur,648,173,475,2014
2014-08-10,W.P. Kuala Lumpur,1292,351,941,2014
2014-08-11,W.P. Kuala Lumpur,85,11,74,2014
2014-08-12,W.P. Kuala Lumpur,545,204,341,2014
2014-08-13,W.P. Kuala Lumpur,628,268,360,2014
2014-08-14,W.P. Kuala Lumpur,748,336,412,2014
2014-08-15,W.P. Kuala Lumpur,628,219,409,2014
2014-08-16,W.P. Kuala Lumpur,458,128,330,2014
2014-08-17,W.P. Kuala Lumpur,1316,315,1001,2014
2014-08-18,W.P. Kuala Lumpur,85,6,79,2014
2014-08-19,W.P. Kuala Lumpur,510,168,342,2014
2014-08-20,W.P. Kuala Lumpur,931,335,596,2014
2014-08-21,W.P. Kuala Lumpur,875,321,554,2014
2014-08-22,W.P. Kuala Lumpur,327,101,226,2014
2014-08-23,W.P. Kuala Lumpur,712,277,435,2014
2014-08-24,W.P. Kuala Lumpur,808,200,608,2014
2014-08-25,W.P. Kuala Lumpur,249,85,164,2014
2014-08-26,W.P. Kuala Lumpur,476,247,229,2014
2014-08-27,W.P. Kuala Lumpur,535,255,280,2014
2014-08-28,W.P. Kuala Lumpur,325,70,255,2014
2014-08-29,W.P. Kuala Lumpur,328,90,238,2014
2014-08-30,W.P. Kuala Lumpur,646,198,448,2014
2014-08-31,W.P. Kuala Lumpur,668,190,478,2014
2014-09-01,W.P. Kuala Lumpur,387,125,262,2014
2014-09-02,W.P. Kuala Lumpur,129,20,109,2014
2014-09-03,W.P. Kuala Lumpur,303,99,204,2014
2014-09-04,W.P. Kuala Lumpur,202,39,163,2014
2014-09-05,W.P. Kuala Lumpur,325,63,262,2014
2014-09-06,W.P. Kuala Lumpur,544,153,391,2014
2014-09-07,W.P. Kuala Lumpur,722,195,527,2014
2014-09-08,W.P. Kuala Lumpur,304,128,176,2014
2014-09-09,W.P. Kuala Lumpur,497,186,311,2014
2014-09-10,W.P. Kuala Lumpur,609,176,433,2014
2014-09-11,W.P. Kuala Lumpur,471,191,280,2014
2014-09-12,W.P. Kuala Lumpur,168,28,140,2014
2014-09-13,W.P. Kuala Lumpur,414,87,327,2014
2014-09-14,W.P. Kuala Lumpur,546,130,416,2014
2014-09-15,W.P. Kuala Lumpur,135,24,111,2014
2014-09-16,W.P. Kuala Lumpur,305,91,214,2014
2014-09-17,W.P. Kuala Lumpur,536,141,395,2014
2014-09-18,W.P. Kuala Lumpur,745,286,459,2014
2014-09-19,W.P. Kuala Lumpur,332,87,245,2014
2014-09-20,W.P. Kuala Lumpur,586,158,428,2014
2014-09-21,W.P. Kuala Lumpur,820,226,594,2014
2014-09-22,W.P. Kuala Lumpur,506,133,373,2014
2014-09-23,W.P. Kuala Lumpur,706,223,483,2014
2014-09-24,W.P. Kuala Lumpur,1152,340,812,2014
2014-09-25,W.P. Kuala Lumpur,807,281,526,2014
2014-09-26,W.P. Kuala Lumpur,503,158,345,2014
2014-09-27,W.P. Kuala Lumpur,1138,382,756,2014
2014-09-28,W.P. Kuala Lumpur,1053,254,799,2014
2014-09-29,W.P. Kuala Lumpur,500,161,339,2014
2014-09-30,W.P. Kuala Lumpur,682,269,413,2014
2014-10-01,W.P. Kuala Lumpur,580,194,386,2014
2014-10-02,W.P. Kuala Lumpur,408,152,256,2014
2014-10-03,W.P. Kuala Lumpur,166,24,142,2014
2014-10-04,W.P. Kuala Lumpur,217,26,191,2014
2014-10-05,W.P. Kuala Lumpur,179,52,127,2014
2014-10-06,W.P. Kuala Lumpur,58,5,53,2014
2014-10-07,W.P. Kuala Lumpur,458,152,306,2014
2014-10-08,W.P. Kuala Lumpur,243,72,171,2014
2014-10-09,W.P. Kuala Lumpur,260,73,187,2014
2014-10-10,W.P. Kuala Lumpur,560,193,367,2014
2014-10-11,W.P. Kuala Lumpur,577,171,406,2014
2014-10-12,W.P. Kuala Lumpur,611,181,430,2014
2014-10-13,W.P. Kuala Lumpur,549,167,382,2014
2014-10-14,W.P. Kuala Lumpur,654,210,444,2014
2014-10-15,W.P. Kuala Lumpur,876,308,568,2014
2014-10-16,W.P. Kuala Lumpur,845,290,555,2014
2014-10-17,W.P. Kuala Lumpur,700,231,469,2014
2014-10-18,W.P. Kuala Lumpur,384,157,227,2014
2014-10-19,W.P. Kuala Lumpur,1471,591,880,2014
2014-10-20,W.P. Kuala Lumpur,203,60,143,2014
2014-10-21,W.P. Kuala Lumpur,184,47,137,2014
2014-10-22,W.P. Kuala Lumpur,104,18,86,2014
2014-10-23,W.P. Kuala Lumpur,247,63,184,2014
2014-10-24,W.P. Kuala Lumpur,224,68,156,2014
2014-10-25,W.P. Kuala Lumpur,265,71,194,2014
2014-10-26,W.P. Kuala Lumpur,654,175,479,2014
2014-10-27,W.P. Kuala Lumpur,263,86,177,2014
2014-10-28,W.P. Kuala Lumpur,561,145,416,2014
2014-10-29,W.P. Kuala Lumpur,743,317,426,2014
2014-10-30,W.P. Kuala Lumpur,691,221,470,2014
2014-10-31,W.P. Kuala Lumpur,370,84,286,2014
2014-11-01,W.P. Kuala Lumpur,387,185,202,2014
2014-11-02,W.P. Kuala Lumpur,554,136,418,2014
2014-11-03,W.P. Kuala Lumpur,226,62,164,2014
2014-11-04,W.P. Kuala Lumpur,515,161,354,2014
2014-11-05,W.P. Kuala Lumpur,685,158,527,2014
2014-11-06,W.P. Kuala Lumpur,422,168,254,2014
2014-11-07,W.P. Kuala Lumpur,145,26,119,2014
2014-11-08,W.P. Kuala Lumpur,284,54,230,2014
2014-11-09,W.P. Kuala Lumpur,469,121,348,2014
2014-11-10,W.P. Kuala Lumpur,247,88,159,2014
2014-11-11,W.P. Kuala Lumpur,547,143,404,2014
2014-11-12,W.P. Kuala Lumpur,594,200,394,2014
2014-11-13,W.P. Kuala Lumpur,522,123,399,2014
2014-11-14,W.P. Kuala Lumpur,271,80,191,2014
2014-11-15,W.P. Kuala Lumpur,477,184,293,2014
2014-11-16,W.P. Kuala Lumpur,453,116,337,2014
2014-11-17,W.P. Kuala Lumpur,376,149,227,2014
2014-11-18,W.P. Kuala Lumpur,506,145,361,2014
2014-11-19,W.P. Kuala Lumpur,752,252,500,2014
2014-11-20,W.P. Kuala Lumpur,719,206,513,2014
2014-11-21,W.P. Kuala Lumpur,324,93,231,2014
2014-11-22,W.P. Kuala Lumpur,351,83,268,2014
2014-11-23,W.P. Kuala Lumpur,744,175,569,2014
2014-11-24,W.P. Kuala Lumpur,264,71,193,2014
2014-11-25,W.P. Kuala Lumpur,337,95,242,2014
2014-11-26,W.P. Kuala Lumpur,391,126,265,2014
2014-11-27,W.P. Kuala Lumpur,440,91,349,2014
2014-11-28,W.P. Kuala Lumpur,499,116,383,2014
2014-11-29,W.P. Kuala Lumpur,553,170,383,2014
2014-11-30,W.P. Kuala Lumpur,698,106,592,2014
2014-12-01,W.P. Kuala Lumpur,309,97,212,2014
2014-12-02,W.P. Kuala Lumpur,359,135,224,2014
2014-12-03,W.P. Kuala Lumpur,538,228,310,2014
2014-12-04,W.P. Kuala Lumpur,568,200,368,2014
2014-12-05,W.P. Kuala Lumpur,360,136,224,2014
2014-12-06,W.P. Kuala Lumpur,601,229,372,2014
2014-12-07,W.P. Kuala Lumpur,833,189,644,2014
2014-12-08,W.P. Kuala Lumpur,257,46,211,2014
2014-12-09,W.P. Kuala Lumpur,390,118,272,2014
2014-12-10,W.P. Kuala Lumpur,536,161,375,2014
2014-12-11,W.P. Kuala Lumpur,328,91,237,2014
2014-12-12,W.P. Kuala Lumpur,146,23,123,2014
2014-12-13,W.P. Kuala Lumpur,320,75,245,2014
2014-12-14,W.P. Kuala Lumpur,749,171,578,2014
2014-12-15,W.P. Kuala Lumpur,275,68,207,2014
2014-12-16,W.P. Kuala Lumpur,419,128,291,2014
2014-12-17,W.P. Kuala Lumpur,467,203,264,2014
2014-12-18,W.P. Kuala Lumpur,405,125,280,2014
2014-12-19,W.P. Kuala Lumpur,554,121,433,2014
2014-12-20,W.P. Kuala Lumpur,587,305,282,2014
2014-12-21,W.P. Kuala Lumpur,629,114,515,2014
2014-12-22,W.P. Kuala Lumpur,156,32,124,2014
2014-12-23,W.P. Kuala Lumpur,227,72,155,2014
2014-12-24,W.P. Kuala Lumpur,165,54,111,2014
2014-12-25,W.P. Kuala Lumpur,448,85,363,2014
2014-12-26,W.P. Kuala Lumpur,183,25,158,2014
2014-12-27,W.P. Kuala Lumpur,368,58,310,2014
2014-12-28,W.P. Kuala Lumpur,731,180,551,2014
2014-12-29,W.P. Kuala Lumpur,160,28,132,2014
2014-12-30,W.P. Kuala Lumpur,421,114,307,2014
2014-12-31,W.P. Kuala Lumpur,437,105,332,2014
2015-01-01,W.P. Kuala Lumpur,673,175,498,2015
2015-01-02,W.P. Kuala Lumpur,404,81,323,2015
2015-01-03,W.P. Kuala Lumpur,791,184,607,2015
2015-01-04,W.P. Kuala Lumpur,810,215,595,2015
2015-01-05,W.P. Kuala Lumpur,344,67,277,2015
2015-01-06,W.P. Kuala Lumpur,548,207,341,2015
2015-01-07,W.P. Kuala Lumpur,1408,597,811,2015
2015-01-08,W.P. Kuala Lumpur,660,194,466,2015
2015-01-09,W.P. Kuala Lumpur,575,178,397,2015
2015-01-10,W.P. Kuala Lumpur,914,286,628,2015
2015-01-11,W.P. Kuala Lumpur,1073,328,745,2015
2015-01-12,W.P. Kuala Lumpur,260,55,205,2015
2015-01-13,W.P. Kuala Lumpur,469,117,352,2015
2015-01-14,W.P. Kuala Lumpur,731,248,483,2015
2015-01-15,W.P. Kuala Lumpur,577,142,435,2015
2015-01-16,W.P. Kuala Lumpur,347,118,229,2015
2015-01-17,W.P. Kuala Lumpur,591,161,430,2015
2015-01-18,W.P. Kuala Lumpur,545,150,395,2015
2015-01-19,W.P. Kuala Lumpur,416,143,273,2015
2015-01-20,W.P. Kuala Lumpur,496,220,276,2015
2015-01-21,W.P. Kuala Lumpur,565,224,341,2015
2015-01-22,W.P. Kuala Lumpur,387,112,275,2015
2015-01-23,W.P. Kuala Lumpur,226,50,176,2015
2015-01-24,W.P. Kuala Lumpur,635,318,317,2015
2015-01-25,W.P. Kuala Lumpur,543,142,401,2015
2015-01-26,W.P. Kuala Lumpur,294,112,182,2015
2015-01-27,W.P. Kuala Lumpur,370,130,240,2015
2015-01-28,W.P. Kuala Lumpur,684,266,418,2015
2015-01-29,W.P. Kuala Lumpur,450,164,286,2015
2015-01-30,W.P. Kuala Lumpur,201,44,157,2015
2015-01-31,W.P. Kuala Lumpur,501,241,260,2015
2015-02-01,W.P. Kuala Lumpur,220,61,159,2015
2015-02-02,W.P. Kuala Lumpur,436,124,312,2015
2015-02-03,W.P. Kuala Lumpur,1546,467,1079,2015
2015-02-04,W.P. Kuala Lumpur,131,18,113,2015
2015-02-05,W.P. Kuala Lumpur,634,283,351,2015
2015-02-06,W.P. Kuala Lumpur,103,20,83,2015
2015-02-07,W.P. Kuala Lumpur,459,144,315,2015
2015-02-08,W.P. Kuala Lumpur,621,154,467,2015
2015-02-09,W.P. Kuala Lumpur,311,114,197,2015
2015-02-10,W.P. Kuala Lumpur,599,220,379,2015
2015-02-11,W.P. Kuala Lumpur,520,177,343,2015
2015-02-12,W.P. Kuala Lumpur,689,176,513,2015
2015-02-13,W.P. Kuala Lumpur,300,75,225,2015
2015-02-14,W.P. Kuala Lumpur,593,182,411,2015
2015-02-15,W.P. Kuala Lumpur,670,181,489,2015
2015-02-16,W.P. Kuala Lumpur,445,131,314,2015
2015-02-17,W.P. Kuala Lumpur,526,157,369,2015
2015-02-18,W.P. Kuala Lumpur,432,126,306,2015
2015-02-19,W.P. Kuala Lumpur,151,54,97,2015
2015-02-20,W.P. Kuala Lumpur,226,52,174,2015
2015-02-21,W.P. Kuala Lumpur,377,86,291,2015
2015-02-22,W.P. Kuala Lumpur,412,123,289,2015
2015-02-23,W.P. Kuala Lumpur,316,98,218,2015
2015-02-24,W.P. Kuala Lumpur,691,299,392,2015
2015-02-25,W.P. Kuala Lumpur,686,215,471,2015
2015-02-26,W.P. Kuala Lumpur,654,295,359,2015
2015-02-27,W.P. Kuala Lumpur,308,78,230,2015
2015-02-28,W.P. Kuala Lumpur,568,183,385,2015
2015-03-01,W.P. Kuala Lumpur,367,104,263,2015
2015-03-02,W.P. Kuala Lumpur,160,56,104,2015
2015-03-03,W.P. Kuala Lumpur,328,98,230,2015
2015-03-04,W.P. Kuala Lumpur,563,180,383,2015
2015-03-05,W.P. Kuala Lumpur,410,102,308,2015
2015-03-06,W.P. Kuala Lumpur,230,66,164,2015
2015-03-07,W.P. Kuala Lumpur,715,245,470,2015
2015-03-08,W.P. Kuala Lumpur,807,207,600,2015
2015-03-09,W.P. Kuala Lumpur,275,37,238,2015
2015-03-10,W.P. Kuala Lumpur,786,211,575,2015
2015-03-11,W.P. Kuala Lumpur,926,244,682,2015
2015-03-12,W.P. Kuala Lumpur,609,170,439,2015
2015-03-13,W.P. Kuala Lumpur,692,217,475,2015
2015-03-14,W.P. Kuala Lumpur,692,211,481,2015
2015-03-15,W.P. Kuala Lumpur,896,230,666,2015
2015-03-16,W.P. Kuala Lumpur,96,6,90,2015
2015-03-17,W.P. Kuala Lumpur,345,118,227,2015
2015-03-18,W.P. Kuala Lumpur,560,181,379,2015
2015-03-19,W.P. Kuala Lumpur,424,157,267,2015
2015-03-20,W.P. Kuala Lumpur,258,62,196,2015
2015-03-21,W.P. Kuala Lumpur,469,95,374,2015
2015-03-22,W.P. Kuala Lumpur,565,139,426,2015
2015-03-23,W.P. Kuala Lumpur,176,50,126,2015
2015-03-24,W.P. Kuala Lumpur,582,201,381,2015
2015-03-25,W.P. Kuala Lumpur,449,174,275,2015
2015-03-26,W.P. Kuala Lumpur,598,143,455,2015
2015-03-27,W.P. Kuala Lumpur,361,131,230,2015
2015-03-28,W.P. Kuala Lumpur,622,218,404,2015
2015-03-29,W.P. Kuala Lumpur,342,71,271,2015
2015-03-30,W.P. Kuala Lumpur,119,41,78,2015
2015-03-31,W.P. Kuala Lumpur,732,298,434,2015
2015-04-01,W.P. Kuala Lumpur,402,143,259,2015
2015-04-02,W.P. Kuala Lumpur,470,180,290,2015
2015-04-03,W.P. Kuala Lumpur,651,378,273,2015
2015-04-04,W.P. Kuala Lumpur,754,204,550,2015
2015-04-05,W.P. Kuala Lumpur,428,103,325,2015
2015-04-06,W.P. Kuala Lumpur,581,141,440,2015
2015-04-07,W.P. Kuala Lumpur,721,202,519,2015
2015-04-08,W.P. Kuala Lumpur,494,136,358,2015
2015-04-09,W.P. Kuala Lumpur,489,150,339,2015
2015-04-10,W.P. Kuala Lumpur,529,191,338,2015
2015-04-11,W.P. Kuala Lumpur,807,237,570,2015
2015-04-12,W.P. Kuala Lumpur,463,106,357,2015
2015-04-13,W.P. Kuala Lumpur,400,105,295,2015
2015-04-14,W.P. Kuala Lumpur,686,185,501,2015
2015-04-15,W.P. Kuala Lumpur,554,170,384,2015
2015-04-16,W.P. Kuala Lumpur,549,180,369,2015
2015-04-17,W.P. Kuala Lumpur,241,40,201,2015
2015-04-18,W.P. Kuala Lumpur,648,197,451,2015
2015-04-19,W.P. Kuala Lumpur,994,191,803,2015
2015-04-20,W.P. Kuala Lumpur,1200,422,778,2015
2015-04-21,W.P. Kuala Lumpur,717,197,520,2015
2015-04-22,W.P. Kuala Lumpur,555,145,410,2015
2015-04-23,W.P. Kuala Lumpur,602,162,440,2015
2015-04-24,W.P. Kuala Lumpur,304,118,186,2015
2015-04-25,W.P. Kuala Lumpur,772,281,491,2015
2015-04-26,W.P. Kuala Lumpur,864,219,645,2015
2015-04-27,W.P. Kuala Lumpur,163,41,122,2015
2015-04-28,W.P. Kuala Lumpur,556,152,404,2015
2015-04-29,W.P. Kuala Lumpur,346,102,244,2015
2015-04-30,W.P. Kuala Lumpur,449,94,355,2015
2015-05-01,W.P. Kuala Lumpur,1582,245,1337,2015
2015-05-02,W.P. Kuala Lumpur,326,59,267,2015
2015-05-03,W.P. Kuala Lumpur,1077,203,874,2015
2015-05-04,W.P. Kuala Lumpur,102,7,95,2015
2015-05-05,W.P. Kuala Lumpur,141,27,114,2015
2015-05-06,W.P. Kuala Lumpur,761,260,501,2015
2015-05-07,W.P. Kuala Lumpur,320,95,225,2015
2015-05-08,W.P. Kuala Lumpur,454,161,293,2015
2015-05-09,W.P. Kuala Lumpur,329,54,275,2015
2015-05-10,W.P. Kuala Lumpur,628,189,439,2015
2015-05-11,W.P. Kuala Lumpur,218,34,184,2015
2015-05-12,W.P. Kuala Lumpur,585,176,409,2015
2015-05-13,W.P. Kuala Lumpur,408,131,277,2015
2015-05-14,W.P. Kuala Lumpur,404,110,294,2015
2015-05-15,W.P. Kuala Lumpur,508,131,377,2015
2015-05-16,W.P. Kuala Lumpur,432,137,295,2015
2015-05-17,W.P. Kuala Lumpur,720,170,550,2015
2015-05-18,W.P. Kuala Lumpur,189,54,135,2015
2015-05-19,W.P. Kuala Lumpur,446,107,339,2015
2015-05-20,W.P. Kuala Lumpur,539,148,391,2015
2015-05-21,W.P. Kuala Lumpur,840,280,560,2015
2015-05-22,W.P. Kuala Lumpur,246,65,181,2015
2015-05-23,W.P. Kuala Lumpur,448,121,327,2015
2015-05-24,W.P. Kuala Lumpur,554,115,439,2015
2015-05-25,W.P. Kuala Lumpur,216,40,176,2015
2015-05-26,W.P. Kuala Lumpur,608,175,433,2015
2015-05-27,W.P. Kuala Lumpur,763,287,476,2015
2015-05-28,W.P. Kuala Lumpur,330,104,226,2015
2015-05-29,W.P. Kuala Lumpur,264,69,195,2015
2015-05-30,W.P. Kuala Lumpur,477,145,332,2015
2015-05-31,W.P. Kuala Lumpur,943,232,711,2015
2015-06-01,W.P. Kuala Lumpur,459,124,335,2015
2015-06-02,W.P. Kuala Lumpur,429,99,330,2015
2015-06-03,W.P. Kuala Lumpur,657,196,461,2015
2015-06-04,W.P. Kuala Lumpur,666,224,442,2015
2015-06-05,W.P. Kuala Lumpur,361,101,260,2015
2015-06-06,W.P. Kuala Lumpur,417,109,308,2015
2015-06-07,W.P. Kuala Lumpur,768,152,616,2015
2015-06-08,W.P. Kuala Lumpur,491,125,366,2015
2015-06-09,W.P. Kuala Lumpur,540,148,392,2015
2015-06-10,W.P. Kuala Lumpur,539,142,397,2015
2015-06-11,W.P. Kuala Lumpur,734,243,491,2015
2015-06-12,W.P. Kuala Lumpur,719,188,531,2015
2015-06-13,W.P. Kuala Lumpur,871,227,644,2015
2015-06-14,W.P. Kuala Lumpur,1364,392,972,2015
2015-06-15,W.P. Kuala Lumpur,610,108,502,2015
2015-06-16,W.P. Kuala Lumpur,759,183,576,2015
2015-06-17,W.P. Kuala Lumpur,726,193,533,2015
2015-06-18,W.P. Kuala Lumpur,29,3,26,2015
2015-06-19,W.P. Kuala Lumpur,44,3,41,2015
2015-06-20,W.P. Kuala Lumpur,360,108,252,2015
2015-06-21,W.P. Kuala Lumpur,878,206,672,2015
2015-06-22,W.P. Kuala Lumpur,113,26,87,2015
2015-06-23,W.P. Kuala Lumpur,100,33,67,2015
2015-06-24,W.P. Kuala Lumpur,98,26,72,2015
2015-06-25,W.P. Kuala Lumpur,107,23,84,2015
2015-06-26,W.P. Kuala Lumpur,78,3,75,2015
2015-06-27,W.P. Kuala Lumpur,853,317,536,2015
2015-06-28,W.P. Kuala Lumpur,827,192,635,2015
2015-06-29,W.P. Kuala Lumpur,82,11,71,2015
2015-06-30,W.P. Kuala Lumpur,122,28,94,2015
2015-07-01,W.P. Kuala Lumpur,124,28,96,2015
2015-07-02,W.P. Kuala Lumpur,143,25,118,2015
2015-07-03,W.P. Kuala Lumpur,175,61,114,2015
2015-07-04,W.P. Kuala Lumpur,298,70,228,2015
2015-07-05,W.P. Kuala Lumpur,1349,233,1116,2015
2015-07-06,W.P. Kuala Lumpur,249,82,167,2015
2015-07-07,W.P. Kuala Lumpur,352,118,234,2015
2015-07-08,W.P. Kuala Lumpur,472,150,322,2015
2015-07-09,W.P. Kuala Lumpur,405,150,255,2015
2015-07-10,W.P. Kuala Lumpur,497,177,320,2015
2015-07-11,W.P. Kuala Lumpur,460,129,331,2015
2015-07-12,W.P. Kuala Lumpur,1065,310,755,2015
2015-07-13,W.P. Kuala Lumpur,126,63,63,2015
2015-07-14,W.P. Kuala Lumpur,161,48,113,2015
2015-07-15,W.P. Kuala Lumpur,96,10,86,2015
2015-07-16,W.P. Kuala Lumpur,72,4,68,2015
2015-07-17,W.P. Kuala Lumpur,0,0,0,2015
2015-07-18,W.P. Kuala Lumpur,217,45,172,2015
2015-07-19,W.P. Kuala Lumpur,476,120,356,2015
2015-07-20,W.P. Kuala Lumpur,299,62,237,2015
2015-07-21,W.P. Kuala Lumpur,380,93,287,2015
2015-07-22,W.P. Kuala Lumpur,344,90,254,2015
2015-07-23,W.P. Kuala Lumpur,228,39,189,2015
2015-07-24,W.P. Kuala Lumpur,334,62,272,2015
2015-07-25,W.P. Kuala Lumpur,874,276,598,2015
2015-07-26,W.P. Kuala Lumpur,1001,257,744,2015
2015-07-27,W.P. Kuala Lumpur,268,75,193,2015
2015-07-28,W.P. Kuala Lumpur,601,189,412,2015
2015-07-29,W.P. Kuala Lumpur,662,268,394,2015
2015-07-30,W.P. Kuala Lumpur,479,121,358,2015
2015-07-31,W.P. Kuala Lumpur,249,73,176,2015
2015-08-01,W.P. Kuala Lumpur,638,213,425,2015
2015-08-02,W.P. Kuala Lumpur,988,238,750,2015
2015-08-03,W.P. Kuala Lumpur,485,127,358,2015
2015-08-04,W.P. Kuala Lumpur,574,200,374,2015
2015-08-05,W.P. Kuala Lumpur,726,211,515,2015
2015-08-06,W.P. Kuala Lumpur,505,210,295,2015
2015-08-07,W.P. Kuala Lumpur,414,112,302,2015
2015-08-08,W.P. Kuala Lumpur,538,136,402,2015
2015-08-09,W.P. Kuala Lumpur,1078,271,807,2015
2015-08-10,W.P. Kuala Lumpur,264,53,211,2015
2015-08-11,W.P. Kuala Lumpur,637,287,350,2015
2015-08-12,W.P. Kuala Lumpur,848,502,346,2015
2015-08-13,W.P. Kuala Lumpur,620,210,410,2015
2015-08-14,W.P. Kuala Lumpur,445,162,283,2015
2015-08-15,W.P. Kuala Lumpur,527,117,410,2015
2015-08-16,W.P. Kuala Lumpur,1293,276,1017,2015
2015-08-17,W.P. Kuala Lumpur,206,35,171,2015
2015-08-18,W.P. Kuala Lumpur,454,146,308,2015
2015-08-19,W.P. Kuala Lumpur,809,194,615,2015
2015-08-20,W.P. Kuala Lumpur,526,161,365,2015
2015-08-21,W.P. Kuala Lumpur,240,52,188,2015
2015-08-22,W.P. Kuala Lumpur,595,157,438,2015
2015-08-23,W.P. Kuala Lumpur,732,182,550,2015
2015-08-24,W.P. Kuala Lumpur,496,197,299,2015
2015-08-25,W.P. Kuala Lumpur,513,207,306,2015
2015-08-26,W.P. Kuala Lumpur,715,270,445,2015
2015-08-27,W.P. Kuala Lumpur,678,216,462,2015
2015-08-28,W.P. Kuala Lumpur,446,92,354,2015
2015-08-29,W.P. Kuala Lumpur,296,60,236,2015
2015-08-30,W.P. Kuala Lumpur,417,126,291,2015
2015-08-31,W.P. Kuala Lumpur,267,78,189,2015
2015-09-01,W.P. Kuala Lumpur,73,4,69,2015
2015-09-02,W.P. Kuala Lumpur,289,95,194,2015
2015-09-03,W.P. Kuala Lumpur,469,168,301,2015
2015-09-04,W.P. Kuala Lumpur,378,149,229,2015
2015-09-05,W.P. Kuala Lumpur,812,216,596,2015
2015-09-06,W.P. Kuala Lumpur,910,269,641,2015
2015-09-07,W.P. Kuala Lumpur,129,12,117,2015
2015-09-08,W.P. Kuala Lumpur,387,107,280,2015
2015-09-09,W.P. Kuala Lumpur,537,147,390,2015
2015-09-10,W.P. Kuala Lumpur,510,131,379,2015
2015-09-11,W.P. Kuala Lumpur,455,167,288,2015
2015-09-12,W.P. Kuala Lumpur,558,157,401,2015
2015-09-13,W.P. Kuala Lumpur,1033,255,778,2015
2015-09-14,W.P. Kuala Lumpur,250,41,209,2015
2015-09-15,W.P. Kuala Lumpur,652,217,435,2015
2015-09-16,W.P. Kuala Lumpur,563,161,402,2015
2015-09-17,W.P. Kuala Lumpur,446,169,277,2015
2015-09-18,W.P. Kuala Lumpur,361,94,267,2015
2015-09-19,W.P. Kuala Lumpur,476,124,352,2015
2015-09-20,W.P. Kuala Lumpur,627,162,465,2015
2015-09-21,W.P. Kuala Lumpur,304,92,212,2015
2015-09-22,W.P. Kuala Lumpur,297,81,216,2015
2015-09-23,W.P. Kuala Lumpur,216,39,177,2015
2015-09-24,W.P. Kuala Lumpur,48,4,44,2015
2015-09-25,W.P. Kuala Lumpur,322,80,242,2015
2015-09-26,W.P. Kuala Lumpur,376,98,278,2015
2015-09-27,W.P. Kuala Lumpur,461,134,327,2015
2015-09-28,W.P. Kuala Lumpur,104,18,86,2015
2015-09-29,W.P. Kuala Lumpur,568,317,251,2015
2015-09-30,W.P. Kuala Lumpur,418,125,293,2015
2015-10-01,W.P. Kuala Lumpur,360,128,232,2015
2015-10-02,W.P. Kuala Lumpur,302,102,200,2015
2015-10-03,W.P. Kuala Lumpur,492,126,366,2015
2015-10-04,W.P. Kuala Lumpur,921,215,706,2015
2015-10-05,W.P. Kuala Lumpur,686,178,508,2015
2015-10-06,W.P. Kuala Lumpur,497,132,365,2015
2015-10-07,W.P. Kuala Lumpur,373,117,256,2015
2015-10-08,W.P. Kuala Lumpur,564,168,396,2015
2015-10-09,W.P. Kuala Lumpur,299,68,231,2015
2015-10-10,W.P. Kuala Lumpur,447,100,347,2015
2015-10-11,W.P. Kuala Lumpur,369,100,269,2015
2015-10-12,W.P. Kuala Lumpur,509,147,362,2015
2015-10-13,W.P. Kuala Lumpur,533,141,392,2015
2015-10-14,W.P. Kuala Lumpur,482,106,376,2015
2015-10-15,W.P. Kuala Lumpur,375,77,298,2015
2015-10-16,W.P. Kuala Lumpur,348,84,264,2015
2015-10-17,W.P. Kuala Lumpur,410,103,307,2015
2015-10-18,W.P. Kuala Lumpur,508,150,358,2015
2015-10-19,W.P. Kuala Lumpur,232,46,186,2015
2015-10-20,W.P. Kuala Lumpur,531,181,350,2015
2015-10-21,W.P. Kuala Lumpur,736,239,497,2015
2015-10-22,W.P. Kuala Lumpur,675,248,427,2015
2015-10-23,W.P. Kuala Lumpur,308,87,221,2015
2015-10-24,W.P. Kuala Lumpur,936,634,302,2015
2015-10-25,W.P. Kuala Lumpur,569,136,433,2015
2015-10-26,W.P. Kuala Lumpur,346,71,275,2015
2015-10-27,W.P. Kuala Lumpur,519,133,386,2015
2015-10-28,W.P. Kuala Lumpur,381,103,278,2015
2015-10-29,W.P. Kuala Lumpur,514,154,360,2015
2015-10-30,W.P. Kuala Lumpur,285,72,213,2015
2015-10-31,W.P. Kuala Lumpur,918,250,668,2015
2015-11-01,W.P. Kuala Lumpur,1066,302,764,2015
2015-11-02,W.P. Kuala Lumpur,571,150,421,2015
2015-11-03,W.P. Kuala Lumpur,836,226,610,2015
2015-11-04,W.P. Kuala Lumpur,867,281,586,2015
2015-11-05,W.P. Kuala Lumpur,894,310,584,2015
2015-11-06,W.P. Kuala Lumpur,271,61,210,2015
2015-11-07,W.P. Kuala Lumpur,324,63,261,2015
2015-11-08,W.P. Kuala Lumpur,775,196,579,2015
2015-11-09,W.P. Kuala Lumpur,247,46,201,2015
2015-11-10,W.P. Kuala Lumpur,382,89,293,2015
2015-11-11,W.P. Kuala Lumpur,388,120,268,2015
2015-11-12,W.P. Kuala Lumpur,614,211,403,2015
2015-11-13,W.P. Kuala Lumpur,301,88,213,2015
2015-11-14,W.P. Kuala Lumpur,437,99,338,2015
2015-11-15,W.P. Kuala Lumpur,620,140,480,2015
2015-11-16,W.P. Kuala Lumpur,464,111,353,2015
2015-11-17,W.P. Kuala Lumpur,634,153,481,2015
2015-11-18,W.P. Kuala Lumpur,436,113,323,2015
2015-11-19,W.P. Kuala Lumpur,715,228,487,2015
2015-11-20,W.P. Kuala Lumpur,459,127,332,2015
2015-11-21,W.P. Kuala Lumpur,513,159,354,2015
2015-11-22,W.P. Kuala Lumpur,731,179,552,2015
2015-11-23,W.P. Kuala Lumpur,419,117,302,2015
2015-11-24,W.P. Kuala Lumpur,799,191,608,2015
2015-11-25,W.P. Kuala Lumpur,592,113,479,2015
2015-11-26,W.P. Kuala Lumpur,384,100,284,2015
2015-11-27,W.P. Kuala Lumpur,370,86,284,2015
2015-11-28,W.P. Kuala Lumpur,485,144,341,2015
2015-11-29,W.P. Kuala Lumpur,686,184,502,2015
2015-11-30,W.P. Kuala Lumpur,435,124,311,2015
2015-12-01,W.P. Kuala Lumpur,678,214,464,2015
2015-12-02,W.P. Kuala Lumpur,584,190,394,2015
2015-12-03,W.P. Kuala Lumpur,615,124,491,2015
2015-12-04,W.P. Kuala Lumpur,328,117,211,2015
2015-12-05,W.P. Kuala Lumpur,446,155,291,2015
2015-12-06,W.P. Kuala Lumpur,640,107,533,2015
2015-12-07,W.P. Kuala Lumpur,493,154,339,2015
2015-12-08,W.P. Kuala Lumpur,689,246,443,2015
2015-12-09,W.P. Kuala Lumpur,547,211,336,2015
2015-12-10,W.P. Kuala Lumpur,412,167,245,2015
2015-12-11,W.P. Kuala Lumpur,213,32,181,2015
2015-12-12,W.P. Kuala Lumpur,484,104,380,2015
2015-12-13,W.P. Kuala Lumpur,540,113,427,2015
2015-12-14,W.P. Kuala Lumpur,172,30,142,2015
2015-12-15,W.P. Kuala Lumpur,680,166,514,2015
2015-12-16,W.P. Kuala Lumpur,538,155,383,2015
2015-12-17,W.P. Kuala Lumpur,447,126,321,2015
2015-12-18,W.P. Kuala Lumpur,538,140,398,2015
2015-12-19,W.P. Kuala Lumpur,421,174,247,2015
2015-12-20,W.P. Kuala Lumpur,1037,256,781,2015
2015-12-21,W.P. Kuala Lumpur,167,21,146,2015
2015-12-22,W.P. Kuala Lumpur,304,67,237,2015
2015-12-23,W.P. Kuala Lumpur,201,35,166,2015
2015-12-24,W.P. Kuala Lumpur,276,54,222,2015
2015-12-25,W.P. Kuala Lumpur,332,65,267,2015
2015-12-26,W.P. Kuala Lumpur,391,62,329,2015
2015-12-27,W.P. Kuala Lumpur,476,98,378,2015
2015-12-28,W.P. Kuala Lumpur,252,49,203,2015
2015-12-29,W.P. Kuala Lumpur,369,88,281,2015
2015-12-30,W.P. Kuala Lumpur,355,94,261,2015
2015-12-31,W.P. Kuala Lumpur,325,46,279,2015
2016-01-01,W.P. Kuala Lumpur,444,109,335,2016
2016-01-02,W.P. Kuala Lumpur,526,116,410,2016
2016-01-03,W.P. Kuala Lumpur,574,137,437,2016
2016-01-04,W.P. Kuala Lumpur,138,29,109,2016
2016-01-05,W.P. Kuala Lumpur,412,126,286,2016
2016-01-06,W.P. Kuala Lumpur,275,55,220,2016
2016-01-07,W.P. Kuala Lumpur,253,52,201,2016
2016-01-08,W.P. Kuala Lumpur,163,33,130,2016
2016-01-09,W.P. Kuala Lumpur,447,107,340,2016
2016-01-10,W.P. Kuala Lumpur,1065,200,865,2016
2016-01-11,W.P. Kuala Lumpur,162,35,127,2016
2016-01-12,W.P. Kuala Lumpur,448,107,341,2016
2016-01-13,W.P. Kuala Lumpur,250,59,191,2016
2016-01-14,W.P. Kuala Lumpur,372,72,300,2016
2016-01-15,W.P. Kuala Lumpur,322,93,229,2016
2016-01-16,W.P. Kuala Lumpur,493,114,379,2016
2016-01-17,W.P. Kuala Lumpur,873,205,668,2016
2016-01-18,W.P. Kuala Lumpur,196,34,162,2016
2016-01-19,W.P. Kuala Lumpur,628,180,448,2016
2016-01-20,W.P. Kuala Lumpur,663,205,458,2016
2016-01-21,W.P. Kuala Lumpur,598,173,425,2016
2016-01-22,W.P. Kuala Lumpur,463,139,324,2016
2016-01-23,W.P. Kuala Lumpur,428,97,331,2016
2016-01-24,W.P. Kuala Lumpur,1588,476,1112,2016
2016-01-25,W.P. Kuala Lumpur,155,12,143,2016
2016-01-26,W.P. Kuala Lumpur,234,72,162,2016
2016-01-27,W.P. Kuala Lumpur,493,174,319,2016
2016-01-28,W.P. Kuala Lumpur,704,331,373,2016
2016-01-29,W.P. Kuala Lumpur,468,144,324,2016
2016-01-30,W.P. Kuala Lumpur,382,94,288,2016
2016-01-31,W.P. Kuala Lumpur,388,82,306,2016
2016-02-01,W.P. Kuala Lumpur,329,121,208,2016
2016-02-02,W.P. Kuala Lumpur,427,129,298,2016
2016-02-03,W.P. Kuala Lumpur,635,165,470,2016
2016-02-04,W.P. Kuala Lumpur,590,196,394,2016
2016-02-05,W.P. Kuala Lumpur,283,68,215,2016
2016-02-06,W.P. Kuala Lumpur,412,106,306,2016
2016-02-07,W.P. Kuala Lumpur,290,76,214,2016
2016-02-08,W.P. Kuala Lumpur,0,0,0,2016
2016-02-09,W.P. Kuala Lumpur,299,68,231,2016
2016-02-10,W.P. Kuala Lumpur,365,93,272,2016
2016-02-11,W.P. Kuala Lumpur,474,173,301,2016
2016-02-12,W.P. Kuala Lumpur,452,162,290,2016
2016-02-13,W.P. Kuala Lumpur,545,121,424,2016
2016-02-14,W.P. Kuala Lumpur,560,165,395,2016
2016-02-15,W.P. Kuala Lumpur,297,113,184,2016
2016-02-16,W.P. Kuala Lumpur,530,166,364,2016
2016-02-17,W.P. Kuala Lumpur,586,217,369,2016
2016-02-18,W.P. Kuala Lumpur,853,300,553,2016
2016-02-19,W.P. Kuala Lumpur,422,115,307,2016
2016-02-20,W.P. Kuala Lumpur,585,145,440,2016
2016-02-21,W.P. Kuala Lumpur,543,149,394,2016
2016-02-22,W.P. Kuala Lumpur,367,97,270,2016
2016-02-23,W.P. Kuala Lumpur,554,150,404,2016
2016-02-24,W.P. Kuala Lumpur,669,180,489,2016
2016-02-25,W.P. Kuala Lumpur,702,251,451,2016
2016-02-26,W.P. Kuala Lumpur,566,177,389,2016
2016-02-27,W.P. Kuala Lumpur,477,140,337,2016
2016-02-28,W.P. Kuala Lumpur,586,141,445,2016
2016-02-29,W.P. Kuala Lumpur,319,93,226,2016
2016-03-01,W.P. Kuala Lumpur,214,34,180,2016
2016-03-02,W.P. Kuala Lumpur,395,148,247,2016
2016-03-03,W.P. Kuala Lumpur,235,61,174,2016
2016-03-04,W.P. Kuala Lumpur,164,28,136,2016
2016-03-05,W.P. Kuala Lumpur,441,135,306,2016
2016-03-06,W.P. Kuala Lumpur,586,159,427,2016
2016-03-07,W.P. Kuala Lumpur,225,31,194,2016
2016-03-08,W.P. Kuala Lumpur,569,247,322,2016
2016-03-09,W.P. Kuala Lumpur,788,301,487,2016
2016-03-10,W.P. Kuala Lumpur,591,221,370,2016
2016-03-11,W.P. Kuala Lumpur,318,115,203,2016
2016-03-12,W.P. Kuala Lumpur,487,111,376,2016
2016-03-13,W.P. Kuala Lumpur,752,172,580,2016
2016-03-14,W.P. Kuala Lumpur,487,105,382,2016
2016-03-15,W.P. Kuala Lumpur,735,245,490,2016
2016-03-16,W.P. Kuala Lumpur,935,287,648,2016
2016-03-17,W.P. Kuala Lumpur,815,215,600,2016
2016-03-18,W.P. Kuala Lumpur,695,214,481,2016
2016-03-19,W.P. Kuala Lumpur,878,234,644,2016
2016-03-20,W.P. Kuala Lumpur,641,139,502,2016
2016-03-21,W.P. Kuala Lumpur,187,45,142,2016
2016-03-22,W.P. Kuala Lumpur,415,83,332,2016
2016-03-23,W.P. Kuala Lumpur,511,194,317,2016
2016-03-24,W.P. Kuala Lumpur,559,181,378,2016
2016-03-25,W.P. Kuala Lumpur,305,83,222,2016
2016-03-26,W.P. Kuala Lumpur,614,168,446,2016
2016-03-27,W.P. Kuala Lumpur,522,125,397,2016
2016-03-28,W.P. Kuala Lumpur,238,78,160,2016
2016-03-29,W.P. Kuala Lumpur,600,199,401,2016
2016-03-30,W.P. Kuala Lumpur,537,184,353,2016
2016-03-31,W.P. Kuala Lumpur,654,216,438,2016
2016-04-01,W.P. Kuala Lumpur,200,63,137,2016
2016-04-02,W.P. Kuala Lumpur,1202,868,334,2016
2016-04-03,W.P. Kuala Lumpur,517,125,392,2016
2016-04-04,W.P. Kuala Lumpur,304,93,211,2016
2016-04-05,W.P. Kuala Lumpur,816,331,485,2016
2016-04-06,W.P. Kuala Lumpur,855,212,643,2016
2016-04-07,W.P. Kuala Lumpur,776,230,546,2016
2016-04-08,W.P. Kuala Lumpur,698,239,459,2016
2016-04-09,W.P. Kuala Lumpur,595,192,403,2016
2016-04-10,W.P. Kuala Lumpur,468,93,375,2016
2016-04-11,W.P. Kuala Lumpur,309,101,208,2016
2016-04-12,W.P. Kuala Lumpur,575,174,401,2016
2016-04-13,W.P. Kuala Lumpur,608,186,422,2016
2016-04-14,W.P. Kuala Lumpur,824,261,563,2016
2016-04-15,W.P. Kuala Lumpur,393,99,294,2016
2016-04-16,W.P. Kuala Lumpur,569,129,440,2016
2016-04-17,W.P. Kuala Lumpur,1116,202,914,2016
2016-04-18,W.P. Kuala Lumpur,335,79,256,2016
2016-04-19,W.P. Kuala Lumpur,486,150,336,2016
2016-04-20,W.P. Kuala Lumpur,533,146,387,2016
2016-04-21,W.P. Kuala Lumpur,423,123,300,2016
2016-04-22,W.P. Kuala Lumpur,646,160,486,2016
2016-04-23,W.P. Kuala Lumpur,602,169,433,2016
2016-04-24,W.P. Kuala Lumpur,928,150,778,2016
2016-04-25,W.P. Kuala Lumpur,405,144,261,2016
2016-04-26,W.P. Kuala Lumpur,272,94,178,2016
2016-04-27,W.P. Kuala Lumpur,810,232,578,2016
2016-04-28,W.P. Kuala Lumpur,598,153,445,2016
2016-04-29,W.P. Kuala Lumpur,174,33,141,2016
2016-04-30,W.P. Kuala Lumpur,395,96,299,2016
2016-05-01,W.P. Kuala Lumpur,1457,213,1244,2016
2016-05-02,W.P. Kuala Lumpur,131,17,114,2016
2016-05-03,W.P. Kuala Lumpur,259,71,188,2016
2016-05-04,W.P. Kuala Lumpur,621,182,439,2016
2016-05-05,W.P. Kuala Lumpur,646,311,335,2016
2016-05-06,W.P. Kuala Lumpur,300,84,216,2016
2016-05-07,W.P. Kuala Lumpur,564,156,408,2016
2016-05-08,W.P. Kuala Lumpur,913,196,717,2016
2016-05-09,W.P. Kuala Lumpur,293,84,209,2016
2016-05-10,W.P. Kuala Lumpur,619,136,483,2016
2016-05-11,W.P. Kuala Lumpur,724,197,527,2016
2016-05-12,W.P. Kuala Lumpur,706,230,476,2016
2016-05-13,W.P. Kuala Lumpur,436,107,329,2016
2016-05-14,W.P. Kuala Lumpur,555,120,435,2016
2016-05-15,W.P. Kuala Lumpur,453,100,353,2016
2016-05-16,W.P. Kuala Lumpur,451,154,297,2016
2016-05-17,W.P. Kuala Lumpur,672,235,437,2016
2016-05-18,W.P. Kuala Lumpur,831,240,591,2016
2016-05-19,W.P. Kuala Lumpur,290,73,217,2016
2016-05-20,W.P. Kuala Lumpur,741,168,573,2016
2016-05-21,W.P. Kuala Lumpur,1283,206,1077,2016
2016-05-22,W.P. Kuala Lumpur,618,171,447,2016
2016-05-23,W.P. Kuala Lumpur,491,141,350,2016
2016-05-24,W.P. Kuala Lumpur,746,199,547,2016
2016-05-25,W.P. Kuala Lumpur,540,195,345,2016
2016-05-26,W.P. Kuala Lumpur,553,140,413,2016
2016-05-27,W.P. Kuala Lumpur,666,199,467,2016
2016-05-28,W.P. Kuala Lumpur,458,151,307,2016
2016-05-29,W.P. Kuala Lumpur,915,208,707,2016
2016-05-30,W.P. Kuala Lumpur,414,140,274,2016
2016-05-31,W.P. Kuala Lumpur,489,123,366,2016
2016-06-01,W.P. Kuala Lumpur,623,167,456,2016
2016-06-02,W.P. Kuala Lumpur,527,136,391,2016
2016-06-03,W.P. Kuala Lumpur,546,156,390,2016
2016-06-04,W.P. Kuala Lumpur,916,211,705,2016
2016-06-05,W.P. Kuala Lumpur,1048,250,798,2016
2016-06-06,W.P. Kuala Lumpur,73,15,58,2016
2016-06-07,W.P. Kuala Lumpur,40,5,35,2016
2016-06-08,W.P. Kuala Lumpur,193,57,136,2016
2016-06-09,W.P. Kuala Lumpur,314,106,208,2016
2016-06-10,W.P. Kuala Lumpur,264,73,191,2016
2016-06-11,W.P. Kuala Lumpur,311,109,202,2016
2016-06-12,W.P. Kuala Lumpur,1316,227,1089,2016
2016-06-13,W.P. Kuala Lumpur,55,12,43,2016
2016-06-14,W.P. Kuala Lumpur,206,51,155,2016
2016-06-15,W.P. Kuala Lumpur,399,168,231,2016
2016-06-16,W.P. Kuala Lumpur,145,35,110,2016
2016-06-17,W.P. Kuala Lumpur,72,4,68,2016
2016-06-18,W.P. Kuala Lumpur,426,114,312,2016
2016-06-19,W.P. Kuala Lumpur,622,119,503,2016
2016-06-20,W.P. Kuala Lumpur,543,191,352,2016
2016-06-21,W.P. Kuala Lumpur,572,201,371,2016
2016-06-22,W.P. Kuala Lumpur,92,12,80,2016
2016-06-23,W.P. Kuala Lumpur,600,212,388,2016
2016-06-24,W.P. Kuala Lumpur,622,213,409,2016
2016-06-25,W.P. Kuala Lumpur,1066,403,663,2016
2016-06-26,W.P. Kuala Lumpur,950,182,768,2016
2016-06-27,W.P. Kuala Lumpur,93,19,74,2016
2016-06-28,W.P. Kuala Lumpur,415,165,250,2016
2016-06-29,W.P. Kuala Lumpur,117,21,96,2016
2016-06-30,W.P. Kuala Lumpur,248,87,161,2016
2016-07-01,W.P. Kuala Lumpur,250,78,172,2016
2016-07-02,W.P. Kuala Lumpur,277,56,221,2016
2016-07-03,W.P. Kuala Lumpur,758,152,606,2016
2016-07-04,W.P. Kuala Lumpur,90,11,79,2016
2016-07-05,W.P. Kuala Lumpur,80,9,71,2016
2016-07-06,W.P. Kuala Lumpur,0,0,0,2016
2016-07-07,W.P. Kuala Lumpur,69,3,66,2016
2016-07-08,W.P. Kuala Lumpur,132,21,111,2016
2016-07-09,W.P. Kuala Lumpur,421,107,314,2016
2016-07-10,W.P. Kuala Lumpur,604,154,450,2016
2016-07-11,W.P. Kuala Lumpur,220,48,172,2016
2016-07-12,W.P. Kuala Lumpur,349,101,248,2016
2016-07-13,W.P. Kuala Lumpur,477,127,350,2016
2016-07-14,W.P. Kuala Lumpur,321,105,216,2016
2016-07-15,W.P. Kuala Lumpur,301,79,222,2016
2016-07-16,W.P. Kuala Lumpur,577,118,459,2016
2016-07-17,W.P. Kuala Lumpur,944,242,702,2016
2016-07-18,W.P. Kuala Lumpur,156,26,130,2016
2016-07-19,W.P. Kuala Lumpur,218,51,167,2016
2016-07-20,W.P. Kuala Lumpur,294,76,218,2016
2016-07-21,W.P. Kuala Lumpur,745,356,389,2016
2016-07-22,W.P. Kuala Lumpur,420,109,311,2016
2016-07-23,W.P. Kuala Lumpur,509,110,399,2016
2016-07-24,W.P. Kuala Lumpur,783,199,584,2016
2016-07-25,W.P. Kuala Lumpur,149,18,131,2016
2016-07-26,W.P. Kuala Lumpur,179,29,150,2016
2016-07-27,W.P. Kuala Lumpur,742,303,439,2016
2016-07-28,W.P. Kuala Lumpur,609,158,451,2016
2016-07-29,W.P. Kuala Lumpur,241,60,181,2016
2016-07-30,W.P. Kuala Lumpur,505,130,375,2016
2016-07-31,W.P. Kuala Lumpur,447,139,308,2016
2016-08-01,W.P. Kuala Lumpur,197,47,150,2016
2016-08-02,W.P. Kuala Lumpur,456,191,265,2016
2016-08-03,W.P. Kuala Lumpur,408,154,254,2016
2016-08-04,W.P. Kuala Lumpur,519,187,332,2016
2016-08-05,W.P. Kuala Lumpur,315,127,188,2016
2016-08-06,W.P. Kuala Lumpur,972,242,730,2016
2016-08-07,W.P. Kuala Lumpur,1048,324,724,2016
2016-08-08,W.P. Kuala Lumpur,186,62,124,2016
2016-08-09,W.P. Kuala Lumpur,606,211,395,2016
2016-08-10,W.P. Kuala Lumpur,605,166,439,2016
2016-08-11,W.P. Kuala Lumpur,663,249,414,2016
2016-08-12,W.P. Kuala Lumpur,477,139,338,2016
2016-08-13,W.P. Kuala Lumpur,903,273,630,2016
2016-08-14,W.P. Kuala Lumpur,890,242,648,2016
2016-08-15,W.P. Kuala Lumpur,460,165,295,2016
2016-08-16,W.P. Kuala Lumpur,1033,345,688,2016
2016-08-17,W.P. Kuala Lumpur,544,214,330,2016
2016-08-18,W.P. Kuala Lumpur,667,197,470,2016
2016-08-19,W.P. Kuala Lumpur,376,110,266,2016
2016-08-20,W.P. Kuala Lumpur,644,159,485,2016
2016-08-21,W.P. Kuala Lumpur,713,186,527,2016
2016-08-22,W.P. Kuala Lumpur,399,141,258,2016
2016-08-23,W.P. Kuala Lumpur,587,185,402,2016
2016-08-24,W.P. Kuala Lumpur,643,174,469,2016
2016-08-25,W.P. Kuala Lumpur,558,112,446,2016
2016-08-26,W.P. Kuala Lumpur,480,94,386,2016
2016-08-27,W.P. Kuala Lumpur,474,115,359,2016
2016-08-28,W.P. Kuala Lumpur,868,205,663,2016
2016-08-29,W.P. Kuala Lumpur,439,146,293,2016
2016-08-30,W.P. Kuala Lumpur,486,154,332,2016
2016-08-31,W.P. Kuala Lumpur,578,141,437,2016
2016-09-01,W.P. Kuala Lumpur,445,206,239,2016
2016-09-02,W.P. Kuala Lumpur,537,261,276,2016
2016-09-03,W.P. Kuala Lumpur,761,200,561,2016
2016-09-04,W.P. Kuala Lumpur,1155,232,923,2016
2016-09-05,W.P. Kuala Lumpur,167,44,123,2016
2016-09-06,W.P. Kuala Lumpur,510,122,388,2016
2016-09-07,W.P. Kuala Lumpur,737,280,457,2016
2016-09-08,W.P. Kuala Lumpur,328,100,228,2016
2016-09-09,W.P. Kuala Lumpur,282,70,212,2016
2016-09-10,W.P. Kuala Lumpur,426,110,316,2016
2016-09-11,W.P. Kuala Lumpur,453,126,327,2016
2016-09-12,W.P. Kuala Lumpur,151,35,116,2016
2016-09-13,W.P. Kuala Lumpur,204,38,166,2016
2016-09-14,W.P. Kuala Lumpur,400,114,286,2016
2016-09-15,W.P. Kuala Lumpur,308,70,238,2016
2016-09-16,W.P. Kuala Lumpur,416,111,305,2016
2016-09-17,W.P. Kuala Lumpur,415,88,327,2016
2016-09-18,W.P. Kuala Lumpur,702,204,498,2016
2016-09-19,W.P. Kuala Lumpur,283,83,200,2016
2016-09-20,W.P. Kuala Lumpur,516,121,395,2016
2016-09-21,W.P. Kuala Lumpur,600,202,398,2016
2016-09-22,W.P. Kuala Lumpur,540,109,431,2016
2016-09-23,W.P. Kuala Lumpur,453,113,340,2016
2016-09-24,W.P. Kuala Lumpur,411,88,323,2016
2016-09-25,W.P. Kuala Lumpur,654,153,501,2016
2016-09-26,W.P. Kuala Lumpur,546,198,348,2016
2016-09-27,W.P. Kuala Lumpur,687,191,496,2016
2016-09-28,W.P. Kuala Lumpur,571,198,373,2016
2016-09-29,W.P. Kuala Lumpur,525,206,319,2016
2016-09-30,W.P. Kuala Lumpur,284,92,192,2016
2016-10-01,W.P. Kuala Lumpur,213,40,173,2016
2016-10-02,W.P. Kuala Lumpur,602,127,475,2016
2016-10-03,W.P. Kuala Lumpur,81,8,73,2016
2016-10-04,W.P. Kuala Lumpur,734,247,487,2016
2016-10-05,W.P. Kuala Lumpur,486,112,374,2016
2016-10-06,W.P. Kuala Lumpur,266,42,224,2016
2016-10-07,W.P. Kuala Lumpur,246,62,184,2016
2016-10-08,W.P. Kuala Lumpur,504,155,349,2016
2016-10-09,W.P. Kuala Lumpur,645,260,385,2016
2016-10-10,W.P. Kuala Lumpur,239,70,169,2016
2016-10-11,W.P. Kuala Lumpur,573,142,431,2016
2016-10-12,W.P. Kuala Lumpur,760,275,485,2016
2016-10-13,W.P. Kuala Lumpur,495,124,371,2016
2016-10-14,W.P. Kuala Lumpur,509,117,392,2016
2016-10-15,W.P. Kuala Lumpur,274,64,210,2016
2016-10-16,W.P. Kuala Lumpur,699,182,517,2016
2016-10-17,W.P. Kuala Lumpur,157,32,125,2016
2016-10-18,W.P. Kuala Lumpur,298,73,225,2016
2016-10-19,W.P. Kuala Lumpur,612,207,405,2016
2016-10-20,W.P. Kuala Lumpur,498,155,343,2016
2016-10-21,W.P. Kuala Lumpur,378,112,266,2016
2016-10-22,W.P. Kuala Lumpur,323,70,253,2016
2016-10-23,W.P. Kuala Lumpur,658,144,514,2016
2016-10-24,W.P. Kuala Lumpur,211,47,164,2016
2016-10-25,W.P. Kuala Lumpur,498,131,367,2016
2016-10-26,W.P. Kuala Lumpur,623,220,403,2016
2016-10-27,W.P. Kuala Lumpur,369,146,223,2016
2016-10-28,W.P. Kuala Lumpur,294,69,225,2016
2016-10-29,W.P. Kuala Lumpur,381,116,265,2016
2016-10-30,W.P. Kuala Lumpur,451,116,335,2016
2016-10-31,W.P. Kuala Lumpur,150,31,119,2016
2016-11-01,W.P. Kuala Lumpur,315,49,266,2016
2016-11-02,W.P. Kuala Lumpur,352,123,229,2016
2016-11-03,W.P. Kuala Lumpur,287,86,201,2016
2016-11-04,W.P. Kuala Lumpur,275,64,211,2016
2016-11-05,W.P. Kuala Lumpur,514,174,340,2016
2016-11-06,W.P. Kuala Lumpur,684,134,550,2016
2016-11-07,W.P. Kuala Lumpur,461,111,350,2016
2016-11-08,W.P. Kuala Lumpur,546,135,411,2016
2016-11-09,W.P. Kuala Lumpur,827,227,600,2016
2016-11-10,W.P. Kuala Lumpur,659,205,454,2016
2016-11-11,W.P. Kuala Lumpur,776,257,519,2016
2016-11-12,W.P. Kuala Lumpur,535,166,369,2016
2016-11-13,W.P. Kuala Lumpur,640,164,476,2016
2016-11-14,W.P. Kuala Lumpur,303,94,209,2016
2016-11-15,W.P. Kuala Lumpur,455,142,313,2016
2016-11-16,W.P. Kuala Lumpur,432,144,288,2016
2016-11-17,W.P. Kuala Lumpur,606,201,405,2016
2016-11-18,W.P. Kuala Lumpur,466,160,306,2016
2016-11-19,W.P. Kuala Lumpur,298,111,187,2016
2016-11-20,W.P. Kuala Lumpur,567,128,439,2016
2016-11-21,W.P. Kuala Lumpur,430,138,292,2016
2016-11-22,W.P. Kuala Lumpur,667,178,489,2016
2016-11-23,W.P. Kuala Lumpur,669,147,522,2016
2016-11-24,W.P. Kuala Lumpur,604,145,459,2016
2016-11-25,W.P. Kuala Lumpur,516,137,379,2016
2016-11-26,W.P. Kuala Lumpur,530,126,404,2016
2016-11-27,W.P. Kuala Lumpur,568,166,402,2016
2016-11-28,W.P. Kuala Lumpur,259,46,213,2016
2016-11-29,W.P. Kuala Lumpur,209,32,177,2016
2016-11-30,W.P. Kuala Lumpur,488,101,387,2016
2016-12-01,W.P. Kuala Lumpur,485,138,347,2016
2016-12-02,W.P. Kuala Lumpur,254,50,204,2016
2016-12-03,W.P. Kuala Lumpur,417,93,324,2016
2016-12-04,W.P. Kuala Lumpur,852,136,716,2016
2016-12-05,W.P. Kuala Lumpur,356,89,267,2016
2016-12-06,W.P. Kuala Lumpur,416,98,318,2016
2016-12-07,W.P. Kuala Lumpur,490,112,378,2016
2016-12-08,W.P. Kuala Lumpur,540,143,397,2016
2016-12-09,W.P. Kuala Lumpur,285,77,208,2016
2016-12-10,W.P. Kuala Lumpur,355,78,277,2016
2016-12-11,W.P. Kuala Lumpur,385,84,301,2016
2016-12-12,W.P. Kuala Lumpur,145,23,122,2016
2016-12-13,W.P. Kuala Lumpur,303,92,211,2016
2016-12-14,W.P. Kuala Lumpur,508,134,374,2016
2016-12-15,W.P. Kuala Lumpur,505,166,339,2016
2016-12-16,W.P. Kuala Lumpur,277,51,226,2016
2016-12-17,W.P. Kuala Lumpur,1058,780,278,2016
2016-12-18,W.P. Kuala Lumpur,742,138,604,2016
2016-12-19,W.P. Kuala Lumpur,330,62,268,2016
2016-12-20,W.P. Kuala Lumpur,583,161,422,2016
2016-12-21,W.P. Kuala Lumpur,355,90,265,2016
2016-12-22,W.P. Kuala Lumpur,456,90,366,2016
2016-12-23,W.P. Kuala Lumpur,286,55,231,2016
2016-12-24,W.P. Kuala Lumpur,314,65,249,2016
2016-12-25,W.P. Kuala Lumpur,355,73,282,2016
2016-12-26,W.P. Kuala Lumpur,248,40,208,2016
2016-12-27,W.P. Kuala Lumpur,240,47,193,2016
2016-12-28,W.P. Kuala Lumpur,264,61,203,2016
2016-12-29,W.P. Kuala Lumpur,560,260,300,2016
2016-12-30,W.P. Kuala Lumpur,487,246,241,2016
2016-12-31,W.P. Kuala Lumpur,404,78,326,2016
2017-01-01,W.P. Kuala Lumpur,452,99,353,2017
2017-01-02,W.P. Kuala Lumpur,343,63,280,2017
2017-01-03,W.P. Kuala Lumpur,144,19,125,2017
2017-01-04,W.P. Kuala Lumpur,194,36,158,2017
2017-01-05,W.P. Kuala Lumpur,297,59,238,2017
2017-01-06,W.P. Kuala Lumpur,226,45,181,2017
2017-01-07,W.P. Kuala Lumpur,618,161,457,2017
2017-01-08,W.P. Kuala Lumpur,716,165,551,2017
2017-01-09,W.P. Kuala Lumpur,421,104,317,2017
2017-01-10,W.P. Kuala Lumpur,378,101,277,2017
2017-01-11,W.P. Kuala Lumpur,684,211,473,2017
2017-01-12,W.P. Kuala Lumpur,598,177,421,2017
2017-01-13,W.P. Kuala Lumpur,256,64,192,2017
2017-01-14,W.P. Kuala Lumpur,389,83,306,2017
2017-01-15,W.P. Kuala Lumpur,703,150,553,2017
2017-01-16,W.P. Kuala Lumpur,241,76,165,2017
2017-01-17,W.P. Kuala Lumpur,431,140,291,2017
2017-01-18,W.P. Kuala Lumpur,906,287,619,2017
2017-01-19,W.P. Kuala Lumpur,598,175,423,2017
2017-01-20,W.P. Kuala Lumpur,428,134,294,2017
2017-01-21,W.P. Kuala Lumpur,615,155,460,2017
2017-01-22,W.P. Kuala Lumpur,687,151,536,2017
2017-01-23,W.P. Kuala Lumpur,292,67,225,2017
2017-01-24,W.P. Kuala Lumpur,880,240,640,2017
2017-01-25,W.P. Kuala Lumpur,603,228,375,2017
2017-01-26,W.P. Kuala Lumpur,528,135,393,2017
2017-01-27,W.P. Kuala Lumpur,308,75,233,2017
2017-01-28,W.P. Kuala Lumpur,229,61,168,2017
2017-01-29,W.P. Kuala Lumpur,210,56,154,2017
2017-01-30,W.P. Kuala Lumpur,374,87,287,2017
2017-01-31,W.P. Kuala Lumpur,187,26,161,2017
2017-02-01,W.P. Kuala Lumpur,226,47,179,2017
2017-02-02,W.P. Kuala Lumpur,338,94,244,2017
2017-02-03,W.P. Kuala Lumpur,483,160,323,2017
2017-02-04,W.P. Kuala Lumpur,439,102,337,2017
2017-02-05,W.P. Kuala Lumpur,758,177,581,2017
2017-02-06,W.P. Kuala Lumpur,137,25,112,2017
2017-02-07,W.P. Kuala Lumpur,333,86,247,2017
2017-02-08,W.P. Kuala Lumpur,477,126,351,2017
2017-02-09,W.P. Kuala Lumpur,1815,495,1320,2017
2017-02-10,W.P. Kuala Lumpur,445,130,315,2017
2017-02-11,W.P. Kuala Lumpur,295,61,234,2017
2017-02-12,W.P. Kuala Lumpur,414,87,327,2017
2017-02-13,W.P. Kuala Lumpur,298,81,217,2017
2017-02-14,W.P. Kuala Lumpur,559,166,393,2017
2017-02-15,W.P. Kuala Lumpur,542,167,375,2017
2017-02-16,W.P. Kuala Lumpur,484,132,352,2017
2017-02-17,W.P. Kuala Lumpur,492,142,350,2017
2017-02-18,W.P. Kuala Lumpur,457,143,314,2017
2017-02-19,W.P. Kuala Lumpur,871,197,674,2017
2017-02-20,W.P. Kuala Lumpur,215,26,189,2017
2017-02-21,W.P. Kuala Lumpur,996,336,660,2017
2017-02-22,W.P. Kuala Lumpur,689,177,512,2017
2017-02-23,W.P. Kuala Lumpur,446,161,285,2017
2017-02-24,W.P. Kuala Lumpur,415,102,313,2017
2017-02-25,W.P. Kuala Lumpur,672,168,504,2017
2017-02-26,W.P. Kuala Lumpur,795,219,576,2017
2017-02-27,W.P. Kuala Lumpur,243,61,182,2017
2017-02-28,W.P. Kuala Lumpur,585,199,386,2017
2017-03-01,W.P. Kuala Lumpur,697,236,461,2017
2017-03-02,W.P. Kuala Lumpur,603,179,424,2017
2017-03-03,W.P. Kuala Lumpur,344,122,222,2017
2017-03-04,W.P. Kuala Lumpur,518,126,392,2017
2017-03-05,W.P. Kuala Lumpur,954,253,701,2017
2017-03-06,W.P. Kuala Lumpur,278,97,181,2017
2017-03-07,W.P. Kuala Lumpur,178,60,118,2017
2017-03-08,W.P. Kuala Lumpur,600,257,343,2017
2017-03-09,W.P. Kuala Lumpur,522,211,311,2017
2017-03-10,W.P. Kuala Lumpur,202,34,168,2017
2017-03-11,W.P. Kuala Lumpur,734,215,519,2017
2017-03-12,W.P. Kuala Lumpur,879,207,672,2017
2017-03-13,W.P. Kuala Lumpur,315,76,239,2017
2017-03-14,W.P. Kuala Lumpur,558,195,363,2017
2017-03-15,W.P. Kuala Lumpur,404,132,272,2017
2017-03-16,W.P. Kuala Lumpur,461,125,336,2017
2017-03-17,W.P. Kuala Lumpur,480,166,314,2017
2017-03-18,W.P. Kuala Lumpur,603,141,462,2017
2017-03-19,W.P. Kuala Lumpur,541,174,367,2017
2017-03-20,W.P. Kuala Lumpur,341,113,228,2017
2017-03-21,W.P. Kuala Lumpur,598,256,342,2017
2017-03-22,W.P. Kuala Lumpur,818,249,569,2017
2017-03-23,W.P. Kuala Lumpur,589,206,383,2017
2017-03-24,W.P. Kuala Lumpur,493,127,366,2017
2017-03-25,W.P. Kuala Lumpur,635,181,454,2017
2017-03-26,W.P. Kuala Lumpur,669,187,482,2017
2017-03-27,W.P. Kuala Lumpur,606,194,412,2017
2017-03-28,W.P. Kuala Lumpur,663,163,500,2017
2017-03-29,W.P. Kuala Lumpur,720,224,496,2017
2017-03-30,W.P. Kuala Lumpur,1028,342,686,2017
2017-03-31,W.P. Kuala Lumpur,393,115,278,2017
2017-04-01,W.P. Kuala Lumpur,667,166,501,2017
2017-04-02,W.P. Kuala Lumpur,479,112,367,2017
2017-04-03,W.P. Kuala Lumpur,375,93,282,2017
2017-04-04,W.P. Kuala Lumpur,622,183,439,2017
2017-04-05,W.P. Kuala Lumpur,742,224,518,2017
2017-04-06,W.P. Kuala Lumpur,746,269,477,2017
2017-04-07,W.P. Kuala Lumpur,498,159,339,2017
2017-04-08,W.P. Kuala Lumpur,510,121,389,2017
2017-04-09,W.P. Kuala Lumpur,639,131,508,2017
2017-04-10,W.P. Kuala Lumpur,212,90,122,2017
2017-04-11,W.P. Kuala Lumpur,629,198,431,2017
2017-04-12,W.P. Kuala Lumpur,790,205,585,2017
2017-04-13,W.P. Kuala Lumpur,679,157,522,2017
2017-04-14,W.P. Kuala Lumpur,543,149,394,2017
2017-04-15,W.P. Kuala Lumpur,493,137,356,2017
2017-04-16,W.P. Kuala Lumpur,964,190,774,2017
2017-04-17,W.P. Kuala Lumpur,267,79,188,2017
2017-04-18,W.P. Kuala Lumpur,168,28,140,2017
2017-04-19,W.P. Kuala Lumpur,690,169,521,2017
2017-04-20,W.P. Kuala Lumpur,693,213,480,2017
2017-04-21,W.P. Kuala Lumpur,262,79,183,2017
2017-04-22,W.P. Kuala Lumpur,693,180,513,2017
2017-04-23,W.P. Kuala Lumpur,1039,165,874,2017
2017-04-24,W.P. Kuala Lumpur,97,13,84,2017
2017-04-25,W.P. Kuala Lumpur,526,160,366,2017
2017-04-26,W.P. Kuala Lumpur,745,281,464,2017
2017-04-27,W.P. Kuala Lumpur,521,143,378,2017
2017-04-28,W.P. Kuala Lumpur,342,75,267,2017
2017-04-29,W.P. Kuala Lumpur,271,66,205,2017
2017-04-30,W.P. Kuala Lumpur,453,117,336,2017
2017-05-01,W.P. Kuala Lumpur,1445,172,1273,2017
2017-05-02,W.P. Kuala Lumpur,403,155,248,2017
2017-05-03,W.P. Kuala Lumpur,516,139,377,2017
2017-05-04,W.P. Kuala Lumpur,580,162,418,2017
2017-05-05,W.P. Kuala Lumpur,424,103,321,2017
2017-05-06,W.P. Kuala Lumpur,444,106,338,2017
2017-05-07,W.P. Kuala Lumpur,997,314,683,2017
2017-05-08,W.P. Kuala Lumpur,395,126,269,2017
2017-05-09,W.P. Kuala Lumpur,841,206,635,2017
2017-05-10,W.P. Kuala Lumpur,1262,251,1011,2017
2017-05-11,W.P. Kuala Lumpur,593,192,401,2017
2017-05-12,W.P. Kuala Lumpur,372,135,237,2017
2017-05-13,W.P. Kuala Lumpur,595,166,429,2017
2017-05-14,W.P. Kuala Lumpur,675,186,489,2017
2017-05-15,W.P. Kuala Lumpur,507,147,360,2017
2017-05-16,W.P. Kuala Lumpur,449,108,341,2017
2017-05-17,W.P. Kuala Lumpur,643,143,500,2017
2017-05-18,W.P. Kuala Lumpur,676,131,545,2017
2017-05-19,W.P. Kuala Lumpur,615,161,454,2017
2017-05-20,W.P. Kuala Lumpur,690,154,536,2017
2017-05-21,W.P. Kuala Lumpur,1210,244,966,2017
2017-05-22,W.P. Kuala Lumpur,587,204,383,2017
2017-05-23,W.P. Kuala Lumpur,685,177,508,2017
2017-05-24,W.P. Kuala Lumpur,806,224,582,2017
2017-05-25,W.P. Kuala Lumpur,709,207,502,2017
2017-05-26,W.P. Kuala Lumpur,461,91,370,2017
2017-05-27,W.P. Kuala Lumpur,105,20,85,2017
2017-05-28,W.P. Kuala Lumpur,741,190,551,2017
2017-05-29,W.P. Kuala Lumpur,37,3,34,2017
2017-05-30,W.P. Kuala Lumpur,37,1,36,2017
2017-05-31,W.P. Kuala Lumpur,57,4,53,2017
2017-06-01,W.P. Kuala Lumpur,107,16,91,2017
2017-06-02,W.P. Kuala Lumpur,123,25,98,2017
2017-06-03,W.P. Kuala Lumpur,281,35,246,2017
2017-06-04,W.P. Kuala Lumpur,471,131,340,2017
2017-06-05,W.P. Kuala Lumpur,76,11,65,2017
2017-06-06,W.P. Kuala Lumpur,227,49,178,2017
2017-06-07,W.P. Kuala Lumpur,333,104,229,2017
2017-06-08,W.P. Kuala Lumpur,246,81,165,2017
2017-06-09,W.P. Kuala Lumpur,74,8,66,2017
2017-06-10,W.P. Kuala Lumpur,345,75,270,2017
2017-06-11,W.P. Kuala Lumpur,781,166,615,2017
2017-06-12,W.P. Kuala Lumpur,54,7,47,2017
2017-06-13,W.P. Kuala Lumpur,199,67,132,2017
2017-06-14,W.P. Kuala Lumpur,308,105,203,2017
2017-06-15,W.P. Kuala Lumpur,161,41,120,2017
2017-06-16,W.P. Kuala Lumpur,159,38,121,2017
2017-06-17,W.P. Kuala Lumpur,389,140,249,2017
2017-06-18,W.P. Kuala Lumpur,1364,232,1132,2017
2017-06-19,W.P. Kuala Lumpur,185,54,131,2017
2017-06-20,W.P. Kuala Lumpur,206,82,124,2017
2017-06-21,W.P. Kuala Lumpur,172,32,140,2017
2017-06-22,W.P. Kuala Lumpur,182,105,77,2017
2017-06-23,W.P. Kuala Lumpur,76,6,70,2017
2017-06-24,W.P. Kuala Lumpur,716,226,490,2017
2017-06-25,W.P. Kuala Lumpur,0,0,0,2017
2017-06-26,W.P. Kuala Lumpur,0,0,0,2017
2017-06-27,W.P. Kuala Lumpur,170,26,144,2017
2017-06-28,W.P. Kuala Lumpur,244,51,193,2017
2017-06-29,W.P. Kuala Lumpur,285,56,229,2017
2017-06-30,W.P. Kuala Lumpur,288,58,230,2017
2017-07-01,W.P. Kuala Lumpur,361,71,290,2017
2017-07-02,W.P. Kuala Lumpur,829,148,681,2017
2017-07-03,W.P. Kuala Lumpur,132,12,120,2017
2017-07-04,W.P. Kuala Lumpur,484,148,336,2017
2017-07-05,W.P. Kuala Lumpur,271,45,226,2017
2017-07-06,W.P. Kuala Lumpur,307,84,223,2017
2017-07-07,W.P. Kuala Lumpur,239,59,180,2017
2017-07-08,W.P. Kuala Lumpur,539,96,443,2017
2017-07-09,W.P. Kuala Lumpur,749,146,603,2017
2017-07-10,W.P. Kuala Lumpur,377,76,301,2017
2017-07-11,W.P. Kuala Lumpur,503,142,361,2017
2017-07-12,W.P. Kuala Lumpur,565,262,303,2017
2017-07-13,W.P. Kuala Lumpur,463,131,332,2017
2017-07-14,W.P. Kuala Lumpur,319,95,224,2017
2017-07-15,W.P. Kuala Lumpur,591,123,468,2017
2017-07-16,W.P. Kuala Lumpur,656,156,500,2017
2017-07-17,W.P. Kuala Lumpur,155,25,130,2017
2017-07-18,W.P. Kuala Lumpur,441,147,294,2017
2017-07-19,W.P. Kuala Lumpur,713,193,520,2017
2017-07-20,W.P. Kuala Lumpur,587,129,458,2017
2017-07-21,W.P. Kuala Lumpur,331,110,221,2017
2017-07-22,W.P. Kuala Lumpur,554,118,436,2017
2017-07-23,W.P. Kuala Lumpur,893,267,626,2017
2017-07-24,W.P. Kuala Lumpur,398,117,281,2017
2017-07-25,W.P. Kuala Lumpur,861,223,638,2017
2017-07-26,W.P. Kuala Lumpur,614,211,403,2017
2017-07-27,W.P. Kuala Lumpur,784,288,496,2017
2017-07-28,W.P. Kuala Lumpur,703,247,456,2017
2017-07-29,W.P. Kuala Lumpur,566,180,386,2017
2017-07-30,W.P. Kuala Lumpur,660,142,518,2017
2017-07-31,W.P. Kuala Lumpur,160,37,123,2017
2017-08-01,W.P. Kuala Lumpur,426,135,291,2017
2017-08-02,W.P. Kuala Lumpur,871,358,513,2017
2017-08-03,W.P. Kuala Lumpur,776,253,523,2017
2017-08-04,W.P. Kuala Lumpur,264,33,231,2017
2017-08-05,W.P. Kuala Lumpur,1167,260,907,2017
2017-08-06,W.P. Kuala Lumpur,1386,375,1011,2017
2017-08-07,W.P. Kuala Lumpur,360,167,193,2017
2017-08-08,W.P. Kuala Lumpur,318,73,245,2017
2017-08-09,W.P. Kuala Lumpur,476,178,298,2017
2017-08-10,W.P. Kuala Lumpur,400,158,242,2017
2017-08-11,W.P. Kuala Lumpur,148,21,127,2017
2017-08-12,W.P. Kuala Lumpur,558,153,405,2017
2017-08-13,W.P. Kuala Lumpur,833,167,666,2017
2017-08-14,W.P. Kuala Lumpur,294,67,227,2017
2017-08-15,W.P. Kuala Lumpur,670,205,465,2017
2017-08-16,W.P. Kuala Lumpur,751,370,381,2017
2017-08-17,W.P. Kuala Lumpur,513,185,328,2017
2017-08-18,W.P. Kuala Lumpur,536,148,388,2017
2017-08-19,W.P. Kuala Lumpur,533,134,399,2017
2017-08-20,W.P. Kuala Lumpur,760,148,612,2017
2017-08-21,W.P. Kuala Lumpur,245,60,185,2017
2017-08-22,W.P. Kuala Lumpur,579,167,412,2017
2017-08-23,W.P. Kuala Lumpur,709,219,490,2017
2017-08-24,W.P. Kuala Lumpur,486,174,312,2017
2017-08-25,W.P. Kuala Lumpur,419,121,298,2017
2017-08-26,W.P. Kuala Lumpur,461,114,347,2017
2017-08-27,W.P. Kuala Lumpur,796,133,663,2017
2017-08-28,W.P. Kuala Lumpur,127,15,112,2017
2017-08-29,W.P. Kuala Lumpur,229,54,175,2017
2017-08-30,W.P. Kuala Lumpur,125,13,112,2017
2017-08-31,W.P. Kuala Lumpur,553,150,403,2017
2017-09-01,W.P. Kuala Lumpur,168,41,127,2017
2017-09-02,W.P. Kuala Lumpur,315,58,257,2017
2017-09-03,W.P. Kuala Lumpur,403,78,325,2017
2017-09-04,W.P. Kuala Lumpur,77,9,68,2017
2017-09-05,W.P. Kuala Lumpur,344,78,266,2017
2017-09-06,W.P. Kuala Lumpur,448,205,243,2017
2017-09-07,W.P. Kuala Lumpur,562,210,352,2017
2017-09-08,W.P. Kuala Lumpur,453,107,346,2017
2017-09-09,W.P. Kuala Lumpur,436,105,331,2017
2017-09-10,W.P. Kuala Lumpur,735,177,558,2017
2017-09-11,W.P. Kuala Lumpur,383,73,310,2017
2017-09-12,W.P. Kuala Lumpur,553,119,434,2017
2017-09-13,W.P. Kuala Lumpur,592,157,435,2017
2017-09-14,W.P. Kuala Lumpur,433,103,330,2017
2017-09-15,W.P. Kuala Lumpur,320,92,228,2017
2017-09-16,W.P. Kuala Lumpur,743,223,520,2017
2017-09-17,W.P. Kuala Lumpur,674,176,498,2017
2017-09-18,W.P. Kuala Lumpur,380,94,286,2017
2017-09-19,W.P. Kuala Lumpur,474,126,348,2017
2017-09-20,W.P. Kuala Lumpur,430,187,243,2017
2017-09-21,W.P. Kuala Lumpur,580,245,335,2017
2017-09-22,W.P. Kuala Lumpur,369,121,248,2017
2017-09-23,W.P. Kuala Lumpur,454,105,349,2017
2017-09-24,W.P. Kuala Lumpur,708,163,545,2017
2017-09-25,W.P. Kuala Lumpur,322,81,241,2017
2017-09-26,W.P. Kuala Lumpur,565,212,353,2017
2017-09-27,W.P. Kuala Lumpur,648,248,400,2017
2017-09-28,W.P. Kuala Lumpur,653,165,488,2017
2017-09-29,W.P. Kuala Lumpur,550,145,405,2017
2017-09-30,W.P. Kuala Lumpur,391,127,264,2017
2017-10-01,W.P. Kuala Lumpur,509,103,406,2017
2017-10-02,W.P. Kuala Lumpur,307,87,220,2017
2017-10-03,W.P. Kuala Lumpur,401,136,265,2017
2017-10-04,W.P. Kuala Lumpur,565,163,402,2017
2017-10-05,W.P. Kuala Lumpur,411,100,311,2017
2017-10-06,W.P. Kuala Lumpur,143,18,125,2017
2017-10-07,W.P. Kuala Lumpur,646,151,495,2017
2017-10-08,W.P. Kuala Lumpur,809,215,594,2017
2017-10-09,W.P. Kuala Lumpur,560,234,326,2017
2017-10-10,W.P. Kuala Lumpur,744,220,524,2017
2017-10-11,W.P. Kuala Lumpur,758,271,487,2017
2017-10-12,W.P. Kuala Lumpur,686,229,457,2017
2017-10-13,W.P. Kuala Lumpur,308,78,230,2017
2017-10-14,W.P. Kuala Lumpur,124,13,111,2017
2017-10-15,W.P. Kuala Lumpur,846,187,659,2017
2017-10-16,W.P. Kuala Lumpur,277,80,197,2017
2017-10-17,W.P. Kuala Lumpur,174,27,147,2017
2017-10-18,W.P. Kuala Lumpur,347,65,282,2017
2017-10-19,W.P. Kuala Lumpur,203,29,174,2017
2017-10-20,W.P. Kuala Lumpur,238,46,192,2017
2017-10-21,W.P. Kuala Lumpur,600,161,439,2017
2017-10-22,W.P. Kuala Lumpur,706,162,544,2017
2017-10-23,W.P. Kuala Lumpur,198,53,145,2017
2017-10-24,W.P. Kuala Lumpur,370,150,220,2017
2017-10-25,W.P. Kuala Lumpur,802,201,601,2017
2017-10-26,W.P. Kuala Lumpur,692,181,511,2017
2017-10-27,W.P. Kuala Lumpur,470,133,337,2017
2017-10-28,W.P. Kuala Lumpur,633,192,441,2017
2017-10-29,W.P. Kuala Lumpur,687,171,516,2017
2017-10-30,W.P. Kuala Lumpur,177,54,123,2017
2017-10-31,W.P. Kuala Lumpur,430,89,341,2017
2017-11-01,W.P. Kuala Lumpur,594,174,420,2017
2017-11-02,W.P. Kuala Lumpur,639,196,443,2017
2017-11-03,W.P. Kuala Lumpur,192,70,122,2017
2017-11-04,W.P. Kuala Lumpur,431,108,323,2017
2017-11-05,W.P. Kuala Lumpur,637,132,505,2017
2017-11-06,W.P. Kuala Lumpur,205,52,153,2017
2017-11-07,W.P. Kuala Lumpur,538,162,376,2017
2017-11-08,W.P. Kuala Lumpur,832,170,662,2017
2017-11-09,W.P. Kuala Lumpur,695,236,459,2017
2017-11-10,W.P. Kuala Lumpur,344,85,259,2017
2017-11-11,W.P. Kuala Lumpur,663,181,482,2017
2017-11-12,W.P. Kuala Lumpur,670,146,524,2017
2017-11-13,W.P. Kuala Lumpur,296,64,232,2017
2017-11-14,W.P. Kuala Lumpur,637,169,468,2017
2017-11-15,W.P. Kuala Lumpur,458,159,299,2017
2017-11-16,W.P. Kuala Lumpur,441,153,288,2017
2017-11-17,W.P. Kuala Lumpur,486,172,314,2017
2017-11-18,W.P. Kuala Lumpur,548,125,423,2017
2017-11-19,W.P. Kuala Lumpur,669,160,509,2017
2017-11-20,W.P. Kuala Lumpur,436,135,301,2017
2017-11-21,W.P. Kuala Lumpur,465,177,288,2017
2017-11-22,W.P. Kuala Lumpur,902,270,632,2017
2017-11-23,W.P. Kuala Lumpur,767,195,572,2017
2017-11-24,W.P. Kuala Lumpur,604,204,400,2017
2017-11-25,W.P. Kuala Lumpur,489,143,346,2017
2017-11-26,W.P. Kuala Lumpur,859,173,686,2017
2017-11-27,W.P. Kuala Lumpur,565,105,460,2017
2017-11-28,W.P. Kuala Lumpur,844,228,616,2017
2017-11-29,W.P. Kuala Lumpur,844,222,622,2017
2017-11-30,W.P. Kuala Lumpur,818,220,598,2017
2017-12-01,W.P. Kuala Lumpur,155,27,128,2017
2017-12-02,W.P. Kuala Lumpur,568,296,272,2017
2017-12-03,W.P. Kuala Lumpur,643,105,538,2017
2017-12-04,W.P. Kuala Lumpur,115,30,85,2017
2017-12-05,W.P. Kuala Lumpur,289,92,197,2017
2017-12-06,W.P. Kuala Lumpur,482,141,341,2017
2017-12-07,W.P. Kuala Lumpur,405,89,316,2017
2017-12-08,W.P. Kuala Lumpur,309,109,200,2017
2017-12-09,W.P. Kuala Lumpur,221,47,174,2017
2017-12-10,W.P. Kuala Lumpur,621,142,479,2017
2017-12-11,W.P. Kuala Lumpur,276,51,225,2017
2017-12-12,W.P. Kuala Lumpur,314,60,254,2017
2017-12-13,W.P. Kuala Lumpur,591,161,430,2017
2017-12-14,W.P. Kuala Lumpur,521,129,392,2017
2017-12-15,W.P. Kuala Lumpur,271,49,222,2017
2017-12-16,W.P. Kuala Lumpur,442,119,323,2017
2017-12-17,W.P. Kuala Lumpur,933,168,765,2017
2017-12-18,W.P. Kuala Lumpur,402,105,297,2017
2017-12-19,W.P. Kuala Lumpur,455,126,329,2017
2017-12-20,W.P. Kuala Lumpur,578,155,423,2017
2017-12-21,W.P. Kuala Lumpur,298,80,218,2017
2017-12-22,W.P. Kuala Lumpur,317,58,259,2017
2017-12-23,W.P. Kuala Lumpur,382,72,310,2017
2017-12-24,W.P. Kuala Lumpur,381,87,294,2017
2017-12-25,W.P. Kuala Lumpur,274,52,222,2017
2017-12-26,W.P. Kuala Lumpur,304,81,223,2017
2017-12-27,W.P. Kuala Lumpur,299,65,234,2017
2017-12-28,W.P. Kuala Lumpur,201,40,161,2017
2017-12-29,W.P. Kuala Lumpur,264,49,215,2017
2017-12-30,W.P. Kuala Lumpur,336,62,274,2017
2017-12-31,W.P. Kuala Lumpur,416,74,342,2017
2018-01-01,W.P. Kuala Lumpur,454,91,363,2018
2018-01-02,W.P. Kuala Lumpur,257,48,209,2018
2018-01-03,W.P. Kuala Lumpur,264,65,199,2018
2018-01-04,W.P. Kuala Lumpur,666,291,375,2018
2018-01-05,W.P. Kuala Lumpur,296,49,247,2018
2018-01-06,W.P. Kuala Lumpur,493,107,386,2018
2018-01-07,W.P. Kuala Lumpur,943,262,681,2018
2018-01-08,W.P. Kuala Lumpur,177,37,140,2018
2018-01-09,W.P. Kuala Lumpur,385,131,254,2018
2018-01-10,W.P. Kuala Lumpur,590,211,379,2018
2018-01-11,W.P. Kuala Lumpur,520,182,338,2018
2018-01-12,W.P. Kuala Lumpur,223,68,155,2018
2018-01-13,W.P. Kuala Lumpur,581,163,418,2018
2018-01-14,W.P. Kuala Lumpur,634,106,528,2018
2018-01-15,W.P. Kuala Lumpur,293,75,218,2018
2018-01-16,W.P. Kuala Lumpur,569,158,411,2018
2018-01-17,W.P. Kuala Lumpur,520,122,398,2018
2018-01-18,W.P. Kuala Lumpur,785,236,549,2018
2018-01-19,W.P. Kuala Lumpur,329,76,253,2018
2018-01-20,W.P. Kuala Lumpur,604,149,455,2018
2018-01-21,W.P. Kuala Lumpur,546,114,432,2018
2018-01-22,W.P. Kuala Lumpur,303,63,240,2018
2018-01-23,W.P. Kuala Lumpur,539,159,380,2018
2018-01-24,W.P. Kuala Lumpur,582,250,332,2018
2018-01-25,W.P. Kuala Lumpur,494,127,367,2018
2018-01-26,W.P. Kuala Lumpur,148,31,117,2018
2018-01-27,W.P. Kuala Lumpur,734,342,392,2018
2018-01-28,W.P. Kuala Lumpur,582,141,441,2018
2018-01-29,W.P. Kuala Lumpur,151,29,122,2018
2018-01-30,W.P. Kuala Lumpur,665,143,522,2018
2018-01-31,W.P. Kuala Lumpur,1379,311,1068,2018
2018-02-01,W.P. Kuala Lumpur,408,112,296,2018
2018-02-02,W.P. Kuala Lumpur,206,41,165,2018
2018-02-03,W.P. Kuala Lumpur,562,245,317,2018
2018-02-04,W.P. Kuala Lumpur,495,137,358,2018
2018-02-05,W.P. Kuala Lumpur,209,28,181,2018
2018-02-06,W.P. Kuala Lumpur,612,183,429,2018
2018-02-07,W.P. Kuala Lumpur,798,219,579,2018
2018-02-08,W.P. Kuala Lumpur,767,230,537,2018
2018-02-09,W.P. Kuala Lumpur,430,102,328,2018
2018-02-10,W.P. Kuala Lumpur,664,154,510,2018
2018-02-11,W.P. Kuala Lumpur,666,157,509,2018
2018-02-12,W.P. Kuala Lumpur,250,63,187,2018
2018-02-13,W.P. Kuala Lumpur,736,217,519,2018
2018-02-14,W.P. Kuala Lumpur,379,102,277,2018
2018-02-15,W.P. Kuala Lumpur,870,530,340,2018
2018-02-16,W.P. Kuala Lumpur,0,0,0,2018
2018-02-17,W.P. Kuala Lumpur,438,114,324,2018
2018-02-18,W.P. Kuala Lumpur,533,165,368,2018
2018-02-19,W.P. Kuala Lumpur,340,84,256,2018
2018-02-20,W.P. Kuala Lumpur,584,132,452,2018
2018-02-21,W.P. Kuala Lumpur,693,220,473,2018
2018-02-22,W.P. Kuala Lumpur,680,241,439,2018
2018-02-23,W.P. Kuala Lumpur,405,108,297,2018
2018-02-24,W.P. Kuala Lumpur,730,196,534,2018
2018-02-25,W.P. Kuala Lumpur,758,224,534,2018
2018-02-26,W.P. Kuala Lumpur,388,77,311,2018
2018-02-27,W.P. Kuala Lumpur,406,93,313,2018
2018-02-28,W.P. Kuala Lumpur,1077,309,768,2018
2018-03-01,W.P. Kuala Lumpur,252,47,205,2018
2018-03-02,W.P. Kuala Lumpur,250,61,189,2018
2018-03-03,W.P. Kuala Lumpur,667,171,496,2018
2018-03-04,W.P. Kuala Lumpur,795,183,612,2018
2018-03-05,W.P. Kuala Lumpur,269,40,229,2018
2018-03-06,W.P. Kuala Lumpur,726,184,542,2018
2018-03-07,W.P. Kuala Lumpur,584,166,418,2018
2018-03-08,W.P. Kuala Lumpur,414,103,311,2018
2018-03-09,W.P. Kuala Lumpur,568,155,413,2018
2018-03-10,W.P. Kuala Lumpur,364,70,294,2018
2018-03-11,W.P. Kuala Lumpur,1180,248,932,2018
2018-03-12,W.P. Kuala Lumpur,284,59,225,2018
2018-03-13,W.P. Kuala Lumpur,588,222,366,2018
2018-03-14,W.P. Kuala Lumpur,660,146,514,2018
2018-03-15,W.P. Kuala Lumpur,548,153,395,2018
2018-03-16,W.P. Kuala Lumpur,212,40,172,2018
2018-03-17,W.P. Kuala Lumpur,777,192,585,2018
2018-03-18,W.P. Kuala Lumpur,859,213,646,2018
2018-03-19,W.P. Kuala Lumpur,257,58,199,2018
2018-03-20,W.P. Kuala Lumpur,780,262,518,2018
2018-03-21,W.P. Kuala Lumpur,553,131,422,2018
2018-03-22,W.P. Kuala Lumpur,664,202,462,2018
2018-03-23,W.P. Kuala Lumpur,242,74,168,2018
2018-03-24,W.P. Kuala Lumpur,545,139,406,2018
2018-03-25,W.P. Kuala Lumpur,584,129,455,2018
2018-03-26,W.P. Kuala Lumpur,497,132,365,2018
2018-03-27,W.P. Kuala Lumpur,830,255,575,2018
2018-03-28,W.P. Kuala Lumpur,843,264,579,2018
2018-03-29,W.P. Kuala Lumpur,759,204,555,2018
2018-03-30,W.P. Kuala Lumpur,720,253,467,2018
2018-03-31,W.P. Kuala Lumpur,669,254,415,2018
2018-04-01,W.P. Kuala Lumpur,644,186,458,2018
2018-04-02,W.P. Kuala Lumpur,359,90,269,2018
2018-04-03,W.P. Kuala Lumpur,468,111,357,2018
2018-04-04,W.P. Kuala Lumpur,674,172,502,2018
2018-04-05,W.P. Kuala Lumpur,722,228,494,2018
2018-04-06,W.P. Kuala Lumpur,400,106,294,2018
2018-04-07,W.P. Kuala Lumpur,605,127,478,2018
2018-04-08,W.P. Kuala Lumpur,468,88,380,2018
2018-04-09,W.P. Kuala Lumpur,339,112,227,2018
2018-04-10,W.P. Kuala Lumpur,710,261,449,2018
2018-04-11,W.P. Kuala Lumpur,761,233,528,2018
2018-04-12,W.P. Kuala Lumpur,655,248,407,2018
2018-04-13,W.P. Kuala Lumpur,227,48,179,2018
2018-04-14,W.P. Kuala Lumpur,571,144,427,2018
2018-04-15,W.P. Kuala Lumpur,591,160,431,2018
2018-04-16,W.P. Kuala Lumpur,497,98,399,2018
2018-04-17,W.P. Kuala Lumpur,562,132,430,2018
2018-04-18,W.P. Kuala Lumpur,637,179,458,2018
2018-04-19,W.P. Kuala Lumpur,780,222,558,2018
2018-04-20,W.P. Kuala Lumpur,366,118,248,2018
2018-04-21,W.P. Kuala Lumpur,643,157,486,2018
2018-04-22,W.P. Kuala Lumpur,832,160,672,2018
2018-04-23,W.P. Kuala Lumpur,412,125,287,2018
2018-04-24,W.P. Kuala Lumpur,636,168,468,2018
2018-04-25,W.P. Kuala Lumpur,488,137,351,2018
2018-04-26,W.P. Kuala Lumpur,558,162,396,2018
2018-04-27,W.P. Kuala Lumpur,407,117,290,2018
2018-04-28,W.P. Kuala Lumpur,356,95,261,2018
2018-04-29,W.P. Kuala Lumpur,1003,283,720,2018
2018-04-30,W.P. Kuala Lumpur,282,72,210,2018
2018-05-01,W.P. Kuala Lumpur,1763,227,1536,2018
2018-05-02,W.P. Kuala Lumpur,746,236,510,2018
2018-05-03,W.P. Kuala Lumpur,741,255,486,2018
2018-05-04,W.P. Kuala Lumpur,777,187,590,2018
2018-05-05,W.P. Kuala Lumpur,643,193,450,2018
2018-05-06,W.P. Kuala Lumpur,871,177,694,2018
2018-05-07,W.P. Kuala Lumpur,568,143,425,2018
2018-05-08,W.P. Kuala Lumpur,255,52,203,2018
2018-05-09,W.P. Kuala Lumpur,50,5,45,2018
2018-05-10,W.P. Kuala Lumpur,76,6,70,2018
2018-05-11,W.P. Kuala Lumpur,421,110,311,2018
2018-05-12,W.P. Kuala Lumpur,598,136,462,2018
2018-05-13,W.P. Kuala Lumpur,1032,229,803,2018
2018-05-14,W.P. Kuala Lumpur,535,144,391,2018
2018-05-15,W.P. Kuala Lumpur,930,237,693,2018
2018-05-16,W.P. Kuala Lumpur,998,278,720,2018
2018-05-17,W.P. Kuala Lumpur,59,7,52,2018
2018-05-18,W.P. Kuala Lumpur,69,10,59,2018
2018-05-19,W.P. Kuala Lumpur,460,129,331,2018
2018-05-20,W.P. Kuala Lumpur,545,138,407,2018
2018-05-21,W.P. Kuala Lumpur,100,17,83,2018
2018-05-22,W.P. Kuala Lumpur,206,87,119,2018
2018-05-23,W.P. Kuala Lumpur,275,114,161,2018
2018-05-24,W.P. Kuala Lumpur,167,78,89,2018
2018-05-25,W.P. Kuala Lumpur,173,52,121,2018
2018-05-26,W.P. Kuala Lumpur,476,116,360,2018
2018-05-27,W.P. Kuala Lumpur,1015,224,791,2018
2018-05-28,W.P. Kuala Lumpur,255,59,196,2018
2018-05-29,W.P. Kuala Lumpur,1676,341,1335,2018
2018-05-30,W.P. Kuala Lumpur,127,52,75,2018
2018-05-31,W.P. Kuala Lumpur,208,74,134,2018
2018-06-01,W.P. Kuala Lumpur,185,27,158,2018
2018-06-02,W.P. Kuala Lumpur,255,54,201,2018
2018-06-03,W.P. Kuala Lumpur,1310,211,1099,2018
2018-06-04,W.P. Kuala Lumpur,309,102,207,2018
2018-06-05,W.P. Kuala Lumpur,324,94,230,2018
2018-06-06,W.P. Kuala Lumpur,275,67,208,2018
2018-06-07,W.P. Kuala Lumpur,240,51,189,2018
2018-06-08,W.P. Kuala Lumpur,235,54,181,2018
2018-06-09,W.P. Kuala Lumpur,361,91,270,2018
2018-06-10,W.P. Kuala Lumpur,914,128,786,2018
2018-06-11,W.P. Kuala Lumpur,285,66,219,2018
2018-06-12,W.P. Kuala Lumpur,283,67,216,2018
2018-06-13,W.P. Kuala Lumpur,309,93,216,2018
2018-06-14,W.P. Kuala Lumpur,99,5,94,2018
2018-06-15,W.P. Kuala Lumpur,0,0,0,2018
2018-06-16,W.P. Kuala Lumpur,77,5,72,2018
2018-06-17,W.P. Kuala Lumpur,348,81,267,2018
2018-06-18,W.P. Kuala Lumpur,259,42,217,2018
2018-06-19,W.P. Kuala Lumpur,278,59,219,2018
2018-06-20,W.P. Kuala Lumpur,342,78,264,2018
2018-06-21,W.P. Kuala Lumpur,356,75,281,2018
2018-06-22,W.P. Kuala Lumpur,487,103,384,2018
2018-06-23,W.P. Kuala Lumpur,535,128,407,2018
2018-06-24,W.P. Kuala Lumpur,813,172,641,2018
2018-06-25,W.P. Kuala Lumpur,422,105,317,2018
2018-06-26,W.P. Kuala Lumpur,511,139,372,2018
2018-06-27,W.P. Kuala Lumpur,621,147,474,2018
2018-06-28,W.P. Kuala Lumpur,620,141,479,2018
2018-06-29,W.P. Kuala Lumpur,361,145,216,2018
2018-06-30,W.P. Kuala Lumpur,921,337,584,2018
2018-07-01,W.P. Kuala Lumpur,990,220,770,2018
2018-07-02,W.P. Kuala Lumpur,120,13,107,2018
2018-07-03,W.P. Kuala Lumpur,442,108,334,2018
2018-07-04,W.P. Kuala Lumpur,514,163,351,2018
2018-07-05,W.P. Kuala Lumpur,420,104,316,2018
2018-07-06,W.P. Kuala Lumpur,437,122,315,2018
2018-07-07,W.P. Kuala Lumpur,596,98,498,2018
2018-07-08,W.P. Kuala Lumpur,992,199,793,2018
2018-07-09,W.P. Kuala Lumpur,328,69,259,2018
2018-07-10,W.P. Kuala Lumpur,640,314,326,2018
2018-07-11,W.P. Kuala Lumpur,1056,372,684,2018
2018-07-12,W.P. Kuala Lumpur,783,314,469,2018
2018-07-13,W.P. Kuala Lumpur,810,289,521,2018
2018-07-14,W.P. Kuala Lumpur,792,249,543,2018
2018-07-15,W.P. Kuala Lumpur,870,199,671,2018
2018-07-16,W.P. Kuala Lumpur,338,100,238,2018
2018-07-17,W.P. Kuala Lumpur,558,139,419,2018
2018-07-18,W.P. Kuala Lumpur,538,177,361,2018
2018-07-19,W.P. Kuala Lumpur,679,220,459,2018
2018-07-20,W.P. Kuala Lumpur,284,57,227,2018
2018-07-21,W.P. Kuala Lumpur,647,158,489,2018
2018-07-22,W.P. Kuala Lumpur,845,170,675,2018
2018-07-23,W.P. Kuala Lumpur,280,41,239,2018
2018-07-24,W.P. Kuala Lumpur,631,146,485,2018
2018-07-25,W.P. Kuala Lumpur,858,271,587,2018
2018-07-26,W.P. Kuala Lumpur,510,122,388,2018
2018-07-27,W.P. Kuala Lumpur,437,94,343,2018
2018-07-28,W.P. Kuala Lumpur,704,168,536,2018
2018-07-29,W.P. Kuala Lumpur,995,252,743,2018
2018-07-30,W.P. Kuala Lumpur,227,73,154,2018
2018-07-31,W.P. Kuala Lumpur,348,115,233,2018
2018-08-01,W.P. Kuala Lumpur,665,358,307,2018
2018-08-02,W.P. Kuala Lumpur,545,165,380,2018
2018-08-03,W.P. Kuala Lumpur,258,64,194,2018
2018-08-04,W.P. Kuala Lumpur,387,100,287,2018
2018-08-05,W.P. Kuala Lumpur,486,91,395,2018
2018-08-06,W.P. Kuala Lumpur,524,177,347,2018
2018-08-07,W.P. Kuala Lumpur,432,128,304,2018
2018-08-08,W.P. Kuala Lumpur,659,263,396,2018
2018-08-09,W.P. Kuala Lumpur,474,192,282,2018
2018-08-10,W.P. Kuala Lumpur,532,176,356,2018
2018-08-11,W.P. Kuala Lumpur,644,165,479,2018
2018-08-12,W.P. Kuala Lumpur,1100,227,873,2018
2018-08-13,W.P. Kuala Lumpur,523,204,319,2018
2018-08-14,W.P. Kuala Lumpur,597,163,434,2018
2018-08-15,W.P. Kuala Lumpur,729,295,434,2018
2018-08-16,W.P. Kuala Lumpur,730,253,477,2018
2018-08-17,W.P. Kuala Lumpur,424,136,288,2018
2018-08-18,W.P. Kuala Lumpur,1245,259,986,2018
2018-08-19,W.P. Kuala Lumpur,1735,439,1296,2018
2018-08-20,W.P. Kuala Lumpur,267,49,218,2018
2018-08-21,W.P. Kuala Lumpur,296,73,223,2018
2018-08-22,W.P. Kuala Lumpur,76,6,70,2018
2018-08-23,W.P. Kuala Lumpur,105,8,97,2018
2018-08-24,W.P. Kuala Lumpur,148,34,114,2018
2018-08-25,W.P. Kuala Lumpur,436,109,327,2018
2018-08-26,W.P. Kuala Lumpur,477,171,306,2018
2018-08-27,W.P. Kuala Lumpur,315,49,266,2018
2018-08-28,W.P. Kuala Lumpur,489,100,389,2018
2018-08-29,W.P. Kuala Lumpur,509,285,224,2018
2018-08-30,W.P. Kuala Lumpur,340,66,274,2018
2018-08-31,W.P. Kuala Lumpur,741,158,583,2018
2018-09-01,W.P. Kuala Lumpur,493,106,387,2018
2018-09-02,W.P. Kuala Lumpur,777,176,601,2018
2018-09-03,W.P. Kuala Lumpur,258,53,205,2018
2018-09-04,W.P. Kuala Lumpur,547,119,428,2018
2018-09-05,W.P. Kuala Lumpur,698,225,473,2018
2018-09-06,W.P. Kuala Lumpur,282,43,239,2018
2018-09-07,W.P. Kuala Lumpur,412,109,303,2018
2018-09-08,W.P. Kuala Lumpur,428,78,350,2018
2018-09-09,W.P. Kuala Lumpur,576,137,439,2018
2018-09-10,W.P. Kuala Lumpur,280,62,218,2018
2018-09-11,W.P. Kuala Lumpur,293,58,235,2018
2018-09-12,W.P. Kuala Lumpur,231,59,172,2018
2018-09-13,W.P. Kuala Lumpur,605,224,381,2018
2018-09-14,W.P. Kuala Lumpur,460,105,355,2018
2018-09-15,W.P. Kuala Lumpur,294,52,242,2018
2018-09-16,W.P. Kuala Lumpur,707,174,533,2018
2018-09-17,W.P. Kuala Lumpur,317,50,267,2018
2018-09-18,W.P. Kuala Lumpur,474,141,333,2018
2018-09-19,W.P. Kuala Lumpur,512,122,390,2018
2018-09-20,W.P. Kuala Lumpur,477,123,354,2018
2018-09-21,W.P. Kuala Lumpur,484,173,311,2018
2018-09-22,W.P. Kuala Lumpur,453,125,328,2018
2018-09-23,W.P. Kuala Lumpur,772,168,604,2018
2018-09-24,W.P. Kuala Lumpur,330,85,245,2018
2018-09-25,W.P. Kuala Lumpur,678,247,431,2018
2018-09-26,W.P. Kuala Lumpur,681,281,400,2018
2018-09-27,W.P. Kuala Lumpur,719,218,501,2018
2018-09-28,W.P. Kuala Lumpur,421,111,310,2018
2018-09-29,W.P. Kuala Lumpur,552,121,431,2018
2018-09-30,W.P. Kuala Lumpur,760,149,611,2018
2018-10-01,W.P. Kuala Lumpur,356,75,281,2018
2018-10-02,W.P. Kuala Lumpur,575,115,460,2018
2018-10-03,W.P. Kuala Lumpur,518,139,379,2018
2018-10-04,W.P. Kuala Lumpur,494,199,295,2018
2018-10-05,W.P. Kuala Lumpur,423,101,322,2018
2018-10-06,W.P. Kuala Lumpur,581,123,458,2018
2018-10-07,W.P. Kuala Lumpur,639,136,503,2018
2018-10-08,W.P. Kuala Lumpur,673,213,460,2018
2018-10-09,W.P. Kuala Lumpur,657,202,455,2018
2018-10-10,W.P. Kuala Lumpur,430,97,333,2018
2018-10-11,W.P. Kuala Lumpur,546,141,405,2018
2018-10-12,W.P. Kuala Lumpur,448,111,337,2018
2018-10-13,W.P. Kuala Lumpur,671,217,454,2018
2018-10-14,W.P. Kuala Lumpur,865,132,733,2018
2018-10-15,W.P. Kuala Lumpur,210,42,168,2018
2018-10-16,W.P. Kuala Lumpur,522,183,339,2018
2018-10-17,W.P. Kuala Lumpur,741,207,534,2018
2018-10-18,W.P. Kuala Lumpur,647,208,439,2018
2018-10-19,W.P. Kuala Lumpur,527,182,345,2018
2018-10-20,W.P. Kuala Lumpur,482,105,377,2018
2018-10-21,W.P. Kuala Lumpur,792,177,615,2018
2018-10-22,W.P. Kuala Lumpur,238,60,178,2018
2018-10-23,W.P. Kuala Lumpur,639,214,425,2018
2018-10-24,W.P. Kuala Lumpur,617,226,391,2018
2018-10-25,W.P. Kuala Lumpur,597,225,372,2018
2018-10-26,W.P. Kuala Lumpur,577,146,431,2018
2018-10-27,W.P. Kuala Lumpur,575,187,388,2018
2018-10-28,W.P. Kuala Lumpur,992,252,740,2018
2018-10-29,W.P. Kuala Lumpur,312,81,231,2018
2018-10-30,W.P. Kuala Lumpur,362,102,260,2018
2018-10-31,W.P. Kuala Lumpur,573,196,377,2018
2018-11-01,W.P. Kuala Lumpur,316,66,250,2018
2018-11-02,W.P. Kuala Lumpur,221,73,148,2018
2018-11-03,W.P. Kuala Lumpur,447,79,368,2018
2018-11-04,W.P. Kuala Lumpur,938,219,719,2018
2018-11-05,W.P. Kuala Lumpur,382,83,299,2018
2018-11-06,W.P. Kuala Lumpur,559,135,424,2018
2018-11-07,W.P. Kuala Lumpur,413,132,281,2018
2018-11-08,W.P. Kuala Lumpur,440,124,316,2018
2018-11-09,W.P. Kuala Lumpur,390,89,301,2018
2018-11-10,W.P. Kuala Lumpur,354,68,286,2018
2018-11-11,W.P. Kuala Lumpur,970,247,723,2018
2018-11-12,W.P. Kuala Lumpur,768,208,560,2018
2018-11-13,W.P. Kuala Lumpur,743,185,558,2018
2018-11-14,W.P. Kuala Lumpur,848,215,633,2018
2018-11-15,W.P. Kuala Lumpur,1192,361,831,2018
2018-11-16,W.P. Kuala Lumpur,593,150,443,2018
2018-11-17,W.P. Kuala Lumpur,450,79,371,2018
2018-11-18,W.P. Kuala Lumpur,897,164,733,2018
2018-11-19,W.P. Kuala Lumpur,747,217,530,2018
2018-11-20,W.P. Kuala Lumpur,190,36,154,2018
2018-11-21,W.P. Kuala Lumpur,784,292,492,2018
2018-11-22,W.P. Kuala Lumpur,852,249,603,2018
2018-11-23,W.P. Kuala Lumpur,547,160,387,2018
2018-11-24,W.P. Kuala Lumpur,579,157,422,2018
2018-11-25,W.P. Kuala Lumpur,989,181,808,2018
2018-11-26,W.P. Kuala Lumpur,474,133,341,2018
2018-11-27,W.P. Kuala Lumpur,488,150,338,2018
2018-11-28,W.P. Kuala Lumpur,529,147,382,2018
2018-11-29,W.P. Kuala Lumpur,607,205,402,2018
2018-11-30,W.P. Kuala Lumpur,452,96,356,2018
2018-12-01,W.P. Kuala Lumpur,465,130,335,2018
2018-12-02,W.P. Kuala Lumpur,877,156,721,2018
2018-12-03,W.P. Kuala Lumpur,476,113,363,2018
2018-12-04,W.P. Kuala Lumpur,577,152,425,2018
2018-12-05,W.P. Kuala Lumpur,790,230,560,2018
2018-12-06,W.P. Kuala Lumpur,720,151,569,2018
2018-12-07,W.P. Kuala Lumpur,343,102,241,2018
2018-12-08,W.P. Kuala Lumpur,523,168,355,2018
2018-12-09,W.P. Kuala Lumpur,432,115,317,2018
2018-12-10,W.P. Kuala Lumpur,153,34,119,2018
2018-12-11,W.P. Kuala Lumpur,352,59,293,2018
2018-12-12,W.P. Kuala Lumpur,185,24,161,2018
2018-12-13,W.P. Kuala Lumpur,451,135,316,2018
2018-12-14,W.P. Kuala Lumpur,271,85,186,2018
2018-12-15,W.P. Kuala Lumpur,639,191,448,2018
2018-12-16,W.P. Kuala Lumpur,328,72,256,2018
2018-12-17,W.P. Kuala Lumpur,274,41,233,2018
2018-12-18,W.P. Kuala Lumpur,408,85,323,2018
2018-12-19,W.P. Kuala Lumpur,450,148,302,2018
2018-12-20,W.P. Kuala Lumpur,319,39,280,2018
2018-12-21,W.P. Kuala Lumpur,169,23,146,2018
2018-12-22,W.P. Kuala Lumpur,482,121,361,2018
2018-12-23,W.P. Kuala Lumpur,785,153,632,2018
2018-12-24,W.P. Kuala Lumpur,266,37,229,2018
2018-12-25,W.P. Kuala Lumpur,454,78,376,2018
2018-12-26,W.P. Kuala Lumpur,193,35,158,2018
2018-12-27,W.P. Kuala Lumpur,377,98,279,2018
2018-12-28,W.P. Kuala Lumpur,300,56,244,2018
2018-12-29,W.P. Kuala Lumpur,549,121,428,2018
2018-12-30,W.P. Kuala Lumpur,670,115,555,2018
2018-12-31,W.P. Kuala Lumpur,249,28,221,2018
2019-01-01,W.P. Kuala Lumpur,611,110,501,2019
2019-01-02,W.P. Kuala Lumpur,130,25,105,2019
2019-01-03,W.P. Kuala Lumpur,408,160,248,2019
2019-01-04,W.P. Kuala Lumpur,225,39,186,2019
2019-01-05,W.P. Kuala Lumpur,468,110,358,2019
2019-01-06,W.P. Kuala Lumpur,762,184,578,2019
2019-01-07,W.P. Kuala Lumpur,152,29,123,2019
2019-01-08,W.P. Kuala Lumpur,476,124,352,2019
2019-01-09,W.P. Kuala Lumpur,559,147,412,2019
2019-01-10,W.P. Kuala Lumpur,688,217,471,2019
2019-01-11,W.P. Kuala Lumpur,426,91,335,2019
2019-01-12,W.P. Kuala Lumpur,709,159,550,2019
2019-01-13,W.P. Kuala Lumpur,1106,220,886,2019
2019-01-14,W.P. Kuala Lumpur,304,59,245,2019
2019-01-15,W.P. Kuala Lumpur,406,104,302,2019
2019-01-16,W.P. Kuala Lumpur,539,152,387,2019
2019-01-17,W.P. Kuala Lumpur,677,172,505,2019
2019-01-18,W.P. Kuala Lumpur,267,52,215,2019
2019-01-19,W.P. Kuala Lumpur,497,124,373,2019
2019-01-20,W.P. Kuala Lumpur,1078,292,786,2019
2019-01-21,W.P. Kuala Lumpur,1566,387,1179,2019
2019-01-22,W.P. Kuala Lumpur,97,8,89,2019
2019-01-23,W.P. Kuala Lumpur,534,210,324,2019
2019-01-24,W.P. Kuala Lumpur,504,201,303,2019
2019-01-25,W.P. Kuala Lumpur,438,131,307,2019
2019-01-26,W.P. Kuala Lumpur,631,157,474,2019
2019-01-27,W.P. Kuala Lumpur,881,249,632,2019
2019-01-28,W.P. Kuala Lumpur,141,22,119,2019
2019-01-29,W.P. Kuala Lumpur,276,49,227,2019
2019-01-30,W.P. Kuala Lumpur,442,98,344,2019
2019-01-31,W.P. Kuala Lumpur,356,128,228,2019
2019-02-01,W.P. Kuala Lumpur,701,199,502,2019
2019-02-02,W.P. Kuala Lumpur,499,106,393,2019
2019-02-03,W.P. Kuala Lumpur,547,127,420,2019
2019-02-04,W.P. Kuala Lumpur,178,23,155,2019
2019-02-05,W.P. Kuala Lumpur,232,75,157,2019
2019-02-06,W.P. Kuala Lumpur,417,98,319,2019
2019-02-07,W.P. Kuala Lumpur,394,92,302,2019
2019-02-08,W.P. Kuala Lumpur,310,71,239,2019
2019-02-09,W.P. Kuala Lumpur,620,132,488,2019
2019-02-10,W.P. Kuala Lumpur,644,175,469,2019
2019-02-11,W.P. Kuala Lumpur,427,119,308,2019
2019-02-12,W.P. Kuala Lumpur,445,100,345,2019
2019-02-13,W.P. Kuala Lumpur,673,237,436,2019
2019-02-14,W.P. Kuala Lumpur,796,268,528,2019
2019-02-15,W.P. Kuala Lumpur,279,57,222,2019
2019-02-16,W.P. Kuala Lumpur,787,263,524,2019
2019-02-17,W.P. Kuala Lumpur,827,229,598,2019
2019-02-18,W.P. Kuala Lumpur,190,21,169,2019
2019-02-19,W.P. Kuala Lumpur,642,183,459,2019
2019-02-20,W.P. Kuala Lumpur,671,259,412,2019
2019-02-21,W.P. Kuala Lumpur,878,286,592,2019
2019-02-22,W.P. Kuala Lumpur,550,124,426,2019
2019-02-23,W.P. Kuala Lumpur,754,214,540,2019
2019-02-24,W.P. Kuala Lumpur,553,137,416,2019
2019-02-25,W.P. Kuala Lumpur,339,77,262,2019
2019-02-26,W.P. Kuala Lumpur,785,318,467,2019
2019-02-27,W.P. Kuala Lumpur,640,156,484,2019
2019-02-28,W.P. Kuala Lumpur,692,199,493,2019
2019-03-01,W.P. Kuala Lumpur,296,55,241,2019
2019-03-02,W.P. Kuala Lumpur,550,121,429,2019
2019-03-03,W.P. Kuala Lumpur,962,293,669,2019
2019-03-04,W.P. Kuala Lumpur,126,21,105,2019
2019-03-05,W.P. Kuala Lumpur,743,221,522,2019
2019-03-06,W.P. Kuala Lumpur,609,225,384,2019
2019-03-07,W.P. Kuala Lumpur,922,307,615,2019
2019-03-08,W.P. Kuala Lumpur,307,78,229,2019
2019-03-09,W.P. Kuala Lumpur,494,146,348,2019
2019-03-10,W.P. Kuala Lumpur,999,177,822,2019
2019-03-11,W.P. Kuala Lumpur,172,37,135,2019
2019-03-12,W.P. Kuala Lumpur,471,103,368,2019
2019-03-13,W.P. Kuala Lumpur,812,237,575,2019
2019-03-14,W.P. Kuala Lumpur,690,211,479,2019
2019-03-15,W.P. Kuala Lumpur,597,152,445,2019
2019-03-16,W.P. Kuala Lumpur,801,199,602,2019
2019-03-17,W.P. Kuala Lumpur,850,190,660,2019
2019-03-18,W.P. Kuala Lumpur,581,156,425,2019
2019-03-19,W.P. Kuala Lumpur,880,272,608,2019
2019-03-20,W.P. Kuala Lumpur,691,215,476,2019
2019-03-21,W.P. Kuala Lumpur,482,156,326,2019
2019-03-22,W.P. Kuala Lumpur,213,48,165,2019
2019-03-23,W.P. Kuala Lumpur,680,186,494,2019
2019-03-24,W.P. Kuala Lumpur,1051,524,527,2019
2019-03-25,W.P. Kuala Lumpur,521,130,391,2019
2019-03-26,W.P. Kuala Lumpur,934,255,679,2019
2019-03-27,W.P. Kuala Lumpur,936,275,661,2019
2019-03-28,W.P. Kuala Lumpur,699,192,507,2019
2019-03-29,W.P. Kuala Lumpur,536,138,398,2019
2019-03-30,W.P. Kuala Lumpur,524,156,368,2019
2019-03-31,W.P. Kuala Lumpur,787,211,576,2019
2019-04-01,W.P. Kuala Lumpur,274,88,186,2019
2019-04-02,W.P. Kuala Lumpur,564,142,422,2019
2019-04-03,W.P. Kuala Lumpur,563,156,407,2019
2019-04-04,W.P. Kuala Lumpur,547,174,373,2019
2019-04-05,W.P. Kuala Lumpur,335,110,225,2019
2019-04-06,W.P. Kuala Lumpur,581,130,451,2019
2019-04-07,W.P. Kuala Lumpur,706,157,549,2019
2019-04-08,W.P. Kuala Lumpur,217,41,176,2019
2019-04-09,W.P. Kuala Lumpur,764,244,520,2019
2019-04-10,W.P. Kuala Lumpur,595,220,375,2019
2019-04-11,W.P. Kuala Lumpur,885,281,604,2019
2019-04-12,W.P. Kuala Lumpur,452,137,315,2019
2019-04-13,W.P. Kuala Lumpur,685,280,405,2019
2019-04-14,W.P. Kuala Lumpur,968,153,815,2019
2019-04-15,W.P. Kuala Lumpur,667,260,407,2019
2019-04-16,W.P. Kuala Lumpur,733,233,500,2019
2019-04-17,W.P. Kuala Lumpur,613,145,468,2019
2019-04-18,W.P. Kuala Lumpur,659,190,469,2019
2019-04-19,W.P. Kuala Lumpur,375,96,279,2019
2019-04-20,W.P. Kuala Lumpur,656,188,468,2019
2019-04-21,W.P. Kuala Lumpur,957,149,808,2019
2019-04-22,W.P. Kuala Lumpur,290,64,226,2019
2019-04-23,W.P. Kuala Lumpur,632,188,444,2019
2019-04-24,W.P. Kuala Lumpur,679,152,527,2019
2019-04-25,W.P. Kuala Lumpur,581,117,464,2019
2019-04-26,W.P. Kuala Lumpur,489,141,348,2019
2019-04-27,W.P. Kuala Lumpur,738,159,579,2019
2019-04-28,W.P. Kuala Lumpur,894,192,702,2019
2019-04-29,W.P. Kuala Lumpur,454,94,360,2019
2019-04-30,W.P. Kuala Lumpur,371,97,274,2019
2019-05-01,W.P. Kuala Lumpur,1741,218,1523,2019
2019-05-02,W.P. Kuala Lumpur,659,206,453,2019
2019-05-03,W.P. Kuala Lumpur,556,147,409,2019
2019-05-04,W.P. Kuala Lumpur,617,156,461,2019
2019-05-05,W.P. Kuala Lumpur,1284,234,1050,2019
2019-05-06,W.P. Kuala Lumpur,100,29,71,2019
2019-05-07,W.P. Kuala Lumpur,135,52,83,2019
2019-05-08,W.P. Kuala Lumpur,122,37,85,2019
2019-05-09,W.P. Kuala Lumpur,187,49,138,2019
2019-05-10,W.P. Kuala Lumpur,225,69,156,2019
2019-05-11,W.P. Kuala Lumpur,378,106,272,2019
2019-05-12,W.P. Kuala Lumpur,973,210,763,2019
2019-05-13,W.P. Kuala Lumpur,176,65,111,2019
2019-05-14,W.P. Kuala Lumpur,111,15,96,2019
2019-05-15,W.P. Kuala Lumpur,108,24,84,2019
2019-05-16,W.P. Kuala Lumpur,214,60,154,2019
2019-05-17,W.P. Kuala Lumpur,229,77,152,2019
2019-05-18,W.P. Kuala Lumpur,385,102,283,2019
2019-05-19,W.P. Kuala Lumpur,1316,242,1074,2019
2019-05-20,W.P. Kuala Lumpur,223,47,176,2019
2019-05-21,W.P. Kuala Lumpur,231,42,189,2019
2019-05-22,W.P. Kuala Lumpur,345,98,247,2019
2019-05-23,W.P. Kuala Lumpur,111,16,95,2019
2019-05-24,W.P. Kuala Lumpur,163,29,134,2019
2019-05-25,W.P. Kuala Lumpur,525,114,411,2019
2019-05-26,W.P. Kuala Lumpur,926,160,766,2019
2019-05-27,W.P. Kuala Lumpur,181,39,142,2019
2019-05-28,W.P. Kuala Lumpur,283,60,223,2019
2019-05-29,W.P. Kuala Lumpur,330,83,247,2019
2019-05-30,W.P. Kuala Lumpur,167,25,142,2019
2019-05-31,W.P. Kuala Lumpur,194,35,159,2019
2019-06-01,W.P. Kuala Lumpur,304,64,240,2019
2019-06-02,W.P. Kuala Lumpur,500,116,384,2019
2019-06-03,W.P. Kuala Lumpur,129,19,110,2019
2019-06-04,W.P. Kuala Lumpur,51,2,49,2019
2019-06-05,W.P. Kuala Lumpur,0,0,0,2019
2019-06-06,W.P. Kuala Lumpur,100,7,93,2019
2019-06-07,W.P. Kuala Lumpur,110,7,103,2019
2019-06-08,W.P. Kuala Lumpur,291,52,239,2019
2019-06-09,W.P. Kuala Lumpur,770,111,659,2019
2019-06-10,W.P. Kuala Lumpur,325,67,258,2019
2019-06-11,W.P. Kuala Lumpur,649,134,515,2019
2019-06-12,W.P. Kuala Lumpur,574,125,449,2019
2019-06-13,W.P. Kuala Lumpur,755,247,508,2019
2019-06-14,W.P. Kuala Lumpur,581,114,467,2019
2019-06-15,W.P. Kuala Lumpur,935,233,702,2019
2019-06-16,W.P. Kuala Lumpur,875,194,681,2019
2019-06-17,W.P. Kuala Lumpur,465,113,352,2019
2019-06-18,W.P. Kuala Lumpur,418,111,307,2019
2019-06-19,W.P. Kuala Lumpur,630,157,473,2019
2019-06-20,W.P. Kuala Lumpur,575,139,436,2019
2019-06-21,W.P. Kuala Lumpur,455,137,318,2019
2019-06-22,W.P. Kuala Lumpur,858,253,605,2019
2019-06-23,W.P. Kuala Lumpur,815,143,672,2019
2019-06-24,W.P. Kuala Lumpur,373,66,307,2019
2019-06-25,W.P. Kuala Lumpur,512,127,385,2019
2019-06-26,W.P. Kuala Lumpur,631,179,452,2019
2019-06-27,W.P. Kuala Lumpur,584,147,437,2019
2019-06-28,W.P. Kuala Lumpur,440,106,334,2019
2019-06-29,W.P. Kuala Lumpur,607,188,419,2019
2019-06-30,W.P. Kuala Lumpur,660,130,530,2019
2019-07-01,W.P. Kuala Lumpur,91,10,81,2019
2019-07-02,W.P. Kuala Lumpur,402,110,292,2019
2019-07-03,W.P. Kuala Lumpur,584,182,402,2019
2019-07-04,W.P. Kuala Lumpur,675,202,473,2019
2019-07-05,W.P. Kuala Lumpur,315,74,241,2019
2019-07-06,W.P. Kuala Lumpur,311,42,269,2019
2019-07-07,W.P. Kuala Lumpur,1061,187,874,2019
2019-07-08,W.P. Kuala Lumpur,402,84,318,2019
2019-07-09,W.P. Kuala Lumpur,601,235,366,2019
2019-07-10,W.P. Kuala Lumpur,785,263,522,2019
2019-07-11,W.P. Kuala Lumpur,521,148,373,2019
2019-07-12,W.P. Kuala Lumpur,474,95,379,2019
2019-07-13,W.P. Kuala Lumpur,846,220,626,2019
2019-07-14,W.P. Kuala Lumpur,1163,244,919,2019
2019-07-15,W.P. Kuala Lumpur,389,84,305,2019
2019-07-16,W.P. Kuala Lumpur,649,186,463,2019
2019-07-17,W.P. Kuala Lumpur,636,176,460,2019
2019-07-18,W.P. Kuala Lumpur,524,126,398,2019
2019-07-19,W.P. Kuala Lumpur,430,96,334,2019
2019-07-20,W.P. Kuala Lumpur,651,186,465,2019
2019-07-21,W.P. Kuala Lumpur,858,216,642,2019
2019-07-22,W.P. Kuala Lumpur,598,198,400,2019
2019-07-23,W.P. Kuala Lumpur,684,192,492,2019
2019-07-24,W.P. Kuala Lumpur,1061,410,651,2019
2019-07-25,W.P. Kuala Lumpur,756,241,515,2019
2019-07-26,W.P. Kuala Lumpur,837,227,610,2019
2019-07-27,W.P. Kuala Lumpur,546,120,426,2019
2019-07-28,W.P. Kuala Lumpur,772,190,582,2019
2019-07-29,W.P. Kuala Lumpur,192,38,154,2019
2019-07-30,W.P. Kuala Lumpur,374,61,313,2019
2019-07-31,W.P. Kuala Lumpur,526,214,312,2019
2019-08-01,W.P. Kuala Lumpur,532,208,324,2019
2019-08-02,W.P. Kuala Lumpur,454,182,272,2019
2019-08-03,W.P. Kuala Lumpur,926,366,560,2019
2019-08-04,W.P. Kuala Lumpur,1177,233,944,2019
2019-08-05,W.P. Kuala Lumpur,249,47,202,2019
2019-08-06,W.P. Kuala Lumpur,550,189,361,2019
2019-08-07,W.P. Kuala Lumpur,638,205,433,2019
2019-08-08,W.P. Kuala Lumpur,517,173,344,2019
2019-08-09,W.P. Kuala Lumpur,264,60,204,2019
2019-08-10,W.P. Kuala Lumpur,123,10,113,2019
2019-08-11,W.P. Kuala Lumpur,413,96,317,2019
2019-08-12,W.P. Kuala Lumpur,195,31,164,2019
2019-08-13,W.P. Kuala Lumpur,189,34,155,2019
2019-08-14,W.P. Kuala Lumpur,407,78,329,2019
2019-08-15,W.P. Kuala Lumpur,371,102,269,2019
2019-08-16,W.P. Kuala Lumpur,245,59,186,2019
2019-08-17,W.P. Kuala Lumpur,632,162,470,2019
2019-08-18,W.P. Kuala Lumpur,1008,184,824,2019
2019-08-19,W.P. Kuala Lumpur,270,40,230,2019
2019-08-20,W.P. Kuala Lumpur,673,201,472,2019
2019-08-21,W.P. Kuala Lumpur,761,310,451,2019
2019-08-22,W.P. Kuala Lumpur,635,162,473,2019
2019-08-23,W.P. Kuala Lumpur,273,65,208,2019
2019-08-24,W.P. Kuala Lumpur,1545,338,1207,2019
2019-08-25,W.P. Kuala Lumpur,1605,400,1205,2019
2019-08-26,W.P. Kuala Lumpur,486,219,267,2019
2019-08-27,W.P. Kuala Lumpur,596,189,407,2019
2019-08-28,W.P. Kuala Lumpur,607,218,389,2019
2019-08-29,W.P. Kuala Lumpur,697,230,467,2019
2019-08-30,W.P. Kuala Lumpur,259,46,213,2019
2019-08-31,W.P. Kuala Lumpur,420,105,315,2019
2019-09-01,W.P. Kuala Lumpur,634,139,495,2019
2019-09-02,W.P. Kuala Lumpur,313,54,259,2019
2019-09-03,W.P. Kuala Lumpur,1125,941,184,2019
2019-09-04,W.P. Kuala Lumpur,518,172,346,2019
2019-09-05,W.P. Kuala Lumpur,432,94,338,2019
2019-09-06,W.P. Kuala Lumpur,238,55,183,2019
2019-09-07,W.P. Kuala Lumpur,559,141,418,2019
2019-09-08,W.P. Kuala Lumpur,749,193,556,2019
2019-09-09,W.P. Kuala Lumpur,116,11,105,2019
2019-09-10,W.P. Kuala Lumpur,273,80,193,2019
2019-09-11,W.P. Kuala Lumpur,644,150,494,2019
2019-09-12,W.P. Kuala Lumpur,510,102,408,2019
2019-09-13,W.P. Kuala Lumpur,463,103,360,2019
2019-09-14,W.P. Kuala Lumpur,396,75,321,2019
2019-09-15,W.P. Kuala Lumpur,613,155,458,2019
2019-09-16,W.P. Kuala Lumpur,316,47,269,2019
2019-09-17,W.P. Kuala Lumpur,211,52,159,2019
2019-09-18,W.P. Kuala Lumpur,590,174,416,2019
2019-09-19,W.P. Kuala Lumpur,368,54,314,2019
2019-09-20,W.P. Kuala Lumpur,401,76,325,2019
2019-09-21,W.P. Kuala Lumpur,700,209,491,2019
2019-09-22,W.P. Kuala Lumpur,1158,264,894,2019
2019-09-23,W.P. Kuala Lumpur,423,78,345,2019
2019-09-24,W.P. Kuala Lumpur,361,89,272,2019
2019-09-25,W.P. Kuala Lumpur,552,151,401,2019
2019-09-26,W.P. Kuala Lumpur,578,173,405,2019
2019-09-27,W.P. Kuala Lumpur,591,105,486,2019
2019-09-28,W.P. Kuala Lumpur,744,209,535,2019
2019-09-29,W.P. Kuala Lumpur,719,143,576,2019
2019-09-30,W.P. Kuala Lumpur,410,167,243,2019
2019-10-01,W.P. Kuala Lumpur,471,164,307,2019
2019-10-02,W.P. Kuala Lumpur,591,160,431,2019
2019-10-03,W.P. Kuala Lumpur,559,196,363,2019
2019-10-04,W.P. Kuala Lumpur,355,101,254,2019
2019-10-05,W.P. Kuala Lumpur,962,647,315,2019
2019-10-06,W.P. Kuala Lumpur,781,129,652,2019
2019-10-07,W.P. Kuala Lumpur,223,54,169,2019
2019-10-08,W.P. Kuala Lumpur,716,260,456,2019
2019-10-09,W.P. Kuala Lumpur,624,175,449,2019
2019-10-10,W.P. Kuala Lumpur,611,182,429,2019
2019-10-11,W.P. Kuala Lumpur,502,103,399,2019
2019-10-12,W.P. Kuala Lumpur,753,185,568,2019
2019-10-13,W.P. Kuala Lumpur,801,164,637,2019
2019-10-14,W.P. Kuala Lumpur,217,66,151,2019
2019-10-15,W.P. Kuala Lumpur,576,161,415,2019
2019-10-16,W.P. Kuala Lumpur,615,177,438,2019
2019-10-17,W.P. Kuala Lumpur,691,167,524,2019
2019-10-18,W.P. Kuala Lumpur,382,113,269,2019
2019-10-19,W.P. Kuala Lumpur,690,176,514,2019
2019-10-20,W.P. Kuala Lumpur,927,185,742,2019
2019-10-21,W.P. Kuala Lumpur,316,77,239,2019
2019-10-22,W.P. Kuala Lumpur,636,189,447,2019
2019-10-23,W.P. Kuala Lumpur,632,141,491,2019
2019-10-24,W.P. Kuala Lumpur,626,181,445,2019
2019-10-25,W.P. Kuala Lumpur,360,91,269,2019
2019-10-26,W.P. Kuala Lumpur,495,106,389,2019
2019-10-27,W.P. Kuala Lumpur,531,96,435,2019
2019-10-28,W.P. Kuala Lumpur,344,68,276,2019
2019-10-29,W.P. Kuala Lumpur,420,71,349,2019
2019-10-30,W.P. Kuala Lumpur,386,75,311,2019
2019-10-31,W.P. Kuala Lumpur,258,66,192,2019
2019-11-01,W.P. Kuala Lumpur,148,28,120,2019
2019-11-02,W.P. Kuala Lumpur,630,202,428,2019
2019-11-03,W.P. Kuala Lumpur,752,169,583,2019
2019-11-04,W.P. Kuala Lumpur,356,75,281,2019
2019-11-05,W.P. Kuala Lumpur,505,148,357,2019
2019-11-06,W.P. Kuala Lumpur,573,172,401,2019
2019-11-07,W.P. Kuala Lumpur,560,151,409,2019
2019-11-08,W.P. Kuala Lumpur,354,76,278,2019
2019-11-09,W.P. Kuala Lumpur,824,202,622,2019
2019-11-10,W.P. Kuala Lumpur,944,198,746,2019
2019-11-11,W.P. Kuala Lumpur,347,84,263,2019
2019-11-12,W.P. Kuala Lumpur,458,110,348,2019
2019-11-13,W.P. Kuala Lumpur,628,130,498,2019
2019-11-14,W.P. Kuala Lumpur,617,202,415,2019
2019-11-15,W.P. Kuala Lumpur,322,95,227,2019
2019-11-16,W.P. Kuala Lumpur,628,173,455,2019
2019-11-17,W.P. Kuala Lumpur,572,122,450,2019
2019-11-18,W.P. Kuala Lumpur,390,128,262,2019
2019-11-19,W.P. Kuala Lumpur,830,204,626,2019
2019-11-20,W.P. Kuala Lumpur,605,150,455,2019
2019-11-21,W.P. Kuala Lumpur,660,214,446,2019
2019-11-22,W.P. Kuala Lumpur,496,119,377,2019
2019-11-23,W.P. Kuala Lumpur,498,85,413,2019
2019-11-24,W.P. Kuala Lumpur,982,183,799,2019
2019-11-25,W.P. Kuala Lumpur,160,31,129,2019
2019-11-26,W.P. Kuala Lumpur,686,207,479,2019
2019-11-27,W.P. Kuala Lumpur,819,238,581,2019
2019-11-28,W.P. Kuala Lumpur,552,101,451,2019
2019-11-29,W.P. Kuala Lumpur,314,54,260,2019
2019-11-30,W.P. Kuala Lumpur,917,465,452,2019
2019-12-01,W.P. Kuala Lumpur,780,115,665,2019
2019-12-02,W.P. Kuala Lumpur,331,71,260,2019
2019-12-03,W.P. Kuala Lumpur,379,69,310,2019
2019-12-04,W.P. Kuala Lumpur,341,87,254,2019
2019-12-05,W.P. Kuala Lumpur,471,150,321,2019
2019-12-06,W.P. Kuala Lumpur,336,112,224,2019
2019-12-07,W.P. Kuala Lumpur,627,151,476,2019
2019-12-08,W.P. Kuala Lumpur,677,162,515,2019
2019-12-09,W.P. Kuala Lumpur,254,41,213,2019
2019-12-10,W.P. Kuala Lumpur,758,515,243,2019
2019-12-11,W.P. Kuala Lumpur,510,97,413,2019
2019-12-12,W.P. Kuala Lumpur,580,172,408,2019
2019-12-13,W.P. Kuala Lumpur,395,88,307,2019
2019-12-14,W.P. Kuala Lumpur,406,87,319,2019
2019-12-15,W.P. Kuala Lumpur,694,125,569,2019
2019-12-16,W.P. Kuala Lumpur,464,136,328,2019
2019-12-17,W.P. Kuala Lumpur,522,119,403,2019
2019-12-18,W.P. Kuala Lumpur,604,142,462,2019
2019-12-19,W.P. Kuala Lumpur,635,141,494,2019
2019-12-20,W.P. Kuala Lumpur,667,179,488,2019
2019-12-21,W.P. Kuala Lumpur,519,97,422,2019
2019-12-22,W.P. Kuala Lumpur,536,125,411,2019
2019-12-23,W.P. Kuala Lumpur,139,17,122,2019
2019-12-24,W.P. Kuala Lumpur,199,31,168,2019
2019-12-25,W.P. Kuala Lumpur,387,50,337,2019
2019-12-26,W.P. Kuala Lumpur,257,37,220,2019
2019-12-27,W.P. Kuala Lumpur,201,28,173,2019
2019-12-28,W.P. Kuala Lumpur,475,79,396,2019
2019-12-29,W.P. Kuala Lumpur,735,158,577,2019
2019-12-30,W.P. Kuala Lumpur,217,30,187,2019
2019-12-31,W.P. Kuala Lumpur,265,42,223,2019
2020-01-01,W.P. Kuala Lumpur,474,76,398,2020
2020-01-02,W.P. Kuala Lumpur,139,13,126,2020
2020-01-03,W.P. Kuala Lumpur,284,69,215,2020
2020-01-04,W.P. Kuala Lumpur,446,78,368,2020
2020-01-05,W.P. Kuala Lumpur,685,128,557,2020
2020-01-06,W.P. Kuala Lumpur,244,32,212,2020
2020-01-07,W.P. Kuala Lumpur,301,61,240,2020
2020-01-08,W.P. Kuala Lumpur,580,238,342,2020
2020-01-09,W.P. Kuala Lumpur,398,81,317,2020
2020-01-10,W.P. Kuala Lumpur,499,133,366,2020
2020-01-11,W.P. Kuala Lumpur,503,104,399,2020
2020-01-12,W.P. Kuala Lumpur,556,89,467,2020
2020-01-13,W.P. Kuala Lumpur,144,30,114,2020
2020-01-14,W.P. Kuala Lumpur,577,125,452,2020
2020-01-15,W.P. Kuala Lumpur,846,298,548,2020
2020-01-16,W.P. Kuala Lumpur,595,248,347,2020
2020-01-17,W.P. Kuala Lumpur,459,176,283,2020
2020-01-18,W.P. Kuala Lumpur,707,240,467,2020
2020-01-19,W.P. Kuala Lumpur,630,129,501,2020
2020-01-20,W.P. Kuala Lumpur,161,18,143,2020
2020-01-21,W.P. Kuala Lumpur,346,60,286,2020
2020-01-22,W.P. Kuala Lumpur,530,125,405,2020
2020-01-23,W.P. Kuala Lumpur,353,52,301,2020
2020-01-24,W.P. Kuala Lumpur,316,52,264,2020
2020-01-25,W.P. Kuala Lumpur,340,69,271,2020
2020-01-26,W.P. Kuala Lumpur,444,108,336,2020
2020-01-27,W.P. Kuala Lumpur,393,95,298,2020
2020-01-28,W.P. Kuala Lumpur,249,50,199,2020
2020-01-29,W.P. Kuala Lumpur,316,77,239,2020
2020-01-30,W.P. Kuala Lumpur,417,86,331,2020
2020-01-31,W.P. Kuala Lumpur,184,26,158,2020
2020-02-01,W.P. Kuala Lumpur,551,121,430,2020
2020-02-02,W.P. Kuala Lumpur,650,131,519,2020
2020-02-03,W.P. Kuala Lumpur,214,41,173,2020
2020-02-04,W.P. Kuala Lumpur,419,94,325,2020
2020-02-05,W.P. Kuala Lumpur,593,117,476,2020
2020-02-06,W.P. Kuala Lumpur,495,110,385,2020
2020-02-07,W.P. Kuala Lumpur,429,72,357,2020
2020-02-08,W.P. Kuala Lumpur,1571,333,1238,2020
2020-02-09,W.P. Kuala Lumpur,605,200,405,2020
2020-02-10,W.P. Kuala Lumpur,160,45,115,2020
2020-02-11,W.P. Kuala Lumpur,457,87,370,2020
2020-02-12,W.P. Kuala Lumpur,369,95,274,2020
2020-02-13,W.P. Kuala Lumpur,352,104,248,2020
2020-02-14,W.P. Kuala Lumpur,226,53,173,2020
2020-02-15,W.P. Kuala Lumpur,566,108,458,2020
2020-02-16,W.P. Kuala Lumpur,953,215,738,2020
2020-02-17,W.P. Kuala Lumpur,245,45,200,2020
2020-02-18,W.P. Kuala Lumpur,282,51,231,2020
2020-02-19,W.P. Kuala Lumpur,486,121,365,2020
2020-02-20,W.P. Kuala Lumpur,787,375,412,2020
2020-02-21,W.P. Kuala Lumpur,397,102,295,2020
2020-02-22,W.P. Kuala Lumpur,690,194,496,2020
2020-02-23,W.P. Kuala Lumpur,723,170,553,2020
2020-02-24,W.P. Kuala Lumpur,128,24,104,2020
2020-02-25,W.P. Kuala Lumpur,735,144,591,2020
2020-02-26,W.P. Kuala Lumpur,624,159,465,2020
2020-02-27,W.P. Kuala Lumpur,587,142,445,2020
2020-02-28,W.P. Kuala Lumpur,583,146,437,2020
2020-02-29,W.P. Kuala Lumpur,658,124,534,2020
2020-03-01,W.P. Kuala Lumpur,988,177,811,2020
2020-03-02,W.P. Kuala Lumpur,458,114,344,2020
2020-03-03,W.P. Kuala Lumpur,442,121,321,2020
2020-03-04,W.P. Kuala Lumpur,542,132,410,2020
2020-03-05,W.P. Kuala Lumpur,586,171,415,2020
2020-03-06,W.P. Kuala Lumpur,464,171,293,2020
2020-03-07,W.P. Kuala Lumpur,723,258,465,2020
2020-03-08,W.P. Kuala Lumpur,898,178,720,2020
2020-03-09,W.P. Kuala Lumpur,367,130,237,2020
2020-03-10,W.P. Kuala Lumpur,464,89,375,2020
2020-03-11,W.P. Kuala Lumpur,488,122,366,2020
2020-03-12,W.P. Kuala Lumpur,294,56,238,2020
2020-03-13,W.P. Kuala Lumpur,186,30,156,2020
2020-03-14,W.P. Kuala Lumpur,721,265,456,2020
2020-03-15,W.P. Kuala Lumpur,564,141,423,2020
2020-03-16,W.P. Kuala Lumpur,106,16,90,2020
2020-03-17,W.P. Kuala Lumpur,212,38,174,2020
2020-03-18,W.P. Kuala Lumpur,114,8,106,2020
2020-03-19,W.P. Kuala Lumpur,142,11,131,2020
2020-03-20,W.P. Kuala Lumpur,302,38,264,2020
2020-03-21,W.P. Kuala Lumpur,275,20,255,2020
2020-03-22,W.P. Kuala Lumpur,154,12,142,2020
2020-03-23,W.P. Kuala Lumpur,191,14,177,2020
2020-03-24,W.P. Kuala Lumpur,274,30,244,2020
2020-03-25,W.P. Kuala Lumpur,381,35,346,2020
2020-03-26,W.P. Kuala Lumpur,410,56,354,2020
2020-03-27,W.P. Kuala Lumpur,344,71,273,2020
2020-03-28,W.P. Kuala Lumpur,330,26,304,2020
2020-03-29,W.P. Kuala Lumpur,206,20,186,2020
2020-03-30,W.P. Kuala Lumpur,158,17,141,2020
2020-03-31,W.P. Kuala Lumpur,231,24,207,2020
2020-04-01,W.P. Kuala Lumpur,234,37,197,2020
2020-04-02,W.P. Kuala Lumpur,190,22,168,2020
2020-04-03,W.P. Kuala Lumpur,191,31,160,2020
2020-04-04,W.P. Kuala Lumpur,201,19,182,2020
2020-04-05,W.P. Kuala Lumpur,157,12,145,2020
2020-04-06,W.P. Kuala Lumpur,171,30,141,2020
2020-04-07,W.P. Kuala Lumpur,218,27,191,2020
2020-04-08,W.P. Kuala Lumpur,217,31,186,2020
2020-04-09,W.P. Kuala Lumpur,155,9,146,2020
2020-04-10,W.P. Kuala Lumpur,264,32,232,2020
2020-04-11,W.P. Kuala Lumpur,447,41,406,2020
2020-04-12,W.P. Kuala Lumpur,494,65,429,2020
2020-04-13,W.P. Kuala Lumpur,522,90,432,2020
2020-04-14,W.P. Kuala Lumpur,599,104,495,2020
2020-04-15,W.P. Kuala Lumpur,695,157,538,2020
2020-04-16,W.P. Kuala Lumpur,507,81,426,2020
2020-04-17,W.P. Kuala Lumpur,547,95,452,2020
2020-04-18,W.P. Kuala Lumpur,643,107,536,2020
2020-04-19,W.P. Kuala Lumpur,548,87,461,2020
2020-04-20,W.P. Kuala Lumpur,536,120,416,2020
2020-04-21,W.P. Kuala Lumpur,724,153,571,2020
2020-04-22,W.P. Kuala Lumpur,588,111,477,2020
2020-04-23,W.P. Kuala Lumpur,726,164,562,2020
2020-04-24,W.P. Kuala Lumpur,198,25,173,2020
2020-04-25,W.P. Kuala Lumpur,327,60,267,2020
2020-04-26,W.P. Kuala Lumpur,236,29,207,2020
2020-04-27,W.P. Kuala Lumpur,256,46,210,2020
2020-04-28,W.P. Kuala Lumpur,341,63,278,2020
2020-04-29,W.P. Kuala Lumpur,335,57,278,2020
2020-04-30,W.P. Kuala Lumpur,368,58,310,2020
2020-05-01,W.P. Kuala Lumpur,379,49,330,2020
2020-05-02,W.P. Kuala Lumpur,404,50,354,2020
2020-05-03,W.P. Kuala Lumpur,393,68,325,2020
2020-05-04,W.P. Kuala Lumpur,228,34,194,2020
2020-05-05,W.P. Kuala Lumpur,250,40,210,2020
2020-05-06,W.P. Kuala Lumpur,420,92,328,2020
2020-05-07,W.P. Kuala Lumpur,397,57,340,2020
2020-05-08,W.P. Kuala Lumpur,354,68,286,2020
2020-05-09,W.P. Kuala Lumpur,423,67,356,2020
2020-05-10,W.P. Kuala Lumpur,544,106,438,2020
2020-05-11,W.P. Kuala Lumpur,318,51,267,2020
2020-05-12,W.P. Kuala Lumpur,272,42,230,2020
2020-05-13,W.P. Kuala Lumpur,211,32,179,2020
2020-05-14,W.P. Kuala Lumpur,243,34,209,2020
2020-05-15,W.P. Kuala Lumpur,234,42,192,2020
2020-05-16,W.P. Kuala Lumpur,490,76,414,2020
2020-05-17,W.P. Kuala Lumpur,483,85,398,2020
2020-05-18,W.P. Kuala Lumpur,199,32,167,2020
2020-05-19,W.P. Kuala Lumpur,215,26,189,2020
2020-05-20,W.P. Kuala Lumpur,300,51,249,2020
2020-05-21,W.P. Kuala Lumpur,346,53,293,2020
2020-05-22,W.P. Kuala Lumpur,393,64,329,2020
2020-05-23,W.P. Kuala Lumpur,569,74,495,2020
2020-05-24,W.P. Kuala Lumpur,0,0,0,2020
2020-05-25,W.P. Kuala Lumpur,415,69,346,2020
2020-05-26,W.P. Kuala Lumpur,620,111,509,2020
2020-05-27,W.P. Kuala Lumpur,682,119,563,2020
2020-05-28,W.P. Kuala Lumpur,647,123,524,2020
2020-05-29,W.P. Kuala Lumpur,659,147,512,2020
2020-05-30,W.P. Kuala Lumpur,1149,241,908,2020
2020-05-31,W.P. Kuala Lumpur,1286,303,983,2020
2020-06-01,W.P. Kuala Lumpur,438,96,342,2020
2020-06-02,W.P. Kuala Lumpur,442,84,358,2020
2020-06-03,W.P. Kuala Lumpur,428,92,336,2020
2020-06-04,W.P. Kuala Lumpur,402,93,309,2020
2020-06-05,W.P. Kuala Lumpur,514,105,409,2020
2020-06-06,W.P. Kuala Lumpur,1052,266,786,2020
2020-06-07,W.P. Kuala Lumpur,1215,311,904,2020
2020-06-08,W.P. Kuala Lumpur,722,163,559,2020
2020-06-09,W.P. Kuala Lumpur,516,103,413,2020
2020-06-10,W.P. Kuala Lumpur,346,56,290,2020
2020-06-11,W.P. Kuala Lumpur,347,71,276,2020
2020-06-12,W.P. Kuala Lumpur,344,79,265,2020
2020-06-13,W.P. Kuala Lumpur,558,132,426,2020
2020-06-14,W.P. Kuala Lumpur,787,140,647,2020
2020-06-15,W.P. Kuala Lumpur,247,43,204,2020
2020-06-16,W.P. Kuala Lumpur,267,42,225,2020
2020-06-17,W.P. Kuala Lumpur,205,20,185,2020
2020-06-18,W.P. Kuala Lumpur,192,37,155,2020
2020-06-19,W.P. Kuala Lumpur,200,25,175,2020
2020-06-20,W.P. Kuala Lumpur,556,102,454,2020
2020-06-21,W.P. Kuala Lumpur,644,149,495,2020
2020-06-22,W.P. Kuala Lumpur,258,39,219,2020
2020-06-23,W.P. Kuala Lumpur,287,48,239,2020
2020-06-24,W.P. Kuala Lumpur,255,55,200,2020
2020-06-25,W.P. Kuala Lumpur,345,98,247,2020
2020-06-26,W.P. Kuala Lumpur,359,63,296,2020
2020-06-27,W.P. Kuala Lumpur,728,149,579,2020
2020-06-28,W.P. Kuala Lumpur,737,158,579,2020
2020-06-29,W.P. Kuala Lumpur,221,33,188,2020
2020-06-30,W.P. Kuala Lumpur,265,40,225,2020
2020-07-01,W.P. Kuala Lumpur,275,29,246,2020
2020-07-02,W.P. Kuala Lumpur,426,76,350,2020
2020-07-03,W.P. Kuala Lumpur,263,26,237,2020
2020-07-04,W.P. Kuala Lumpur,735,145,590,2020
2020-07-05,W.P. Kuala Lumpur,792,151,641,2020
2020-07-06,W.P. Kuala Lumpur,542,282,260,2020
2020-07-07,W.P. Kuala Lumpur,305,59,246,2020
2020-07-08,W.P. Kuala Lumpur,335,75,260,2020
2020-07-09,W.P. Kuala Lumpur,385,51,334,2020
2020-07-10,W.P. Kuala Lumpur,345,67,278,2020
2020-07-11,W.P. Kuala Lumpur,654,125,529,2020
2020-07-12,W.P. Kuala Lumpur,820,185,635,2020
2020-07-13,W.P. Kuala Lumpur,181,21,160,2020
2020-07-14,W.P. Kuala Lumpur,446,81,365,2020
2020-07-15,W.P. Kuala Lumpur,414,84,330,2020
2020-07-16,W.P. Kuala Lumpur,340,47,293,2020
2020-07-17,W.P. Kuala Lumpur,298,54,244,2020
2020-07-18,W.P. Kuala Lumpur,775,150,625,2020
2020-07-19,W.P. Kuala Lumpur,1021,202,819,2020
2020-07-20,W.P. Kuala Lumpur,162,23,139,2020
2020-07-21,W.P. Kuala Lumpur,254,40,214,2020
2020-07-22,W.P. Kuala Lumpur,542,95,447,2020
2020-07-23,W.P. Kuala Lumpur,560,108,452,2020
2020-07-24,W.P. Kuala Lumpur,272,52,220,2020
2020-07-25,W.P. Kuala Lumpur,682,129,553,2020
2020-07-26,W.P. Kuala Lumpur,942,198,744,2020
2020-07-27,W.P. Kuala Lumpur,160,23,137,2020
2020-07-28,W.P. Kuala Lumpur,149,20,129,2020
2020-07-29,W.P. Kuala Lumpur,327,26,301,2020
2020-07-30,W.P. Kuala Lumpur,334,48,286,2020
2020-07-31,W.P. Kuala Lumpur,282,67,215,2020
2020-08-01,W.P. Kuala Lumpur,338,64,274,2020
2020-08-02,W.P. Kuala Lumpur,352,58,294,2020
2020-08-03,W.P. Kuala Lumpur,310,48,262,2020
2020-08-04,W.P. Kuala Lumpur,320,59,261,2020
2020-08-05,W.P. Kuala Lumpur,476,93,383,2020
2020-08-06,W.P. Kuala Lumpur,571,128,443,2020
2020-08-07,W.P. Kuala Lumpur,497,105,392,2020
2020-08-08,W.P. Kuala Lumpur,1253,296,957,2020
2020-08-09,W.P. Kuala Lumpur,1335,346,989,2020
2020-08-10,W.P. Kuala Lumpur,376,73,303,2020
2020-08-11,W.P. Kuala Lumpur,655,147,508,2020
2020-08-12,W.P. Kuala Lumpur,614,123,491,2020
2020-08-13,W.P. Kuala Lumpur,609,126,483,2020
2020-08-14,W.P. Kuala Lumpur,683,202,481,2020
2020-08-15,W.P. Kuala Lumpur,1126,385,741,2020
2020-08-16,W.P. Kuala Lumpur,1010,245,765,2020
2020-08-17,W.P. Kuala Lumpur,279,70,209,2020
2020-08-18,W.P. Kuala Lumpur,238,35,203,2020
2020-08-19,W.P. Kuala Lumpur,585,153,432,2020
2020-08-20,W.P. Kuala Lumpur,593,106,487,2020
2020-08-21,W.P. Kuala Lumpur,530,112,418,2020
2020-08-22,W.P. Kuala Lumpur,883,197,686,2020
2020-08-23,W.P. Kuala Lumpur,946,221,725,2020
2020-08-24,W.P. Kuala Lumpur,259,60,199,2020
2020-08-25,W.P. Kuala Lumpur,640,178,462,2020
2020-08-26,W.P. Kuala Lumpur,659,276,383,2020
2020-08-27,W.P. Kuala Lumpur,539,134,405,2020
2020-08-28,W.P. Kuala Lumpur,385,87,298,2020
2020-08-29,W.P. Kuala Lumpur,809,177,632,2020
2020-08-30,W.P. Kuala Lumpur,986,226,760,2020
2020-08-31,W.P. Kuala Lumpur,1213,275,938,2020
2020-09-01,W.P. Kuala Lumpur,213,25,188,2020
2020-09-02,W.P. Kuala Lumpur,434,90,344,2020
2020-09-03,W.P. Kuala Lumpur,371,73,298,2020
2020-09-04,W.P. Kuala Lumpur,252,32,220,2020
2020-09-05,W.P. Kuala Lumpur,542,115,427,2020
2020-09-06,W.P. Kuala Lumpur,996,209,787,2020
2020-09-07,W.P. Kuala Lumpur,268,42,226,2020
2020-09-08,W.P. Kuala Lumpur,409,97,312,2020
2020-09-09,W.P. Kuala Lumpur,299,59,240,2020
2020-09-10,W.P. Kuala Lumpur,356,86,270,2020
2020-09-11,W.P. Kuala Lumpur,315,64,251,2020
2020-09-12,W.P. Kuala Lumpur,583,124,459,2020
2020-09-13,W.P. Kuala Lumpur,611,84,527,2020
2020-09-14,W.P. Kuala Lumpur,221,55,166,2020
2020-09-15,W.P. Kuala Lumpur,279,48,231,2020
2020-09-16,W.P. Kuala Lumpur,697,122,575,2020
2020-09-17,W.P. Kuala Lumpur,190,21,169,2020
2020-09-18,W.P. Kuala Lumpur,313,55,258,2020
2020-09-19,W.P. Kuala Lumpur,593,111,482,2020
2020-09-20,W.P. Kuala Lumpur,785,129,656,2020
2020-09-21,W.P. Kuala Lumpur,284,43,241,2020
2020-09-22,W.P. Kuala Lumpur,378,64,314,2020
2020-09-23,W.P. Kuala Lumpur,343,60,283,2020
2020-09-24,W.P. Kuala Lumpur,311,59,252,2020
2020-09-25,W.P. Kuala Lumpur,231,33,198,2020
2020-09-26,W.P. Kuala Lumpur,693,144,549,2020
2020-09-27,W.P. Kuala Lumpur,869,151,718,2020
2020-09-28,W.P. Kuala Lumpur,247,49,198,2020
2020-09-29,W.P. Kuala Lumpur,463,119,344,2020
2020-09-30,W.P. Kuala Lumpur,378,96,282,2020
2020-10-01,W.P. Kuala Lumpur,470,89,381,2020
2020-10-02,W.P. Kuala Lumpur,239,48,191,2020
2020-10-03,W.P. Kuala Lumpur,656,122,534,2020
2020-10-04,W.P. Kuala Lumpur,752,139,613,2020
2020-10-05,W.P. Kuala Lumpur,227,33,194,2020
2020-10-06,W.P. Kuala Lumpur,378,63,315,2020
2020-10-07,W.P. Kuala Lumpur,171,20,151,2020
2020-10-08,W.P. Kuala Lumpur,199,56,143,2020
2020-10-09,W.P. Kuala Lumpur,212,25,187,2020
2020-10-10,W.P. Kuala Lumpur,652,121,531,2020
2020-10-11,W.P. Kuala Lumpur,911,156,755,2020
2020-10-12,W.P. Kuala Lumpur,235,16,219,2020
2020-10-13,W.P. Kuala Lumpur,324,51,273,2020
2020-10-14,W.P. Kuala Lumpur,214,36,178,2020
2020-10-15,W.P. Kuala Lumpur,221,17,204,2020
2020-10-16,W.P. Kuala Lumpur,613,109,504,2020
2020-10-17,W.P. Kuala Lumpur,948,174,774,2020
2020-10-18,W.P. Kuala Lumpur,1240,226,1014,2020
2020-10-19,W.P. Kuala Lumpur,402,73,329,2020
2020-10-20,W.P. Kuala Lumpur,421,69,352,2020
2020-10-21,W.P. Kuala Lumpur,460,102,358,2020
2020-10-22,W.P. Kuala Lumpur,450,119,331,2020
2020-10-23,W.P. Kuala Lumpur,625,117,508,2020
2020-10-24,W.P. Kuala Lumpur,1019,207,812,2020
2020-10-25,W.P. Kuala Lumpur,953,193,760,2020
2020-10-26,W.P. Kuala Lumpur,255,42,213,2020
2020-10-27,W.P. Kuala Lumpur,230,23,207,2020
2020-10-28,W.P. Kuala Lumpur,241,36,205,2020
2020-10-29,W.P. Kuala Lumpur,606,112,494,2020
2020-10-30,W.P. Kuala Lumpur,563,105,458,2020
2020-10-31,W.P. Kuala Lumpur,788,143,645,2020
2020-11-01,W.P. Kuala Lumpur,919,189,730,2020
2020-11-02,W.P. Kuala Lumpur,230,43,187,2020
2020-11-03,W.P. Kuala Lumpur,299,56,243,2020
2020-11-04,W.P. Kuala Lumpur,270,45,225,2020
2020-11-05,W.P. Kuala Lumpur,350,69,281,2020
2020-11-06,W.P. Kuala Lumpur,455,79,376,2020
2020-11-07,W.P. Kuala Lumpur,826,169,657,2020
2020-11-08,W.P. Kuala Lumpur,1023,172,851,2020
2020-11-09,W.P. Kuala Lumpur,215,33,182,2020
2020-11-10,W.P. Kuala Lumpur,255,33,222,2020
2020-11-11,W.P. Kuala Lumpur,287,40,247,2020
2020-11-12,W.P. Kuala Lumpur,454,84,370,2020
2020-11-13,W.P. Kuala Lumpur,615,120,495,2020
2020-11-14,W.P. Kuala Lumpur,873,202,671,2020
2020-11-15,W.P. Kuala Lumpur,1044,292,752,2020
2020-11-16,W.P. Kuala Lumpur,215,29,186,2020
2020-11-17,W.P. Kuala Lumpur,223,32,191,2020
2020-11-18,W.P. Kuala Lumpur,476,121,355,2020
2020-11-19,W.P. Kuala Lumpur,353,53,300,2020
2020-11-20,W.P. Kuala Lumpur,334,45,289,2020
2020-11-21,W.P. Kuala Lumpur,559,118,441,2020
2020-11-22,W.P. Kuala Lumpur,1313,261,1052,2020
2020-11-23,W.P. Kuala Lumpur,213,20,193,2020
2020-11-24,W.P. Kuala Lumpur,338,54,284,2020
2020-11-25,W.P. Kuala Lumpur,202,23,179,2020
2020-11-26,W.P. Kuala Lumpur,260,45,215,2020
2020-11-27,W.P. Kuala Lumpur,242,28,214,2020
2020-11-28,W.P. Kuala Lumpur,757,166,591,2020
2020-11-29,W.P. Kuala Lumpur,775,135,640,2020
2020-11-30,W.P. Kuala Lumpur,197,17,180,2020
2020-12-01,W.P. Kuala Lumpur,302,39,263,2020
2020-12-02,W.P. Kuala Lumpur,219,30,189,2020
2020-12-03,W.P. Kuala Lumpur,216,30,186,2020
2020-12-04,W.P. Kuala Lumpur,257,36,221,2020
2020-12-05,W.P. Kuala Lumpur,646,117,529,2020
2020-12-06,W.P. Kuala Lumpur,1320,243,1077,2020
2020-12-07,W.P. Kuala Lumpur,226,22,204,2020
2020-12-08,W.P. Kuala Lumpur,198,24,174,2020
2020-12-09,W.P. Kuala Lumpur,383,70,313,2020
2020-12-10,W.P. Kuala Lumpur,212,31,181,2020
2020-12-11,W.P. Kuala Lumpur,522,70,452,2020
2020-12-12,W.P. Kuala Lumpur,591,126,465,2020
2020-12-13,W.P. Kuala Lumpur,804,161,643,2020
2020-12-14,W.P. Kuala Lumpur,170,14,156,2020
2020-12-15,W.P. Kuala Lumpur,237,37,200,2020
2020-12-16,W.P. Kuala Lumpur,314,52,262,2020
2020-12-17,W.P. Kuala Lumpur,195,28,167,2020
2020-12-18,W.P. Kuala Lumpur,323,39,284,2020
2020-12-19,W.P. Kuala Lumpur,528,70,458,2020
2020-12-20,W.P. Kuala Lumpur,676,127,549,2020
2020-12-21,W.P. Kuala Lumpur,246,23,223,2020
2020-12-22,W.P. Kuala Lumpur,287,39,248,2020
2020-12-23,W.P. Kuala Lumpur,410,109,301,2020
2020-12-24,W.P. Kuala Lumpur,367,51,316,2020
2020-12-25,W.P. Kuala Lumpur,626,117,509,2020
2020-12-26,W.P. Kuala Lumpur,622,118,504,2020
2020-12-27,W.P. Kuala Lumpur,638,93,545,2020
2020-12-28,W.P. Kuala Lumpur,301,51,250,2020
2020-12-29,W.P. Kuala Lumpur,332,46,286,2020
2020-12-30,W.P. Kuala Lumpur,399,61,338,2020
2020-12-31,W.P. Kuala Lumpur,415,58,357,2020
2021-01-01,W.P. Kuala Lumpur,597,109,488,2021
2021-01-02,W.P. Kuala Lumpur,652,112,540,2021
2021-01-03,W.P. Kuala Lumpur,703,140,563,2021
2021-01-04,W.P. Kuala Lumpur,165,34,131,2021
2021-01-05,W.P. Kuala Lumpur,200,24,176,2021
2021-01-06,W.P. Kuala Lumpur,217,19,198,2021
2021-01-07,W.P. Kuala Lumpur,253,27,226,2021
2021-01-08,W.P. Kuala Lumpur,308,34,274,2021
2021-01-09,W.P. Kuala Lumpur,623,113,510,2021
2021-01-10,W.P. Kuala Lumpur,689,143,546,2021
2021-01-11,W.P. Kuala Lumpur,257,33,224,2021
2021-01-12,W.P. Kuala Lumpur,494,231,263,2021
2021-01-13,W.P. Kuala Lumpur,783,640,143,2021
2021-01-14,W.P. Kuala Lumpur,115,9,106,2021
2021-01-15,W.P. Kuala Lumpur,232,32,200,2021
2021-01-16,W.P. Kuala Lumpur,640,135,505,2021
2021-01-17,W.P. Kuala Lumpur,787,189,598,2021
2021-01-18,W.P. Kuala Lumpur,212,18,194,2021
2021-01-19,W.P. Kuala Lumpur,220,19,201,2021
2021-01-20,W.P. Kuala Lumpur,314,42,272,2021
2021-01-21,W.P. Kuala Lumpur,290,51,239,2021
2021-01-22,W.P. Kuala Lumpur,479,68,411,2021
2021-01-23,W.P. Kuala Lumpur,1027,179,848,2021
2021-01-24,W.P. Kuala Lumpur,1242,242,1000,2021
2021-01-25,W.P. Kuala Lumpur,442,67,375,2021
2021-01-26,W.P. Kuala Lumpur,474,69,405,2021
2021-01-27,W.P. Kuala Lumpur,385,66,319,2021
2021-01-28,W.P. Kuala Lumpur,800,153,647,2021
2021-01-29,W.P. Kuala Lumpur,636,122,514,2021
2021-01-30,W.P. Kuala Lumpur,856,189,667,2021
2021-01-31,W.P. Kuala Lumpur,932,187,745,2021
2021-02-01,W.P. Kuala Lumpur,547,101,446,2021
2021-02-02,W.P. Kuala Lumpur,342,61,281,2021
2021-02-03,W.P. Kuala Lumpur,532,117,415,2021
2021-02-04,W.P. Kuala Lumpur,392,65,327,2021
2021-02-05,W.P. Kuala Lumpur,383,63,320,2021
2021-02-06,W.P. Kuala Lumpur,875,233,642,2021
2021-02-07,W.P. Kuala Lumpur,995,240,755,2021
2021-02-08,W.P. Kuala Lumpur,392,62,330,2021
2021-02-09,W.P. Kuala Lumpur,399,75,324,2021
2021-02-10,W.P. Kuala Lumpur,533,88,445,2021
2021-02-11,W.P. Kuala Lumpur,472,86,386,2021
2021-02-12,W.P. Kuala Lumpur,575,97,478,2021
2021-02-13,W.P. Kuala Lumpur,787,176,611,2021
2021-02-14,W.P. Kuala Lumpur,947,191,756,2021
2021-02-15,W.P. Kuala Lumpur,440,85,355,2021
2021-02-16,W.P. Kuala Lumpur,337,54,283,2021
2021-02-17,W.P. Kuala Lumpur,318,41,277,2021
2021-02-18,W.P. Kuala Lumpur,360,62,298,2021
2021-02-19,W.P. Kuala Lumpur,317,48,269,2021
2021-02-20,W.P. Kuala Lumpur,609,89,520,2021
2021-02-21,W.P. Kuala Lumpur,712,114,598,2021
2021-02-22,W.P. Kuala Lumpur,250,33,217,2021
2021-02-23,W.P. Kuala Lumpur,251,28,223,2021
2021-02-24,W.P. Kuala Lumpur,283,61,222,2021
2021-02-25,W.P. Kuala Lumpur,292,51,241,2021
2021-02-26,W.P. Kuala Lumpur,341,51,290,2021
2021-02-27,W.P. Kuala Lumpur,621,105,516,2021
2021-02-28,W.P. Kuala Lumpur,920,176,744,2021
2021-03-01,W.P. Kuala Lumpur,239,21,218,2021
2021-03-02,W.P. Kuala Lumpur,436,98,338,2021
2021-03-03,W.P. Kuala Lumpur,421,63,358,2021
2021-03-04,W.P. Kuala Lumpur,350,43,307,2021
2021-03-05,W.P. Kuala Lumpur,412,49,363,2021
2021-03-06,W.P. Kuala Lumpur,780,111,669,2021
2021-03-07,W.P. Kuala Lumpur,869,133,736,2021
2021-03-08,W.P. Kuala Lumpur,242,25,217,2021
2021-03-09,W.P. Kuala Lumpur,330,55,275,2021
2021-03-10,W.P. Kuala Lumpur,380,75,305,2021
2021-03-11,W.P. Kuala Lumpur,460,105,355,2021
2021-03-12,W.P. Kuala Lumpur,373,74,299,2021
2021-03-13,W.P. Kuala Lumpur,803,177,626,2021
2021-03-14,W.P. Kuala Lumpur,744,131,613,2021
2021-03-15,W.P. Kuala Lumpur,257,27,230,2021
2021-03-16,W.P. Kuala Lumpur,358,86,272,2021
2021-03-17,W.P. Kuala Lumpur,454,102,352,2021
2021-03-18,W.P. Kuala Lumpur,383,67,316,2021
2021-03-19,W.P. Kuala Lumpur,538,97,441,2021
2021-03-20,W.P. Kuala Lumpur,923,200,723,2021
2021-03-21,W.P. Kuala Lumpur,1116,196,920,2021
2021-03-22,W.P. Kuala Lumpur,187,9,178,2021
2021-03-23,W.P. Kuala Lumpur,441,67,374,2021
2021-03-24,W.P. Kuala Lumpur,415,78,337,2021
2021-03-25,W.P. Kuala Lumpur,270,35,235,2021
2021-03-26,W.P. Kuala Lumpur,386,82,304,2021
2021-03-27,W.P. Kuala Lumpur,786,123,663,2021
2021-03-28,W.P. Kuala Lumpur,1066,204,862,2021
2021-03-29,W.P. Kuala Lumpur,258,49,209,2021
2021-03-30,W.P. Kuala Lumpur,308,45,263,2021
2021-03-31,W.P. Kuala Lumpur,403,102,301,2021
2021-04-01,W.P. Kuala Lumpur,287,36,251,2021
2021-04-02,W.P. Kuala Lumpur,389,58,331,2021
2021-04-03,W.P. Kuala Lumpur,773,162,611,2021
2021-04-04,W.P. Kuala Lumpur,1180,213,967,2021
2021-04-05,W.P. Kuala Lumpur,249,39,210,2021
2021-04-06,W.P. Kuala Lumpur,366,56,310,2021
2021-04-07,W.P. Kuala Lumpur,392,54,338,2021
2021-04-08,W.P. Kuala Lumpur,603,198,405,2021
2021-04-09,W.P. Kuala Lumpur,519,78,441,2021
2021-04-10,W.P. Kuala Lumpur,791,93,698,2021
2021-04-11,W.P. Kuala Lumpur,1069,139,930,2021
2021-04-12,W.P. Kuala Lumpur,891,242,649,2021
2021-04-13,W.P. Kuala Lumpur,107,6,101,2021
2021-04-14,W.P. Kuala Lumpur,143,10,133,2021
2021-04-15,W.P. Kuala Lumpur,122,19,103,2021
2021-04-16,W.P. Kuala Lumpur,157,21,136,2021
2021-04-17,W.P. Kuala Lumpur,441,60,381,2021
2021-04-18,W.P. Kuala Lumpur,715,128,587,2021
2021-04-19,W.P. Kuala Lumpur,163,16,147,2021
2021-04-20,W.P. Kuala Lumpur,112,6,106,2021
2021-04-21,W.P. Kuala Lumpur,115,7,108,2021
2021-04-22,W.P. Kuala Lumpur,166,21,145,2021
2021-04-23,W.P. Kuala Lumpur,279,39,240,2021
2021-04-24,W.P. Kuala Lumpur,469,98,371,2021
2021-04-25,W.P. Kuala Lumpur,1037,188,849,2021
2021-04-26,W.P. Kuala Lumpur,114,15,99,2021
2021-04-27,W.P. Kuala Lumpur,130,4,126,2021
2021-04-28,W.P. Kuala Lumpur,221,41,180,2021
2021-04-29,W.P. Kuala Lumpur,370,41,329,2021
2021-04-30,W.P. Kuala Lumpur,279,26,253,2021
2021-05-01,W.P. Kuala Lumpur,733,129,604,2021
2021-05-02,W.P. Kuala Lumpur,648,109,539,2021
2021-05-03,W.P. Kuala Lumpur,163,17,146,2021
2021-05-04,W.P. Kuala Lumpur,148,23,125,2021
2021-05-05,W.P. Kuala Lumpur,149,5,144,2021
2021-05-06,W.P. Kuala Lumpur,236,18,218,2021
2021-05-07,W.P. Kuala Lumpur,267,28,239,2021
2021-05-08,W.P. Kuala Lumpur,613,107,506,2021
2021-05-09,W.P. Kuala Lumpur,461,67,394,2021
2021-05-10,W.P. Kuala Lumpur,166,15,151,2021
2021-05-11,W.P. Kuala Lumpur,209,35,174,2021
2021-05-12,W.P. Kuala Lumpur,355,52,303,2021
2021-05-13,W.P. Kuala Lumpur,0,0,0,2021
2021-05-14,W.P. Kuala Lumpur,880,127,753,2021
2021-05-15,W.P. Kuala Lumpur,1343,234,1109,2021
2021-05-16,W.P. Kuala Lumpur,1227,214,1013,2021
2021-05-17,W.P. Kuala Lumpur,645,89,556,2021
2021-05-18,W.P. Kuala Lumpur,513,78,435,2021
2021-05-19,W.P. Kuala Lumpur,427,65,362,2021
2021-05-20,W.P. Kuala Lumpur,458,88,370,2021
2021-05-21,W.P. Kuala Lumpur,515,77,438,2021
2021-05-22,W.P. Kuala Lumpur,1025,172,853,2021
2021-05-23,W.P. Kuala Lumpur,1111,204,907,2021
2021-05-24,W.P. Kuala Lumpur,273,37,236,2021
2021-05-25,W.P. Kuala Lumpur,217,30,187,2021
2021-05-26,W.P. Kuala Lumpur,548,89,459,2021
2021-05-27,W.P. Kuala Lumpur,283,44,239,2021
2021-05-28,W.P. Kuala Lumpur,559,100,459,2021
2021-05-29,W.P. Kuala Lumpur,614,97,517,2021
2021-05-30,W.P. Kuala Lumpur,524,74,450,2021
2021-05-31,W.P. Kuala Lumpur,298,25,273,2021
2021-06-01,W.P. Kuala Lumpur,237,39,198,2021
2021-06-02,W.P. Kuala Lumpur,331,60,271,2021
2021-06-03,W.P. Kuala Lumpur,318,58,260,2021
2021-06-04,W.P. Kuala Lumpur,272,27,245,2021
2021-06-05,W.P. Kuala Lumpur,578,119,459,2021
2021-06-06,W.P. Kuala Lumpur,645,107,538,2021
2021-06-07,W.P. Kuala Lumpur,343,52,291,2021
2021-06-08,W.P. Kuala Lumpur,366,60,306,2021
2021-06-09,W.P. Kuala Lumpur,398,78,320,2021
2021-06-10,W.P. Kuala Lumpur,325,63,262,2021
2021-06-11,W.P. Kuala Lumpur,477,81,396,2021
2021-06-12,W.P. Kuala Lumpur,701,98,603,2021
2021-06-13,W.P. Kuala Lumpur,856,148,708,2021
2021-06-14,W.P. Kuala Lumpur,733,102,631,2021
2021-06-15,W.P. Kuala Lumpur,539,78,461,2021
2021-06-16,W.P. Kuala Lumpur,503,70,433,2021
2021-06-17,W.P. Kuala Lumpur,397,67,330,2021
2021-06-18,W.P. Kuala Lumpur,526,81,445,2021
2021-06-19,W.P. Kuala Lumpur,881,136,745,2021
2021-06-20,W.P. Kuala Lumpur,1047,202,845,2021
2021-06-21,W.P. Kuala Lumpur,389,61,328,2021
2021-06-22,W.P. Kuala Lumpur,415,69,346,2021
2021-06-23,W.P. Kuala Lumpur,410,89,321,2021
2021-06-24,W.P. Kuala Lumpur,308,54,254,2021
2021-06-25,W.P. Kuala Lumpur,436,82,354,2021
2021-06-26,W.P. Kuala Lumpur,824,142,682,2021
2021-06-27,W.P. Kuala Lumpur,798,172,626,2021
2021-06-28,W.P. Kuala Lumpur,324,41,283,2021
2021-06-29,W.P. Kuala Lumpur,292,38,254,2021
2021-06-30,W.P. Kuala Lumpur,371,56,315,2021
2021-07-01,W.P. Kuala Lumpur,507,93,414,2021
2021-07-02,W.P. Kuala Lumpur,376,57,319,2021
2021-07-03,W.P. Kuala Lumpur,219,20,199,2021
2021-07-04,W.P. Kuala Lumpur,249,34,215,2021
2021-07-05,W.P. Kuala Lumpur,216,31,185,2021
2021-07-06,W.P. Kuala Lumpur,223,37,186,2021
2021-07-07,W.P. Kuala Lumpur,140,12,128,2021
2021-07-08,W.P. Kuala Lumpur,223,26,197,2021
2021-07-09,W.P. Kuala Lumpur,290,55,235,2021
2021-07-10,W.P. Kuala Lumpur,454,74,380,2021
2021-07-11,W.P. Kuala Lumpur,337,60,277,2021
2021-07-12,W.P. Kuala Lumpur,113,10,103,2021
2021-07-13,W.P. Kuala Lumpur,157,14,143,2021
2021-07-14,W.P. Kuala Lumpur,145,10,135,2021
2021-07-15,W.P. Kuala Lumpur,101,13,88,2021
2021-07-16,W.P. Kuala Lumpur,90,5,85,2021
2021-07-17,W.P. Kuala Lumpur,178,16,162,2021
2021-07-18,W.P. Kuala Lumpur,230,33,197,2021
2021-07-19,W.P. Kuala Lumpur,135,14,121,2021
2021-07-20,W.P. Kuala Lumpur,197,37,160,2021
2021-07-21,W.P. Kuala Lumpur,190,26,164,2021
2021-07-22,W.P. Kuala Lumpur,271,37,234,2021
2021-07-23,W.P. Kuala Lumpur,299,33,266,2021
2021-07-24,W.P. Kuala Lumpur,399,63,336,2021
2021-07-25,W.P. Kuala Lumpur,461,91,370,2021
2021-07-26,W.P. Kuala Lumpur,182,27,155,2021
2021-07-27,W.P. Kuala Lumpur,212,28,184,2021
2021-07-28,W.P. Kuala Lumpur,345,55,290,2021
2021-07-29,W.P. Kuala Lumpur,313,40,273,2021
2021-07-30,W.P. Kuala Lumpur,400,63,337,2021
2021-07-31,W.P. Kuala Lumpur,527,74,453,2021
2021-08-01,W.P. Kuala Lumpur,533,89,444,2021
2021-08-02,W.P. Kuala Lumpur,308,32,276,2021
2021-08-03,W.P. Kuala Lumpur,326,38,288,2021
2021-08-04,W.P. Kuala Lumpur,476,76,400,2021
2021-08-05,W.P. Kuala Lumpur,373,80,293,2021
2021-08-06,W.P. Kuala Lumpur,434,77,357,2021
2021-08-07,W.P. Kuala Lumpur,604,98,506,2021
2021-08-08,W.P. Kuala Lumpur,648,120,528,2021
2021-08-09,W.P. Kuala Lumpur,309,49,260,2021
2021-08-10,W.P. Kuala Lumpur,500,82,418,2021
2021-08-11,W.P. Kuala Lumpur,278,41,237,2021
2021-08-12,W.P. Kuala Lumpur,254,37,217,2021
2021-08-13,W.P. Kuala Lumpur,353,67,286,2021
2021-08-14,W.P. Kuala Lumpur,706,95,611,2021
2021-08-15,W.P. Kuala Lumpur,785,148,637,2021
2021-08-16,W.P. Kuala Lumpur,277,42,235,2021
2021-08-17,W.P. Kuala Lumpur,317,41,276,2021
2021-08-18,W.P. Kuala Lumpur,403,49,354,2021
2021-08-19,W.P. Kuala Lumpur,483,79,404,2021
2021-08-20,W.P. Kuala Lumpur,417,74,343,2021
2021-08-21,W.P. Kuala Lumpur,903,145,758,2021
2021-08-22,W.P. Kuala Lumpur,939,158,781,2021
2021-08-23,W.P. Kuala Lumpur,358,56,302,2021
2021-08-24,W.P. Kuala Lumpur,402,76,326,2021
2021-08-25,W.P. Kuala Lumpur,460,121,339,2021
2021-08-26,W.P. Kuala Lumpur,439,61,378,2021
2021-08-27,W.P. Kuala Lumpur,590,134,456,2021
2021-08-28,W.P. Kuala Lumpur,982,182,800,2021
2021-08-29,W.P. Kuala Lumpur,1202,199,1003,2021
2021-08-30,W.P. Kuala Lumpur,543,106,437,2021
2021-08-31,W.P. Kuala Lumpur,1216,248,968,2021
2021-09-01,W.P. Kuala Lumpur,705,140,565,2021
2021-09-02,W.P. Kuala Lumpur,506,87,419,2021
2021-09-03,W.P. Kuala Lumpur,415,70,345,2021
2021-09-04,W.P. Kuala Lumpur,833,148,685,2021
2021-09-05,W.P. Kuala Lumpur,832,164,668,2021
2021-09-06,W.P. Kuala Lumpur,349,54,295,2021
2021-09-07,W.P. Kuala Lumpur,448,97,351,2021
2021-09-08,W.P. Kuala Lumpur,450,70,380,2021
2021-09-09,W.P. Kuala Lumpur,419,78,341,2021
2021-09-10,W.P. Kuala Lumpur,434,80,354,2021
2021-09-11,W.P. Kuala Lumpur,779,125,654,2021
2021-09-12,W.P. Kuala Lumpur,741,130,611,2021
2021-09-13,W.P. Kuala Lumpur,294,42,252,2021
2021-09-14,W.P. Kuala Lumpur,406,75,331,2021
2021-09-15,W.P. Kuala Lumpur,371,63,308,2021
2021-09-16,W.P. Kuala Lumpur,1113,194,919,2021
2021-09-17,W.P. Kuala Lumpur,474,80,394,2021
2021-09-18,W.P. Kuala Lumpur,797,161,636,2021
2021-09-19,W.P. Kuala Lumpur,1053,214,839,2021
2021-09-20,W.P. Kuala Lumpur,314,52,262,2021
2021-09-21,W.P. Kuala Lumpur,349,62,287,2021
2021-09-22,W.P. Kuala Lumpur,340,60,280,2021
2021-09-23,W.P. Kuala Lumpur,583,91,492,2021
2021-09-24,W.P. Kuala Lumpur,365,64,301,2021
2021-09-25,W.P. Kuala Lumpur,605,108,497,2021
2021-09-26,W.P. Kuala Lumpur,727,89,638,2021
2021-09-27,W.P. Kuala Lumpur,297,57,240,2021
2021-09-28,W.P. Kuala Lumpur,453,65,388,2021
2021-09-29,W.P. Kuala Lumpur,591,120,471,2021
2021-09-30,W.P. Kuala Lumpur,551,117,434,2021
2021-10-01,W.P. Kuala Lumpur,289,53,236,2021
2021-10-02,W.P. Kuala Lumpur,630,85,545,2021
2021-10-03,W.P. Kuala Lumpur,874,159,715,2021
2021-10-04,W.P. Kuala Lumpur,211,18,193,2021
2021-10-05,W.P. Kuala Lumpur,244,20,224,2021
2021-10-06,W.P. Kuala Lumpur,262,49,213,2021
2021-10-07,W.P. Kuala Lumpur,244,21,223,2021
2021-10-08,W.P. Kuala Lumpur,360,55,305,2021
2021-10-09,W.P. Kuala Lumpur,684,135,549,2021
2021-10-10,W.P. Kuala Lumpur,710,144,566,2021
2021-10-11,W.P. Kuala Lumpur,241,24,217,2021
2021-10-12,W.P. Kuala Lumpur,396,77,319,2021
2021-10-13,W.P. Kuala Lumpur,416,78,338,2021
2021-10-14,W.P. Kuala Lumpur,317,61,256,2021
2021-10-15,W.P. Kuala Lumpur,286,39,247,2021
2021-10-16,W.P. Kuala Lumpur,564,101,463,2021
2021-10-17,W.P. Kuala Lumpur,673,128,545,2021
2021-10-18,W.P. Kuala Lumpur,256,43,213,2021
2021-10-19,W.P. Kuala Lumpur,443,57,386,2021
2021-10-20,W.P. Kuala Lumpur,256,51,205,2021
2021-10-21,W.P. Kuala Lumpur,268,43,225,2021
2021-10-22,W.P. Kuala Lumpur,325,50,275,2021
2021-10-23,W.P. Kuala Lumpur,479,98,381,2021
2021-10-24,W.P. Kuala Lumpur,576,86,490,2021
2021-10-25,W.P. Kuala Lumpur,148,14,134,2021
2021-10-26,W.P. Kuala Lumpur,190,24,166,2021
2021-10-27,W.P. Kuala Lumpur,433,89,344,2021
2021-10-28,W.P. Kuala Lumpur,408,101,307,2021
2021-10-29,W.P. Kuala Lumpur,488,115,373,2021
2021-10-30,W.P. Kuala Lumpur,620,135,485,2021
2021-10-31,W.P. Kuala Lumpur,840,160,680,2021
2021-11-01,W.P. Kuala Lumpur,360,64,296,2021
2021-11-02,W.P. Kuala Lumpur,360,56,304,2021
2021-11-03,W.P. Kuala Lumpur,319,40,279,2021
2021-11-04,W.P. Kuala Lumpur,740,80,660,2021
2021-11-05,W.P. Kuala Lumpur,345,49,296,2021
2021-11-06,W.P. Kuala Lumpur,510,84,426,2021
2021-11-07,W.P. Kuala Lumpur,616,105,511,2021
2021-11-08,W.P. Kuala Lumpur,267,35,232,2021
2021-11-09,W.P. Kuala Lumpur,326,80,246,2021
2021-11-10,W.P. Kuala Lumpur,389,66,323,2021
2021-11-11,W.P. Kuala Lumpur,440,102,338,2021
2021-11-12,W.P. Kuala Lumpur,384,68,316,2021
2021-11-13,W.P. Kuala Lumpur,801,122,679,2021
2021-11-14,W.P. Kuala Lumpur,1053,162,891,2021
2021-11-15,W.P. Kuala Lumpur,298,42,256,2021
2021-11-16,W.P. Kuala Lumpur,446,77,369,2021
2021-11-17,W.P. Kuala Lumpur,354,73,281,2021
2021-11-18,W.P. Kuala Lumpur,526,159,367,2021
2021-11-19,W.P. Kuala Lumpur,369,67,302,2021
2021-11-20,W.P. Kuala Lumpur,683,106,577,2021
2021-11-21,W.P. Kuala Lumpur,790,149,641,2021
2021-11-22,W.P. Kuala Lumpur,289,46,243,2021
2021-11-23,W.P. Kuala Lumpur,387,86,301,2021
2021-11-24,W.P. Kuala Lumpur,361,81,280,2021
2021-11-25,W.P. Kuala Lumpur,541,163,378,2021
2021-11-26,W.P. Kuala Lumpur,430,101,329,2021
2021-11-27,W.P. Kuala Lumpur,636,119,517,2021
2021-11-28,W.P. Kuala Lumpur,694,134,560,2021
2021-11-29,W.P. Kuala Lumpur,331,53,278,2021
2021-11-30,W.P. Kuala Lumpur,606,131,475,2021
2021-12-01,W.P. Kuala Lumpur,443,83,360,2021
2021-12-02,W.P. Kuala Lumpur,429,80,349,2021
2021-12-03,W.P. Kuala Lumpur,431,65,366,2021
2021-12-04,W.P. Kuala Lumpur,598,101,497,2021
2021-12-05,W.P. Kuala Lumpur,862,149,713,2021
2021-12-06,W.P. Kuala Lumpur,370,66,304,2021
2021-12-07,W.P. Kuala Lumpur,362,76,286,2021
2021-12-08,W.P. Kuala Lumpur,396,61,335,2021
2021-12-09,W.P. Kuala Lumpur,365,67,298,2021
2021-12-10,W.P. Kuala Lumpur,372,56,316,2021
2021-12-11,W.P. Kuala Lumpur,580,72,508,2021
2021-12-12,W.P. Kuala Lumpur,931,144,787,2021
2021-12-13,W.P. Kuala Lumpur,328,84,244,2021
2021-12-14,W.P. Kuala Lumpur,776,288,488,2021
2021-12-15,W.P. Kuala Lumpur,613,184,429,2021
2021-12-16,W.P. Kuala Lumpur,680,231,449,2021
2021-12-17,W.P. Kuala Lumpur,396,77,319,2021
2021-12-18,W.P. Kuala Lumpur,458,91,367,2021
2021-12-19,W.P. Kuala Lumpur,505,83,422,2021
2021-12-20,W.P. Kuala Lumpur,346,81,265,2021
2021-12-21,W.P. Kuala Lumpur,487,124,363,2021
2021-12-22,W.P. Kuala Lumpur,368,104,264,2021
2021-12-23,W.P. Kuala Lumpur,440,59,381,2021
2021-12-24,W.P. Kuala Lumpur,472,58,414,2021
2021-12-25,W.P. Kuala Lumpur,673,86,587,2021
2021-12-26,W.P. Kuala Lumpur,714,99,615,2021
2021-12-27,W.P. Kuala Lumpur,328,52,276,2021
2021-12-28,W.P. Kuala Lumpur,457,68,389,2021
2021-12-29,W.P. Kuala Lumpur,510,93,417,2021
2021-12-30,W.P. Kuala Lumpur,422,52,370,2021
2021-12-31,W.P. Kuala Lumpur,551,63,488,2021
2022-01-01,W.P. Kuala Lumpur,807,129,678,2022
2022-01-02,W.P. Kuala Lumpur,707,113,594,2022
2022-01-03,W.P. Kuala Lumpur,230,26,204,2022
2022-01-04,W.P. Kuala Lumpur,281,34,247,2022
2022-01-05,W.P. Kuala Lumpur,366,45,321,2022
2022-01-06,W.P. Kuala Lumpur,365,52,313,2022
2022-01-07,W.P. Kuala Lumpur,327,39,288,2022
2022-01-08,W.P. Kuala Lumpur,867,236,631,2022
2022-01-09,W.P. Kuala Lumpur,867,165,702,2022
2022-01-10,W.P. Kuala Lumpur,290,34,256,2022
2022-01-11,W.P. Kuala Lumpur,233,28,205,2022
2022-01-12,W.P. Kuala Lumpur,324,75,249,2022
2022-01-13,W.P. Kuala Lumpur,267,46,221,2022
2022-01-14,W.P. Kuala Lumpur,358,60,298,2022
2022-01-15,W.P. Kuala Lumpur,626,116,510,2022
2022-01-16,W.P. Kuala Lumpur,809,135,674,2022
2022-01-17,W.P. Kuala Lumpur,320,50,270,2022
2022-01-18,W.P. Kuala Lumpur,717,110,607,2022
2022-01-19,W.P. Kuala Lumpur,409,88,321,2022
2022-01-20,W.P. Kuala Lumpur,324,61,263,2022
2022-01-21,W.P. Kuala Lumpur,392,70,322,2022
2022-01-22,W.P. Kuala Lumpur,722,106,616,2022
2022-01-23,W.P. Kuala Lumpur,802,130,672,2022
2022-01-24,W.P. Kuala Lumpur,422,95,327,2022
2022-01-25,W.P. Kuala Lumpur,543,157,386,2022
2022-01-26,W.P. Kuala Lumpur,512,105,407,2022
2022-01-27,W.P. Kuala Lumpur,449,78,371,2022
2022-01-28,W.P. Kuala Lumpur,420,57,363,2022
2022-01-29,W.P. Kuala Lumpur,608,91,517,2022
2022-01-30,W.P. Kuala Lumpur,669,111,558,2022
2022-01-31,W.P. Kuala Lumpur,404,50,354,2022
2022-02-01,W.P. Kuala Lumpur,468,66,402,2022
2022-02-02,W.P. Kuala Lumpur,569,97,472,2022
2022-02-03,W.P. Kuala Lumpur,404,60,344,2022
2022-02-04,W.P. Kuala Lumpur,460,58,402,2022
2022-02-05,W.P. Kuala Lumpur,719,103,616,2022
2022-02-06,W.P. Kuala Lumpur,598,75,523,2022
2022-02-07,W.P. Kuala Lumpur,420,64,356,2022
2022-02-08,W.P. Kuala Lumpur,411,66,345,2022
2022-02-09,W.P. Kuala Lumpur,420,63,357,2022
2022-02-10,W.P. Kuala Lumpur,436,98,338,2022
2022-02-11,W.P. Kuala Lumpur,548,111,437,2022
2022-02-12,W.P. Kuala Lumpur,730,156,574,2022
2022-02-13,W.P. Kuala Lumpur,830,125,705,2022
2022-02-14,W.P. Kuala Lumpur,336,60,276,2022
2022-02-15,W.P. Kuala Lumpur,505,110,395,2022
2022-02-16,W.P. Kuala Lumpur,371,68,303,2022
2022-02-17,W.P. Kuala Lumpur,381,59,322,2022
2022-02-18,W.P. Kuala Lumpur,397,53,344,2022
2022-02-19,W.P. Kuala Lumpur,745,126,619,2022
2022-02-20,W.P. Kuala Lumpur,927,185,742,2022
2022-02-21,W.P. Kuala Lumpur,305,40,265,2022
2022-02-22,W.P. Kuala Lumpur,334,60,274,2022
2022-02-23,W.P. Kuala Lumpur,354,80,274,2022
2022-02-24,W.P. Kuala Lumpur,612,143,469,2022
2022-02-25,W.P. Kuala Lumpur,354,60,294,2022
2022-02-26,W.P. Kuala Lumpur,710,103,607,2022
2022-02-27,W.P. Kuala Lumpur,812,122,690,2022
2022-02-28,W.P. Kuala Lumpur,387,63,324,2022
2022-03-01,W.P. Kuala Lumpur,355,40,315,2022
2022-03-02,W.P. Kuala Lumpur,384,78,306,2022
2022-03-03,W.P. Kuala Lumpur,319,58,261,2022
2022-03-04,W.P. Kuala Lumpur,352,53,299,2022
2022-03-05,W.P. Kuala Lumpur,637,169,468,2022
2022-03-06,W.P. Kuala Lumpur,812,116,696,2022
2022-03-07,W.P. Kuala Lumpur,232,23,209,2022
2022-03-08,W.P. Kuala Lumpur,292,36,256,2022
2022-03-09,W.P. Kuala Lumpur,401,78,323,2022
2022-03-10,W.P. Kuala Lumpur,498,102,396,2022
2022-03-11,W.P. Kuala Lumpur,472,82,390,2022
2022-03-12,W.P. Kuala Lumpur,688,97,591,2022
2022-03-13,W.P. Kuala Lumpur,896,175,721,2022
2022-03-14,W.P. Kuala Lumpur,257,23,234,2022
2022-03-15,W.P. Kuala Lumpur,433,139,294,2022
2022-03-16,W.P. Kuala Lumpur,378,98,280,2022
2022-03-17,W.P. Kuala Lumpur,322,74,248,2022
2022-03-18,W.P. Kuala Lumpur,364,85,279,2022
2022-03-19,W.P. Kuala Lumpur,697,181,516,2022
2022-03-20,W.P. Kuala Lumpur,970,174,796,2022
2022-03-21,W.P. Kuala Lumpur,382,48,334,2022
2022-03-22,W.P. Kuala Lumpur,325,61,264,2022
2022-03-23,W.P. Kuala Lumpur,587,172,415,2022
2022-03-24,W.P. Kuala Lumpur,542,214,328,2022
2022-03-25,W.P. Kuala Lumpur,453,58,395,2022
2022-03-26,W.P. Kuala Lumpur,962,149,813,2022
2022-03-27,W.P. Kuala Lumpur,1175,207,968,2022
2022-03-28,W.P. Kuala Lumpur,593,112,481,2022
2022-03-29,W.P. Kuala Lumpur,521,129,392,2022
2022-03-30,W.P. Kuala Lumpur,652,114,538,2022
2022-03-31,W.P. Kuala Lumpur,842,226,616,2022
2022-04-01,W.P. Kuala Lumpur,512,71,441,2022
2022-04-02,W.P. Kuala Lumpur,888,115,773,2022
2022-04-03,W.P. Kuala Lumpur,659,94,565,2022
2022-04-04,W.P. Kuala Lumpur,224,60,164,2022
2022-04-05,W.P. Kuala Lumpur,235,76,159,2022
2022-04-06,W.P. Kuala Lumpur,157,22,135,2022
2022-04-07,W.P. Kuala Lumpur,179,30,149,2022
2022-04-08,W.P. Kuala Lumpur,246,34,212,2022
2022-04-09,W.P. Kuala Lumpur,449,89,360,2022
2022-04-10,W.P. Kuala Lumpur,776,150,626,2022
2022-04-11,W.P. Kuala Lumpur,188,28,160,2022
2022-04-12,W.P. Kuala Lumpur,294,57,237,2022
2022-04-13,W.P. Kuala Lumpur,267,50,217,2022
2022-04-14,W.P. Kuala Lumpur,388,113,275,2022
2022-04-15,W.P. Kuala Lumpur,470,108,362,2022
2022-04-16,W.P. Kuala Lumpur,695,145,550,2022
2022-04-17,W.P. Kuala Lumpur,945,154,791,2022
2022-04-18,W.P. Kuala Lumpur,306,47,259,2022
2022-04-19,W.P. Kuala Lumpur,476,78,398,2022
2022-04-20,W.P. Kuala Lumpur,286,45,241,2022
2022-04-21,W.P. Kuala Lumpur,250,52,198,2022
2022-04-22,W.P. Kuala Lumpur,319,32,287,2022
2022-04-23,W.P. Kuala Lumpur,610,90,520,2022
2022-04-24,W.P. Kuala Lumpur,985,179,806,2022
2022-04-25,W.P. Kuala Lumpur,350,80,270,2022
2022-04-26,W.P. Kuala Lumpur,279,47,232,2022
2022-04-27,W.P. Kuala Lumpur,256,83,173,2022
2022-04-28,W.P. Kuala Lumpur,272,53,219,2022
2022-04-29,W.P. Kuala Lumpur,264,33,231,2022
2022-04-30,W.P. Kuala Lumpur,449,89,360,2022
2022-05-01,W.P. Kuala Lumpur,606,105,501,2022
2022-05-02,W.P. Kuala Lumpur,0,0,0,2022
2022-05-03,W.P. Kuala Lumpur,156,10,146,2022
2022-05-04,W.P. Kuala Lumpur,356,38,318,2022
2022-05-05,W.P. Kuala Lumpur,428,57,371,2022
2022-05-06,W.P. Kuala Lumpur,498,62,436,2022
2022-05-07,W.P. Kuala Lumpur,753,128,625,2022
2022-05-08,W.P. Kuala Lumpur,1116,190,926,2022
2022-05-09,W.P. Kuala Lumpur,296,37,259,2022
2022-05-10,W.P. Kuala Lumpur,461,113,348,2022
2022-05-11,W.P. Kuala Lumpur,599,164,435,2022
2022-05-12,W.P. Kuala Lumpur,686,138,548,2022
2022-05-13,W.P. Kuala Lumpur,400,43,357,2022
2022-05-14,W.P. Kuala Lumpur,749,151,598,2022
2022-05-15,W.P. Kuala Lumpur,1125,198,927,2022
2022-05-16,W.P. Kuala Lumpur,629,100,529,2022
2022-05-17,W.P. Kuala Lumpur,466,141,325,2022
2022-05-18,W.P. Kuala Lumpur,470,110,360,2022
2022-05-19,W.P. Kuala Lumpur,677,161,516,2022
2022-05-20,W.P. Kuala Lumpur,475,131,344,2022
2022-05-21,W.P. Kuala Lumpur,844,151,693,2022
2022-05-22,W.P. Kuala Lumpur,1235,227,1008,2022
2022-05-23,W.P. Kuala Lumpur,437,46,391,2022
2022-05-24,W.P. Kuala Lumpur,449,110,339,2022
2022-05-25,W.P. Kuala Lumpur,439,117,322,2022
2022-05-26,W.P. Kuala Lumpur,648,147,501,2022
2022-05-27,W.P. Kuala Lumpur,482,135,347,2022
2022-05-28,W.P. Kuala Lumpur,694,106,588,2022
2022-05-29,W.P. Kuala Lumpur,761,133,628,2022
2022-05-30,W.P. Kuala Lumpur,378,59,319,2022
2022-05-31,W.P. Kuala Lumpur,621,181,440,2022
2022-06-01,W.P. Kuala Lumpur,620,188,432,2022
2022-06-02,W.P. Kuala Lumpur,569,160,409,2022
2022-06-03,W.P. Kuala Lumpur,491,114,377,2022
2022-06-04,W.P. Kuala Lumpur,741,139,602,2022
2022-06-05,W.P. Kuala Lumpur,788,158,630,2022
2022-06-06,W.P. Kuala Lumpur,659,124,535,2022
2022-06-07,W.P. Kuala Lumpur,449,61,388,2022
2022-06-08,W.P. Kuala Lumpur,505,79,426,2022
2022-06-09,W.P. Kuala Lumpur,540,101,439,2022
2022-06-10,W.P. Kuala Lumpur,528,103,425,2022
2022-06-11,W.P. Kuala Lumpur,656,111,545,2022
2022-06-12,W.P. Kuala Lumpur,1210,206,1004,2022
2022-06-13,W.P. Kuala Lumpur,418,72,346,2022
2022-06-14,W.P. Kuala Lumpur,887,138,749,2022
2022-06-15,W.P. Kuala Lumpur,608,131,477,2022
2022-06-16,W.P. Kuala Lumpur,640,130,510,2022
2022-06-17,W.P. Kuala Lumpur,599,150,449,2022
2022-06-18,W.P. Kuala Lumpur,932,227,705,2022
2022-06-19,W.P. Kuala Lumpur,939,154,785,2022
2022-06-20,W.P. Kuala Lumpur,699,158,541,2022
2022-06-21,W.P. Kuala Lumpur,381,74,307,2022
2022-06-22,W.P. Kuala Lumpur,522,127,395,2022
2022-06-23,W.P. Kuala Lumpur,440,85,355,2022
2022-06-24,W.P. Kuala Lumpur,453,88,365,2022
2022-06-25,W.P. Kuala Lumpur,690,101,589,2022
2022-06-26,W.P. Kuala Lumpur,1018,188,830,2022
2022-06-27,W.P. Kuala Lumpur,618,175,443,2022
2022-06-28,W.P. Kuala Lumpur,597,127,470,2022
2022-06-29,W.P. Kuala Lumpur,610,120,490,2022
2022-06-30,W.P. Kuala Lumpur,819,169,650,2022
2022-07-01,W.P. Kuala Lumpur,533,122,411,2022
2022-07-02,W.P. Kuala Lumpur,823,126,697,2022
2022-07-03,W.P. Kuala Lumpur,1005,164,841,2022
2022-07-04,W.P. Kuala Lumpur,248,24,224,2022
2022-07-05,W.P. Kuala Lumpur,523,86,437,2022
2022-07-06,W.P. Kuala Lumpur,592,151,441,2022
2022-07-07,W.P. Kuala Lumpur,585,142,443,2022
2022-07-08,W.P. Kuala Lumpur,506,114,392,2022
2022-07-09,W.P. Kuala Lumpur,531,103,428,2022
2022-07-10,W.P. Kuala Lumpur,528,112,416,2022
2022-07-11,W.P. Kuala Lumpur,407,61,346,2022
2022-07-12,W.P. Kuala Lumpur,373,96,277,2022
2022-07-13,W.P. Kuala Lumpur,398,106,292,2022
2022-07-14,W.P. Kuala Lumpur,510,152,358,2022
2022-07-15,W.P. Kuala Lumpur,429,75,354,2022
2022-07-16,W.P. Kuala Lumpur,568,83,485,2022
2022-07-17,W.P. Kuala Lumpur,1197,245,952,2022
2022-07-18,W.P. Kuala Lumpur,380,67,313,2022
2022-07-19,W.P. Kuala Lumpur,571,119,452,2022
2022-07-20,W.P. Kuala Lumpur,482,76,406,2022
2022-07-21,W.P. Kuala Lumpur,613,142,471,2022
2022-07-22,W.P. Kuala Lumpur,486,110,376,2022
2022-07-23,W.P. Kuala Lumpur,1227,389,838,2022
2022-07-24,W.P. Kuala Lumpur,910,196,714,2022
2022-07-25,W.P. Kuala Lumpur,362,72,290,2022
2022-07-26,W.P. Kuala Lumpur,528,110,418,2022
2022-07-27,W.P. Kuala Lumpur,479,143,336,2022
2022-07-28,W.P. Kuala Lumpur,580,110,470,2022
2022-07-29,W.P. Kuala Lumpur,283,39,244,2022
2022-07-30,W.P. Kuala Lumpur,618,100,518,2022
2022-07-31,W.P. Kuala Lumpur,597,110,487,2022
2022-08-01,W.P. Kuala Lumpur,345,61,284,2022
2022-08-02,W.P. Kuala Lumpur,275,36,239,2022
2022-08-03,W.P. Kuala Lumpur,386,59,327,2022
2022-08-04,W.P. Kuala Lumpur,343,104,239,2022
2022-08-05,W.P. Kuala Lumpur,411,72,339,2022
2022-08-06,W.P. Kuala Lumpur,538,103,435,2022
2022-08-07,W.P. Kuala Lumpur,695,129,566,2022
2022-08-08,W.P. Kuala Lumpur,373,101,272,2022
2022-08-09,W.P. Kuala Lumpur,384,69,315,2022
2022-08-10,W.P. Kuala Lumpur,407,104,303,2022
2022-08-11,W.P. Kuala Lumpur,569,113,456,2022
2022-08-12,W.P. Kuala Lumpur,412,92,320,2022
2022-08-13,W.P. Kuala Lumpur,716,133,583,2022
2022-08-14,W.P. Kuala Lumpur,840,160,680,2022
2022-08-15,W.P. Kuala Lumpur,296,54,242,2022
2022-08-16,W.P. Kuala Lumpur,431,94,337,2022
2022-08-17,W.P. Kuala Lumpur,445,82,363,2022
2022-08-18,W.P. Kuala Lumpur,653,207,446,2022
2022-08-19,W.P. Kuala Lumpur,470,82,388,2022
2022-08-20,W.P. Kuala Lumpur,691,140,551,2022
2022-08-21,W.P. Kuala Lumpur,860,137,723,2022
2022-08-22,W.P. Kuala Lumpur,374,79,295,2022
2022-08-23,W.P. Kuala Lumpur,389,73,316,2022
2022-08-24,W.P. Kuala Lumpur,462,95,367,2022
2022-08-25,W.P. Kuala Lumpur,425,87,338,2022
2022-08-26,W.P. Kuala Lumpur,577,132,445,2022
2022-08-27,W.P. Kuala Lumpur,775,158,617,2022
2022-08-28,W.P. Kuala Lumpur,960,125,835,2022
2022-08-29,W.P. Kuala Lumpur,406,168,238,2022
2022-08-30,W.P. Kuala Lumpur,609,253,356,2022
2022-08-31,W.P. Kuala Lumpur,1168,202,966,2022
2022-09-01,W.P. Kuala Lumpur,457,83,374,2022
2022-09-02,W.P. Kuala Lumpur,316,64,252,2022
2022-09-03,W.P. Kuala Lumpur,580,99,481,2022
2022-09-04,W.P. Kuala Lumpur,929,151,778,2022
2022-09-05,W.P. Kuala Lumpur,339,64,275,2022
2022-09-06,W.P. Kuala Lumpur,568,111,457,2022
2022-09-07,W.P. Kuala Lumpur,559,217,342,2022
2022-09-08,W.P. Kuala Lumpur,580,195,385,2022
2022-09-09,W.P. Kuala Lumpur,416,121,295,2022
2022-09-10,W.P. Kuala Lumpur,622,90,532,2022
2022-09-11,W.P. Kuala Lumpur,731,121,610,2022
2022-09-12,W.P. Kuala Lumpur,386,43,343,2022
2022-09-13,W.P. Kuala Lumpur,575,123,452,2022
2022-09-14,W.P. Kuala Lumpur,541,124,417,2022
2022-09-15,W.P. Kuala Lumpur,577,213,364,2022
2022-09-16,W.P. Kuala Lumpur,820,116,704,2022
2022-09-17,W.P. Kuala Lumpur,664,89,575,2022
2022-09-18,W.P. Kuala Lumpur,811,121,690,2022
2022-09-19,W.P. Kuala Lumpur,565,133,432,2022
2022-09-20,W.P. Kuala Lumpur,484,120,364,2022
2022-09-21,W.P. Kuala Lumpur,513,181,332,2022
2022-09-22,W.P. Kuala Lumpur,483,73,410,2022
2022-09-23,W.P. Kuala Lumpur,488,67,421,2022
2022-09-24,W.P. Kuala Lumpur,589,118,471,2022
2022-09-25,W.P. Kuala Lumpur,906,139,767,2022
2022-09-26,W.P. Kuala Lumpur,552,116,436,2022
2022-09-27,W.P. Kuala Lumpur,394,68,326,2022
2022-09-28,W.P. Kuala Lumpur,457,129,328,2022
2022-09-29,W.P. Kuala Lumpur,673,144,529,2022
2022-09-30,W.P. Kuala Lumpur,528,99,429,2022
2022-10-01,W.P. Kuala Lumpur,718,117,601,2022
2022-10-02,W.P. Kuala Lumpur,943,127,816,2022
2022-10-03,W.P. Kuala Lumpur,475,137,338,2022
2022-10-04,W.P. Kuala Lumpur,475,115,360,2022
2022-10-05,W.P. Kuala Lumpur,599,106,493,2022
2022-10-06,W.P. Kuala Lumpur,529,84,445,2022
2022-10-07,W.P. Kuala Lumpur,417,49,368,2022
2022-10-08,W.P. Kuala Lumpur,725,106,619,2022
2022-10-09,W.P. Kuala Lumpur,1066,172,894,2022
2022-10-10,W.P. Kuala Lumpur,484,67,417,2022
2022-10-11,W.P. Kuala Lumpur,596,165,431,2022
2022-10-12,W.P. Kuala Lumpur,684,162,522,2022
2022-10-13,W.P. Kuala Lumpur,693,115,578,2022
2022-10-14,W.P. Kuala Lumpur,476,117,359,2022
2022-10-15,W.P. Kuala Lumpur,845,156,689,2022
2022-10-16,W.P. Kuala Lumpur,1063,157,906,2022
2022-10-17,W.P. Kuala Lumpur,357,70,287,2022
2022-10-18,W.P. Kuala Lumpur,596,121,475,2022
2022-10-19,W.P. Kuala Lumpur,517,131,386,2022
2022-10-20,W.P. Kuala Lumpur,341,75,266,2022
2022-10-21,W.P. Kuala Lumpur,291,60,231,2022
2022-10-22,W.P. Kuala Lumpur,803,130,673,2022
2022-10-23,W.P. Kuala Lumpur,837,130,707,2022
2022-10-24,W.P. Kuala Lumpur,695,138,557,2022
2022-10-25,W.P. Kuala Lumpur,446,104,342,2022
2022-10-26,W.P. Kuala Lumpur,670,185,485,2022
2022-10-27,W.P. Kuala Lumpur,394,104,290,2022
2022-10-28,W.P. Kuala Lumpur,311,46,265,2022
2022-10-29,W.P. Kuala Lumpur,540,72,468,2022
2022-10-30,W.P. Kuala Lumpur,908,180,728,2022
2022-10-31,W.P. Kuala Lumpur,406,72,334,2022
2022-11-01,W.P. Kuala Lumpur,235,24,211,2022
2022-11-02,W.P. Kuala Lumpur,407,52,355,2022
2022-11-03,W.P. Kuala Lumpur,368,51,317,2022
2022-11-04,W.P. Kuala Lumpur,242,37,205,2022
2022-11-05,W.P. Kuala Lumpur,817,199,618,2022
2022-11-06,W.P. Kuala Lumpur,1004,293,711,2022
2022-11-07,W.P. Kuala Lumpur,335,62,273,2022
2022-11-08,W.P. Kuala Lumpur,589,170,419,2022
2022-11-09,W.P. Kuala Lumpur,475,95,380,2022
2022-11-10,W.P. Kuala Lumpur,653,199,454,2022
2022-11-11,W.P. Kuala Lumpur,334,53,281,2022
2022-11-12,W.P. Kuala Lumpur,665,94,571,2022
2022-11-13,W.P. Kuala Lumpur,861,156,705,2022
2022-11-14,W.P. Kuala Lumpur,491,137,354,2022
2022-11-15,W.P. Kuala Lumpur,506,158,348,2022
2022-11-16,W.P. Kuala Lumpur,577,172,405,2022
2022-11-17,W.P. Kuala Lumpur,437,67,370,2022
2022-11-18,W.P. Kuala Lumpur,476,59,417,2022
2022-11-19,W.P. Kuala Lumpur,117,16,101,2022
2022-11-20,W.P. Kuala Lumpur,209,20,189,2022
2022-11-21,W.P. Kuala Lumpur,241,33,208,2022
2022-11-22,W.P. Kuala Lumpur,424,114,310,2022
2022-11-23,W.P. Kuala Lumpur,589,187,402,2022
2022-11-24,W.P. Kuala Lumpur,858,186,672,2022
2022-11-25,W.P. Kuala Lumpur,508,100,408,2022
2022-11-26,W.P. Kuala Lumpur,648,186,462,2022
2022-11-27,W.P. Kuala Lumpur,670,108,562,2022
2022-11-28,W.P. Kuala Lumpur,510,50,460,2022
2022-11-29,W.P. Kuala Lumpur,627,236,391,2022
2022-11-30,W.P. Kuala Lumpur,569,145,424,2022
2022-12-01,W.P. Kuala Lumpur,568,116,452,2022
2022-12-02,W.P. Kuala Lumpur,426,80,346,2022
2022-12-03,W.P. Kuala Lumpur,837,192,645,2022
2022-12-04,W.P. Kuala Lumpur,906,141,765,2022
2022-12-05,W.P. Kuala Lumpur,376,39,337,2022
2022-12-06,W.P. Kuala Lumpur,629,121,508,2022
2022-12-07,W.P. Kuala Lumpur,496,90,406,2022
2022-12-08,W.P. Kuala Lumpur,483,96,387,2022
2022-12-09,W.P. Kuala Lumpur,456,91,365,2022
2022-12-10,W.P. Kuala Lumpur,723,103,620,2022
2022-12-11,W.P. Kuala Lumpur,923,119,804,2022
2022-12-12,W.P. Kuala Lumpur,489,49,440,2022
2022-12-13,W.P. Kuala Lumpur,617,127,490,2022
2022-12-14,W.P. Kuala Lumpur,693,201,492,2022
2022-12-15,W.P. Kuala Lumpur,529,141,388,2022
2022-12-16,W.P. Kuala Lumpur,466,80,386,2022
2022-12-17,W.P. Kuala Lumpur,1024,198,826,2022
2022-12-18,W.P. Kuala Lumpur,1085,174,911,2022
2022-12-19,W.P. Kuala Lumpur,449,111,338,2022
2022-12-20,W.P. Kuala Lumpur,695,160,535,2022
2022-12-21,W.P. Kuala Lumpur,642,189,453,2022
2022-12-22,W.P. Kuala Lumpur,588,120,468,2022
2022-12-23,W.P. Kuala Lumpur,501,73,428,2022
2022-12-24,W.P. Kuala Lumpur,631,84,547,2022
2022-12-25,W.P. Kuala Lumpur,857,141,716,2022
2022-12-26,W.P. Kuala Lumpur,665,102,563,2022
2022-12-27,W.P. Kuala Lumpur,448,70,378,2022
2022-12-28,W.P. Kuala Lumpur,464,99,365,2022
2022-12-29,W.P. Kuala Lumpur,440,62,378,2022
2022-12-30,W.P. Kuala Lumpur,472,53,419,2022
2022-12-31,W.P. Kuala Lumpur,826,105,721,2022
2023-01-01,W.P. Kuala Lumpur,989,147,842,2023
2023-01-02,W.P. Kuala Lumpur,653,70,583,2023
2023-01-03,W.P. Kuala Lumpur,237,43,194,2023
2023-01-04,W.P. Kuala Lumpur,505,104,401,2023
2023-01-05,W.P. Kuala Lumpur,535,105,430,2023
2023-01-06,W.P. Kuala Lumpur,513,90,423,2023
2023-01-07,W.P. Kuala Lumpur,773,154,619,2023
2023-01-08,W.P. Kuala Lumpur,1044,191,853,2023
2023-01-09,W.P. Kuala Lumpur,230,35,195,2023
2023-01-10,W.P. Kuala Lumpur,583,134,449,2023
2023-01-11,W.P. Kuala Lumpur,544,211,333,2023
2023-01-12,W.P. Kuala Lumpur,347,48,299,2023
2023-01-13,W.P. Kuala Lumpur,440,81,359,2023
2023-01-14,W.P. Kuala Lumpur,740,78,662,2023
2023-01-15,W.P. Kuala Lumpur,850,122,728,2023
2023-01-16,W.P. Kuala Lumpur,264,31,233,2023
2023-01-17,W.P. Kuala Lumpur,702,185,517,2023
2023-01-18,W.P. Kuala Lumpur,561,146,415,2023
2023-01-19,W.P. Kuala Lumpur,535,161,374,2023
2023-01-20,W.P. Kuala Lumpur,384,37,347,2023
2023-01-21,W.P. Kuala Lumpur,443,56,387,2023
2023-01-22,W.P. Kuala Lumpur,259,34,225,2023
2023-01-23,W.P. Kuala Lumpur,512,58,454,2023
2023-01-24,W.P. Kuala Lumpur,529,76,453,2023
2023-01-25,W.P. Kuala Lumpur,386,34,352,2023
2023-01-26,W.P. Kuala Lumpur,582,83,499,2023
2023-01-27,W.P. Kuala Lumpur,454,55,399,2023
2023-01-28,W.P. Kuala Lumpur,762,123,639,2023
2023-01-29,W.P. Kuala Lumpur,840,156,684,2023
2023-01-30,W.P. Kuala Lumpur,300,64,236,2023
2023-01-31,W.P. Kuala Lumpur,453,55,398,2023
2023-02-01,W.P. Kuala Lumpur,554,99,455,2023
2023-02-02,W.P. Kuala Lumpur,636,222,414,2023
2023-02-03,W.P. Kuala Lumpur,268,24,244,2023
2023-02-04,W.P. Kuala Lumpur,875,172,703,2023
2023-02-05,W.P. Kuala Lumpur,1467,278,1189,2023
2023-02-06,W.P. Kuala Lumpur,483,79,404,2023
2023-02-07,W.P. Kuala Lumpur,347,35,312,2023
2023-02-08,W.P. Kuala Lumpur,558,109,449,2023
2023-02-09,W.P. Kuala Lumpur,504,116,388,2023
2023-02-10,W.P. Kuala Lumpur,299,26,273,2023
2023-02-11,W.P. Kuala Lumpur,1018,302,716,2023
2023-02-12,W.P. Kuala Lumpur,887,102,785,2023
2023-02-13,W.P. Kuala Lumpur,173,10,163,2023
2023-02-14,W.P. Kuala Lumpur,375,54,321,2023
2023-02-15,W.P. Kuala Lumpur,384,65,319,2023
2023-02-16,W.P. Kuala Lumpur,702,197,505,2023
2023-02-17,W.P. Kuala Lumpur,638,194,444,2023
2023-02-18,W.P. Kuala Lumpur,1061,217,844,2023
2023-02-19,W.P. Kuala Lumpur,986,211,775,2023
2023-02-20,W.P. Kuala Lumpur,391,43,348,2023
2023-02-21,W.P. Kuala Lumpur,519,117,402,2023
2023-02-22,W.P. Kuala Lumpur,363,57,306,2023
2023-02-23,W.P. Kuala Lumpur,588,122,466,2023
2023-02-24,W.P. Kuala Lumpur,399,57,342,2023
2023-02-25,W.P. Kuala Lumpur,797,213,584,2023
2023-02-26,W.P. Kuala Lumpur,952,123,829,2023
2023-02-27,W.P. Kuala Lumpur,572,150,422,2023
2023-02-28,W.P. Kuala Lumpur,544,160,384,2023
2023-03-01,W.P. Kuala Lumpur,415,115,300,2023
2023-03-02,W.P. Kuala Lumpur,563,88,475,2023
2023-03-03,W.P. Kuala Lumpur,416,67,349,2023
2023-03-04,W.P. Kuala Lumpur,754,103,651,2023
2023-03-05,W.P. Kuala Lumpur,986,139,847,2023
2023-03-06,W.P. Kuala Lumpur,347,70,277,2023
2023-03-07,W.P. Kuala Lumpur,581,124,457,2023
2023-03-08,W.P. Kuala Lumpur,623,106,517,2023
2023-03-09,W.P. Kuala Lumpur,683,175,508,2023
2023-03-10,W.P. Kuala Lumpur,388,42,346,2023
2023-03-11,W.P. Kuala Lumpur,1020,179,841,2023
2023-03-12,W.P. Kuala Lumpur,1087,150,937,2023
2023-03-13,W.P. Kuala Lumpur,587,179,408,2023
2023-03-14,W.P. Kuala Lumpur,567,99,468,2023
2023-03-15,W.P. Kuala Lumpur,694,127,567,2023
2023-03-16,W.P. Kuala Lumpur,608,175,433,2023
2023-03-17,W.P. Kuala Lumpur,565,131,434,2023
2023-03-18,W.P. Kuala Lumpur,947,129,818,2023
2023-03-19,W.P. Kuala Lumpur,1180,179,1001,2023
2023-03-20,W.P. Kuala Lumpur,626,174,452,2023
2023-03-21,W.P. Kuala Lumpur,1009,308,701,2023
2023-03-22,W.P. Kuala Lumpur,917,262,655,2023
2023-03-23,W.P. Kuala Lumpur,427,225,202,2023
2023-03-24,W.P. Kuala Lumpur,375,205,170,2023
2023-03-25,W.P. Kuala Lumpur,509,80,429,2023
2023-03-26,W.P. Kuala Lumpur,725,130,595,2023
2023-03-27,W.P. Kuala Lumpur,190,53,137,2023
2023-03-28,W.P. Kuala Lumpur,238,70,168,2023
2023-03-29,W.P. Kuala Lumpur,390,75,315,2023
2023-03-30,W.P. Kuala Lumpur,371,93,278,2023
2023-03-31,W.P. Kuala Lumpur,305,78,227,2023
2023-04-01,W.P. Kuala Lumpur,544,94,450,2023
2023-04-02,W.P. Kuala Lumpur,921,164,757,2023
2023-04-03,W.P. Kuala Lumpur,202,39,163,2023
2023-04-04,W.P. Kuala Lumpur,194,35,159,2023
2023-04-05,W.P. Kuala Lumpur,216,41,175,2023
2023-04-06,W.P. Kuala Lumpur,433,132,301,2023
2023-04-07,W.P. Kuala Lumpur,392,101,291,2023
2023-04-08,W.P. Kuala Lumpur,872,148,724,2023
2023-04-09,W.P. Kuala Lumpur,1015,134,881,2023
2023-04-10,W.P. Kuala Lumpur,172,29,143,2023
2023-04-11,W.P. Kuala Lumpur,438,194,244,2023
2023-04-12,W.P. Kuala Lumpur,359,158,201,2023
2023-04-13,W.P. Kuala Lumpur,245,33,212,2023
2023-04-14,W.P. Kuala Lumpur,295,50,245,2023
2023-04-15,W.P. Kuala Lumpur,672,130,542,2023
2023-04-16,W.P. Kuala Lumpur,921,125,796,2023
2023-04-17,W.P. Kuala Lumpur,176,30,146,2023
2023-04-18,W.P. Kuala Lumpur,281,87,194,2023
2023-04-19,W.P. Kuala Lumpur,307,111,196,2023
2023-04-20,W.P. Kuala Lumpur,187,11,176,2023
2023-04-21,W.P. Kuala Lumpur,172,14,158,2023
2023-04-22,W.P. Kuala Lumpur,0,0,0,2023
2023-04-23,W.P. Kuala Lumpur,140,27,113,2023
2023-04-24,W.P. Kuala Lumpur,421,50,371,2023
2023-04-25,W.P. Kuala Lumpur,358,38,320,2023
2023-04-26,W.P. Kuala Lumpur,384,36,348,2023
2023-04-27,W.P. Kuala Lumpur,340,54,286,2023
2023-04-28,W.P. Kuala Lumpur,369,54,315,2023
2023-04-29,W.P. Kuala Lumpur,626,81,545,2023
2023-04-30,W.P. Kuala Lumpur,883,146,737,2023
2023-05-01,W.P. Kuala Lumpur,1425,193,1232,2023
2023-05-02,W.P. Kuala Lumpur,220,11,209,2023
2023-05-03,W.P. Kuala Lumpur,323,37,286,2023
2023-05-04,W.P. Kuala Lumpur,1369,233,1136,2023
2023-05-05,W.P. Kuala Lumpur,402,76,326,2023
2023-05-06,W.P. Kuala Lumpur,621,75,546,2023
2023-05-07,W.P. Kuala Lumpur,1057,177,880,2023
2023-05-08,W.P. Kuala Lumpur,366,89,277,2023
2023-05-09,W.P. Kuala Lumpur,353,38,315,2023
2023-05-10,W.P. Kuala Lumpur,447,101,346,2023
2023-05-11,W.P. Kuala Lumpur,420,102,318,2023
2023-05-12,W.P. Kuala Lumpur,571,187,384,2023
2023-05-13,W.P. Kuala Lumpur,668,111,557,2023
2023-05-14,W.P. Kuala Lumpur,882,101,781,2023
2023-05-15,W.P. Kuala Lumpur,391,48,343,2023
2023-05-16,W.P. Kuala Lumpur,471,101,370,2023
2023-05-17,W.P. Kuala Lumpur,397,63,334,2023
2023-05-18,W.P. Kuala Lumpur,463,72,391,2023
2023-05-19,W.P. Kuala Lumpur,329,76,253,2023
2023-05-20,W.P. Kuala Lumpur,807,215,592,2023
2023-05-21,W.P. Kuala Lumpur,883,145,738,2023
2023-05-22,W.P. Kuala Lumpur,361,53,308,2023
2023-05-23,W.P. Kuala Lumpur,260,25,235,2023
2023-05-24,W.P. Kuala Lumpur,507,135,372,2023
2023-05-25,W.P. Kuala Lumpur,507,145,362,2023
2023-05-26,W.P. Kuala Lumpur,350,46,304,2023
2023-05-27,W.P. Kuala Lumpur,645,67,578,2023
2023-05-28,W.P. Kuala Lumpur,831,84,747,2023
2023-05-29,W.P. Kuala Lumpur,413,89,324,2023
2023-05-30,W.P. Kuala Lumpur,644,115,529,2023
2023-05-31,W.P. Kuala Lumpur,561,107,454,2023
2023-06-01,W.P. Kuala Lumpur,481,83,398,2023
2023-06-02,W.P. Kuala Lumpur,420,61,359,2023
2023-06-03,W.P. Kuala Lumpur,678,101,577,2023
2023-06-04,W.P. Kuala Lumpur,1031,168,863,2023
2023-06-05,W.P. Kuala Lumpur,641,151,490,2023
2023-06-06,W.P. Kuala Lumpur,343,73,270,2023
2023-06-07,W.P. Kuala Lumpur,588,141,447,2023
2023-06-08,W.P. Kuala Lumpur,709,173,536,2023
2023-06-09,W.P. Kuala Lumpur,594,178,416,2023
2023-06-10,W.P. Kuala Lumpur,718,96,622,2023
2023-06-11,W.P. Kuala Lumpur,1312,181,1131,2023
2023-06-12,W.P. Kuala Lumpur,640,119,521,2023
2023-06-13,W.P. Kuala Lumpur,576,137,439,2023
2023-06-14,W.P. Kuala Lumpur,952,126,826,2023
2023-06-15,W.P. Kuala Lumpur,608,93,515,2023
2023-06-16,W.P. Kuala Lumpur,742,166,576,2023
2023-06-17,W.P. Kuala Lumpur,1170,261,909,2023
2023-06-18,W.P. Kuala Lumpur,1457,234,1223,2023
2023-06-19,W.P. Kuala Lumpur,604,132,472,2023
2023-06-20,W.P. Kuala Lumpur,594,112,482,2023
2023-06-21,W.P. Kuala Lumpur,782,177,605,2023
2023-06-22,W.P. Kuala Lumpur,528,108,420,2023
2023-06-23,W.P. Kuala Lumpur,560,100,460,2023
2023-06-24,W.P. Kuala Lumpur,794,161,633,2023
2023-06-25,W.P. Kuala Lumpur,904,127,777,2023
2023-06-26,W.P. Kuala Lumpur,472,131,341,2023
2023-06-27,W.P. Kuala Lumpur,446,110,336,2023
2023-06-28,W.P. Kuala Lumpur,251,17,234,2023
2023-06-29,W.P. Kuala Lumpur,339,34,305,2023
2023-06-30,W.P. Kuala Lumpur,333,36,297,2023
2023-07-01,W.P. Kuala Lumpur,696,87,609,2023
2023-07-02,W.P. Kuala Lumpur,743,107,636,2023
2023-07-03,W.P. Kuala Lumpur,413,75,338,2023
2023-07-04,W.P. Kuala Lumpur,327,39,288,2023
2023-07-05,W.P. Kuala Lumpur,516,111,405,2023
2023-07-06,W.P. Kuala Lumpur,585,146,439,2023
2023-07-07,W.P. Kuala Lumpur,438,76,362,2023
2023-07-08,W.P. Kuala Lumpur,810,134,676,2023
2023-07-09,W.P. Kuala Lumpur,1073,166,907,2023
2023-07-10,W.P. Kuala Lumpur,465,116,349,2023
2023-07-11,W.P. Kuala Lumpur,478,99,379,2023
2023-07-12,W.P. Kuala Lumpur,626,129,497,2023
2023-07-13,W.P. Kuala Lumpur,381,74,307,2023
2023-07-14,W.P. Kuala Lumpur,439,75,364,2023
2023-07-15,W.P. Kuala Lumpur,1106,272,834,2023
2023-07-16,W.P. Kuala Lumpur,880,151,729,2023
2023-07-17,W.P. Kuala Lumpur,381,84,297,2023
2023-07-18,W.P. Kuala Lumpur,561,117,444,2023
2023-07-19,W.P. Kuala Lumpur,679,117,562,2023
2023-07-20,W.P. Kuala Lumpur,531,112,419,2023
2023-07-21,W.P. Kuala Lumpur,319,60,259,2023
2023-07-22,W.P. Kuala Lumpur,759,112,647,2023
2023-07-23,W.P. Kuala Lumpur,862,161,701,2023
2023-07-24,W.P. Kuala Lumpur,363,98,265,2023
2023-07-25,W.P. Kuala Lumpur,576,106,470,2023
2023-07-26,W.P. Kuala Lumpur,388,47,341,2023
2023-07-27,W.P. Kuala Lumpur,456,76,380,2023
2023-07-28,W.P. Kuala Lumpur,524,142,382,2023
2023-07-29,W.P. Kuala Lumpur,683,93,590,2023
2023-07-30,W.P. Kuala Lumpur,989,175,814,2023
2023-07-31,W.P. Kuala Lumpur,290,54,236,2023
2023-08-01,W.P. Kuala Lumpur,596,164,432,2023
2023-08-02,W.P. Kuala Lumpur,591,184,407,2023
2023-08-03,W.P. Kuala Lumpur,451,174,277,2023
2023-08-04,W.P. Kuala Lumpur,605,241,364,2023
2023-08-05,W.P. Kuala Lumpur,784,96,688,2023
2023-08-06,W.P. Kuala Lumpur,855,117,738,2023
2023-08-07,W.P. Kuala Lumpur,313,51,262,2023
2023-08-08,W.P. Kuala Lumpur,420,136,284,2023
2023-08-09,W.P. Kuala Lumpur,477,57,420,2023
2023-08-10,W.P. Kuala Lumpur,579,152,427,2023
2023-08-11,W.P. Kuala Lumpur,221,17,204,2023
2023-08-12,W.P. Kuala Lumpur,508,74,434,2023
2023-08-13,W.P. Kuala Lumpur,1002,130,872,2023
2023-08-14,W.P. Kuala Lumpur,286,29,257,2023
2023-08-15,W.P. Kuala Lumpur,573,102,471,2023
2023-08-16,W.P. Kuala Lumpur,601,157,444,2023
2023-08-17,W.P. Kuala Lumpur,555,151,404,2023
2023-08-18,W.P. Kuala Lumpur,357,73,284,2023
2023-08-19,W.P. Kuala Lumpur,694,121,573,2023
2023-08-20,W.P. Kuala Lumpur,1103,194,909,2023
2023-08-21,W.P. Kuala Lumpur,333,50,283,2023
2023-08-22,W.P. Kuala Lumpur,473,125,348,2023
2023-08-23,W.P. Kuala Lumpur,470,117,353,2023
2023-08-24,W.P. Kuala Lumpur,689,125,564,2023
2023-08-25,W.P. Kuala Lumpur,330,53,277,2023
2023-08-26,W.P. Kuala Lumpur,664,104,560,2023
2023-08-27,W.P. Kuala Lumpur,635,71,564,2023
2023-08-28,W.P. Kuala Lumpur,415,83,332,2023
2023-08-29,W.P. Kuala Lumpur,554,71,483,2023
2023-08-30,W.P. Kuala Lumpur,439,106,333,2023
2023-08-31,W.P. Kuala Lumpur,1042,187,855,2023
2023-09-01,W.P. Kuala Lumpur,238,19,219,2023
2023-09-02,W.P. Kuala Lumpur,639,76,563,2023
2023-09-03,W.P. Kuala Lumpur,898,119,779,2023
2023-09-04,W.P. Kuala Lumpur,295,26,269,2023
2023-09-05,W.P. Kuala Lumpur,351,35,316,2023
2023-09-06,W.P. Kuala Lumpur,388,63,325,2023
2023-09-07,W.P. Kuala Lumpur,564,123,441,2023
2023-09-08,W.P. Kuala Lumpur,277,28,249,2023
2023-09-09,W.P. Kuala Lumpur,753,107,646,2023
2023-09-10,W.P. Kuala Lumpur,948,129,819,2023
2023-09-11,W.P. Kuala Lumpur,411,64,347,2023
2023-09-12,W.P. Kuala Lumpur,399,40,359,2023
2023-09-13,W.P. Kuala Lumpur,629,126,503,2023
2023-09-14,W.P. Kuala Lumpur,554,161,393,2023
2023-09-15,W.P. Kuala Lumpur,315,45,270,2023
2023-09-16,W.P. Kuala Lumpur,945,110,835,2023
2023-09-17,W.P. Kuala Lumpur,996,142,854,2023
2023-09-18,W.P. Kuala Lumpur,350,40,310,2023
2023-09-19,W.P. Kuala Lumpur,629,170,459,2023
2023-09-20,W.P. Kuala Lumpur,475,170,305,2023
2023-09-21,W.P. Kuala Lumpur,604,138,466,2023
2023-09-22,W.P. Kuala Lumpur,246,20,226,2023
2023-09-23,W.P. Kuala Lumpur,752,109,643,2023
2023-09-24,W.P. Kuala Lumpur,823,119,704,2023
2023-09-25,W.P. Kuala Lumpur,562,166,396,2023
2023-09-26,W.P. Kuala Lumpur,435,173,262,2023
2023-09-27,W.P. Kuala Lumpur,508,136,372,2023
2023-09-28,W.P. Kuala Lumpur,690,83,607,2023
2023-09-29,W.P. Kuala Lumpur,237,35,202,2023
2023-09-30,W.P. Kuala Lumpur,555,81,474,2023
2023-10-01,W.P. Kuala Lumpur,774,103,671,2023
2023-10-02,W.P. Kuala Lumpur,250,26,224,2023
2023-10-03,W.P. Kuala Lumpur,478,68,410,2023
2023-10-04,W.P. Kuala Lumpur,384,57,327,2023
2023-10-05,W.P. Kuala Lumpur,425,89,336,2023
2023-10-06,W.P. Kuala Lumpur,259,28,231,2023
2023-10-07,W.P. Kuala Lumpur,710,212,498,2023
2023-10-08,W.P. Kuala Lumpur,927,254,673,2023
2023-10-09,W.P. Kuala Lumpur,410,50,360,2023
2023-10-10,W.P. Kuala Lumpur,485,155,330,2023
2023-10-11,W.P. Kuala Lumpur,389,113,276,2023
2023-10-12,W.P. Kuala Lumpur,427,79,348,2023
2023-10-13,W.P. Kuala Lumpur,183,24,159,2023
2023-10-14,W.P. Kuala Lumpur,700,96,604,2023
2023-10-15,W.P. Kuala Lumpur,1000,160,840,2023
2023-10-16,W.P. Kuala Lumpur,527,117,410,2023
2023-10-17,W.P. Kuala Lumpur,557,129,428,2023
2023-10-18,W.P. Kuala Lumpur,638,167,471,2023
2023-10-19,W.P. Kuala Lumpur,542,111,431,2023
2023-10-20,W.P. Kuala Lumpur,343,38,305,2023
2023-10-21,W.P. Kuala Lumpur,764,146,618,2023
2023-10-22,W.P. Kuala Lumpur,739,109,630,2023
2023-10-23,W.P. Kuala Lumpur,355,71,284,2023
2023-10-24,W.P. Kuala Lumpur,407,92,315,2023
2023-10-25,W.P. Kuala Lumpur,419,91,328,2023
2023-10-26,W.P. Kuala Lumpur,392,78,314,2023
2023-10-27,W.P. Kuala Lumpur,219,10,209,2023
2023-10-28,W.P. Kuala Lumpur,800,100,700,2023
2023-10-29,W.P. Kuala Lumpur,949,146,803,2023
2023-10-30,W.P. Kuala Lumpur,499,119,380,2023
2023-10-31,W.P. Kuala Lumpur,672,124,548,2023
2023-11-01,W.P. Kuala Lumpur,776,284,492,2023
2023-11-02,W.P. Kuala Lumpur,591,212,379,2023
2023-11-03,W.P. Kuala Lumpur,194,17,177,2023
2023-11-04,W.P. Kuala Lumpur,739,163,576,2023
2023-11-05,W.P. Kuala Lumpur,805,109,696,2023
2023-11-06,W.P. Kuala Lumpur,469,111,358,2023
2023-11-07,W.P. Kuala Lumpur,555,113,442,2023
2023-11-08,W.P. Kuala Lumpur,504,77,427,2023
2023-11-09,W.P. Kuala Lumpur,489,61,428,2023
2023-11-10,W.P. Kuala Lumpur,211,22,189,2023
2023-11-11,W.P. Kuala Lumpur,509,66,443,2023
2023-11-12,W.P. Kuala Lumpur,491,78,413,2023
2023-11-13,W.P. Kuala Lumpur,488,77,411,2023
2023-11-14,W.P. Kuala Lumpur,494,78,416,2023
2023-11-15,W.P. Kuala Lumpur,496,68,428,2023
2023-11-16,W.P. Kuala Lumpur,601,88,513,2023
2023-11-17,W.P. Kuala Lumpur,298,40,258,2023
2023-11-18,W.P. Kuala Lumpur,658,119,539,2023
2023-11-19,W.P. Kuala Lumpur,988,82,906,2023
2023-11-20,W.P. Kuala Lumpur,239,15,224,2023
2023-11-21,W.P. Kuala Lumpur,448,99,349,2023
2023-11-22,W.P. Kuala Lumpur,421,86,335,2023
2023-11-23,W.P. Kuala Lumpur,426,107,319,2023
2023-11-24,W.P. Kuala Lumpur,258,29,229,2023
2023-11-25,W.P. Kuala Lumpur,864,331,533,2023
2023-11-26,W.P. Kuala Lumpur,643,89,554,2023
2023-11-27,W.P. Kuala Lumpur,316,38,278,2023
2023-11-28,W.P. Kuala Lumpur,475,110,365,2023
2023-11-29,W.P. Kuala Lumpur,484,74,410,2023
2023-11-30,W.P. Kuala Lumpur,471,69,402,2023
2023-12-01,W.P. Kuala Lumpur,248,25,223,2023
2023-12-02,W.P. Kuala Lumpur,584,68,516,2023
2023-12-03,W.P. Kuala Lumpur,707,59,648,2023
2023-12-04,W.P. Kuala Lumpur,319,40,279,2023
2023-12-05,W.P. Kuala Lumpur,475,63,412,2023
2023-12-06,W.P. Kuala Lumpur,451,79,372,2023
2023-12-07,W.P. Kuala Lumpur,715,123,592,2023
2023-12-08,W.P. Kuala Lumpur,276,20,256,2023
2023-12-09,W.P. Kuala Lumpur,874,193,681,2023
2023-12-10,W.P. Kuala Lumpur,844,110,734,2023
2023-12-11,W.P. Kuala Lumpur,506,44,462,2023
2023-12-12,W.P. Kuala Lumpur,497,116,381,2023
2023-12-13,W.P. Kuala Lumpur,480,83,397,2023
2023-12-14,W.P. Kuala Lumpur,517,86,431,2023
2023-12-15,W.P. Kuala Lumpur,385,48,337,2023
2023-12-16,W.P. Kuala Lumpur,676,91,585,2023
2023-12-17,W.P. Kuala Lumpur,961,105,856,2023
2023-12-18,W.P. Kuala Lumpur,440,76,364,2023
2023-12-19,W.P. Kuala Lumpur,619,152,467,2023
2023-12-20,W.P. Kuala Lumpur,572,155,417,2023
2023-12-21,W.P. Kuala Lumpur,416,80,336,2023
2023-12-22,W.P. Kuala Lumpur,327,25,302,2023
2023-12-23,W.P. Kuala Lumpur,581,54,527,2023
2023-12-24,W.P. Kuala Lumpur,696,70,626,2023
2023-12-25,W.P. Kuala Lumpur,715,101,614,2023
2023-12-26,W.P. Kuala Lumpur,445,35,410,2023
2023-12-27,W.P. Kuala Lumpur,470,109,361,2023
2023-12-28,W.P. Kuala Lumpur,600,132,468,2023
2023-12-29,W.P. Kuala Lumpur,517,63,454,2023
2023-12-30,W.P. Kuala Lumpur,767,89,678,2023
2023-12-31,W.P. Kuala Lumpur,1038,145,893,2023
2024-01-01,W.P. Kuala Lumpur,661,64,597,2024
2024-01-02,W.P. Kuala Lumpur,299,29,270,2024
2024-01-03,W.P. Kuala Lumpur,419,62,357,2024
2024-01-04,W.P. Kuala Lumpur,448,117,331,2024
2024-01-05,W.P. Kuala Lumpur,382,84,298,2024
2024-01-06,W.P. Kuala Lumpur,724,99,625,2024
2024-01-07,W.P. Kuala Lumpur,1036,170,866,2024
2024-01-08,W.P. Kuala Lumpur,330,124,206,2024
2024-01-09,W.P. Kuala Lumpur,450,97,353,2024
2024-01-10,W.P. Kuala Lumpur,456,117,339,2024
2024-01-11,W.P. Kuala Lumpur,504,118,386,2024
2024-01-12,W.P. Kuala Lumpur,424,93,331,2024
2024-01-13,W.P. Kuala Lumpur,880,183,697,2024
2024-01-14,W.P. Kuala Lumpur,987,149,838,2024
2024-01-15,W.P. Kuala Lumpur,319,77,242,2024
2024-01-16,W.P. Kuala Lumpur,515,102,413,2024
2024-01-17,W.P. Kuala Lumpur,395,79,316,2024
2024-01-18,W.P. Kuala Lumpur,515,82,433,2024
2024-01-19,W.P. Kuala Lumpur,443,75,368,2024
2024-01-20,W.P. Kuala Lumpur,724,138,586,2024
2024-01-21,W.P. Kuala Lumpur,871,132,739,2024
2024-01-22,W.P. Kuala Lumpur,180,19,161,2024
2024-01-23,W.P. Kuala Lumpur,427,84,343,2024
2024-01-24,W.P. Kuala Lumpur,306,42,264,2024
2024-01-25,W.P. Kuala Lumpur,1521,283,1238,2024
2024-01-26,W.P. Kuala Lumpur,189,16,173,2024
2024-01-27,W.P. Kuala Lumpur,495,75,420,2024
2024-01-28,W.P. Kuala Lumpur,633,75,558,2024
2024-01-29,W.P. Kuala Lumpur,327,34,293,2024
2024-01-30,W.P. Kuala Lumpur,474,111,363,2024
2024-01-31,W.P. Kuala Lumpur,472,77,395,2024
2024-02-01,W.P. Kuala Lumpur,574,89,485,2024
2024-02-02,W.P. Kuala Lumpur,290,35,255,2024
